,start_nloc,start_token_count,start_function_count,start_functions,end_nloc,end_token_count,end_function_count,end_functions,delta_nloc,delta_token_count,delta_function_count,modification_count,fix_count,modifications,coupling,top_logical_connection
doc.go,1,2,0,[],1,2,0,[],0,0,0,1,1,"[{'timestamp': 1558049101.0, 'added_lines': 0, 'deleted_lines': 23, 'nloc': 1}]",{},"('core/core.go', 0.0, 0.0)"
assets/assets.go,72,501,3,"[{'cyclomatic_complexity': 1, 'nloc': 3, 'token_count': 26, 'name': 'SeedInitDocs', 'long_name': 'SeedInitDocs nd * core . IpfsNode', 'start_line': 33, 'end_line': 35, 'full_parameters': ['nd * core . IpfsNode'], 'filename': '/home/dimi/Documents/Informatik_Studium/FSS/SoftEvo/DataCollection/FFS_SoftEvo/go-ipfs/assets/assets.go', 'top_nesting_level': 0, 'length': 3, 'fan_in': 0, 'fan_out': 0, 'general_fan_out': 0}, {'cyclomatic_complexity': 1, 'nloc': 3, 'token_count': 26, 'name': 'SeedInitDirIndex', 'long_name': 'SeedInitDirIndex nd * core . IpfsNode', 'start_line': 43, 'end_line': 45, 'full_parameters': ['nd * core . IpfsNode'], 'filename': '/home/dimi/Documents/Informatik_Studium/FSS/SoftEvo/DataCollection/FFS_SoftEvo/go-ipfs/assets/assets.go', 'top_nesting_level': 0, 'length': 3, 'fan_in': 0, 'fan_out': 0, 'general_fan_out': 0}, {'cyclomatic_complexity': 11, 'nloc': 40, 'token_count': 313, 'name': 'addAssetList', 'long_name': 'addAssetList nd * core . IpfsNode , l [ ] string', 'start_line': 47, 'end_line': 97, 'full_parameters': ['nd * core . IpfsNode', ' l [ ] string'], 'filename': '/home/dimi/Documents/Informatik_Studium/FSS/SoftEvo/DataCollection/FFS_SoftEvo/go-ipfs/assets/assets.go', 'top_nesting_level': 0, 'length': 51, 'fan_in': 0, 'fan_out': 0, 'general_fan_out': 0}]",53,378,2,"[{'cyclomatic_complexity': 1, 'nloc': 3, 'token_count': 25, 'name': 'SeedInitDocs', 'long_name': 'SeedInitDocs nd * core . IpfsNode', 'start_line': 33, 'end_line': 35, 'full_parameters': ['nd * core . IpfsNode'], 'filename': '/home/dimi/Documents/Informatik_Studium/FSS/SoftEvo/DataCollection/FFS_SoftEvo/go-ipfs/assets/assets.go', 'top_nesting_level': 0, 'length': 3, 'fan_in': 0, 'fan_out': 0, 'general_fan_out': 0}, {'cyclomatic_complexity': 8, 'nloc': 30, 'token_count': 266, 'name': 'addAssetList', 'long_name': 'addAssetList nd * core . IpfsNode , l [ ] string', 'start_line': 37, 'end_line': 74, 'full_parameters': ['nd * core . IpfsNode', ' l [ ] string'], 'filename': '/home/dimi/Documents/Informatik_Studium/FSS/SoftEvo/DataCollection/FFS_SoftEvo/go-ipfs/assets/assets.go', 'top_nesting_level': 0, 'length': 38, 'fan_in': 0, 'fan_out': 0, 'general_fan_out': 0}]",-19,-123,-1,61,61,"[{'timestamp': 1512356285.0, 'added_lines': 1, 'deleted_lines': 6, 'nloc': 68}, {'timestamp': 1512365669.0, 'added_lines': 1, 'deleted_lines': 1, 'nloc': 68}, {'timestamp': 1516838128.0, 'added_lines': 1, 'deleted_lines': 1, 'nloc': 68}, {'timestamp': 1528520460.0, 'added_lines': 1, 'deleted_lines': 1, 'nloc': 68}, {'timestamp': 1531779409.0, 'added_lines': 1, 'deleted_lines': 1, 'nloc': 68}, {'timestamp': 1532986515.0, 'added_lines': 1, 'deleted_lines': 1, 'nloc': 68}, {'timestamp': 1533500571.0, 'added_lines': 1, 'deleted_lines': 1, 'nloc': 68}, {'timestamp': 1533618653.0, 'added_lines': 1, 'deleted_lines': 1, 'nloc': 68}, {'timestamp': 1533779477.0, 'added_lines': 1, 'deleted_lines': 1, 'nloc': 68}, {'timestamp': 1533946888.0, 'added_lines': 1, 'deleted_lines': 1, 'nloc': 68}, {'timestamp': 1534115707.0, 'added_lines': 2, 'deleted_lines': 2, 'nloc': 68}, {'timestamp': 1534195762.0, 'added_lines': 1, 'deleted_lines': 1, 'nloc': 68}, {'timestamp': 1534347022.0, 'added_lines': 2, 'deleted_lines': 2, 'nloc': 68}, {'timestamp': 1534896611.0, 'added_lines': 2, 'deleted_lines': 2, 'nloc': 68}, {'timestamp': 1535601896.0, 'added_lines': 1, 'deleted_lines': 1, 'nloc': 68}, {'timestamp': 1536388808.0, 'added_lines': 1, 'deleted_lines': 1, 'nloc': 68}, {'timestamp': 1536718784.0, 'added_lines': 13, 'deleted_lines': 13, 'nloc': 68}, {'timestamp': 1536723292.0, 'added_lines': 1, 'deleted_lines': 1, 'nloc': 68}, {'timestamp': 1537790637.0, 'added_lines': 1, 'deleted_lines': 1, 'nloc': 68}, {'timestamp': 1537792589.0, 'added_lines': 1, 'deleted_lines': 1, 'nloc': 68}, {'timestamp': 1538544957.0, 'added_lines': 1, 'deleted_lines': 1, 'nloc': 68}, {'timestamp': 1538694687.0, 'added_lines': 1, 'deleted_lines': 1, 'nloc': 68}, {'timestamp': 1538695953.0, 'added_lines': 1, 'deleted_lines': 1, 'nloc': 68}, {'timestamp': 1538773916.0, 'added_lines': 1, 'deleted_lines': 1, 'nloc': 68}, {'timestamp': 1539176817.0, 'added_lines': 1, 'deleted_lines': 1, 'nloc': 68}, {'timestamp': 1539357340.0, 'added_lines': 1, 'deleted_lines': 1, 'nloc': 68}, {'timestamp': 1539850591.0, 'added_lines': 1, 'deleted_lines': 1, 'nloc': 68}, {'timestamp': 1540400358.0, 'added_lines': 1, 'deleted_lines': 1, 'nloc': 68}, {'timestamp': 1540410565.0, 'added_lines': 1, 'deleted_lines': 1, 'nloc': 68}, {'timestamp': 1540418491.0, 'added_lines': 1, 'deleted_lines': 1, 'nloc': 68}, {'timestamp': 1540603818.0, 'added_lines': 1, 'deleted_lines': 1, 'nloc': 68}, {'timestamp': 1541106379.0, 'added_lines': 1, 'deleted_lines': 1, 'nloc': 68}, {'timestamp': 1541189794.0, 'added_lines': 1, 'deleted_lines': 1, 'nloc': 68}, {'timestamp': 1541204121.0, 'added_lines': 2, 'deleted_lines': 2, 'nloc': 68}, {'timestamp': 1541903826.0, 'added_lines': 1, 'deleted_lines': 1, 'nloc': 68}, {'timestamp': 1543443696.0, 'added_lines': 1, 'deleted_lines': 1, 'nloc': 68}, {'timestamp': 1544225843.0, 'added_lines': 1, 'deleted_lines': 1, 'nloc': 68}, {'timestamp': 1540556089.0, 'added_lines': 1, 'deleted_lines': 1, 'nloc': 68}, {'timestamp': 1541682253.0, 'added_lines': 3, 'deleted_lines': 3, 'nloc': 68}, {'timestamp': 1547003974.0, 'added_lines': 1, 'deleted_lines': 1, 'nloc': 68}, {'timestamp': 1547499910.0, 'added_lines': 1, 'deleted_lines': 1, 'nloc': 68}, {'timestamp': 1548165641.0, 'added_lines': 21, 'deleted_lines': 27, 'nloc': 63}, {'timestamp': 1548866534.0, 'added_lines': 1, 'deleted_lines': 1, 'nloc': 63}, {'timestamp': 1549672857.0, 'added_lines': 2, 'deleted_lines': 2, 'nloc': 63}, {'timestamp': 1549673846.0, 'added_lines': 2, 'deleted_lines': 2, 'nloc': 63}, {'timestamp': 1549903582.0, 'added_lines': 3, 'deleted_lines': 3, 'nloc': 63}, {'timestamp': 1550185115.0, 'added_lines': 2, 'deleted_lines': 2, 'nloc': 63}, {'timestamp': 1550507829.0, 'added_lines': 2, 'deleted_lines': 2, 'nloc': 63}, {'timestamp': 1550576884.0, 'added_lines': 2, 'deleted_lines': 2, 'nloc': 63}, {'timestamp': 1550711994.0, 'added_lines': 2, 'deleted_lines': 2, 'nloc': 63}, {'timestamp': 1550723346.0, 'added_lines': 3, 'deleted_lines': 3, 'nloc': 63}, {'timestamp': 1551229859.0, 'added_lines': 2, 'deleted_lines': 2, 'nloc': 63}, {'timestamp': 1551299964.0, 'added_lines': 2, 'deleted_lines': 2, 'nloc': 63}, {'timestamp': 1551551196.0, 'added_lines': 5, 'deleted_lines': 5, 'nloc': 63}, {'timestamp': 1553608614.0, 'added_lines': 2, 'deleted_lines': 2, 'nloc': 63}, {'timestamp': 1559787584.0, 'added_lines': 2, 'deleted_lines': 16, 'nloc': 53}, {'timestamp': 1561317459.0, 'added_lines': 2, 'deleted_lines': 0, 'nloc': 53}, {'timestamp': 1597808082.0, 'added_lines': 1, 'deleted_lines': 1, 'nloc': 53}, {'timestamp': 1597881449.0, 'added_lines': 1, 'deleted_lines': 1, 'nloc': 53}, {'timestamp': 1612816895.0, 'added_lines': 2, 'deleted_lines': 2, 'nloc': 53}, {'timestamp': 1612817391.0, 'added_lines': 2, 'deleted_lines': 2, 'nloc': 53}]","{'cmd/ipfs/init.go': 22, 'fuse/ipns/common.go': 45, 'namesys/publisher.go': 50, 'blocks/blockstore/arc_cache.go': 2, 'blocks/blockstore/arc_cache_test.go': 2, 'blocks/blockstore/blockstore.go': 2, 'blocks/blockstore/blockstore_test.go': 2, 'blocks/blockstore/bloom_cache.go': 2, 'blocks/blockstore/bloom_cache_test.go': 2, 'blocks/blockstore/util/remove.go': 2, 'blocks/blocksutil/block_generator.go': 2, 'blockservice/blockservice.go': 4, 'blockservice/blockservice_test.go': 4, 'blockservice/test/blocks_test.go': 4, 'cmd/ipfs/daemon.go': 18, 'cmd/ipfs/ipfs.go': 15, 'cmd/ipfs/main.go': 22, 'cmd/ipfs/main_test.go': 1, 'cmd/ipfswatch/main.go': 17, 'cmd/seccat/seccat.go': 20, 'commands/command.go': 9, 'commands/command_test.go': 2, 'commands/request.go': 13, 'commands/response.go': 6, 'commands/response_test.go': 2, 'core/bootstrap.go': 19, 'core/bootstrap_test.go': 19, 'core/builder.go': 48, 'core/commands/active.go': 11, 'core/commands/add.go': 37, 'core/commands/bitswap.go': 43, 'core/commands/block.go': 26, 'core/commands/bootstrap.go': 20, 'core/commands/cat.go': 23, 'core/commands/commands.go': 15, 'core/commands/config.go': 20, 'core/commands/dag/dag.go': 50, 'core/commands/dht.go': 46, 'core/commands/dht_test.go': 18, 'core/commands/diag.go': 11, 'core/commands/dns.go': 18, 'core/commands/external.go': 11, 'core/commands/files/files.go': 2, 'core/commands/filestore.go': 20, 'core/commands/get.go': 51, 'core/commands/get_test.go': 15, 'core/commands/helptext_test.go': 15, 'core/commands/id.go': 31, 'core/commands/ipns.go': 9, 'core/commands/ipnsps.go': 5, 'core/commands/keystore.go': 22, 'core/commands/log.go': 14, 'core/commands/ls.go': 52, 'core/commands/mount_nofuse.go': 11, 'core/commands/mount_unix.go': 20, 'core/commands/mount_windows.go': 11, 'core/commands/name.go': 4, 'core/commands/object/diff.go': 20, 'core/commands/object/object.go': 51, 'core/commands/object/patch.go': 23, 'core/commands/p2p.go': 22, 'core/commands/pin.go': 51, 'core/commands/ping.go': 26, 'core/commands/publish.go': 11, 'core/commands/pubsub.go': 31, 'core/commands/refs.go': 46, 'core/commands/repo.go': 32, 'core/commands/resolve.go': 48, 'core/commands/root.go': 15, 'core/commands/shutdown.go': 14, 'core/commands/stat.go': 18, 'core/commands/swarm.go': 28, 'core/commands/sysdiag.go': 16, 'core/commands/tar.go': 44, 'core/commands/unixfs/ls.go': 50, 'core/commands/unixfs/unixfs.go': 11, 'core/commands/version.go': 12, 'core/core.go': 48, 'core/coreapi/coreapi.go': 26, 'core/coreapi/interface/interface.go': 2, 'core/coreapi/unixfs.go': 52, 'core/coreapi/unixfs_test.go': 37, 'core/coredag/cbor.go': 17, 'core/coredag/dagpb.go': 41, 'core/coredag/dagtransl.go': 13, 'core/coredag/raw.go': 41, 'core/corehttp/commands.go': 45, 'core/corehttp/corehttp.go': 11, 'core/corehttp/gateway.go': 31, 'core/corehttp/gateway_handler.go': 54, 'core/corehttp/gateway_test.go': 48, 'core/corehttp/metrics_test.go': 26, 'core/corerepo/gc.go': 43, 'core/corerepo/pinning.go': 20, 'core/coreunix/add.go': 53, 'core/coreunix/add_test.go': 50, 'core/coreunix/metadata.go': 48, 'core/coreunix/metadata_test.go': 48, 'core/mock/mock.go': 27, 'core/pathresolver.go': 41, 'exchange/bitswap/bitswap.go': 4, 'exchange/bitswap/bitswap_test.go': 4, 'exchange/bitswap/decision/bench_test.go': 4, 'exchange/bitswap/decision/engine.go': 4, 'exchange/bitswap/decision/engine_test.go': 4, 'exchange/bitswap/decision/ledger.go': 4, 'exchange/bitswap/decision/peer_request_queue.go': 4, 'exchange/bitswap/decision/peer_request_queue_test.go': 4, 'exchange/bitswap/get.go': 4, 'exchange/bitswap/message/message.go': 4, 'exchange/bitswap/message/message_test.go': 4, 'exchange/bitswap/network/interface.go': 4, 'exchange/bitswap/network/ipfs_impl.go': 4, 'exchange/bitswap/notifications/notifications.go': 4, 'exchange/bitswap/notifications/notifications_test.go': 4, 'exchange/bitswap/session.go': 4, 'exchange/bitswap/session_test.go': 4, 'exchange/bitswap/stat.go': 4, 'exchange/bitswap/testnet/interface.go': 3, 'exchange/bitswap/testnet/network_test.go': 4, 'exchange/bitswap/testnet/peernet.go': 4, 'exchange/bitswap/testnet/virtual.go': 4, 'exchange/bitswap/testutils.go': 4, 'exchange/bitswap/wantlist/wantlist.go': 4, 'exchange/bitswap/wantlist/wantlist_test.go': 4, 'exchange/bitswap/wantmanager.go': 4, 'exchange/bitswap/workers.go': 4, 'exchange/interface.go': 2, 'exchange/offline/offline.go': 2, 'exchange/offline/offline_test.go': 2, 'exchange/reprovide/providers.go': 41, 'exchange/reprovide/reprovide.go': 24, 'exchange/reprovide/reprovide_test.go': 28, 'filestore/filestore.go': 23, 'filestore/filestore_test.go': 41, 'filestore/fsrefstore.go': 23, 'filestore/util.go': 21, 'fuse/ipns/ipns_test.go': 26, 'fuse/ipns/ipns_unix.go': 48, 'fuse/node/mount_test.go': 26, 'fuse/readonly/ipfs_test.go': 52, 'fuse/readonly/readonly_unix.go': 48, 'importer/balanced/balanced_test.go': 4, 'importer/balanced/builder.go': 4, 'importer/chunk/rabin_test.go': 2, 'importer/chunk/splitting_test.go': 2, 'importer/helpers/dagbuilder.go': 4, 'importer/helpers/helpers.go': 4, 'importer/importer.go': 4, 'importer/importer_test.go': 4, 'importer/trickle/trickle_test.go': 4, 'importer/trickle/trickledag.go': 4, 'merkledag/batch.go': 2, 'merkledag/coding.go': 4, 'merkledag/merkledag.go': 4, 'merkledag/merkledag_test.go': 4, 'merkledag/node.go': 4, 'merkledag/node_test.go': 4, 'merkledag/raw.go': 4, 'merkledag/traverse/traverse.go': 4, 'merkledag/traverse/traverse_test.go': 4, 'merkledag/utils/diff.go': 4, 'merkledag/utils/diffenum.go': 4, 'merkledag/utils/diffenum_test.go': 4, 'merkledag/utils/utils.go': 4, 'merkledag/utils/utils_test.go': 4, 'mfs/dir.go': 12, 'mfs/file.go': 12, 'mfs/mfs_test.go': 12, 'mfs/ops.go': 10, 'mfs/repub_test.go': 7, 'mfs/system.go': 12, 'namesys/ipns_select_test.go': 3, 'namesys/namesys.go': 45, 'namesys/publisher_test.go': 27, 'namesys/pubsub.go': 2, 'namesys/pubsub_test.go': 2, 'namesys/republisher/repub.go': 40, 'namesys/republisher/repub_test.go': 40, 'namesys/resolve_test.go': 42, 'namesys/routing.go': 45, 'p2p/p2p.go': 19, 'p2p/registry.go': 7, 'package.json': 49, 'path/path.go': 4, 'path/resolver.go': 2, 'path/resolver_test.go': 2, 'pin/gc/gc.go': 41, 'pin/pin.go': 41, 'pin/pin_test.go': 41, 'pin/set.go': 41, 'pin/set_test.go': 41, 'plugin/ipld.go': 13, 'plugin/loader/initializer.go': 10, 'plugin/plugins/git/git.go': 13, 'repo/config/bootstrap_peers.go': 4, 'repo/config/init.go': 4, 'repo/fsrepo/fsrepo.go': 19, 'repo/fsrepo/lock/lock.go': 2, 'repo/fsrepo/serialize/serialize.go': 3, 'repo/mock.go': 15, 'repo/repo.go': 18, 'routing/mock/centralized_client.go': 2, 'routing/mock/centralized_server.go': 2, 'routing/mock/centralized_test.go': 2, 'routing/mock/interface.go': 2, 'routing/none/none_client.go': 2, 'routing/offline/offline.go': 2, 'routing/offline/offline_test.go': 2, 'tar/format.go': 48, 'test/dependencies/ma-pipe-unidir/main.go': 8, 'test/integration/addcat_test.go': 29, 'test/integration/bench_cat_test.go': 29, 'test/integration/bench_test.go': 13, 'test/integration/bitswap_wo_routing_test.go': 30, 'test/integration/three_legged_cat_test.go': 29, 'thirdparty/ds-help/key.go': 2, 'thirdparty/pollEndpoint/main.go': 11, 'thirdparty/posinfo/posinfo.go': 2, 'unixfs/archive/archive.go': 5, 'unixfs/archive/tar/writer.go': 5, 'unixfs/hamt/hamt.go': 5, 'unixfs/io/dagreader.go': 5, 'unixfs/io/dirbuilder.go': 3, 'unixfs/io/resolve.go': 5, 'unixfs/mod/dagmodifier.go': 5, 'unixfs/mod/dagmodifier_test.go': 4, 'unixfs/test/utils.go': 5, 'commands/legacy/command.go': 8, 'commands/legacy/legacy.go': 8, 'commands/legacy/legacy_test.go': 8, 'commands/legacy/request.go': 8, 'commands/legacy/response.go': 8, 'core/commands/commands_test.go': 14, 'core/coreapi/dag.go': 12, 'core/coreapi/dag_test.go': 3, 'core/coreapi/interface/options/dag.go': 8, 'core/coreapi/key.go': 44, 'core/coreapi/name.go': 45, 'merkledag/test/utils.go': 3, 'namesys/namesys_test.go': 50, 'repo/fsrepo/datastores.go': 12, 'repo/fsrepo/fsrepo_test.go': 16, 'thirdparty/datastore2/datastore_closer.go': 1, 'thirdparty/datastore2/delayed.go': 1, 'thirdparty/datastore2/threadsafe.go': 1, 'unixfs/io/pbdagreader.go': 4, 'blocks/blockstoreutil/remove.go': 19, 'blockservice/test/mock.go': 2, 'cmd/ipfs/util/ulimit.go': 6, 'cmd/ipfs/util/ulimit_freebsd.go': 2, 'cmd/ipfs/util/ulimit_unix.go': 2, 'cmd/seccat/util.go': 6, 'core/commands/files.go': 50, 'core/coreapi/block.go': 19, 'core/coreapi/block_test.go': 2, 'core/coreapi/interface/coreapi.go': 9, 'core/coreapi/interface/dag.go': 9, 'core/coreapi/interface/object.go': 9, 'core/coreapi/interface/options/block.go': 3, 'core/coreapi/interface/path.go': 32, 'core/coreapi/interface/unixfs.go': 12, 'core/coreapi/object.go': 50, 'core/coreapi/pin.go': 44, 'core/corehttp/logs.go': 6, 'fuse/ipns/link_unix.go': 2, 'fuse/mount/fuse.go': 2, 'fuse/mount/mount.go': 6, 'fuse/node/mount_darwin.go': 2, 'fuse/node/mount_unix.go': 6, 'keystore/keystore.go': 6, 'merkledag/errservice.go': 2, 'merkledag/readonly.go': 2, 'merkledag/readonly_test.go': 2, 'merkledag/rwservice.go': 2, 'merkledag/session.go': 2, 'namesys/ipns_validate_test.go': 1, 'namesys/validator.go': 1, 'path/resolver/resolver.go': 2, 'path/resolver/resolver_test.go': 2, 'plugin/loader/load.go': 4, 'thirdparty/verifbs/verifbs.go': 19, 'thirdparty/verifcid/validate.go': 2, 'thirdparty/verifcid/validate_test.go': 2, 'unixfs/hamt/hamt_stress_test.go': 3, 'unixfs/hamt/hamt_test.go': 3, 'core/commands/urlstore.go': 45, 'namesys/ipns_resolver_validation_test.go': 42, 'unixfs/io/directory.go': 2, 'core/coreapi/path.go': 48, 'core/coreunix/cat.go': 15, 'mfs/fd.go': 8, 'unixfs/importer/balanced/balanced_test.go': 1, 'unixfs/importer/balanced/builder.go': 1, 'unixfs/importer/helpers/dagbuilder.go': 1, 'unixfs/importer/helpers/helpers.go': 1, 'unixfs/importer/importer.go': 1, 'unixfs/importer/importer_test.go': 1, 'unixfs/importer/trickle/trickle_test.go': 1, 'unixfs/importer/trickle/trickledag.go': 1, 'unixfs/io/dagreader_test.go': 1, 'unixfs/io/directory_test.go': 1, 'unixfs/unixfs.go': 1, 'unixfs/unixfs_test.go': 1, 'core/coreapi/name_test.go': 30, 'core/pathresolver_test.go': 37, 'dagutils/diff.go': 41, 'dagutils/diffenum.go': 37, 'dagutils/diffenum_test.go': 37, 'dagutils/utils.go': 37, 'dagutils/utils_test.go': 37, 'namesys/base.go': 41, 'namesys/cache.go': 37, 'namesys/dns.go': 41, 'namesys/interface.go': 41, 'namesys/proquint.go': 41, 'core/commands/env.go': 3, 'core/coreapi/interface/key.go': 6, 'filestore/pb/dataobj.pb.go': 3, 'keystore/keystore_test.go': 4, 'keystore/memkeystore.go': 4, 'pin/internal/pb/header.pb.go': 3, 'repo/config/identity.go': 1, 'thirdparty/cidv0v1/blockstore.go': 16, 'core/core_test.go': 15, 'repo/fsrepo/config_test.go': 12, 'repo/fsrepo/misc.go': 12, 'test/bench/bench_cli_ipfs_add/main.go': 12, 'test/bench/offline_add/main.go': 12, 'core/commands/cmdenv/env.go': 22, 'core/commands/name/ipns.go': 37, 'core/commands/name/publish.go': 23, 'core/coreapi/dht.go': 33, 'core/coreapi/dht_test.go': 5, 'test/sharness/t0275-cid-security.sh': 1, 'core/commands/name/ipnsps.go': 12, 'core/commands/name/name.go': 9, 'core/coreapi/interface/dht.go': 9, 'p2p/listener.go': 12, 'p2p/local.go': 12, 'p2p/remote.go': 12, 'p2p/stream.go': 12, 'core/coreapi/interface/swarm.go': 8, 'core/coreapi/swarm.go': 22, 'core/coreapi/interface/options/unixfs.go': 14, 'core/coreapi/pubsub.go': 20, 'core/coreapi/unixfile.go': 17, 'core/commands/cid.go': 9, 'cmd/ipfs/dnsresolve_test.go': 5, 'core/coreapi/interface/pubsub.go': 3, 'test/dependencies/iptb/iptb.go': 11, 'plugin/plugins/badgerds/badgerds.go': 3, 'plugin/plugins/flatfs/flatfs.go': 3, 'plugin/plugins/levelds/levelds.go': 3, 'commands/context.go': 15, 'core/corehttp/proxy.go': 8, 'assets/bindata.go': 4, 'core/corehttp/gateway_indexPage.go': 1, 'core/coreapi/interface/tests/name.go': 3, 'core/coreapi/interface/tests/unixfs.go': 3, 'core/coreapi/test/api_test.go': 12, 'plugin/loader/loader.go': 12, 'core/commands/cmdenv/cidbase.go': 6, 'core/commands/cmdenv/file.go': 3, 'core/corehttp/ipns_hostname.go': 11, 'namesys/dns_test.go': 10, 'plugin/daemon.go': 10, 'core/commands/cmdenv/cidbase_test.go': 2, 'core/corehttp/metrics.go': 1, 'core/corehttp/proxy_test.go': 1, 'core/corerepo/stat.go': 1, 'plugin/tracer.go': 1, 'thirdparty/notifier/notifier.go': 1, '.gitmodules': 1, 'assets/README.md': 1, 'assets/assets_test.go': 1, 'assets/bindata_dep.go': 1, 'assets/dir-index-html': 1, 'go.mod': 1, 'go.sum': 1, 'assets/bindata_version_hash.go': 3, 'bin/test-go-fmt': 2, None: 1}","('core/corehttp/gateway_handler.go', 0.8852459016393442, 0.34394904458598724)"
assets/assets_test.go,45,246,5,"[{'cyclomatic_complexity': 1, 'nloc': 3, 'token_count': 21, 'name': 'TestEmbeddedDocs', 'long_name': 'TestEmbeddedDocs t * testing . T', 'start_line': 11, 'end_line': 13, 'full_parameters': ['t * testing . T'], 'filename': '/home/dimi/Documents/Informatik_Studium/FSS/SoftEvo/DataCollection/FFS_SoftEvo/go-ipfs/assets/assets_test.go', 'top_nesting_level': 0, 'length': 3, 'fan_in': 0, 'fan_out': 0, 'general_fan_out': 0}, {'cyclomatic_complexity': 1, 'nloc': 4, 'token_count': 27, 'name': 'TestDirIndex', 'long_name': 'TestDirIndex t * testing . T', 'start_line': 15, 'end_line': 21, 'full_parameters': ['t * testing . T'], 'filename': '/home/dimi/Documents/Informatik_Studium/FSS/SoftEvo/DataCollection/FFS_SoftEvo/go-ipfs/assets/assets_test.go', 'top_nesting_level': 0, 'length': 7, 'fan_in': 0, 'fan_out': 0, 'general_fan_out': 0}, {'cyclomatic_complexity': 1, 'nloc': 4, 'token_count': 19, 'name': '', 'long_name': '(f string)', 'start_line': 32, 'end_line': 35, 'full_parameters': [], 'filename': '/home/dimi/Documents/Informatik_Studium/FSS/SoftEvo/DataCollection/FFS_SoftEvo/go-ipfs/assets/assets_test.go', 'top_nesting_level': 0, 'length': 4, 'fan_in': 0, 'fan_out': 0, 'general_fan_out': 0}, {'cyclomatic_complexity': 3, 'nloc': 11, 'token_count': 76, 'name': 'testNFiles', 'long_name': 'testNFiles fs [ ] string , wantCnt int , t * testing . T , ftype string', 'start_line': 23, 'end_line': 38, 'full_parameters': ['fs [ ] string', ' wantCnt int', ' t * testing . T', ' ftype string'], 'filename': '/home/dimi/Documents/Informatik_Studium/FSS/SoftEvo/DataCollection/FFS_SoftEvo/go-ipfs/assets/assets_test.go', 'top_nesting_level': 0, 'length': 16, 'fan_in': 0, 'fan_out': 0, 'general_fan_out': 0}, {'cyclomatic_complexity': 4, 'nloc': 17, 'token_count': 95, 'name': 'testOneFile', 'long_name': 'testOneFile f string , t * testing . T', 'start_line': 40, 'end_line': 61, 'full_parameters': ['f string', ' t * testing . T'], 'filename': '/home/dimi/Documents/Informatik_Studium/FSS/SoftEvo/DataCollection/FFS_SoftEvo/go-ipfs/assets/assets_test.go', 'top_nesting_level': 0, 'length': 22, 'fan_in': 0, 'fan_out': 0, 'general_fan_out': 0}]",41,219,4,"[{'cyclomatic_complexity': 1, 'nloc': 3, 'token_count': 21, 'name': 'TestEmbeddedDocs', 'long_name': 'TestEmbeddedDocs t * testing . T', 'start_line': 11, 'end_line': 13, 'full_parameters': ['t * testing . T'], 'filename': '/home/dimi/Documents/Informatik_Studium/FSS/SoftEvo/DataCollection/FFS_SoftEvo/go-ipfs/assets/assets_test.go', 'top_nesting_level': 0, 'length': 3, 'fan_in': 0, 'fan_out': 0, 'general_fan_out': 0}, {'cyclomatic_complexity': 1, 'nloc': 4, 'token_count': 19, 'name': '', 'long_name': '(f string)', 'start_line': 24, 'end_line': 27, 'full_parameters': [], 'filename': '/home/dimi/Documents/Informatik_Studium/FSS/SoftEvo/DataCollection/FFS_SoftEvo/go-ipfs/assets/assets_test.go', 'top_nesting_level': 0, 'length': 4, 'fan_in': 0, 'fan_out': 0, 'general_fan_out': 0}, {'cyclomatic_complexity': 3, 'nloc': 11, 'token_count': 76, 'name': 'testNFiles', 'long_name': 'testNFiles fs [ ] string , wantCnt int , t * testing . T , ftype string', 'start_line': 15, 'end_line': 30, 'full_parameters': ['fs [ ] string', ' wantCnt int', ' t * testing . T', ' ftype string'], 'filename': '/home/dimi/Documents/Informatik_Studium/FSS/SoftEvo/DataCollection/FFS_SoftEvo/go-ipfs/assets/assets_test.go', 'top_nesting_level': 0, 'length': 16, 'fan_in': 0, 'fan_out': 0, 'general_fan_out': 0}, {'cyclomatic_complexity': 4, 'nloc': 17, 'token_count': 95, 'name': 'testOneFile', 'long_name': 'testOneFile f string , t * testing . T', 'start_line': 32, 'end_line': 53, 'full_parameters': ['f string', ' t * testing . T'], 'filename': '/home/dimi/Documents/Informatik_Studium/FSS/SoftEvo/DataCollection/FFS_SoftEvo/go-ipfs/assets/assets_test.go', 'top_nesting_level': 0, 'length': 22, 'fan_in': 0, 'fan_out': 0, 'general_fan_out': 0}]",-4,-27,-1,1,1,"[{'timestamp': 1559787584.0, 'added_lines': 0, 'deleted_lines': 8, 'nloc': 41}]","{'.gitmodules': 1, 'assets/README.md': 1, 'assets/assets.go': 1, 'assets/bindata.go': 1, 'assets/bindata_dep.go': 1, 'assets/dir-index-html': 1, 'go.mod': 1, 'go.sum': 1}","('assets/assets.go', 1.0, 0.01639344262295082)"
assets/bindata.go,417,2804,44,"[{'cyclomatic_complexity': 4, 'nloc': 16, 'token_count': 116, 'name': 'bindataRead', 'long_name': 'bindataRead data [ ] byte , name string', 'start_line': 33, 'end_line': 51, 'full_parameters': ['data [ ] byte', ' name string'], 'filename': '/home/dimi/Documents/Informatik_Studium/FSS/SoftEvo/DataCollection/FFS_SoftEvo/go-ipfs/assets/bindata.go', 'top_nesting_level': 0, 'length': 19, 'fan_in': 0, 'fan_out': 0, 'general_fan_out': 0}, {'cyclomatic_complexity': 1, 'nloc': 3, 'token_count': 15, 'name': 'Name', 'long_name': '(fi bindataFileInfo)Name', 'start_line': 65, 'end_line': 67, 'full_parameters': [], 'filename': '/home/dimi/Documents/Informatik_Studium/FSS/SoftEvo/DataCollection/FFS_SoftEvo/go-ipfs/assets/bindata.go', 'top_nesting_level': 0, 'length': 3, 'fan_in': 0, 'fan_out': 0, 'general_fan_out': 0}, {'cyclomatic_complexity': 1, 'nloc': 3, 'token_count': 15, 'name': 'Size', 'long_name': '(fi bindataFileInfo)Size', 'start_line': 68, 'end_line': 70, 'full_parameters': [], 'filename': '/home/dimi/Documents/Informatik_Studium/FSS/SoftEvo/DataCollection/FFS_SoftEvo/go-ipfs/assets/bindata.go', 'top_nesting_level': 0, 'length': 3, 'fan_in': 0, 'fan_out': 0, 'general_fan_out': 0}, {'cyclomatic_complexity': 1, 'nloc': 3, 'token_count': 17, 'name': 'Mode', 'long_name': '(fi bindataFileInfo)Mode', 'start_line': 71, 'end_line': 73, 'full_parameters': [], 'filename': '/home/dimi/Documents/Informatik_Studium/FSS/SoftEvo/DataCollection/FFS_SoftEvo/go-ipfs/assets/bindata.go', 'top_nesting_level': 0, 'length': 3, 'fan_in': 0, 'fan_out': 0, 'general_fan_out': 0}, {'cyclomatic_complexity': 1, 'nloc': 3, 'token_count': 17, 'name': 'ModTime', 'long_name': '(fi bindataFileInfo)ModTime', 'start_line': 74, 'end_line': 76, 'full_parameters': [], 'filename': '/home/dimi/Documents/Informatik_Studium/FSS/SoftEvo/DataCollection/FFS_SoftEvo/go-ipfs/assets/bindata.go', 'top_nesting_level': 0, 'length': 3, 'fan_in': 0, 'fan_out': 0, 'general_fan_out': 0}, {'cyclomatic_complexity': 1, 'nloc': 3, 'token_count': 13, 'name': 'IsDir', 'long_name': '(fi bindataFileInfo)IsDir', 'start_line': 77, 'end_line': 79, 'full_parameters': [], 'filename': '/home/dimi/Documents/Informatik_Studium/FSS/SoftEvo/DataCollection/FFS_SoftEvo/go-ipfs/assets/bindata.go', 'top_nesting_level': 0, 'length': 3, 'fan_in': 0, 'fan_out': 0, 'general_fan_out': 0}, {'cyclomatic_complexity': 1, 'nloc': 1, 'token_count': 11, 'name': 'Sys', 'long_name': '(fi bindataFileInfo)Sys', 'start_line': 80, 'end_line': 80, 'full_parameters': [], 'filename': '/home/dimi/Documents/Informatik_Studium/FSS/SoftEvo/DataCollection/FFS_SoftEvo/go-ipfs/assets/bindata.go', 'top_nesting_level': 0, 'length': 1, 'fan_in': 0, 'fan_out': 0, 'general_fan_out': 0}, {'cyclomatic_complexity': 1, 'nloc': 6, 'token_count': 21, 'name': 'initDocAboutBytes', 'long_name': 'initDocAboutBytes', 'start_line': 86, 'end_line': 91, 'full_parameters': [], 'filename': '/home/dimi/Documents/Informatik_Studium/FSS/SoftEvo/DataCollection/FFS_SoftEvo/go-ipfs/assets/bindata.go', 'top_nesting_level': 0, 'length': 6, 'fan_in': 0, 'fan_out': 0, 'general_fan_out': 0}, {'cyclomatic_complexity': 2, 'nloc': 9, 'token_count': 78, 'name': 'initDocAbout', 'long_name': 'initDocAbout', 'start_line': 93, 'end_line': 102, 'full_parameters': [], 'filename': '/home/dimi/Documents/Informatik_Studium/FSS/SoftEvo/DataCollection/FFS_SoftEvo/go-ipfs/assets/bindata.go', 'top_nesting_level': 0, 'length': 10, 'fan_in': 0, 'fan_out': 0, 'general_fan_out': 0}, {'cyclomatic_complexity': 1, 'nloc': 6, 'token_count': 21, 'name': 'initDocContactBytes', 'long_name': 'initDocContactBytes', 'start_line': 106, 'end_line': 111, 'full_parameters': [], 'filename': '/home/dimi/Documents/Informatik_Studium/FSS/SoftEvo/DataCollection/FFS_SoftEvo/go-ipfs/assets/bindata.go', 'top_nesting_level': 0, 'length': 6, 'fan_in': 0, 'fan_out': 0, 'general_fan_out': 0}, {'cyclomatic_complexity': 2, 'nloc': 9, 'token_count': 78, 'name': 'initDocContact', 'long_name': 'initDocContact', 'start_line': 113, 'end_line': 122, 'full_parameters': [], 'filename': '/home/dimi/Documents/Informatik_Studium/FSS/SoftEvo/DataCollection/FFS_SoftEvo/go-ipfs/assets/bindata.go', 'top_nesting_level': 0, 'length': 10, 'fan_in': 0, 'fan_out': 0, 'general_fan_out': 0}, {'cyclomatic_complexity': 1, 'nloc': 6, 'token_count': 21, 'name': 'initDocHelpBytes', 'long_name': 'initDocHelpBytes', 'start_line': 126, 'end_line': 131, 'full_parameters': [], 'filename': '/home/dimi/Documents/Informatik_Studium/FSS/SoftEvo/DataCollection/FFS_SoftEvo/go-ipfs/assets/bindata.go', 'top_nesting_level': 0, 'length': 6, 'fan_in': 0, 'fan_out': 0, 'general_fan_out': 0}, {'cyclomatic_complexity': 2, 'nloc': 9, 'token_count': 78, 'name': 'initDocHelp', 'long_name': 'initDocHelp', 'start_line': 133, 'end_line': 142, 'full_parameters': [], 'filename': '/home/dimi/Documents/Informatik_Studium/FSS/SoftEvo/DataCollection/FFS_SoftEvo/go-ipfs/assets/bindata.go', 'top_nesting_level': 0, 'length': 10, 'fan_in': 0, 'fan_out': 0, 'general_fan_out': 0}, {'cyclomatic_complexity': 1, 'nloc': 6, 'token_count': 21, 'name': 'initDocPingBytes', 'long_name': 'initDocPingBytes', 'start_line': 146, 'end_line': 151, 'full_parameters': [], 'filename': '/home/dimi/Documents/Informatik_Studium/FSS/SoftEvo/DataCollection/FFS_SoftEvo/go-ipfs/assets/bindata.go', 'top_nesting_level': 0, 'length': 6, 'fan_in': 0, 'fan_out': 0, 'general_fan_out': 0}, {'cyclomatic_complexity': 2, 'nloc': 9, 'token_count': 78, 'name': 'initDocPing', 'long_name': 'initDocPing', 'start_line': 153, 'end_line': 162, 'full_parameters': [], 'filename': '/home/dimi/Documents/Informatik_Studium/FSS/SoftEvo/DataCollection/FFS_SoftEvo/go-ipfs/assets/bindata.go', 'top_nesting_level': 0, 'length': 10, 'fan_in': 0, 'fan_out': 0, 'general_fan_out': 0}, {'cyclomatic_complexity': 1, 'nloc': 6, 'token_count': 21, 'name': 'initDocQuickStartBytes', 'long_name': 'initDocQuickStartBytes', 'start_line': 166, 'end_line': 171, 'full_parameters': [], 'filename': '/home/dimi/Documents/Informatik_Studium/FSS/SoftEvo/DataCollection/FFS_SoftEvo/go-ipfs/assets/bindata.go', 'top_nesting_level': 0, 'length': 6, 'fan_in': 0, 'fan_out': 0, 'general_fan_out': 0}, {'cyclomatic_complexity': 2, 'nloc': 9, 'token_count': 78, 'name': 'initDocQuickStart', 'long_name': 'initDocQuickStart', 'start_line': 173, 'end_line': 182, 'full_parameters': [], 'filename': '/home/dimi/Documents/Informatik_Studium/FSS/SoftEvo/DataCollection/FFS_SoftEvo/go-ipfs/assets/bindata.go', 'top_nesting_level': 0, 'length': 10, 'fan_in': 0, 'fan_out': 0, 'general_fan_out': 0}, {'cyclomatic_complexity': 1, 'nloc': 6, 'token_count': 21, 'name': 'initDocReadmeBytes', 'long_name': 'initDocReadmeBytes', 'start_line': 186, 'end_line': 191, 'full_parameters': [], 'filename': '/home/dimi/Documents/Informatik_Studium/FSS/SoftEvo/DataCollection/FFS_SoftEvo/go-ipfs/assets/bindata.go', 'top_nesting_level': 0, 'length': 6, 'fan_in': 0, 'fan_out': 0, 'general_fan_out': 0}, {'cyclomatic_complexity': 2, 'nloc': 9, 'token_count': 78, 'name': 'initDocReadme', 'long_name': 'initDocReadme', 'start_line': 193, 'end_line': 202, 'full_parameters': [], 'filename': '/home/dimi/Documents/Informatik_Studium/FSS/SoftEvo/DataCollection/FFS_SoftEvo/go-ipfs/assets/bindata.go', 'top_nesting_level': 0, 'length': 10, 'fan_in': 0, 'fan_out': 0, 'general_fan_out': 0}, {'cyclomatic_complexity': 1, 'nloc': 6, 'token_count': 21, 'name': 'initDocSecurityNotesBytes', 'long_name': 'initDocSecurityNotesBytes', 'start_line': 206, 'end_line': 211, 'full_parameters': [], 'filename': '/home/dimi/Documents/Informatik_Studium/FSS/SoftEvo/DataCollection/FFS_SoftEvo/go-ipfs/assets/bindata.go', 'top_nesting_level': 0, 'length': 6, 'fan_in': 0, 'fan_out': 0, 'general_fan_out': 0}, {'cyclomatic_complexity': 2, 'nloc': 9, 'token_count': 78, 'name': 'initDocSecurityNotes', 'long_name': 'initDocSecurityNotes', 'start_line': 213, 'end_line': 222, 'full_parameters': [], 'filename': '/home/dimi/Documents/Informatik_Studium/FSS/SoftEvo/DataCollection/FFS_SoftEvo/go-ipfs/assets/bindata.go', 'top_nesting_level': 0, 'length': 10, 'fan_in': 0, 'fan_out': 0, 'general_fan_out': 0}, {'cyclomatic_complexity': 1, 'nloc': 6, 'token_count': 21, 'name': 'dirIndexHtmlLicenseBytes', 'long_name': 'dirIndexHtmlLicenseBytes', 'start_line': 226, 'end_line': 231, 'full_parameters': [], 'filename': '/home/dimi/Documents/Informatik_Studium/FSS/SoftEvo/DataCollection/FFS_SoftEvo/go-ipfs/assets/bindata.go', 'top_nesting_level': 0, 'length': 6, 'fan_in': 0, 'fan_out': 0, 'general_fan_out': 0}, {'cyclomatic_complexity': 2, 'nloc': 9, 'token_count': 78, 'name': 'dirIndexHtmlLicense', 'long_name': 'dirIndexHtmlLicense', 'start_line': 233, 'end_line': 242, 'full_parameters': [], 'filename': '/home/dimi/Documents/Informatik_Studium/FSS/SoftEvo/DataCollection/FFS_SoftEvo/go-ipfs/assets/bindata.go', 'top_nesting_level': 0, 'length': 10, 'fan_in': 0, 'fan_out': 0, 'general_fan_out': 0}, {'cyclomatic_complexity': 1, 'nloc': 6, 'token_count': 21, 'name': 'dirIndexHtmlReadmeMdBytes', 'long_name': 'dirIndexHtmlReadmeMdBytes', 'start_line': 246, 'end_line': 251, 'full_parameters': [], 'filename': '/home/dimi/Documents/Informatik_Studium/FSS/SoftEvo/DataCollection/FFS_SoftEvo/go-ipfs/assets/bindata.go', 'top_nesting_level': 0, 'length': 6, 'fan_in': 0, 'fan_out': 0, 'general_fan_out': 0}, {'cyclomatic_complexity': 2, 'nloc': 9, 'token_count': 78, 'name': 'dirIndexHtmlReadmeMd', 'long_name': 'dirIndexHtmlReadmeMd', 'start_line': 253, 'end_line': 262, 'full_parameters': [], 'filename': '/home/dimi/Documents/Informatik_Studium/FSS/SoftEvo/DataCollection/FFS_SoftEvo/go-ipfs/assets/bindata.go', 'top_nesting_level': 0, 'length': 10, 'fan_in': 0, 'fan_out': 0, 'general_fan_out': 0}, {'cyclomatic_complexity': 1, 'nloc': 6, 'token_count': 21, 'name': 'dirIndexHtmlDirIndexUncatHtmlBytes', 'long_name': 'dirIndexHtmlDirIndexUncatHtmlBytes', 'start_line': 266, 'end_line': 271, 'full_parameters': [], 'filename': '/home/dimi/Documents/Informatik_Studium/FSS/SoftEvo/DataCollection/FFS_SoftEvo/go-ipfs/assets/bindata.go', 'top_nesting_level': 0, 'length': 6, 'fan_in': 0, 'fan_out': 0, 'general_fan_out': 0}, {'cyclomatic_complexity': 2, 'nloc': 9, 'token_count': 78, 'name': 'dirIndexHtmlDirIndexUncatHtml', 'long_name': 'dirIndexHtmlDirIndexUncatHtml', 'start_line': 273, 'end_line': 282, 'full_parameters': [], 'filename': '/home/dimi/Documents/Informatik_Studium/FSS/SoftEvo/DataCollection/FFS_SoftEvo/go-ipfs/assets/bindata.go', 'top_nesting_level': 0, 'length': 10, 'fan_in': 0, 'fan_out': 0, 'general_fan_out': 0}, {'cyclomatic_complexity': 1, 'nloc': 6, 'token_count': 21, 'name': 'dirIndexHtmlDirIndexHtmlBytes', 'long_name': 'dirIndexHtmlDirIndexHtmlBytes', 'start_line': 286, 'end_line': 291, 'full_parameters': [], 'filename': '/home/dimi/Documents/Informatik_Studium/FSS/SoftEvo/DataCollection/FFS_SoftEvo/go-ipfs/assets/bindata.go', 'top_nesting_level': 0, 'length': 6, 'fan_in': 0, 'fan_out': 0, 'general_fan_out': 0}, {'cyclomatic_complexity': 2, 'nloc': 9, 'token_count': 78, 'name': 'dirIndexHtmlDirIndexHtml', 'long_name': 'dirIndexHtmlDirIndexHtml', 'start_line': 293, 'end_line': 302, 'full_parameters': [], 'filename': '/home/dimi/Documents/Informatik_Studium/FSS/SoftEvo/DataCollection/FFS_SoftEvo/go-ipfs/assets/bindata.go', 'top_nesting_level': 0, 'length': 10, 'fan_in': 0, 'fan_out': 0, 'general_fan_out': 0}, {'cyclomatic_complexity': 1, 'nloc': 6, 'token_count': 21, 'name': 'dirIndexHtmlIndexGoBytes', 'long_name': 'dirIndexHtmlIndexGoBytes', 'start_line': 306, 'end_line': 311, 'full_parameters': [], 'filename': '/home/dimi/Documents/Informatik_Studium/FSS/SoftEvo/DataCollection/FFS_SoftEvo/go-ipfs/assets/bindata.go', 'top_nesting_level': 0, 'length': 6, 'fan_in': 0, 'fan_out': 0, 'general_fan_out': 0}, {'cyclomatic_complexity': 2, 'nloc': 9, 'token_count': 78, 'name': 'dirIndexHtmlIndexGo', 'long_name': 'dirIndexHtmlIndexGo', 'start_line': 313, 'end_line': 322, 'full_parameters': [], 'filename': '/home/dimi/Documents/Informatik_Studium/FSS/SoftEvo/DataCollection/FFS_SoftEvo/go-ipfs/assets/bindata.go', 'top_nesting_level': 0, 'length': 10, 'fan_in': 0, 'fan_out': 0, 'general_fan_out': 0}, {'cyclomatic_complexity': 1, 'nloc': 6, 'token_count': 21, 'name': 'dirIndexHtmlKnowniconsTxtBytes', 'long_name': 'dirIndexHtmlKnowniconsTxtBytes', 'start_line': 326, 'end_line': 331, 'full_parameters': [], 'filename': '/home/dimi/Documents/Informatik_Studium/FSS/SoftEvo/DataCollection/FFS_SoftEvo/go-ipfs/assets/bindata.go', 'top_nesting_level': 0, 'length': 6, 'fan_in': 0, 'fan_out': 0, 'general_fan_out': 0}, {'cyclomatic_complexity': 2, 'nloc': 9, 'token_count': 78, 'name': 'dirIndexHtmlKnowniconsTxt', 'long_name': 'dirIndexHtmlKnowniconsTxt', 'start_line': 333, 'end_line': 342, 'full_parameters': [], 'filename': '/home/dimi/Documents/Informatik_Studium/FSS/SoftEvo/DataCollection/FFS_SoftEvo/go-ipfs/assets/bindata.go', 'top_nesting_level': 0, 'length': 10, 'fan_in': 0, 'fan_out': 0, 'general_fan_out': 0}, {'cyclomatic_complexity': 1, 'nloc': 6, 'token_count': 21, 'name': 'dirIndexHtmlPackageJsonBytes', 'long_name': 'dirIndexHtmlPackageJsonBytes', 'start_line': 346, 'end_line': 351, 'full_parameters': [], 'filename': '/home/dimi/Documents/Informatik_Studium/FSS/SoftEvo/DataCollection/FFS_SoftEvo/go-ipfs/assets/bindata.go', 'top_nesting_level': 0, 'length': 6, 'fan_in': 0, 'fan_out': 0, 'general_fan_out': 0}, {'cyclomatic_complexity': 2, 'nloc': 9, 'token_count': 78, 'name': 'dirIndexHtmlPackageJson', 'long_name': 'dirIndexHtmlPackageJson', 'start_line': 353, 'end_line': 362, 'full_parameters': [], 'filename': '/home/dimi/Documents/Informatik_Studium/FSS/SoftEvo/DataCollection/FFS_SoftEvo/go-ipfs/assets/bindata.go', 'top_nesting_level': 0, 'length': 10, 'fan_in': 0, 'fan_out': 0, 'general_fan_out': 0}, {'cyclomatic_complexity': 3, 'nloc': 11, 'token_count': 86, 'name': 'Asset', 'long_name': 'Asset name string', 'start_line': 367, 'end_line': 377, 'full_parameters': ['name string'], 'filename': '/home/dimi/Documents/Informatik_Studium/FSS/SoftEvo/DataCollection/FFS_SoftEvo/go-ipfs/assets/bindata.go', 'top_nesting_level': 0, 'length': 11, 'fan_in': 0, 'fan_out': 0, 'general_fan_out': 0}, {'cyclomatic_complexity': 2, 'nloc': 7, 'token_count': 41, 'name': 'MustAsset', 'long_name': 'MustAsset name string', 'start_line': 381, 'end_line': 388, 'full_parameters': ['name string'], 'filename': '/home/dimi/Documents/Informatik_Studium/FSS/SoftEvo/DataCollection/FFS_SoftEvo/go-ipfs/assets/bindata.go', 'top_nesting_level': 0, 'length': 8, 'fan_in': 0, 'fan_out': 0, 'general_fan_out': 0}, {'cyclomatic_complexity': 3, 'nloc': 11, 'token_count': 86, 'name': 'AssetInfo', 'long_name': 'AssetInfo name string', 'start_line': 393, 'end_line': 403, 'full_parameters': ['name string'], 'filename': '/home/dimi/Documents/Informatik_Studium/FSS/SoftEvo/DataCollection/FFS_SoftEvo/go-ipfs/assets/bindata.go', 'top_nesting_level': 0, 'length': 11, 'fan_in': 0, 'fan_out': 0, 'general_fan_out': 0}, {'cyclomatic_complexity': 2, 'nloc': 7, 'token_count': 41, 'name': 'AssetNames', 'long_name': 'AssetNames', 'start_line': 406, 'end_line': 412, 'full_parameters': [], 'filename': '/home/dimi/Documents/Informatik_Studium/FSS/SoftEvo/DataCollection/FFS_SoftEvo/go-ipfs/assets/bindata.go', 'top_nesting_level': 0, 'length': 7, 'fan_in': 0, 'fan_out': 0, 'general_fan_out': 0}, {'cyclomatic_complexity': 1, 'nloc': 16, 'token_count': 67, 'name': '', 'long_name': '()(*asset,error)', 'start_line': 415, 'end_line': 430, 'full_parameters': [], 'filename': '/home/dimi/Documents/Informatik_Studium/FSS/SoftEvo/DataCollection/FFS_SoftEvo/go-ipfs/assets/bindata.go', 'top_nesting_level': 0, 'length': 16, 'fan_in': 0, 'fan_out': 0, 'general_fan_out': 0}, {'cyclomatic_complexity': 6, 'nloc': 21, 'token_count': 143, 'name': 'AssetDir', 'long_name': 'AssetDir name string', 'start_line': 445, 'end_line': 465, 'full_parameters': ['name string'], 'filename': '/home/dimi/Documents/Informatik_Studium/FSS/SoftEvo/DataCollection/FFS_SoftEvo/go-ipfs/assets/bindata.go', 'top_nesting_level': 0, 'length': 21, 'fan_in': 0, 'fan_out': 0, 'general_fan_out': 0}, {'cyclomatic_complexity': 6, 'nloc': 23, 'token_count': 140, 'name': 'RestoreAsset', 'long_name': 'RestoreAsset dir , name string', 'start_line': 494, 'end_line': 516, 'full_parameters': ['dir', ' name string'], 'filename': '/home/dimi/Documents/Informatik_Studium/FSS/SoftEvo/DataCollection/FFS_SoftEvo/go-ipfs/assets/bindata.go', 'top_nesting_level': 0, 'length': 23, 'fan_in': 0, 'fan_out': 0, 'general_fan_out': 0}, {'cyclomatic_complexity': 4, 'nloc': 13, 'token_count': 66, 'name': 'RestoreAssets', 'long_name': 'RestoreAssets dir , name string', 'start_line': 519, 'end_line': 533, 'full_parameters': ['dir', ' name string'], 'filename': '/home/dimi/Documents/Informatik_Studium/FSS/SoftEvo/DataCollection/FFS_SoftEvo/go-ipfs/assets/bindata.go', 'top_nesting_level': 0, 'length': 15, 'fan_in': 0, 'fan_out': 0, 'general_fan_out': 0}, {'cyclomatic_complexity': 1, 'nloc': 4, 'token_count': 52, 'name': '_filePath', 'long_name': '_filePath dir , name string', 'start_line': 535, 'end_line': 538, 'full_parameters': ['dir', ' name string'], 'filename': '/home/dimi/Documents/Informatik_Studium/FSS/SoftEvo/DataCollection/FFS_SoftEvo/go-ipfs/assets/bindata.go', 'top_nesting_level': 0, 'length': 4, 'fan_in': 0, 'fan_out': 0, 'general_fan_out': 0}]",327,2145,34,"[{'cyclomatic_complexity': 4, 'nloc': 16, 'token_count': 116, 'name': 'bindataRead', 'long_name': 'bindataRead data [ ] byte , name string', 'start_line': 27, 'end_line': 45, 'full_parameters': ['data [ ] byte', ' name string'], 'filename': '/home/dimi/Documents/Informatik_Studium/FSS/SoftEvo/DataCollection/FFS_SoftEvo/go-ipfs/assets/bindata.go', 'top_nesting_level': 0, 'length': 19, 'fan_in': 0, 'fan_out': 0, 'general_fan_out': 0}, {'cyclomatic_complexity': 1, 'nloc': 3, 'token_count': 15, 'name': 'Name', 'long_name': '(fi bindataFileInfo)Name', 'start_line': 60, 'end_line': 62, 'full_parameters': [], 'filename': '/home/dimi/Documents/Informatik_Studium/FSS/SoftEvo/DataCollection/FFS_SoftEvo/go-ipfs/assets/bindata.go', 'top_nesting_level': 0, 'length': 3, 'fan_in': 0, 'fan_out': 0, 'general_fan_out': 0}, {'cyclomatic_complexity': 1, 'nloc': 3, 'token_count': 15, 'name': 'Size', 'long_name': '(fi bindataFileInfo)Size', 'start_line': 65, 'end_line': 67, 'full_parameters': [], 'filename': '/home/dimi/Documents/Informatik_Studium/FSS/SoftEvo/DataCollection/FFS_SoftEvo/go-ipfs/assets/bindata.go', 'top_nesting_level': 0, 'length': 3, 'fan_in': 0, 'fan_out': 0, 'general_fan_out': 0}, {'cyclomatic_complexity': 1, 'nloc': 3, 'token_count': 17, 'name': 'Mode', 'long_name': '(fi bindataFileInfo)Mode', 'start_line': 70, 'end_line': 72, 'full_parameters': [], 'filename': '/home/dimi/Documents/Informatik_Studium/FSS/SoftEvo/DataCollection/FFS_SoftEvo/go-ipfs/assets/bindata.go', 'top_nesting_level': 0, 'length': 3, 'fan_in': 0, 'fan_out': 0, 'general_fan_out': 0}, {'cyclomatic_complexity': 1, 'nloc': 3, 'token_count': 17, 'name': 'ModTime', 'long_name': '(fi bindataFileInfo)ModTime', 'start_line': 75, 'end_line': 77, 'full_parameters': [], 'filename': '/home/dimi/Documents/Informatik_Studium/FSS/SoftEvo/DataCollection/FFS_SoftEvo/go-ipfs/assets/bindata.go', 'top_nesting_level': 0, 'length': 3, 'fan_in': 0, 'fan_out': 0, 'general_fan_out': 0}, {'cyclomatic_complexity': 1, 'nloc': 3, 'token_count': 21, 'name': 'IsDir', 'long_name': '(fi bindataFileInfo)IsDir', 'start_line': 80, 'end_line': 82, 'full_parameters': [], 'filename': '/home/dimi/Documents/Informatik_Studium/FSS/SoftEvo/DataCollection/FFS_SoftEvo/go-ipfs/assets/bindata.go', 'top_nesting_level': 0, 'length': 3, 'fan_in': 0, 'fan_out': 0, 'general_fan_out': 0}, {'cyclomatic_complexity': 1, 'nloc': 1, 'token_count': 11, 'name': 'Sys', 'long_name': '(fi bindataFileInfo)Sys', 'start_line': 85, 'end_line': 85, 'full_parameters': [], 'filename': '/home/dimi/Documents/Informatik_Studium/FSS/SoftEvo/DataCollection/FFS_SoftEvo/go-ipfs/assets/bindata.go', 'top_nesting_level': 0, 'length': 1, 'fan_in': 0, 'fan_out': 0, 'general_fan_out': 0}, {'cyclomatic_complexity': 1, 'nloc': 6, 'token_count': 21, 'name': 'initDocAboutBytes', 'long_name': 'initDocAboutBytes', 'start_line': 91, 'end_line': 96, 'full_parameters': [], 'filename': '/home/dimi/Documents/Informatik_Studium/FSS/SoftEvo/DataCollection/FFS_SoftEvo/go-ipfs/assets/bindata.go', 'top_nesting_level': 0, 'length': 6, 'fan_in': 0, 'fan_out': 0, 'general_fan_out': 0}, {'cyclomatic_complexity': 2, 'nloc': 9, 'token_count': 78, 'name': 'initDocAbout', 'long_name': 'initDocAbout', 'start_line': 98, 'end_line': 107, 'full_parameters': [], 'filename': '/home/dimi/Documents/Informatik_Studium/FSS/SoftEvo/DataCollection/FFS_SoftEvo/go-ipfs/assets/bindata.go', 'top_nesting_level': 0, 'length': 10, 'fan_in': 0, 'fan_out': 0, 'general_fan_out': 0}, {'cyclomatic_complexity': 1, 'nloc': 6, 'token_count': 21, 'name': 'initDocContactBytes', 'long_name': 'initDocContactBytes', 'start_line': 111, 'end_line': 116, 'full_parameters': [], 'filename': '/home/dimi/Documents/Informatik_Studium/FSS/SoftEvo/DataCollection/FFS_SoftEvo/go-ipfs/assets/bindata.go', 'top_nesting_level': 0, 'length': 6, 'fan_in': 0, 'fan_out': 0, 'general_fan_out': 0}, {'cyclomatic_complexity': 2, 'nloc': 9, 'token_count': 78, 'name': 'initDocContact', 'long_name': 'initDocContact', 'start_line': 118, 'end_line': 127, 'full_parameters': [], 'filename': '/home/dimi/Documents/Informatik_Studium/FSS/SoftEvo/DataCollection/FFS_SoftEvo/go-ipfs/assets/bindata.go', 'top_nesting_level': 0, 'length': 10, 'fan_in': 0, 'fan_out': 0, 'general_fan_out': 0}, {'cyclomatic_complexity': 1, 'nloc': 6, 'token_count': 21, 'name': 'initDocHelpBytes', 'long_name': 'initDocHelpBytes', 'start_line': 131, 'end_line': 136, 'full_parameters': [], 'filename': '/home/dimi/Documents/Informatik_Studium/FSS/SoftEvo/DataCollection/FFS_SoftEvo/go-ipfs/assets/bindata.go', 'top_nesting_level': 0, 'length': 6, 'fan_in': 0, 'fan_out': 0, 'general_fan_out': 0}, {'cyclomatic_complexity': 2, 'nloc': 9, 'token_count': 78, 'name': 'initDocHelp', 'long_name': 'initDocHelp', 'start_line': 138, 'end_line': 147, 'full_parameters': [], 'filename': '/home/dimi/Documents/Informatik_Studium/FSS/SoftEvo/DataCollection/FFS_SoftEvo/go-ipfs/assets/bindata.go', 'top_nesting_level': 0, 'length': 10, 'fan_in': 0, 'fan_out': 0, 'general_fan_out': 0}, {'cyclomatic_complexity': 1, 'nloc': 6, 'token_count': 21, 'name': 'initDocPingBytes', 'long_name': 'initDocPingBytes', 'start_line': 151, 'end_line': 156, 'full_parameters': [], 'filename': '/home/dimi/Documents/Informatik_Studium/FSS/SoftEvo/DataCollection/FFS_SoftEvo/go-ipfs/assets/bindata.go', 'top_nesting_level': 0, 'length': 6, 'fan_in': 0, 'fan_out': 0, 'general_fan_out': 0}, {'cyclomatic_complexity': 2, 'nloc': 9, 'token_count': 78, 'name': 'initDocPing', 'long_name': 'initDocPing', 'start_line': 158, 'end_line': 167, 'full_parameters': [], 'filename': '/home/dimi/Documents/Informatik_Studium/FSS/SoftEvo/DataCollection/FFS_SoftEvo/go-ipfs/assets/bindata.go', 'top_nesting_level': 0, 'length': 10, 'fan_in': 0, 'fan_out': 0, 'general_fan_out': 0}, {'cyclomatic_complexity': 1, 'nloc': 6, 'token_count': 21, 'name': 'initDocQuickStartBytes', 'long_name': 'initDocQuickStartBytes', 'start_line': 171, 'end_line': 176, 'full_parameters': [], 'filename': '/home/dimi/Documents/Informatik_Studium/FSS/SoftEvo/DataCollection/FFS_SoftEvo/go-ipfs/assets/bindata.go', 'top_nesting_level': 0, 'length': 6, 'fan_in': 0, 'fan_out': 0, 'general_fan_out': 0}, {'cyclomatic_complexity': 2, 'nloc': 9, 'token_count': 78, 'name': 'initDocQuickStart', 'long_name': 'initDocQuickStart', 'start_line': 178, 'end_line': 187, 'full_parameters': [], 'filename': '/home/dimi/Documents/Informatik_Studium/FSS/SoftEvo/DataCollection/FFS_SoftEvo/go-ipfs/assets/bindata.go', 'top_nesting_level': 0, 'length': 10, 'fan_in': 0, 'fan_out': 0, 'general_fan_out': 0}, {'cyclomatic_complexity': 1, 'nloc': 6, 'token_count': 21, 'name': 'initDocReadmeBytes', 'long_name': 'initDocReadmeBytes', 'start_line': 191, 'end_line': 196, 'full_parameters': [], 'filename': '/home/dimi/Documents/Informatik_Studium/FSS/SoftEvo/DataCollection/FFS_SoftEvo/go-ipfs/assets/bindata.go', 'top_nesting_level': 0, 'length': 6, 'fan_in': 0, 'fan_out': 0, 'general_fan_out': 0}, {'cyclomatic_complexity': 2, 'nloc': 9, 'token_count': 78, 'name': 'initDocReadme', 'long_name': 'initDocReadme', 'start_line': 198, 'end_line': 207, 'full_parameters': [], 'filename': '/home/dimi/Documents/Informatik_Studium/FSS/SoftEvo/DataCollection/FFS_SoftEvo/go-ipfs/assets/bindata.go', 'top_nesting_level': 0, 'length': 10, 'fan_in': 0, 'fan_out': 0, 'general_fan_out': 0}, {'cyclomatic_complexity': 1, 'nloc': 6, 'token_count': 21, 'name': 'initDocSecurityNotesBytes', 'long_name': 'initDocSecurityNotesBytes', 'start_line': 211, 'end_line': 216, 'full_parameters': [], 'filename': '/home/dimi/Documents/Informatik_Studium/FSS/SoftEvo/DataCollection/FFS_SoftEvo/go-ipfs/assets/bindata.go', 'top_nesting_level': 0, 'length': 6, 'fan_in': 0, 'fan_out': 0, 'general_fan_out': 0}, {'cyclomatic_complexity': 2, 'nloc': 9, 'token_count': 78, 'name': 'initDocSecurityNotes', 'long_name': 'initDocSecurityNotes', 'start_line': 218, 'end_line': 227, 'full_parameters': [], 'filename': '/home/dimi/Documents/Informatik_Studium/FSS/SoftEvo/DataCollection/FFS_SoftEvo/go-ipfs/assets/bindata.go', 'top_nesting_level': 0, 'length': 10, 'fan_in': 0, 'fan_out': 0, 'general_fan_out': 0}, {'cyclomatic_complexity': 1, 'nloc': 6, 'token_count': 21, 'name': 'dirIndexHtmlDirIndexHtmlBytes', 'long_name': 'dirIndexHtmlDirIndexHtmlBytes', 'start_line': 231, 'end_line': 236, 'full_parameters': [], 'filename': '/home/dimi/Documents/Informatik_Studium/FSS/SoftEvo/DataCollection/FFS_SoftEvo/go-ipfs/assets/bindata.go', 'top_nesting_level': 0, 'length': 6, 'fan_in': 0, 'fan_out': 0, 'general_fan_out': 0}, {'cyclomatic_complexity': 2, 'nloc': 9, 'token_count': 78, 'name': 'dirIndexHtmlDirIndexHtml', 'long_name': 'dirIndexHtmlDirIndexHtml', 'start_line': 238, 'end_line': 247, 'full_parameters': [], 'filename': '/home/dimi/Documents/Informatik_Studium/FSS/SoftEvo/DataCollection/FFS_SoftEvo/go-ipfs/assets/bindata.go', 'top_nesting_level': 0, 'length': 10, 'fan_in': 0, 'fan_out': 0, 'general_fan_out': 0}, {'cyclomatic_complexity': 1, 'nloc': 6, 'token_count': 21, 'name': 'dirIndexHtmlKnowniconsTxtBytes', 'long_name': 'dirIndexHtmlKnowniconsTxtBytes', 'start_line': 251, 'end_line': 256, 'full_parameters': [], 'filename': '/home/dimi/Documents/Informatik_Studium/FSS/SoftEvo/DataCollection/FFS_SoftEvo/go-ipfs/assets/bindata.go', 'top_nesting_level': 0, 'length': 6, 'fan_in': 0, 'fan_out': 0, 'general_fan_out': 0}, {'cyclomatic_complexity': 2, 'nloc': 9, 'token_count': 78, 'name': 'dirIndexHtmlKnowniconsTxt', 'long_name': 'dirIndexHtmlKnowniconsTxt', 'start_line': 258, 'end_line': 267, 'full_parameters': [], 'filename': '/home/dimi/Documents/Informatik_Studium/FSS/SoftEvo/DataCollection/FFS_SoftEvo/go-ipfs/assets/bindata.go', 'top_nesting_level': 0, 'length': 10, 'fan_in': 0, 'fan_out': 0, 'general_fan_out': 0}, {'cyclomatic_complexity': 3, 'nloc': 11, 'token_count': 86, 'name': 'Asset', 'long_name': 'Asset name string', 'start_line': 272, 'end_line': 282, 'full_parameters': ['name string'], 'filename': '/home/dimi/Documents/Informatik_Studium/FSS/SoftEvo/DataCollection/FFS_SoftEvo/go-ipfs/assets/bindata.go', 'top_nesting_level': 0, 'length': 11, 'fan_in': 0, 'fan_out': 0, 'general_fan_out': 0}, {'cyclomatic_complexity': 2, 'nloc': 7, 'token_count': 41, 'name': 'MustAsset', 'long_name': 'MustAsset name string', 'start_line': 286, 'end_line': 293, 'full_parameters': ['name string'], 'filename': '/home/dimi/Documents/Informatik_Studium/FSS/SoftEvo/DataCollection/FFS_SoftEvo/go-ipfs/assets/bindata.go', 'top_nesting_level': 0, 'length': 8, 'fan_in': 0, 'fan_out': 0, 'general_fan_out': 0}, {'cyclomatic_complexity': 3, 'nloc': 11, 'token_count': 86, 'name': 'AssetInfo', 'long_name': 'AssetInfo name string', 'start_line': 298, 'end_line': 308, 'full_parameters': ['name string'], 'filename': '/home/dimi/Documents/Informatik_Studium/FSS/SoftEvo/DataCollection/FFS_SoftEvo/go-ipfs/assets/bindata.go', 'top_nesting_level': 0, 'length': 11, 'fan_in': 0, 'fan_out': 0, 'general_fan_out': 0}, {'cyclomatic_complexity': 2, 'nloc': 7, 'token_count': 41, 'name': 'AssetNames', 'long_name': 'AssetNames', 'start_line': 311, 'end_line': 317, 'full_parameters': [], 'filename': '/home/dimi/Documents/Informatik_Studium/FSS/SoftEvo/DataCollection/FFS_SoftEvo/go-ipfs/assets/bindata.go', 'top_nesting_level': 0, 'length': 7, 'fan_in': 0, 'fan_out': 0, 'general_fan_out': 0}, {'cyclomatic_complexity': 1, 'nloc': 11, 'token_count': 47, 'name': '', 'long_name': '()(*asset,error)', 'start_line': 320, 'end_line': 330, 'full_parameters': [], 'filename': '/home/dimi/Documents/Informatik_Studium/FSS/SoftEvo/DataCollection/FFS_SoftEvo/go-ipfs/assets/bindata.go', 'top_nesting_level': 0, 'length': 11, 'fan_in': 0, 'fan_out': 0, 'general_fan_out': 0}, {'cyclomatic_complexity': 6, 'nloc': 21, 'token_count': 143, 'name': 'AssetDir', 'long_name': 'AssetDir name string', 'start_line': 345, 'end_line': 365, 'full_parameters': ['name string'], 'filename': '/home/dimi/Documents/Informatik_Studium/FSS/SoftEvo/DataCollection/FFS_SoftEvo/go-ipfs/assets/bindata.go', 'top_nesting_level': 0, 'length': 21, 'fan_in': 0, 'fan_out': 0, 'general_fan_out': 0}, {'cyclomatic_complexity': 6, 'nloc': 23, 'token_count': 140, 'name': 'RestoreAsset', 'long_name': 'RestoreAsset dir , name string', 'start_line': 389, 'end_line': 411, 'full_parameters': ['dir', ' name string'], 'filename': '/home/dimi/Documents/Informatik_Studium/FSS/SoftEvo/DataCollection/FFS_SoftEvo/go-ipfs/assets/bindata.go', 'top_nesting_level': 0, 'length': 23, 'fan_in': 0, 'fan_out': 0, 'general_fan_out': 0}, {'cyclomatic_complexity': 4, 'nloc': 13, 'token_count': 66, 'name': 'RestoreAssets', 'long_name': 'RestoreAssets dir , name string', 'start_line': 414, 'end_line': 428, 'full_parameters': ['dir', ' name string'], 'filename': '/home/dimi/Documents/Informatik_Studium/FSS/SoftEvo/DataCollection/FFS_SoftEvo/go-ipfs/assets/bindata.go', 'top_nesting_level': 0, 'length': 15, 'fan_in': 0, 'fan_out': 0, 'general_fan_out': 0}, {'cyclomatic_complexity': 1, 'nloc': 4, 'token_count': 52, 'name': '_filePath', 'long_name': '_filePath dir , name string', 'start_line': 430, 'end_line': 433, 'full_parameters': ['dir', ' name string'], 'filename': '/home/dimi/Documents/Informatik_Studium/FSS/SoftEvo/DataCollection/FFS_SoftEvo/go-ipfs/assets/bindata.go', 'top_nesting_level': 0, 'length': 4, 'fan_in': 0, 'fan_out': 0, 'general_fan_out': 0}]",-90,-659,-10,11,11,"[{'timestamp': 1541682253.0, 'added_lines': 25, 'deleted_lines': 25, 'nloc': 417}, {'timestamp': 1559787584.0, 'added_lines': 32, 'deleted_lines': 138, 'nloc': 327}, {'timestamp': 1587405326.0, 'added_lines': 13, 'deleted_lines': 13, 'nloc': 327}, {'timestamp': 1587504098.0, 'added_lines': 5, 'deleted_lines': 5, 'nloc': 327}, {'timestamp': 1588699911.0, 'added_lines': 11, 'deleted_lines': 11, 'nloc': 327}, {'timestamp': 1597808082.0, 'added_lines': 15, 'deleted_lines': 14, 'nloc': 327}, {'timestamp': 1597881449.0, 'added_lines': 9, 'deleted_lines': 9, 'nloc': 327}, {'timestamp': 1595726794.0, 'added_lines': 2, 'deleted_lines': 2, 'nloc': 327}, {'timestamp': 1595887341.0, 'added_lines': 2, 'deleted_lines': 2, 'nloc': 327}, {'timestamp': 1601294969.0, 'added_lines': 2, 'deleted_lines': 2, 'nloc': 327}, {'timestamp': 1612535168.0, 'added_lines': 11, 'deleted_lines': 11, 'nloc': 327}]","{'assets/assets.go': 4, 'core/corehttp/gateway_handler.go': 2, 'core/corehttp/gateway_indexPage.go': 2, 'core/corehttp/gateway_test.go': 1, 'package.json': 1, '.gitmodules': 1, 'assets/README.md': 2, 'assets/assets_test.go': 1, 'assets/bindata_dep.go': 1, 'assets/dir-index-html': 6, 'go.mod': 1, 'go.sum': 1, 'assets/bindata_version_hash.go': 5, 'core/commands/pin/pin.go': 1, 'core/commands/root.go': 1, 'namesys/dns.go': 1, 'namesys/dns_test.go': 1}","('assets/assets.go', 0.36363636363636365, 0.06557377049180328)"
assets/dir-index-html/index.go,1,2,0,[],1,2,0,[],0,0,0,0,0,[],{},()
assets/dir-index-html/test/main.go,108,496,2,"[{'cyclomatic_complexity': 1, 'nloc': 4, 'token_count': 24, 'name': 'string', 'long_name': '(rawUrl string)string', 'start_line': 93, 'end_line': 96, 'full_parameters': [], 'filename': '/home/dimi/Documents/Informatik_Studium/FSS/SoftEvo/DataCollection/FFS_SoftEvo/go-ipfs/assets/dir-index-html/test/main.go', 'top_nesting_level': 0, 'length': 4, 'fan_in': 0, 'fan_out': 0, 'general_fan_out': 0}, {'cyclomatic_complexity': 1, 'nloc': 5, 'token_count': 16, 'name': 'string', 'long_name': '(name string)string', 'start_line': 90, 'end_line': 97, 'full_parameters': [], 'filename': '/home/dimi/Documents/Informatik_Studium/FSS/SoftEvo/DataCollection/FFS_SoftEvo/go-ipfs/assets/dir-index-html/test/main.go', 'top_nesting_level': 0, 'length': 8, 'fan_in': 0, 'fan_out': 0, 'general_fan_out': 0}]",108,496,2,"[{'cyclomatic_complexity': 1, 'nloc': 4, 'token_count': 24, 'name': 'string', 'long_name': '(rawUrl string)string', 'start_line': 93, 'end_line': 96, 'full_parameters': [], 'filename': '/home/dimi/Documents/Informatik_Studium/FSS/SoftEvo/DataCollection/FFS_SoftEvo/go-ipfs/assets/dir-index-html/test/main.go', 'top_nesting_level': 0, 'length': 4, 'fan_in': 0, 'fan_out': 0, 'general_fan_out': 0}, {'cyclomatic_complexity': 1, 'nloc': 5, 'token_count': 16, 'name': 'string', 'long_name': '(name string)string', 'start_line': 90, 'end_line': 97, 'full_parameters': [], 'filename': '/home/dimi/Documents/Informatik_Studium/FSS/SoftEvo/DataCollection/FFS_SoftEvo/go-ipfs/assets/dir-index-html/test/main.go', 'top_nesting_level': 0, 'length': 8, 'fan_in': 0, 'fan_out': 0, 'general_fan_out': 0}]",0,0,0,0,0,[],{},()
cmd/ipfs/runmain_test.go,20,115,1,"[{'cyclomatic_complexity': 2, 'nloc': 12, 'token_count': 105, 'name': 'TestRunMain', 'long_name': 'TestRunMain t * testing . T', 'start_line': 16, 'end_line': 30, 'full_parameters': ['t * testing . T'], 'filename': '/home/dimi/Documents/Informatik_Studium/FSS/SoftEvo/DataCollection/FFS_SoftEvo/go-ipfs/cmd/ipfs/runmain_test.go', 'top_nesting_level': 0, 'length': 15, 'fan_in': 0, 'fan_out': 0, 'general_fan_out': 0}]",20,115,1,"[{'cyclomatic_complexity': 2, 'nloc': 12, 'token_count': 105, 'name': 'TestRunMain', 'long_name': 'TestRunMain t * testing . T', 'start_line': 16, 'end_line': 30, 'full_parameters': ['t * testing . T'], 'filename': '/home/dimi/Documents/Informatik_Studium/FSS/SoftEvo/DataCollection/FFS_SoftEvo/go-ipfs/cmd/ipfs/runmain_test.go', 'top_nesting_level': 0, 'length': 15, 'fan_in': 0, 'fan_out': 0, 'general_fan_out': 0}]",0,0,0,0,0,[],{},()
cmd/ipfs/daemon.go,540,3549,18,"[{'cyclomatic_complexity': 1, 'nloc': 4, 'token_count': 43, 'name': '', 'long_name': '(node*core.IpfsNode,_net.Listener,mux*http.ServeMux)(*http.ServeMux,error)', 'start_line': 175, 'end_line': 178, 'full_parameters': [], 'filename': '/home/dimi/Documents/Informatik_Studium/FSS/SoftEvo/DataCollection/FFS_SoftEvo/go-ipfs/cmd/ipfs/daemon.go', 'top_nesting_level': 0, 'length': 4, 'fan_in': 0, 'fan_out': 0, 'general_fan_out': 0}, {'cyclomatic_complexity': 1, 'nloc': 3, 'token_count': 13, 'name': 'defaultMux', 'long_name': 'defaultMux path string', 'start_line': 174, 'end_line': 179, 'full_parameters': ['path string'], 'filename': '/home/dimi/Documents/Informatik_Studium/FSS/SoftEvo/DataCollection/FFS_SoftEvo/go-ipfs/cmd/ipfs/daemon.go', 'top_nesting_level': 0, 'length': 6, 'fan_in': 0, 'fan_out': 0, 'general_fan_out': 0}, {'cyclomatic_complexity': 1, 'nloc': 5, 'token_count': 28, 'name': '', 'long_name': '()', 'start_line': 203, 'end_line': 207, 'full_parameters': [], 'filename': '/home/dimi/Documents/Informatik_Studium/FSS/SoftEvo/DataCollection/FFS_SoftEvo/go-ipfs/cmd/ipfs/daemon.go', 'top_nesting_level': 0, 'length': 5, 'fan_in': 0, 'fan_out': 0, 'general_fan_out': 0}, {'cyclomatic_complexity': 2, 'nloc': 8, 'token_count': 34, 'name': '', 'long_name': '()', 'start_line': 348, 'end_line': 358, 'full_parameters': [], 'filename': '/home/dimi/Documents/Informatik_Studium/FSS/SoftEvo/DataCollection/FFS_SoftEvo/go-ipfs/cmd/ipfs/daemon.go', 'top_nesting_level': 0, 'length': 11, 'fan_in': 0, 'fan_out': 0, 'general_fan_out': 0}, {'cyclomatic_complexity': 1, 'nloc': 3, 'token_count': 17, 'name': '', 'long_name': '()(*core.IpfsNode,error)', 'start_line': 360, 'end_line': 362, 'full_parameters': [], 'filename': '/home/dimi/Documents/Informatik_Studium/FSS/SoftEvo/DataCollection/FFS_SoftEvo/go-ipfs/cmd/ipfs/daemon.go', 'top_nesting_level': 0, 'length': 3, 'fan_in': 0, 'fan_out': 0, 'general_fan_out': 0}, {'cyclomatic_complexity': 36, 'nloc': 175, 'token_count': 1039, 'name': 'daemonFunc', 'long_name': 'daemonFunc req cmds . Request , res cmds . Response', 'start_line': 183, 'end_line': 419, 'full_parameters': ['req cmds . Request', ' res cmds . Response'], 'filename': '/home/dimi/Documents/Informatik_Studium/FSS/SoftEvo/DataCollection/FFS_SoftEvo/go-ipfs/cmd/ipfs/daemon.go', 'top_nesting_level': 0, 'length': 237, 'fan_in': 0, 'fan_out': 0, 'general_fan_out': 0}, {'cyclomatic_complexity': 1, 'nloc': 4, 'token_count': 27, 'name': '', 'long_name': '()', 'start_line': 487, 'end_line': 490, 'full_parameters': [], 'filename': '/home/dimi/Documents/Informatik_Studium/FSS/SoftEvo/DataCollection/FFS_SoftEvo/go-ipfs/cmd/ipfs/daemon.go', 'top_nesting_level': 0, 'length': 4, 'fan_in': 0, 'fan_out': 0, 'general_fan_out': 0}, {'cyclomatic_complexity': 11, 'nloc': 55, 'token_count': 402, 'name': 'serveHTTPApi', 'long_name': 'serveHTTPApi req cmds . Request', 'start_line': 422, 'end_line': 492, 'full_parameters': ['req cmds . Request'], 'filename': '/home/dimi/Documents/Informatik_Studium/FSS/SoftEvo/DataCollection/FFS_SoftEvo/go-ipfs/cmd/ipfs/daemon.go', 'top_nesting_level': 0, 'length': 71, 'fan_in': 0, 'fan_out': 0, 'general_fan_out': 0}, {'cyclomatic_complexity': 7, 'nloc': 26, 'token_count': 170, 'name': 'printSwarmAddrs', 'long_name': 'printSwarmAddrs node * core . IpfsNode', 'start_line': 495, 'end_line': 523, 'full_parameters': ['node * core . IpfsNode'], 'filename': '/home/dimi/Documents/Informatik_Studium/FSS/SoftEvo/DataCollection/FFS_SoftEvo/go-ipfs/cmd/ipfs/daemon.go', 'top_nesting_level': 0, 'length': 29, 'fan_in': 0, 'fan_out': 0, 'general_fan_out': 0}, {'cyclomatic_complexity': 1, 'nloc': 4, 'token_count': 27, 'name': '', 'long_name': '()', 'start_line': 576, 'end_line': 579, 'full_parameters': [], 'filename': '/home/dimi/Documents/Informatik_Studium/FSS/SoftEvo/DataCollection/FFS_SoftEvo/go-ipfs/cmd/ipfs/daemon.go', 'top_nesting_level': 0, 'length': 4, 'fan_in': 0, 'fan_out': 0, 'general_fan_out': 0}, {'cyclomatic_complexity': 9, 'nloc': 44, 'token_count': 320, 'name': 'serveHTTPGateway', 'long_name': 'serveHTTPGateway req cmds . Request', 'start_line': 526, 'end_line': 581, 'full_parameters': ['req cmds . Request'], 'filename': '/home/dimi/Documents/Informatik_Studium/FSS/SoftEvo/DataCollection/FFS_SoftEvo/go-ipfs/cmd/ipfs/daemon.go', 'top_nesting_level': 0, 'length': 56, 'fan_in': 0, 'fan_out': 0, 'general_fan_out': 0}, {'cyclomatic_complexity': 8, 'nloc': 31, 'token_count': 195, 'name': 'mountFuse', 'long_name': 'mountFuse req cmds . Request', 'start_line': 584, 'end_line': 618, 'full_parameters': ['req cmds . Request'], 'filename': '/home/dimi/Documents/Informatik_Studium/FSS/SoftEvo/DataCollection/FFS_SoftEvo/go-ipfs/cmd/ipfs/daemon.go', 'top_nesting_level': 0, 'length': 35, 'fan_in': 0, 'fan_out': 0, 'general_fan_out': 0}, {'cyclomatic_complexity': 1, 'nloc': 4, 'token_count': 24, 'name': '', 'long_name': '()', 'start_line': 630, 'end_line': 633, 'full_parameters': [], 'filename': '/home/dimi/Documents/Informatik_Studium/FSS/SoftEvo/DataCollection/FFS_SoftEvo/go-ipfs/cmd/ipfs/daemon.go', 'top_nesting_level': 0, 'length': 4, 'fan_in': 0, 'fan_out': 0, 'general_fan_out': 0}, {'cyclomatic_complexity': 3, 'nloc': 12, 'token_count': 74, 'name': 'maybeRunGC', 'long_name': 'maybeRunGC req cmds . Request , node * core . IpfsNode', 'start_line': 620, 'end_line': 635, 'full_parameters': ['req cmds . Request', ' node * core . IpfsNode'], 'filename': '/home/dimi/Documents/Informatik_Studium/FSS/SoftEvo/DataCollection/FFS_SoftEvo/go-ipfs/cmd/ipfs/daemon.go', 'top_nesting_level': 0, 'length': 16, 'fan_in': 0, 'fan_out': 0, 'general_fan_out': 0}, {'cyclomatic_complexity': 2, 'nloc': 6, 'token_count': 26, 'name': '', 'long_name': '(c<-chan error)', 'start_line': 645, 'end_line': 650, 'full_parameters': [], 'filename': '/home/dimi/Documents/Informatik_Studium/FSS/SoftEvo/DataCollection/FFS_SoftEvo/go-ipfs/cmd/ipfs/daemon.go', 'top_nesting_level': 0, 'length': 6, 'fan_in': 0, 'fan_out': 0, 'general_fan_out': 0}, {'cyclomatic_complexity': 1, 'nloc': 4, 'token_count': 14, 'name': '', 'long_name': '()', 'start_line': 660, 'end_line': 663, 'full_parameters': [], 'filename': '/home/dimi/Documents/Informatik_Studium/FSS/SoftEvo/DataCollection/FFS_SoftEvo/go-ipfs/cmd/ipfs/daemon.go', 'top_nesting_level': 0, 'length': 4, 'fan_in': 0, 'fan_out': 0, 'general_fan_out': 0}, {'cyclomatic_complexity': 3, 'nloc': 13, 'token_count': 63, 'name': 'merge', 'long_name': 'merge cs ... < - chan error', 'start_line': 639, 'end_line': 665, 'full_parameters': ['cs ... < - chan error'], 'filename': '/home/dimi/Documents/Informatik_Studium/FSS/SoftEvo/DataCollection/FFS_SoftEvo/go-ipfs/cmd/ipfs/daemon.go', 'top_nesting_level': 0, 'length': 27, 'fan_in': 0, 'fan_out': 0, 'general_fan_out': 0}, {'cyclomatic_complexity': 5, 'nloc': 17, 'token_count': 73, 'name': 'YesNoPrompt', 'long_name': 'YesNoPrompt prompt string', 'start_line': 667, 'end_line': 684, 'full_parameters': ['prompt string'], 'filename': '/home/dimi/Documents/Informatik_Studium/FSS/SoftEvo/DataCollection/FFS_SoftEvo/go-ipfs/cmd/ipfs/daemon.go', 'top_nesting_level': 0, 'length': 18, 'fan_in': 0, 'fan_out': 0, 'general_fan_out': 0}]",704,4457,24,"[{'cyclomatic_complexity': 1, 'nloc': 4, 'token_count': 43, 'name': '', 'long_name': '(node*core.IpfsNode,_net.Listener,mux*http.ServeMux)(*http.ServeMux,error)', 'start_line': 201, 'end_line': 204, 'full_parameters': [], 'filename': '/home/dimi/Documents/Informatik_Studium/FSS/SoftEvo/DataCollection/FFS_SoftEvo/go-ipfs/cmd/ipfs/daemon.go', 'top_nesting_level': 0, 'length': 4, 'fan_in': 0, 'fan_out': 0, 'general_fan_out': 0}, {'cyclomatic_complexity': 1, 'nloc': 3, 'token_count': 13, 'name': 'defaultMux', 'long_name': 'defaultMux path string', 'start_line': 200, 'end_line': 205, 'full_parameters': ['path string'], 'filename': '/home/dimi/Documents/Informatik_Studium/FSS/SoftEvo/DataCollection/FFS_SoftEvo/go-ipfs/cmd/ipfs/daemon.go', 'top_nesting_level': 0, 'length': 6, 'fan_in': 0, 'fan_out': 0, 'general_fan_out': 0}, {'cyclomatic_complexity': 2, 'nloc': 5, 'token_count': 16, 'name': '', 'long_name': '()', 'start_line': 217, 'end_line': 224, 'full_parameters': [], 'filename': '/home/dimi/Documents/Informatik_Studium/FSS/SoftEvo/DataCollection/FFS_SoftEvo/go-ipfs/cmd/ipfs/daemon.go', 'top_nesting_level': 0, 'length': 8, 'fan_in': 0, 'fan_out': 0, 'general_fan_out': 0}, {'cyclomatic_complexity': 2, 'nloc': 5, 'token_count': 21, 'name': '', 'long_name': '()', 'start_line': 339, 'end_line': 343, 'full_parameters': [], 'filename': '/home/dimi/Documents/Informatik_Studium/FSS/SoftEvo/DataCollection/FFS_SoftEvo/go-ipfs/cmd/ipfs/daemon.go', 'top_nesting_level': 0, 'length': 5, 'fan_in': 0, 'fan_out': 0, 'general_fan_out': 0}, {'cyclomatic_complexity': 2, 'nloc': 8, 'token_count': 32, 'name': '', 'long_name': '()', 'start_line': 434, 'end_line': 444, 'full_parameters': [], 'filename': '/home/dimi/Documents/Informatik_Studium/FSS/SoftEvo/DataCollection/FFS_SoftEvo/go-ipfs/cmd/ipfs/daemon.go', 'top_nesting_level': 0, 'length': 11, 'fan_in': 0, 'fan_out': 0, 'general_fan_out': 0}, {'cyclomatic_complexity': 1, 'nloc': 3, 'token_count': 17, 'name': '', 'long_name': '()(*core.IpfsNode,error)', 'start_line': 446, 'end_line': 448, 'full_parameters': [], 'filename': '/home/dimi/Documents/Informatik_Studium/FSS/SoftEvo/DataCollection/FFS_SoftEvo/go-ipfs/cmd/ipfs/daemon.go', 'top_nesting_level': 0, 'length': 3, 'fan_in': 0, 'fan_out': 0, 'general_fan_out': 0}, {'cyclomatic_complexity': 1, 'nloc': 6, 'token_count': 29, 'name': '', 'long_name': '()', 'start_line': 530, 'end_line': 535, 'full_parameters': [], 'filename': '/home/dimi/Documents/Informatik_Studium/FSS/SoftEvo/DataCollection/FFS_SoftEvo/go-ipfs/cmd/ipfs/daemon.go', 'top_nesting_level': 0, 'length': 6, 'fan_in': 0, 'fan_out': 0, 'general_fan_out': 0}, {'cyclomatic_complexity': 7, 'nloc': 21, 'token_count': 128, 'name': '', 'long_name': '()', 'start_line': 539, 'end_line': 561, 'full_parameters': [], 'filename': '/home/dimi/Documents/Informatik_Studium/FSS/SoftEvo/DataCollection/FFS_SoftEvo/go-ipfs/cmd/ipfs/daemon.go', 'top_nesting_level': 0, 'length': 23, 'fan_in': 0, 'fan_out': 0, 'general_fan_out': 0}, {'cyclomatic_complexity': 38, 'nloc': 160, 'token_count': 904, 'name': 'migrations', 'long_name': '(distPath string)migrations', 'start_line': 311, 'end_line': 574, 'full_parameters': [], 'filename': '/home/dimi/Documents/Informatik_Studium/FSS/SoftEvo/DataCollection/FFS_SoftEvo/go-ipfs/cmd/ipfs/daemon.go', 'top_nesting_level': 0, 'length': 264, 'fan_in': 0, 'fan_out': 0, 'general_fan_out': 0}, {'cyclomatic_complexity': 1, 'nloc': 4, 'token_count': 34, 'name': '', 'long_name': '(lis manet.Listener)', 'start_line': 671, 'end_line': 674, 'full_parameters': [], 'filename': '/home/dimi/Documents/Informatik_Studium/FSS/SoftEvo/DataCollection/FFS_SoftEvo/go-ipfs/cmd/ipfs/daemon.go', 'top_nesting_level': 0, 'length': 4, 'fan_in': 0, 'fan_out': 0, 'general_fan_out': 0}, {'cyclomatic_complexity': 1, 'nloc': 4, 'token_count': 14, 'name': '', 'long_name': '()', 'start_line': 677, 'end_line': 680, 'full_parameters': [], 'filename': '/home/dimi/Documents/Informatik_Studium/FSS/SoftEvo/DataCollection/FFS_SoftEvo/go-ipfs/cmd/ipfs/daemon.go', 'top_nesting_level': 0, 'length': 4, 'fan_in': 0, 'fan_out': 0, 'general_fan_out': 0}, {'cyclomatic_complexity': 16, 'nloc': 80, 'token_count': 581, 'name': 'serveHTTPApi', 'long_name': 'serveHTTPApi req * cmds . Request , cctx * oldcmds . Context', 'start_line': 577, 'end_line': 683, 'full_parameters': ['req * cmds . Request', ' cctx * oldcmds . Context'], 'filename': '/home/dimi/Documents/Informatik_Studium/FSS/SoftEvo/DataCollection/FFS_SoftEvo/go-ipfs/cmd/ipfs/daemon.go', 'top_nesting_level': 0, 'length': 107, 'fan_in': 0, 'fan_out': 0, 'general_fan_out': 0}, {'cyclomatic_complexity': 7, 'nloc': 26, 'token_count': 158, 'name': 'printSwarmAddrs', 'long_name': 'printSwarmAddrs node * core . IpfsNode', 'start_line': 686, 'end_line': 714, 'full_parameters': ['node * core . IpfsNode'], 'filename': '/home/dimi/Documents/Informatik_Studium/FSS/SoftEvo/DataCollection/FFS_SoftEvo/go-ipfs/cmd/ipfs/daemon.go', 'top_nesting_level': 0, 'length': 29, 'fan_in': 0, 'fan_out': 0, 'general_fan_out': 0}, {'cyclomatic_complexity': 1, 'nloc': 4, 'token_count': 34, 'name': '', 'long_name': '(lis manet.Listener)', 'start_line': 800, 'end_line': 803, 'full_parameters': [], 'filename': '/home/dimi/Documents/Informatik_Studium/FSS/SoftEvo/DataCollection/FFS_SoftEvo/go-ipfs/cmd/ipfs/daemon.go', 'top_nesting_level': 0, 'length': 4, 'fan_in': 0, 'fan_out': 0, 'general_fan_out': 0}, {'cyclomatic_complexity': 1, 'nloc': 4, 'token_count': 14, 'name': '', 'long_name': '()', 'start_line': 806, 'end_line': 809, 'full_parameters': [], 'filename': '/home/dimi/Documents/Informatik_Studium/FSS/SoftEvo/DataCollection/FFS_SoftEvo/go-ipfs/cmd/ipfs/daemon.go', 'top_nesting_level': 0, 'length': 4, 'fan_in': 0, 'fan_out': 0, 'general_fan_out': 0}, {'cyclomatic_complexity': 16, 'nloc': 72, 'token_count': 487, 'name': 'serveHTTPGateway', 'long_name': 'serveHTTPGateway req * cmds . Request , cctx * oldcmds . Context', 'start_line': 717, 'end_line': 812, 'full_parameters': ['req * cmds . Request', ' cctx * oldcmds . Context'], 'filename': '/home/dimi/Documents/Informatik_Studium/FSS/SoftEvo/DataCollection/FFS_SoftEvo/go-ipfs/cmd/ipfs/daemon.go', 'top_nesting_level': 0, 'length': 96, 'fan_in': 0, 'fan_out': 0, 'general_fan_out': 0}, {'cyclomatic_complexity': 6, 'nloc': 25, 'token_count': 156, 'name': 'mountFuse', 'long_name': 'mountFuse req * cmds . Request , cctx * oldcmds . Context', 'start_line': 815, 'end_line': 843, 'full_parameters': ['req * cmds . Request', ' cctx * oldcmds . Context'], 'filename': '/home/dimi/Documents/Informatik_Studium/FSS/SoftEvo/DataCollection/FFS_SoftEvo/go-ipfs/cmd/ipfs/daemon.go', 'top_nesting_level': 0, 'length': 29, 'fan_in': 0, 'fan_out': 0, 'general_fan_out': 0}, {'cyclomatic_complexity': 1, 'nloc': 4, 'token_count': 22, 'name': '', 'long_name': '()', 'start_line': 852, 'end_line': 855, 'full_parameters': [], 'filename': '/home/dimi/Documents/Informatik_Studium/FSS/SoftEvo/DataCollection/FFS_SoftEvo/go-ipfs/cmd/ipfs/daemon.go', 'top_nesting_level': 0, 'length': 4, 'fan_in': 0, 'fan_out': 0, 'general_fan_out': 0}, {'cyclomatic_complexity': 2, 'nloc': 9, 'token_count': 63, 'name': 'maybeRunGC', 'long_name': 'maybeRunGC req * cmds . Request , node * core . IpfsNode', 'start_line': 845, 'end_line': 857, 'full_parameters': ['req * cmds . Request', ' node * core . IpfsNode'], 'filename': '/home/dimi/Documents/Informatik_Studium/FSS/SoftEvo/DataCollection/FFS_SoftEvo/go-ipfs/cmd/ipfs/daemon.go', 'top_nesting_level': 0, 'length': 13, 'fan_in': 0, 'fan_out': 0, 'general_fan_out': 0}, {'cyclomatic_complexity': 2, 'nloc': 6, 'token_count': 26, 'name': '', 'long_name': '(c<-chan error)', 'start_line': 867, 'end_line': 872, 'full_parameters': [], 'filename': '/home/dimi/Documents/Informatik_Studium/FSS/SoftEvo/DataCollection/FFS_SoftEvo/go-ipfs/cmd/ipfs/daemon.go', 'top_nesting_level': 0, 'length': 6, 'fan_in': 0, 'fan_out': 0, 'general_fan_out': 0}, {'cyclomatic_complexity': 1, 'nloc': 4, 'token_count': 14, 'name': '', 'long_name': '()', 'start_line': 882, 'end_line': 885, 'full_parameters': [], 'filename': '/home/dimi/Documents/Informatik_Studium/FSS/SoftEvo/DataCollection/FFS_SoftEvo/go-ipfs/cmd/ipfs/daemon.go', 'top_nesting_level': 0, 'length': 4, 'fan_in': 0, 'fan_out': 0, 'general_fan_out': 0}, {'cyclomatic_complexity': 3, 'nloc': 13, 'token_count': 63, 'name': 'merge', 'long_name': 'merge cs ... < - chan error', 'start_line': 861, 'end_line': 887, 'full_parameters': ['cs ... < - chan error'], 'filename': '/home/dimi/Documents/Informatik_Studium/FSS/SoftEvo/DataCollection/FFS_SoftEvo/go-ipfs/cmd/ipfs/daemon.go', 'top_nesting_level': 0, 'length': 27, 'fan_in': 0, 'fan_out': 0, 'general_fan_out': 0}, {'cyclomatic_complexity': 5, 'nloc': 17, 'token_count': 73, 'name': 'YesNoPrompt', 'long_name': 'YesNoPrompt prompt string', 'start_line': 889, 'end_line': 906, 'full_parameters': ['prompt string'], 'filename': '/home/dimi/Documents/Informatik_Studium/FSS/SoftEvo/DataCollection/FFS_SoftEvo/go-ipfs/cmd/ipfs/daemon.go', 'top_nesting_level': 0, 'length': 18, 'fan_in': 0, 'fan_out': 0, 'general_fan_out': 0}, {'cyclomatic_complexity': 2, 'nloc': 10, 'token_count': 72, 'name': 'printVersion', 'long_name': 'printVersion', 'start_line': 908, 'end_line': 917, 'full_parameters': [], 'filename': '/home/dimi/Documents/Informatik_Studium/FSS/SoftEvo/DataCollection/FFS_SoftEvo/go-ipfs/cmd/ipfs/daemon.go', 'top_nesting_level': 0, 'length': 10, 'fan_in': 0, 'fan_out': 0, 'general_fan_out': 0}]",164,908,6,153,153,"[{'timestamp': 1507862369.0, 'added_lines': 2, 'deleted_lines': 17, 'nloc': 526}, {'timestamp': 1491058697.0, 'added_lines': 41, 'deleted_lines': 39, 'nloc': 527}, {'timestamp': 1508770239.0, 'added_lines': 1, 'deleted_lines': 1, 'nloc': 527}, {'timestamp': 1509016767.0, 'added_lines': 1, 'deleted_lines': 1, 'nloc': 527}, {'timestamp': 1499331469.0, 'added_lines': 7, 'deleted_lines': 7, 'nloc': 527}, {'timestamp': 1511223906.0, 'added_lines': 3, 'deleted_lines': 3, 'nloc': 527}, {'timestamp': 1511245249.0, 'added_lines': 3, 'deleted_lines': 3, 'nloc': 527}, {'timestamp': 1499441579.0, 'added_lines': 4, 'deleted_lines': 0, 'nloc': 531}, {'timestamp': 1511373659.0, 'added_lines': 1, 'deleted_lines': 1, 'nloc': 527}, {'timestamp': 1490133129.0, 'added_lines': 3, 'deleted_lines': 5, 'nloc': 530}, {'timestamp': 1512365669.0, 'added_lines': 5, 'deleted_lines': 5, 'nloc': 530}, {'timestamp': 1514450040.0, 'added_lines': 1, 'deleted_lines': 1, 'nloc': 530}, {'timestamp': 1511187070.0, 'added_lines': 41, 'deleted_lines': 71, 'nloc': 501}, {'timestamp': 1511800961.0, 'added_lines': 4, 'deleted_lines': 0, 'nloc': 505}, {'timestamp': 1512058290.0, 'added_lines': 4, 'deleted_lines': 3, 'nloc': 506}, {'timestamp': 1512121226.0, 'added_lines': 4, 'deleted_lines': 4, 'nloc': 503}, {'timestamp': 1513436097.0, 'added_lines': 2, 'deleted_lines': 2, 'nloc': 503}, {'timestamp': 1513612261.0, 'added_lines': 2, 'deleted_lines': 2, 'nloc': 503}, {'timestamp': 1513614564.0, 'added_lines': 2, 'deleted_lines': 2, 'nloc': 504}, {'timestamp': 1513764628.0, 'added_lines': 0, 'deleted_lines': 1, 'nloc': 504}, {'timestamp': 1513764708.0, 'added_lines': 1, 'deleted_lines': 1, 'nloc': 504}, {'timestamp': 1513765470.0, 'added_lines': 1, 'deleted_lines': 1, 'nloc': 504}, {'timestamp': 1513766201.0, 'added_lines': 1, 'deleted_lines': 1, 'nloc': 504}, {'timestamp': 1513772371.0, 'added_lines': 9, 'deleted_lines': 11, 'nloc': 504}, {'timestamp': 1513772654.0, 'added_lines': 1, 'deleted_lines': 1, 'nloc': 504}, {'timestamp': 1513773452.0, 'added_lines': 1, 'deleted_lines': 1, 'nloc': 504}, {'timestamp': 1513788060.0, 'added_lines': 2, 'deleted_lines': 2, 'nloc': 504}, {'timestamp': 1513791994.0, 'added_lines': 2, 'deleted_lines': 2, 'nloc': 504}, {'timestamp': 1515277696.0, 'added_lines': 1, 'deleted_lines': 1, 'nloc': 504}, {'timestamp': 1515465466.0, 'added_lines': 2, 'deleted_lines': 2, 'nloc': 504}, {'timestamp': 1515708185.0, 'added_lines': 18, 'deleted_lines': 18, 'nloc': 504}, {'timestamp': 1515713724.0, 'added_lines': 1, 'deleted_lines': 1, 'nloc': 504}, {'timestamp': 1516341168.0, 'added_lines': 1, 'deleted_lines': 1, 'nloc': 504}, {'timestamp': 1516838128.0, 'added_lines': 4, 'deleted_lines': 4, 'nloc': 504}, {'timestamp': 1517105039.0, 'added_lines': 1, 'deleted_lines': 1, 'nloc': 504}, {'timestamp': 1517453697.0, 'added_lines': 3, 'deleted_lines': 3, 'nloc': 504}, {'timestamp': 1519173780.0, 'added_lines': 1, 'deleted_lines': 1, 'nloc': 504}, {'timestamp': 1519900596.0, 'added_lines': 2, 'deleted_lines': 2, 'nloc': 504}, {'timestamp': 1521072414.0, 'added_lines': 5, 'deleted_lines': 1, 'nloc': 507}, {'timestamp': 1521314540.0, 'added_lines': 1, 'deleted_lines': 1, 'nloc': 504}, {'timestamp': 1521500314.0, 'added_lines': 1, 'deleted_lines': 1, 'nloc': 504}, {'timestamp': 1503239041.0, 'added_lines': 18, 'deleted_lines': 0, 'nloc': 524}, {'timestamp': 1509474878.0, 'added_lines': 1, 'deleted_lines': 2, 'nloc': 523}, {'timestamp': 1524596476.0, 'added_lines': 1, 'deleted_lines': 1, 'nloc': 523}, {'timestamp': 1526509320.0, 'added_lines': 0, 'deleted_lines': 4, 'nloc': 519}, {'timestamp': 1525408792.0, 'added_lines': 3, 'deleted_lines': 3, 'nloc': 519}, {'timestamp': 1528059336.0, 'added_lines': 1, 'deleted_lines': 1, 'nloc': 519}, {'timestamp': 1520489177.0, 'added_lines': 3, 'deleted_lines': 4, 'nloc': 518}, {'timestamp': 1528268108.0, 'added_lines': 1, 'deleted_lines': 1, 'nloc': 518}, {'timestamp': 1528520460.0, 'added_lines': 5, 'deleted_lines': 5, 'nloc': 518}, {'timestamp': 1529984485.0, 'added_lines': 4, 'deleted_lines': 4, 'nloc': 518}, {'timestamp': 1532146078.0, 'added_lines': 2, 'deleted_lines': 2, 'nloc': 518}, {'timestamp': 1533779477.0, 'added_lines': 2, 'deleted_lines': 2, 'nloc': 518}, {'timestamp': 1533946888.0, 'added_lines': 2, 'deleted_lines': 2, 'nloc': 518}, {'timestamp': 1534896611.0, 'added_lines': 2, 'deleted_lines': 2, 'nloc': 518}, {'timestamp': 1536066990.0, 'added_lines': 1, 'deleted_lines': 1, 'nloc': 518}, {'timestamp': 1536098764.0, 'added_lines': 2, 'deleted_lines': 2, 'nloc': 518}, {'timestamp': 1536240403.0, 'added_lines': 3, 'deleted_lines': 3, 'nloc': 518}, {'timestamp': 1536251299.0, 'added_lines': 3, 'deleted_lines': 3, 'nloc': 518}, {'timestamp': 1523628870.0, 'added_lines': 21, 'deleted_lines': 36, 'nloc': 502}, {'timestamp': 1535044155.0, 'added_lines': 1, 'deleted_lines': 1, 'nloc': 502}, {'timestamp': 1537193530.0, 'added_lines': 1, 'deleted_lines': 1, 'nloc': 502}, {'timestamp': 1537276863.0, 'added_lines': 1, 'deleted_lines': 1, 'nloc': 502}, {'timestamp': 1537391809.0, 'added_lines': 1, 'deleted_lines': 1, 'nloc': 502}, {'timestamp': 1537482878.0, 'added_lines': 12, 'deleted_lines': 0, 'nloc': 511}, {'timestamp': 1537429983.0, 'added_lines': 5, 'deleted_lines': 1, 'nloc': 515}, {'timestamp': 1537792589.0, 'added_lines': 2, 'deleted_lines': 2, 'nloc': 511}, {'timestamp': 1537989051.0, 'added_lines': 1, 'deleted_lines': 0, 'nloc': 516}, {'timestamp': 1538630728.0, 'added_lines': 2, 'deleted_lines': 2, 'nloc': 516}, {'timestamp': 1538036722.0, 'added_lines': 65, 'deleted_lines': 29, 'nloc': 544}, {'timestamp': 1537210683.0, 'added_lines': 3, 'deleted_lines': 3, 'nloc': 544}, {'timestamp': 1539850591.0, 'added_lines': 2, 'deleted_lines': 2, 'nloc': 544}, {'timestamp': 1540399032.0, 'added_lines': 3, 'deleted_lines': 3, 'nloc': 544}, {'timestamp': 1540400358.0, 'added_lines': 2, 'deleted_lines': 2, 'nloc': 544}, {'timestamp': 1540552487.0, 'added_lines': 1, 'deleted_lines': 1, 'nloc': 544}, {'timestamp': 1540597832.0, 'added_lines': 1, 'deleted_lines': 1, 'nloc': 544}, {'timestamp': 1540939129.0, 'added_lines': 2, 'deleted_lines': 2, 'nloc': 544}, {'timestamp': 1541204121.0, 'added_lines': 4, 'deleted_lines': 4, 'nloc': 544}, {'timestamp': 1541211840.0, 'added_lines': 1, 'deleted_lines': 1, 'nloc': 545}, {'timestamp': 1534960588.0, 'added_lines': 1, 'deleted_lines': 0, 'nloc': 546}, {'timestamp': 1539375755.0, 'added_lines': 3, 'deleted_lines': 1, 'nloc': 548}, {'timestamp': 1541886406.0, 'added_lines': 7, 'deleted_lines': 6, 'nloc': 548}, {'timestamp': 1542068612.0, 'added_lines': 3, 'deleted_lines': 3, 'nloc': 548}, {'timestamp': 1544661332.0, 'added_lines': 1, 'deleted_lines': 1, 'nloc': 548}, {'timestamp': 1540556089.0, 'added_lines': 1, 'deleted_lines': 1, 'nloc': 548}, {'timestamp': 1544616047.0, 'added_lines': 1, 'deleted_lines': 2, 'nloc': 547}, {'timestamp': 1546567583.0, 'added_lines': 4, 'deleted_lines': 1, 'nloc': 549}, {'timestamp': 1546917821.0, 'added_lines': 8, 'deleted_lines': 6, 'nloc': 549}, {'timestamp': 1546917910.0, 'added_lines': 1, 'deleted_lines': 5, 'nloc': 545}, {'timestamp': 1546982412.0, 'added_lines': 10, 'deleted_lines': 1, 'nloc': 550}, {'timestamp': 1547003974.0, 'added_lines': 2, 'deleted_lines': 2, 'nloc': 549}, {'timestamp': 1547152271.0, 'added_lines': 1, 'deleted_lines': 1, 'nloc': 550}, {'timestamp': 1548866534.0, 'added_lines': 1, 'deleted_lines': 1, 'nloc': 550}, {'timestamp': 1548794658.0, 'added_lines': 15, 'deleted_lines': 0, 'nloc': 561}, {'timestamp': 1549903582.0, 'added_lines': 1, 'deleted_lines': 1, 'nloc': 561}, {'timestamp': 1550507829.0, 'added_lines': 2, 'deleted_lines': 2, 'nloc': 561}, {'timestamp': 1550610741.0, 'added_lines': 1, 'deleted_lines': 1, 'nloc': 561}, {'timestamp': 1551138343.0, 'added_lines': 1, 'deleted_lines': 1, 'nloc': 561}, {'timestamp': 1551229859.0, 'added_lines': 2, 'deleted_lines': 2, 'nloc': 561}, {'timestamp': 1551299964.0, 'added_lines': 1, 'deleted_lines': 1, 'nloc': 561}, {'timestamp': 1551471469.0, 'added_lines': 1, 'deleted_lines': 1, 'nloc': 561}, {'timestamp': 1551754781.0, 'added_lines': 2, 'deleted_lines': 2, 'nloc': 561}, {'timestamp': 1551551196.0, 'added_lines': 7, 'deleted_lines': 7, 'nloc': 561}, {'timestamp': 1553697989.0, 'added_lines': 2, 'deleted_lines': 2, 'nloc': 561}, {'timestamp': 1554331093.0, 'added_lines': 4, 'deleted_lines': 0, 'nloc': 562}, {'timestamp': 1554332347.0, 'added_lines': 4, 'deleted_lines': 2, 'nloc': 564}, {'timestamp': 1553871352.0, 'added_lines': 1, 'deleted_lines': 1, 'nloc': 564}, {'timestamp': 1554255872.0, 'added_lines': 4, 'deleted_lines': 3, 'nloc': 565}, {'timestamp': 1556015751.0, 'added_lines': 4, 'deleted_lines': 4, 'nloc': 565}, {'timestamp': 1556612769.0, 'added_lines': 5, 'deleted_lines': 5, 'nloc': 565}, {'timestamp': 1557554420.0, 'added_lines': 21, 'deleted_lines': 22, 'nloc': 564}, {'timestamp': 1562610931.0, 'added_lines': 16, 'deleted_lines': 9, 'nloc': 571}, {'timestamp': 1566973868.0, 'added_lines': 5, 'deleted_lines': 1, 'nloc': 568}, {'timestamp': 1537764450.0, 'added_lines': 57, 'deleted_lines': 49, 'nloc': 581}, {'timestamp': 1537810535.0, 'added_lines': 1, 'deleted_lines': 1, 'nloc': 581}, {'timestamp': 1569380180.0, 'added_lines': 45, 'deleted_lines': 31, 'nloc': 592}, {'timestamp': 1569382237.0, 'added_lines': 2, 'deleted_lines': 0, 'nloc': 594}, {'timestamp': 1569623841.0, 'added_lines': 3, 'deleted_lines': 3, 'nloc': 594}, {'timestamp': 1569854489.0, 'added_lines': 14, 'deleted_lines': 1, 'nloc': 584}, {'timestamp': 1569462092.0, 'added_lines': 6, 'deleted_lines': 2, 'nloc': 606}, {'timestamp': 1573801139.0, 'added_lines': 1, 'deleted_lines': 0, 'nloc': 607}, {'timestamp': 1573805478.0, 'added_lines': 1, 'deleted_lines': 1, 'nloc': 607}, {'timestamp': 1574068068.0, 'added_lines': 0, 'deleted_lines': 1, 'nloc': 606}, {'timestamp': 1574425124.0, 'added_lines': 1, 'deleted_lines': 6, 'nloc': 601}, {'timestamp': 1577243561.0, 'added_lines': 1, 'deleted_lines': 1, 'nloc': 601}, {'timestamp': 1579218500.0, 'added_lines': 1, 'deleted_lines': 1, 'nloc': 601}, {'timestamp': 1552604821.0, 'added_lines': 1, 'deleted_lines': 1, 'nloc': 601}, {'timestamp': 1552609298.0, 'added_lines': 6, 'deleted_lines': 5, 'nloc': 601}, {'timestamp': 1585144997.0, 'added_lines': 3, 'deleted_lines': 3, 'nloc': 601}, {'timestamp': 1586206546.0, 'added_lines': 3, 'deleted_lines': 0, 'nloc': 604}, {'timestamp': 1586859889.0, 'added_lines': 1, 'deleted_lines': 1, 'nloc': 604}, {'timestamp': 1587221101.0, 'added_lines': 4, 'deleted_lines': 4, 'nloc': 604}, {'timestamp': 1592294541.0, 'added_lines': 5, 'deleted_lines': 3, 'nloc': 606}, {'timestamp': 1594333110.0, 'added_lines': 9, 'deleted_lines': 1, 'nloc': 613}, {'timestamp': 1595277534.0, 'added_lines': 2, 'deleted_lines': 0, 'nloc': 615}, {'timestamp': 1597895573.0, 'added_lines': 1, 'deleted_lines': 1, 'nloc': 615}, {'timestamp': 1603146253.0, 'added_lines': 12, 'deleted_lines': 6, 'nloc': 621}, {'timestamp': 1595559566.0, 'added_lines': 1, 'deleted_lines': 0, 'nloc': 622}, {'timestamp': 1611878324.0, 'added_lines': 3, 'deleted_lines': 0, 'nloc': 623}, {'timestamp': 1608173236.0, 'added_lines': 2, 'deleted_lines': 2, 'nloc': 623}, {'timestamp': 1613617929.0, 'added_lines': 2, 'deleted_lines': 0, 'nloc': 624}, {'timestamp': 1614357668.0, 'added_lines': 4, 'deleted_lines': 3, 'nloc': 625}, {'timestamp': 1615853625.0, 'added_lines': 1, 'deleted_lines': 2, 'nloc': 624}, {'timestamp': 1616197988.0, 'added_lines': 4, 'deleted_lines': 0, 'nloc': 626}, {'timestamp': 1620837194.0, 'added_lines': 56, 'deleted_lines': 2, 'nloc': 668}, {'timestamp': 1622468001.0, 'added_lines': 19, 'deleted_lines': 0, 'nloc': 685}, {'timestamp': 1622497350.0, 'added_lines': 1, 'deleted_lines': 1, 'nloc': 668}, {'timestamp': 1623082460.0, 'added_lines': 10, 'deleted_lines': 0, 'nloc': 693}, {'timestamp': 1622497350.0, 'added_lines': 1, 'deleted_lines': 1, 'nloc': 668}, {'timestamp': 1622468001.0, 'added_lines': 19, 'deleted_lines': 0, 'nloc': 685}, {'timestamp': 1623082460.0, 'added_lines': 10, 'deleted_lines': 0, 'nloc': 693}, {'timestamp': 1627669677.0, 'added_lines': 17, 'deleted_lines': 2, 'nloc': 698}, {'timestamp': 1632249068.0, 'added_lines': 7, 'deleted_lines': 0, 'nloc': 704}]","{None: 32, 'blocks/blockstore/caching.go': 1, 'blocks/blockstore/util/remove.go': 3, 'cmd/ipfs/init.go': 46, 'cmd/ipfs/ipfs.go': 53, 'cmd/ipfs/main.go': 64, 'cmd/ipfs/main_test.go': 4, 'cmd/ipfswatch/main.go': 22, 'cmd/seccat/seccat.go': 20, 'commands/channelmarshaler.go': 1, 'commands/cli/cmd_suggestion.go': 1, 'commands/cli/helptext.go': 3, 'commands/cli/helptext_test.go': 2, 'commands/cli/parse.go': 2, 'commands/cli/parse_test.go': 2, 'commands/command.go': 29, 'commands/command_test.go': 20, 'commands/http/client.go': 2, 'commands/http/handler.go': 2, 'commands/http/multifilereader.go': 2, 'commands/http/multifilereader_test.go': 2, 'commands/http/parse.go': 2, 'commands/reqlog.go': 2, 'commands/request.go': 40, 'commands/response.go': 24, 'commands/response_test.go': 20, 'core/bootstrap.go': 19, 'core/commands/active.go': 25, 'core/commands/add.go': 60, 'core/commands/bitswap.go': 58, 'core/commands/block.go': 56, 'core/commands/bootstrap.go': 28, 'core/commands/cat.go': 56, 'core/commands/commands.go': 58, 'core/commands/config.go': 33, 'core/commands/dag/dag.go': 35, 'core/commands/dht.go': 38, 'core/commands/diag.go': 23, 'core/commands/dns.go': 27, 'core/commands/e/error.go': 1, 'core/commands/external.go': 24, 'core/commands/files/files.go': 12, 'core/commands/filestore.go': 53, 'core/commands/get.go': 61, 'core/commands/helptext_test.go': 51, 'core/commands/id.go': 41, 'core/commands/ipns.go': 15, 'core/commands/keystore.go': 38, 'core/commands/log.go': 30, 'core/commands/ls.go': 35, 'core/commands/mount_nofuse.go': 23, 'core/commands/mount_unix.go': 30, 'core/commands/mount_windows.go': 23, 'core/commands/name.go': 11, 'core/commands/object/diff.go': 25, 'core/commands/object/object.go': 44, 'core/commands/object/patch.go': 40, 'core/commands/p2p.go': 33, 'core/commands/pin.go': 38, 'core/commands/ping.go': 36, 'core/commands/publish.go': 16, 'core/commands/pubsub.go': 56, 'core/commands/refs.go': 32, 'core/commands/repo.go': 60, 'core/commands/resolve.go': 33, 'core/commands/root.go': 56, 'core/commands/shutdown.go': 34, 'core/commands/stat.go': 60, 'core/commands/swarm.go': 41, 'core/commands/sysdiag.go': 32, 'core/commands/tar.go': 30, 'core/commands/unixfs/ls.go': 29, 'core/commands/unixfs/unixfs.go': 23, 'core/commands/version.go': 28, 'core/core_test.go': 11, 'core/corehttp/commands.go': 61, 'core/corehttp/gateway.go': 23, 'core/coreunix/add.go': 28, 'core/coreunix/add_test.go': 29, 'core/coreunix/metadata_test.go': 23, 'exchange/bitswap/bitswap_test.go': 12, 'exchange/bitswap/decision/engine_test.go': 9, 'exchange/bitswap/message/message_test.go': 4, 'exchange/bitswap/message/pb/Makefile': 1, 'exchange/bitswap/testnet/network_test.go': 9, 'exchange/bitswap/testnet/peernet.go': 11, 'exchange/reprovide/reprovide_test.go': 20, 'fuse/ipns/common.go': 17, 'fuse/node/mount_test.go': 18, 'importer/balanced/balanced_test.go': 6, 'importer/chunk/rabin_test.go': 3, 'importer/helpers/dagbuilder.go': 11, 'importer/importer.go': 11, 'merkledag/utils/utils_test.go': 4, 'mfs/repub_test.go': 9, 'namesys/dns.go': 12, 'namesys/interface.go': 14, 'namesys/ipns_select_test.go': 5, 'namesys/proquint.go': 12, 'namesys/republisher/repub_test.go': 25, 'package.json': 59, 'repo/config/identity.go': 3, 'routing/offline/offline_test.go': 6, 'test/integration/addcat_test.go': 26, 'test/integration/bench_cat_test.go': 25, 'test/integration/bitswap_wo_routing_test.go': 24, 'test/integration/three_legged_cat_test.go': 25, 'test/sharness/t0600-issues-and-regressions-online.sh': 2, 'core/bootstrap_test.go': 17, 'core/commands/dht_test.go': 16, 'core/commands/get_test.go': 51, 'core/core.go': 39, 'core/corehttp/gateway_test.go': 26, 'core/corehttp/metrics_test.go': 21, 'core/mock/mock.go': 23, 'exchange/bitswap/decision/bench_test.go': 7, 'exchange/bitswap/decision/peer_request_queue_test.go': 7, 'exchange/bitswap/message/message.go': 8, 'exchange/bitswap/network/interface.go': 8, 'exchange/bitswap/network/ipfs_impl.go': 9, 'exchange/bitswap/testnet/interface.go': 7, 'exchange/bitswap/testnet/virtual.go': 8, 'exchange/bitswap/testutils.go': 10, 'fuse/ipns/ipns_test.go': 19, 'fuse/readonly/ipfs_test.go': 23, 'namesys/publisher_test.go': 17, 'namesys/resolve_test.go': 18, 'p2p/p2p.go': 18, 'p2p/registry.go': 10, 'repo/config/bootstrap_peers.go': 11, 'routing/mock/centralized_client.go': 4, 'routing/mock/centralized_server.go': 4, 'routing/mock/centralized_test.go': 4, 'routing/mock/interface.go': 4, 'routing/none/none_client.go': 4, 'test/integration/bench_test.go': 16, 'core/builder.go': 30, 'core/commands/ipnsps.go': 11, 'namesys/namesys.go': 23, 'namesys/namesys_test.go': 23, 'namesys/pubsub.go': 6, 'namesys/pubsub_test.go': 6, 'test/sharness/t0183-namesys-pubsub.sh': 2, 'cmd/ipfs/util/ulimit.go': 12, 'cmd/ipfs/util/ulimit_freebsd.go': 3, 'cmd/ipfs/util/ulimit_test.go': 2, 'cmd/ipfs/util/ulimit_unix.go': 3, 'cmd/ipfs/util/ulimit_windows.go': 1, 'assets/assets.go': 18, 'blocks/blockstore/arc_cache.go': 2, 'blocks/blockstore/arc_cache_test.go': 2, 'blocks/blockstore/blockstore.go': 3, 'blocks/blockstore/blockstore_test.go': 2, 'blocks/blockstore/bloom_cache.go': 2, 'blocks/blockstore/bloom_cache_test.go': 2, 'blocks/blocksutil/block_generator.go': 2, 'blockservice/blockservice.go': 7, 'blockservice/blockservice_test.go': 6, 'blockservice/test/blocks_test.go': 6, 'core/coreapi/coreapi.go': 13, 'core/coreapi/interface/interface.go': 2, 'core/coreapi/unixfs.go': 20, 'core/coreapi/unixfs_test.go': 14, 'core/coredag/cbor.go': 7, 'core/coredag/dagpb.go': 13, 'core/coredag/dagtransl.go': 6, 'core/coredag/raw.go': 13, 'core/corehttp/corehttp.go': 20, 'core/corehttp/gateway_handler.go': 29, 'core/corerepo/gc.go': 23, 'core/corerepo/pinning.go': 8, 'core/coreunix/metadata.go': 18, 'core/pathresolver.go': 16, 'exchange/bitswap/bitswap.go': 7, 'exchange/bitswap/decision/engine.go': 7, 'exchange/bitswap/decision/ledger.go': 6, 'exchange/bitswap/decision/peer_request_queue.go': 6, 'exchange/bitswap/get.go': 6, 'exchange/bitswap/notifications/notifications.go': 3, 'exchange/bitswap/notifications/notifications_test.go': 3, 'exchange/bitswap/session.go': 7, 'exchange/bitswap/session_test.go': 5, 'exchange/bitswap/stat.go': 3, 'exchange/bitswap/wantlist/wantlist.go': 3, 'exchange/bitswap/wantlist/wantlist_test.go': 3, 'exchange/bitswap/wantmanager.go': 7, 'exchange/bitswap/workers.go': 6, 'exchange/interface.go': 2, 'exchange/offline/offline.go': 2, 'exchange/offline/offline_test.go': 2, 'exchange/reprovide/providers.go': 16, 'exchange/reprovide/reprovide.go': 16, 'filestore/filestore.go': 13, 'filestore/filestore_test.go': 16, 'filestore/fsrefstore.go': 12, 'filestore/util.go': 12, 'fuse/ipns/ipns_unix.go': 22, 'fuse/readonly/readonly_unix.go': 24, 'importer/balanced/builder.go': 3, 'importer/chunk/splitting_test.go': 2, 'importer/helpers/helpers.go': 3, 'importer/importer_test.go': 5, 'importer/trickle/trickle_test.go': 5, 'importer/trickle/trickledag.go': 3, 'merkledag/batch.go': 2, 'merkledag/coding.go': 3, 'merkledag/merkledag.go': 3, 'merkledag/merkledag_test.go': 6, 'merkledag/node.go': 3, 'merkledag/node_test.go': 3, 'merkledag/raw.go': 3, 'merkledag/traverse/traverse.go': 3, 'merkledag/traverse/traverse_test.go': 3, 'merkledag/utils/diff.go': 3, 'merkledag/utils/diffenum.go': 3, 'merkledag/utils/diffenum_test.go': 3, 'merkledag/utils/utils.go': 6, 'mfs/dir.go': 5, 'mfs/file.go': 7, 'mfs/mfs_test.go': 8, 'mfs/ops.go': 4, 'mfs/system.go': 8, 'namesys/publisher.go': 22, 'namesys/republisher/repub.go': 16, 'namesys/routing.go': 21, 'path/path.go': 3, 'path/resolver.go': 3, 'path/resolver_test.go': 2, 'pin/gc/gc.go': 17, 'pin/pin.go': 16, 'pin/pin_test.go': 17, 'pin/set.go': 13, 'pin/set_test.go': 16, 'plugin/ipld.go': 6, 'plugin/loader/initializer.go': 5, 'plugin/plugins/git/git.go': 6, 'repo/config/init.go': 9, 'repo/fsrepo/fsrepo.go': 19, 'repo/fsrepo/lock/lock.go': 3, 'repo/fsrepo/serialize/serialize.go': 3, 'repo/mock.go': 12, 'repo/repo.go': 13, 'routing/offline/offline.go': 3, 'tar/format.go': 21, 'test/dependencies/ma-pipe-unidir/main.go': 11, 'thirdparty/ds-help/key.go': 2, 'thirdparty/pollEndpoint/main.go': 15, 'thirdparty/posinfo/posinfo.go': 2, 'unixfs/archive/archive.go': 3, 'unixfs/archive/tar/writer.go': 3, 'unixfs/hamt/hamt.go': 3, 'unixfs/io/dagreader.go': 3, 'unixfs/io/dirbuilder.go': 3, 'unixfs/io/resolve.go': 3, 'unixfs/mod/dagmodifier.go': 5, 'unixfs/mod/dagmodifier_test.go': 3, 'unixfs/test/utils.go': 5, 'commands/legacy/command.go': 34, 'commands/legacy/legacy.go': 35, 'commands/legacy/legacy_test.go': 36, 'commands/legacy/request.go': 35, 'commands/legacy/response.go': 35, 'commands/legacy/responseemitter.go': 4, 'core/commands/env.go': 4, 'core/corehttp/option_test.go': 3, 'core/commands/commands_test.go': 44, 'test/sharness/t0040-add-and-cat.sh': 5, 'TODO.md': 3, 'test/sharness/t0110-gateway.sh': 3, 'test/sharness/t0410-api-add.sh': 2, 'core/coreapi/dag.go': 5, 'core/coreapi/dag_test.go': 3, 'core/coreapi/interface/options/dag.go': 4, 'core/coreapi/key.go': 16, 'core/coreapi/name.go': 17, 'merkledag/test/utils.go': 5, 'repo/fsrepo/datastores.go': 11, 'repo/fsrepo/fsrepo_test.go': 10, 'thirdparty/datastore2/datastore_closer.go': 1, 'thirdparty/datastore2/delayed.go': 1, 'thirdparty/datastore2/threadsafe.go': 1, 'unixfs/io/pbdagreader.go': 2, 'cmd/seccat/util.go': 10, 'core/corehttp/logs.go': 9, 'fuse/mount/mount.go': 10, 'fuse/node/mount_unix.go': 11, 'importer/chunk/splitting.go': 1, 'namesys/ipns_validate_test.go': 4, 'plugin/loader/load.go': 7, 'core/commands/files.go': 38, 'test/sharness/t0063-daemon-init.sh': 1, 'core/commands/root_test.go': 1, 'test/sharness/t0090-get.sh': 2, 'docs/config.md': 8, 'repo/config/discovery.go': 2, 'repo/config/config.go': 1, 'repo/config/profile.go': 1, 'repo/config/routing.go': 1, 'test/sharness/t0020-init.sh': 3, 'test/sharness/t0021-config.sh': 1, 'blocks/blockstoreutil/remove.go': 11, 'blockservice/test/mock.go': 4, 'core/coreapi/pin.go': 15, 'keystore/keystore.go': 10, 'keystore/keystore_test.go': 7, 'keystore/memkeystore.go': 6, 'namesys/validator.go': 3, 'path/resolver/resolver.go': 3, 'thirdparty/verifbs/verifbs.go': 10, 'core/corehttp/ipns_hostname.go': 6, 'core/coreapi/block.go': 8, 'core/coreapi/block_test.go': 2, 'core/coreapi/interface/coreapi.go': 3, 'core/coreapi/interface/dag.go': 3, 'core/coreapi/interface/object.go': 3, 'core/coreapi/interface/options/block.go': 2, 'core/coreapi/interface/path.go': 7, 'core/coreapi/interface/unixfs.go': 6, 'core/coreapi/object.go': 17, 'fuse/ipns/link_unix.go': 2, 'fuse/mount/fuse.go': 4, 'fuse/node/mount_darwin.go': 3, 'merkledag/errservice.go': 1, 'merkledag/readonly.go': 1, 'merkledag/readonly_test.go': 1, 'merkledag/rwservice.go': 1, 'merkledag/session.go': 1, 'path/resolver/resolver_test.go': 1, 'thirdparty/verifcid/validate.go': 1, 'thirdparty/verifcid/validate_test.go': 1, 'unixfs/hamt/hamt_stress_test.go': 1, 'unixfs/hamt/hamt_test.go': 1, 'namesys/ipns_resolver_validation_test.go': 12, 'test/sharness/t0170-dht.sh': 1, 'core/corehttp/metrics.go': 4, 'core/commands/urlstore.go': 28, 'core/coreapi/interface/key.go': 5, 'core/coreapi/name_test.go': 7, 'core/coreapi/path.go': 15, 'core/coreunix/cat.go': 4, 'core/pathresolver_test.go': 10, 'dagutils/diff.go': 12, 'dagutils/diffenum.go': 10, 'dagutils/diffenum_test.go': 10, 'dagutils/utils.go': 11, 'dagutils/utils_test.go': 10, 'filestore/pb/dataobj.pb.go': 3, 'mfs/fd.go': 2, 'namesys/base.go': 11, 'namesys/cache.go': 10, 'pin/internal/pb/header.pb.go': 3, 'thirdparty/cidv0v1/blockstore.go': 6, 'repo/fsrepo/config_test.go': 8, 'repo/fsrepo/misc.go': 8, 'test/bench/bench_cli_ipfs_add/main.go': 10, 'test/bench/offline_add/main.go': 10, 'core/commands/cmdenv/env.go': 24, 'core/commands/name/ipns.go': 25, 'core/commands/name/ipnsps.go': 23, 'core/commands/name/name.go': 21, 'core/commands/name/publish.go': 23, 'test/sharness/lib/test-lib.sh': 3, 'test/sharness/t0060-daemon.sh': 6, 'core/coreapi/dht.go': 9, 'core/coreapi/dht_test.go': 3, 'core/coreapi/interface/dht.go': 4, 'p2p/listener.go': 7, 'p2p/local.go': 10, 'p2p/remote.go': 9, 'p2p/stream.go': 9, 'core/corehttp/mutex_profile.go': 2, 'core/commands/cid.go': 19, 'core/coreapi/unixfile.go': 5, 'README.md': 3, 'core/coreapi/pubsub.go': 10, 'cmd/ipfs/dnsresolve_test.go': 5, 'core/coreapi/interface/options/unixfs.go': 3, 'core/coreapi/interface/pubsub.go': 2, 'core/coreapi/interface/swarm.go': 3, 'core/coreapi/swarm.go': 9, 'test/dependencies/iptb/iptb.go': 6, 'p2p/proxy.go': 1, 'p2p/proxy_test.go': 1, 'test/sharness/t0184-http-proxy-over-p2p.sh': 3, 'commands/context.go': 15, 'core/coreapi/interface/tests/name.go': 2, 'core/coreapi/interface/tests/unixfs.go': 2, 'core/coreapi/test/api_test.go': 7, 'core/corehttp/proxy.go': 5, 'core/commands/cmdenv/cidbase.go': 9, 'core/commands/cmdenv/file.go': 3, 'plugin/daemon.go': 6, 'plugin/loader/loader.go': 8, 'namesys/dns_test.go': 5, 'plugin/plugins/badgerds/badgerds.go': 3, 'plugin/plugins/flatfs/flatfs.go': 3, 'plugin/plugins/levelds/levelds.go': 2, 'core/corerepo/stat.go': 2, 'core/commands/cmdenv/cidbase_test.go': 1, 'core/corehttp/proxy_test.go': 1, 'plugin/tracer.go': 1, 'thirdparty/notifier/notifier.go': 2, 'provider/queue.go': 1, 'provider/queue_test.go': 1, 'go.mod': 14, 'core/ncore.go': 2, 'fuse/ipns/mount_unix.go': 1, 'fuse/readonly/mount_unix.go': 1, 'core/bootstrap/bootstrap.go': 2, 'core/bootstrap/bootstrap_test.go': 1, 'core/node/builder.go': 2, 'core/node/core.go': 2, 'core/node/discovery.go': 1, 'core/node/groups.go': 3, 'core/node/helpers.go': 2, 'core/node/identity.go': 1, 'core/node/ipns.go': 1, 'core/node/libp2p.go': 1, 'core/node/provider.go': 2, 'core/node/storage.go': 2, 'core/node/helpers/helpers.go': 1, 'core/node/libp2p/discovery.go': 2, 'core/node/libp2p/libp2p.go': 3, 'go.sum': 13, 'package-list.json': 1, 'cmd/ipfs/sockets/sockets.go': 1, 'cmd/ipfs/sockets/sockets_linux.go': 1, 'misc/systemd/ipfs-api.socket': 1, 'misc/systemd/ipfs-gateway.socket': 1, 'misc/systemd/ipfs.service': 2, 'cmd/ipfs/daemon_linux.go': 1, 'cmd/ipfs/daemon_other.go': 1, 'test/dependencies/pollEndpoint/main.go': 1, 'test/sharness/t0067-unix-api.sh': 1, 'test/sharness/t0111-gateway-writeable.sh': 2, 'plugin/daemoninternal.go': 1, 'mk/util.mk': 1, 'test/sharness/README.md': 2, 'test/sharness/t0175-reprovider.sh': 1, 'test/sharness/t0272-urlstore.sh': 2, 'core/node/libp2p/pnet.go': 1, 'core/node/libp2p/smux.go': 2, 'core/node/libp2p/transport.go': 2, 'plugin/loader/load_unix.go': 1, 'core/corehttp/p2p_proxy.go': 1, 'core/corehttp/p2p_proxy_test.go': 1, 'core/corehttp/hostname.go': 1, 'core/corehttp/hostname_test.go': 1, 'docs/environment-variables.md': 3, 'test/sharness/t0114-gateway-subdomains.sh': 3, 'test/sharness/t0160-resolve.sh': 1, 'core/node/libp2p/routingopt.go': 1, 'CHANGELOG.md': 1, 'Dockerfile': 1, 'bin/check_go_version': 1, 'coverage/Rules.mk': 1, 'docs/debug-guide.md': 1, 'gc/gc.go': 1, 'keystore/memkeystore_test.go': 1, 'misc/completion/ipfs-completion.bash': 1, 'plugin/plugins/gen_main.sh': 1, 'repo/fsrepo/migrations/migrations.go': 5, 'repo/onlyone.go': 1, 'test/3nodetest/run-test-on-img.sh': 1, 'test/ipfs-test-lib.sh': 1, 'test/sharness/lib/iptb-lib.sh': 1, 'test/sharness/t0010-basic-commands.sh': 1, 'test/sharness/t0030-mount.sh': 1, 'test/sharness/t0031-mount-publish.sh': 1, 'test/sharness/t0050-block.sh': 1, 'test/sharness/t0051-object.sh': 1, 'test/sharness/t0053-dag.sh': 1, 'test/sharness/t0062-daemon-api.sh': 1, 'test/sharness/t0080-repo.sh': 1, 'test/sharness/t0087-repo-robust-gc.sh': 1, 'test/sharness/t0131-multinode-client-routing.sh': 1, 'test/sharness/t0140-swarm.sh': 1, 'test/sharness/t0250-files-api.sh': 1, 'test/sharness/t0270-filestore.sh': 1, 'test/sharness_test_coverage_helper.sh': 1, 'thirdparty/README.md': 1, 'core/node/libp2p/relay.go': 1, 'core/node/libp2p/sec.go': 1, 'docs/experimental-features.md': 1, 'test/sharness/t0125-twonode.sh': 1, 'test/sharness/t0130-multinode.sh': 1, 'test/sharness/t0190-quic-ping.sh': 1, 'test/sharness/t0191-noise.sh': 1, 'cmd/ipfs/rotate.go': 1, 'core/commands/extra.go': 1, 'plugin/loader/preload.sh': 1, 'cmd/ipfs/pinmfs.go': 1, 'cmd/ipfs/pinmfs_test.go': 1, 'core/commands/config_test.go': 1, 'core/commands/pin/remotepin.go': 1, 'test/sharness/t0700-remotepin.sh': 1, 'repo/fsrepo/migrations/fetch.go': 4, 'repo/fsrepo/migrations/fetch_test.go': 5, 'repo/fsrepo/migrations/ipfsdir.go': 3, 'repo/fsrepo/migrations/ipfsdir_test.go': 4, 'repo/fsrepo/migrations/migrations_test.go': 5, 'repo/fsrepo/migrations/unpack.go': 3, 'repo/fsrepo/migrations/versions.go': 3, 'repo/fsrepo/migrations/versions_test.go': 3, 'repo/fsrepo/migrations/fetcher.go': 3, 'repo/fsrepo/migrations/httpfetcher.go': 3, 'repo/fsrepo/migrations/unpack_test.go': 2, 'cmd/ipfs/migration.go': 1, 'cmd/ipfs/migration_test.go': 1, 'repo/fsrepo/migrations/ipfsfetcher/ipfsfetcher.go': 2, 'repo/fsrepo/migrations/ipfsfetcher/ipfsfetcher_test.go': 2, 'cmd/ipfs/add_migrations.go': 1, 'test/sharness/t0026-id.sh': 1, 'version.go': 1}","('cmd/ipfs/main.go', 0.41830065359477125, 0.6095238095238096)"
cmd/ipfs/init.go,208,1262,6,"[{'cyclomatic_complexity': 10, 'nloc': 43, 'token_count': 286, 'name': '', 'long_name': '(req cmds.Request,res cmds.Response)', 'start_line': 75, 'end_line': 125, 'full_parameters': [], 'filename': '/home/dimi/Documents/Informatik_Studium/FSS/SoftEvo/DataCollection/FFS_SoftEvo/go-ipfs/cmd/ipfs/init.go', 'top_nesting_level': 0, 'length': 51, 'fan_in': 0, 'fan_out': 0, 'general_fan_out': 0}, {'cyclomatic_complexity': 1, 'nloc': 3, 'token_count': 29, 'name': 'initWithDefaults', 'long_name': 'initWithDefaults out io . Writer , repoRoot string', 'start_line': 132, 'end_line': 134, 'full_parameters': ['out io . Writer', ' repoRoot string'], 'filename': '/home/dimi/Documents/Informatik_Studium/FSS/SoftEvo/DataCollection/FFS_SoftEvo/go-ipfs/cmd/ipfs/init.go', 'top_nesting_level': 0, 'length': 3, 'fan_in': 0, 'fan_out': 0, 'general_fan_out': 0}, {'cyclomatic_complexity': 12, 'nloc': 36, 'token_count': 203, 'name': 'doInit', 'long_name': 'doInit out io . Writer , repoRoot string , empty bool , nBitsForKeypair int , confProfiles [ ] string , conf * config . Config', 'start_line': 136, 'end_line': 179, 'full_parameters': ['out io . Writer', ' repoRoot string', ' empty bool', ' nBitsForKeypair int', ' confProfiles [ ] string', ' conf * config . Config'], 'filename': '/home/dimi/Documents/Informatik_Studium/FSS/SoftEvo/DataCollection/FFS_SoftEvo/go-ipfs/cmd/ipfs/init.go', 'top_nesting_level': 0, 'length': 44, 'fan_in': 0, 'fan_out': 0, 'general_fan_out': 0}, {'cyclomatic_complexity': 6, 'nloc': 22, 'token_count': 128, 'name': 'checkWriteable', 'long_name': 'checkWriteable dir string', 'start_line': 181, 'end_line': 207, 'full_parameters': ['dir string'], 'filename': '/home/dimi/Documents/Informatik_Studium/FSS/SoftEvo/DataCollection/FFS_SoftEvo/go-ipfs/cmd/ipfs/init.go', 'top_nesting_level': 0, 'length': 27, 'fan_in': 0, 'fan_out': 0, 'general_fan_out': 0}, {'cyclomatic_complexity': 5, 'nloc': 23, 'token_count': 154, 'name': 'addDefaultAssets', 'long_name': 'addDefaultAssets out io . Writer , repoRoot string', 'start_line': 209, 'end_line': 236, 'full_parameters': ['out io . Writer', ' repoRoot string'], 'filename': '/home/dimi/Documents/Informatik_Studium/FSS/SoftEvo/DataCollection/FFS_SoftEvo/go-ipfs/cmd/ipfs/init.go', 'top_nesting_level': 0, 'length': 28, 'fan_in': 0, 'fan_out': 0, 'general_fan_out': 0}, {'cyclomatic_complexity': 4, 'nloc': 18, 'token_count': 117, 'name': 'initializeIpnsKeyspace', 'long_name': 'initializeIpnsKeyspace repoRoot string', 'start_line': 238, 'end_line': 259, 'full_parameters': ['repoRoot string'], 'filename': '/home/dimi/Documents/Informatik_Studium/FSS/SoftEvo/DataCollection/FFS_SoftEvo/go-ipfs/cmd/ipfs/init.go', 'top_nesting_level': 0, 'length': 22, 'fan_in': 0, 'fan_out': 0, 'general_fan_out': 0}]",213,1285,5,"[{'cyclomatic_complexity': 5, 'nloc': 15, 'token_count': 82, 'name': 'applyProfiles', 'long_name': 'applyProfiles conf * config . Config , profiles string', 'start_line': 129, 'end_line': 145, 'full_parameters': ['conf * config . Config', ' profiles string'], 'filename': '/home/dimi/Documents/Informatik_Studium/FSS/SoftEvo/DataCollection/FFS_SoftEvo/go-ipfs/cmd/ipfs/init.go', 'top_nesting_level': 0, 'length': 17, 'fan_in': 0, 'fan_out': 0, 'general_fan_out': 0}, {'cyclomatic_complexity': 8, 'nloc': 23, 'token_count': 138, 'name': 'doInit', 'long_name': 'doInit out io . Writer , repoRoot string , empty bool , confProfiles string , conf * config . Config', 'start_line': 147, 'end_line': 175, 'full_parameters': ['out io . Writer', ' repoRoot string', ' empty bool', ' confProfiles string', ' conf * config . Config'], 'filename': '/home/dimi/Documents/Informatik_Studium/FSS/SoftEvo/DataCollection/FFS_SoftEvo/go-ipfs/cmd/ipfs/init.go', 'top_nesting_level': 0, 'length': 29, 'fan_in': 0, 'fan_out': 0, 'general_fan_out': 0}, {'cyclomatic_complexity': 6, 'nloc': 22, 'token_count': 128, 'name': 'checkWritable', 'long_name': 'checkWritable dir string', 'start_line': 177, 'end_line': 203, 'full_parameters': ['dir string'], 'filename': '/home/dimi/Documents/Informatik_Studium/FSS/SoftEvo/DataCollection/FFS_SoftEvo/go-ipfs/cmd/ipfs/init.go', 'top_nesting_level': 0, 'length': 27, 'fan_in': 0, 'fan_out': 0, 'general_fan_out': 0}, {'cyclomatic_complexity': 5, 'nloc': 23, 'token_count': 154, 'name': 'addDefaultAssets', 'long_name': 'addDefaultAssets out io . Writer , repoRoot string', 'start_line': 205, 'end_line': 232, 'full_parameters': ['out io . Writer', ' repoRoot string'], 'filename': '/home/dimi/Documents/Informatik_Studium/FSS/SoftEvo/DataCollection/FFS_SoftEvo/go-ipfs/cmd/ipfs/init.go', 'top_nesting_level': 0, 'length': 28, 'fan_in': 0, 'fan_out': 0, 'general_fan_out': 0}, {'cyclomatic_complexity': 5, 'nloc': 23, 'token_count': 150, 'name': 'initializeIpnsKeyspace', 'long_name': 'initializeIpnsKeyspace repoRoot string', 'start_line': 234, 'end_line': 264, 'full_parameters': ['repoRoot string'], 'filename': '/home/dimi/Documents/Informatik_Studium/FSS/SoftEvo/DataCollection/FFS_SoftEvo/go-ipfs/cmd/ipfs/init.go', 'top_nesting_level': 0, 'length': 31, 'fan_in': 0, 'fan_out': 0, 'general_fan_out': 0}]",5,23,-1,83,83,"[{'timestamp': 1491058697.0, 'added_lines': 21, 'deleted_lines': 16, 'nloc': 210}, {'timestamp': 1499331469.0, 'added_lines': 1, 'deleted_lines': 1, 'nloc': 210}, {'timestamp': 1511223906.0, 'added_lines': 1, 'deleted_lines': 1, 'nloc': 210}, {'timestamp': 1511245249.0, 'added_lines': 1, 'deleted_lines': 1, 'nloc': 210}, {'timestamp': 1512356285.0, 'added_lines': 1, 'deleted_lines': 1, 'nloc': 210}, {'timestamp': 1512365669.0, 'added_lines': 1, 'deleted_lines': 1, 'nloc': 210}, {'timestamp': 1504647877.0, 'added_lines': 2, 'deleted_lines': 2, 'nloc': 210}, {'timestamp': 1513447186.0, 'added_lines': 1, 'deleted_lines': 1, 'nloc': 210}, {'timestamp': 1511187070.0, 'added_lines': 1, 'deleted_lines': 1, 'nloc': 210}, {'timestamp': 1513436097.0, 'added_lines': 1, 'deleted_lines': 1, 'nloc': 210}, {'timestamp': 1513612261.0, 'added_lines': 1, 'deleted_lines': 1, 'nloc': 210}, {'timestamp': 1515277696.0, 'added_lines': 1, 'deleted_lines': 1, 'nloc': 210}, {'timestamp': 1521072414.0, 'added_lines': 7, 'deleted_lines': 2, 'nloc': 214}, {'timestamp': 1519388503.0, 'added_lines': 13, 'deleted_lines': 26, 'nloc': 204}, {'timestamp': 1503244620.0, 'added_lines': 2, 'deleted_lines': 0, 'nloc': 206}, {'timestamp': 1509474878.0, 'added_lines': 2, 'deleted_lines': 1, 'nloc': 207}, {'timestamp': 1521564637.0, 'added_lines': 2, 'deleted_lines': 9, 'nloc': 200}, {'timestamp': 1521399286.0, 'added_lines': 1, 'deleted_lines': 1, 'nloc': 207}, {'timestamp': 1521427288.0, 'added_lines': 3, 'deleted_lines': 3, 'nloc': 207}, {'timestamp': 1524596476.0, 'added_lines': 1, 'deleted_lines': 1, 'nloc': 200}, {'timestamp': 1525408792.0, 'added_lines': 1, 'deleted_lines': 1, 'nloc': 200}, {'timestamp': 1528520460.0, 'added_lines': 2, 'deleted_lines': 2, 'nloc': 200}, {'timestamp': 1529984485.0, 'added_lines': 1, 'deleted_lines': 1, 'nloc': 200}, {'timestamp': 1533779477.0, 'added_lines': 1, 'deleted_lines': 1, 'nloc': 200}, {'timestamp': 1532357069.0, 'added_lines': 1, 'deleted_lines': 1, 'nloc': 200}, {'timestamp': 1532365899.0, 'added_lines': 1, 'deleted_lines': 1, 'nloc': 200}, {'timestamp': 1532388583.0, 'added_lines': 1, 'deleted_lines': 1, 'nloc': 200}, {'timestamp': 1533809170.0, 'added_lines': 1, 'deleted_lines': 1, 'nloc': 200}, {'timestamp': 1533946888.0, 'added_lines': 2, 'deleted_lines': 2, 'nloc': 200}, {'timestamp': 1534072974.0, 'added_lines': 1, 'deleted_lines': 1, 'nloc': 200}, {'timestamp': 1534896611.0, 'added_lines': 3, 'deleted_lines': 3, 'nloc': 200}, {'timestamp': 1535255498.0, 'added_lines': 1, 'deleted_lines': 1, 'nloc': 200}, {'timestamp': 1535601896.0, 'added_lines': 1, 'deleted_lines': 1, 'nloc': 200}, {'timestamp': 1536388808.0, 'added_lines': 1, 'deleted_lines': 1, 'nloc': 200}, {'timestamp': 1523628870.0, 'added_lines': 6, 'deleted_lines': 12, 'nloc': 194}, {'timestamp': 1535044155.0, 'added_lines': 1, 'deleted_lines': 1, 'nloc': 194}, {'timestamp': 1537193530.0, 'added_lines': 1, 'deleted_lines': 1, 'nloc': 194}, {'timestamp': 1537391809.0, 'added_lines': 1, 'deleted_lines': 1, 'nloc': 194}, {'timestamp': 1537792589.0, 'added_lines': 2, 'deleted_lines': 2, 'nloc': 194}, {'timestamp': 1538544957.0, 'added_lines': 1, 'deleted_lines': 1, 'nloc': 194}, {'timestamp': 1538547366.0, 'added_lines': 1, 'deleted_lines': 1, 'nloc': 194}, {'timestamp': 1539850591.0, 'added_lines': 2, 'deleted_lines': 2, 'nloc': 194}, {'timestamp': 1540400358.0, 'added_lines': 1, 'deleted_lines': 1, 'nloc': 194}, {'timestamp': 1540489644.0, 'added_lines': 1, 'deleted_lines': 1, 'nloc': 194}, {'timestamp': 1540552487.0, 'added_lines': 1, 'deleted_lines': 1, 'nloc': 194}, {'timestamp': 1540597832.0, 'added_lines': 1, 'deleted_lines': 1, 'nloc': 194}, {'timestamp': 1541204121.0, 'added_lines': 2, 'deleted_lines': 2, 'nloc': 194}, {'timestamp': 1543282933.0, 'added_lines': 1, 'deleted_lines': 1, 'nloc': 194}, {'timestamp': 1544225843.0, 'added_lines': 1, 'deleted_lines': 1, 'nloc': 194}, {'timestamp': 1544661332.0, 'added_lines': 1, 'deleted_lines': 1, 'nloc': 194}, {'timestamp': 1544667474.0, 'added_lines': 0, 'deleted_lines': 5, 'nloc': 190}, {'timestamp': 1540556089.0, 'added_lines': 1, 'deleted_lines': 1, 'nloc': 190}, {'timestamp': 1540562190.0, 'added_lines': 1, 'deleted_lines': 1, 'nloc': 190}, {'timestamp': 1542594282.0, 'added_lines': 7, 'deleted_lines': 4, 'nloc': 193}, {'timestamp': 1543031503.0, 'added_lines': 1, 'deleted_lines': 1, 'nloc': 193}, {'timestamp': 1543868676.0, 'added_lines': 3, 'deleted_lines': 2, 'nloc': 194}, {'timestamp': 1544737281.0, 'added_lines': 3, 'deleted_lines': 3, 'nloc': 194}, {'timestamp': 1545095383.0, 'added_lines': 8, 'deleted_lines': 4, 'nloc': 198}, {'timestamp': 1545323704.0, 'added_lines': 1, 'deleted_lines': 1, 'nloc': 198}, {'timestamp': 1546553605.0, 'added_lines': 1, 'deleted_lines': 1, 'nloc': 198}, {'timestamp': 1547003974.0, 'added_lines': 1, 'deleted_lines': 1, 'nloc': 198}, {'timestamp': 1547152271.0, 'added_lines': 1, 'deleted_lines': 1, 'nloc': 198}, {'timestamp': 1548571614.0, 'added_lines': 9, 'deleted_lines': 6, 'nloc': 201}, {'timestamp': 1548866534.0, 'added_lines': 2, 'deleted_lines': 2, 'nloc': 201}, {'timestamp': 1549588289.0, 'added_lines': 1, 'deleted_lines': 1, 'nloc': 201}, {'timestamp': 1549903582.0, 'added_lines': 2, 'deleted_lines': 2, 'nloc': 201}, {'timestamp': 1550507829.0, 'added_lines': 2, 'deleted_lines': 2, 'nloc': 201}, {'timestamp': 1550610741.0, 'added_lines': 1, 'deleted_lines': 1, 'nloc': 201}, {'timestamp': 1551138343.0, 'added_lines': 1, 'deleted_lines': 1, 'nloc': 201}, {'timestamp': 1551229859.0, 'added_lines': 1, 'deleted_lines': 1, 'nloc': 201}, {'timestamp': 1551299964.0, 'added_lines': 1, 'deleted_lines': 1, 'nloc': 201}, {'timestamp': 1551471469.0, 'added_lines': 1, 'deleted_lines': 1, 'nloc': 201}, {'timestamp': 1551754061.0, 'added_lines': 0, 'deleted_lines': 4, 'nloc': 198}, {'timestamp': 1551551196.0, 'added_lines': 4, 'deleted_lines': 4, 'nloc': 198}, {'timestamp': 1557554420.0, 'added_lines': 8, 'deleted_lines': 9, 'nloc': 197}, {'timestamp': 1562610931.0, 'added_lines': 27, 'deleted_lines': 31, 'nloc': 195}, {'timestamp': 1594333110.0, 'added_lines': 33, 'deleted_lines': 9, 'nloc': 217}, {'timestamp': 1595277534.0, 'added_lines': 3, 'deleted_lines': 0, 'nloc': 220}, {'timestamp': 1596643741.0, 'added_lines': 1, 'deleted_lines': 1, 'nloc': 220}, {'timestamp': 1603146253.0, 'added_lines': 22, 'deleted_lines': 28, 'nloc': 216}, {'timestamp': 1611864949.0, 'added_lines': 1, 'deleted_lines': 16, 'nloc': 203}, {'timestamp': 1613691223.0, 'added_lines': 1, 'deleted_lines': 1, 'nloc': 203}, {'timestamp': 1615908763.0, 'added_lines': 17, 'deleted_lines': 2, 'nloc': 213}]","{'blocks/blockstore/caching.go': 1, 'blocks/blockstore/util/remove.go': 2, 'cmd/ipfs/daemon.go': 46, 'cmd/ipfs/ipfs.go': 35, 'cmd/ipfs/main.go': 55, 'cmd/ipfs/main_test.go': 4, 'cmd/ipfswatch/main.go': 32, 'cmd/seccat/seccat.go': 22, None: 33, 'commands/channelmarshaler.go': 1, 'commands/cli/cmd_suggestion.go': 1, 'commands/cli/helptext.go': 3, 'commands/cli/helptext_test.go': 2, 'commands/cli/parse.go': 2, 'commands/cli/parse_test.go': 2, 'commands/command.go': 16, 'commands/command_test.go': 7, 'commands/http/client.go': 2, 'commands/http/handler.go': 2, 'commands/http/multifilereader.go': 2, 'commands/http/multifilereader_test.go': 2, 'commands/http/parse.go': 2, 'commands/reqlog.go': 1, 'commands/request.go': 38, 'commands/response.go': 11, 'commands/response_test.go': 7, 'core/bootstrap.go': 31, 'core/commands/active.go': 25, 'core/commands/add.go': 43, 'core/commands/bitswap.go': 43, 'core/commands/block.go': 44, 'core/commands/bootstrap.go': 44, 'core/commands/cat.go': 40, 'core/commands/commands.go': 37, 'core/commands/config.go': 54, 'core/commands/dag/dag.go': 43, 'core/commands/dht.go': 39, 'core/commands/diag.go': 23, 'core/commands/dns.go': 28, 'core/commands/e/error.go': 1, 'core/commands/external.go': 25, 'core/commands/files/files.go': 9, 'core/commands/filestore.go': 35, 'core/commands/get.go': 45, 'core/commands/helptext_test.go': 33, 'core/commands/id.go': 40, 'core/commands/ipns.go': 14, 'core/commands/keystore.go': 37, 'core/commands/log.go': 29, 'core/commands/ls.go': 37, 'core/commands/mount_nofuse.go': 23, 'core/commands/mount_unix.go': 45, 'core/commands/mount_windows.go': 22, 'core/commands/name.go': 10, 'core/commands/object/diff.go': 25, 'core/commands/object/object.go': 51, 'core/commands/object/patch.go': 42, 'core/commands/p2p.go': 33, 'core/commands/pin.go': 39, 'core/commands/ping.go': 36, 'core/commands/publish.go': 15, 'core/commands/pubsub.go': 40, 'core/commands/refs.go': 37, 'core/commands/repo.go': 56, 'core/commands/resolve.go': 40, 'core/commands/root.go': 36, 'core/commands/shutdown.go': 32, 'core/commands/stat.go': 41, 'core/commands/swarm.go': 50, 'core/commands/sysdiag.go': 30, 'core/commands/tar.go': 40, 'core/commands/unixfs/ls.go': 34, 'core/commands/unixfs/unixfs.go': 23, 'core/commands/version.go': 29, 'core/core_test.go': 25, 'core/corehttp/commands.go': 53, 'core/corehttp/gateway.go': 24, 'core/coreunix/add.go': 34, 'core/coreunix/add_test.go': 44, 'core/coreunix/metadata_test.go': 25, 'exchange/bitswap/bitswap_test.go': 6, 'exchange/bitswap/decision/engine_test.go': 6, 'exchange/bitswap/message/message_test.go': 3, 'exchange/bitswap/message/pb/Makefile': 1, 'exchange/bitswap/testnet/network_test.go': 6, 'exchange/bitswap/testnet/peernet.go': 6, 'exchange/reprovide/reprovide_test.go': 20, 'fuse/ipns/common.go': 24, 'fuse/node/mount_test.go': 21, 'importer/balanced/balanced_test.go': 6, 'importer/chunk/rabin_test.go': 2, 'importer/helpers/dagbuilder.go': 11, 'importer/importer.go': 10, 'merkledag/utils/utils_test.go': 3, 'mfs/repub_test.go': 7, 'namesys/dns.go': 17, 'namesys/interface.go': 19, 'namesys/ipns_select_test.go': 4, 'namesys/proquint.go': 17, 'namesys/republisher/repub_test.go': 21, 'package.json': 52, 'repo/config/identity.go': 3, 'routing/offline/offline_test.go': 3, 'test/integration/addcat_test.go': 25, 'test/integration/bench_cat_test.go': 24, 'test/integration/bitswap_wo_routing_test.go': 21, 'test/integration/three_legged_cat_test.go': 24, 'core/bootstrap_test.go': 29, 'core/commands/dht_test.go': 19, 'core/commands/get_test.go': 34, 'core/core.go': 39, 'core/corehttp/gateway_test.go': 33, 'core/corehttp/metrics_test.go': 20, 'core/mock/mock.go': 31, 'exchange/bitswap/decision/bench_test.go': 5, 'exchange/bitswap/decision/peer_request_queue_test.go': 5, 'exchange/bitswap/message/message.go': 5, 'exchange/bitswap/network/interface.go': 5, 'exchange/bitswap/network/ipfs_impl.go': 5, 'exchange/bitswap/testnet/interface.go': 5, 'exchange/bitswap/testnet/virtual.go': 6, 'exchange/bitswap/testutils.go': 5, 'fuse/ipns/ipns_test.go': 20, 'fuse/readonly/ipfs_test.go': 27, 'namesys/publisher_test.go': 19, 'namesys/resolve_test.go': 21, 'p2p/p2p.go': 19, 'p2p/registry.go': 9, 'repo/config/bootstrap_peers.go': 6, 'routing/mock/centralized_client.go': 2, 'routing/mock/centralized_server.go': 2, 'routing/mock/centralized_test.go': 2, 'routing/mock/interface.go': 2, 'routing/none/none_client.go': 2, 'test/integration/bench_test.go': 16, 'assets/assets.go': 22, 'namesys/publisher.go': 25, 'blocks/blockstore/arc_cache.go': 1, 'blocks/blockstore/arc_cache_test.go': 1, 'blocks/blockstore/blockstore.go': 1, 'blocks/blockstore/blockstore_test.go': 1, 'blocks/blockstore/bloom_cache.go': 1, 'blocks/blockstore/bloom_cache_test.go': 1, 'blocks/blocksutil/block_generator.go': 1, 'blockservice/blockservice.go': 4, 'blockservice/blockservice_test.go': 4, 'blockservice/test/blocks_test.go': 4, 'core/builder.go': 37, 'core/commands/ipnsps.go': 9, 'core/coreapi/coreapi.go': 14, 'core/coreapi/interface/interface.go': 1, 'core/coreapi/unixfs.go': 25, 'core/coreapi/unixfs_test.go': 31, 'core/coredag/cbor.go': 6, 'core/coredag/dagpb.go': 17, 'core/coredag/dagtransl.go': 6, 'core/coredag/raw.go': 17, 'core/corehttp/corehttp.go': 12, 'core/corehttp/gateway_handler.go': 28, 'core/corerepo/gc.go': 25, 'core/corerepo/pinning.go': 10, 'core/coreunix/metadata.go': 22, 'core/pathresolver.go': 20, 'exchange/bitswap/bitswap.go': 5, 'exchange/bitswap/decision/engine.go': 4, 'exchange/bitswap/decision/ledger.go': 5, 'exchange/bitswap/decision/peer_request_queue.go': 4, 'exchange/bitswap/get.go': 4, 'exchange/bitswap/notifications/notifications.go': 2, 'exchange/bitswap/notifications/notifications_test.go': 2, 'exchange/bitswap/session.go': 4, 'exchange/bitswap/session_test.go': 4, 'exchange/bitswap/stat.go': 2, 'exchange/bitswap/wantlist/wantlist.go': 2, 'exchange/bitswap/wantlist/wantlist_test.go': 2, 'exchange/bitswap/wantmanager.go': 4, 'exchange/bitswap/workers.go': 4, 'exchange/interface.go': 1, 'exchange/offline/offline.go': 1, 'exchange/offline/offline_test.go': 1, 'exchange/reprovide/providers.go': 19, 'exchange/reprovide/reprovide.go': 18, 'filestore/filestore.go': 12, 'filestore/filestore_test.go': 19, 'filestore/fsrefstore.go': 12, 'filestore/util.go': 12, 'fuse/ipns/ipns_unix.go': 25, 'fuse/readonly/readonly_unix.go': 25, 'importer/balanced/builder.go': 2, 'importer/chunk/splitting_test.go': 1, 'importer/helpers/helpers.go': 2, 'importer/importer_test.go': 4, 'importer/trickle/trickle_test.go': 5, 'importer/trickle/trickledag.go': 4, 'merkledag/batch.go': 1, 'merkledag/coding.go': 3, 'merkledag/merkledag.go': 3, 'merkledag/merkledag_test.go': 5, 'merkledag/node.go': 2, 'merkledag/node_test.go': 2, 'merkledag/raw.go': 3, 'merkledag/traverse/traverse.go': 2, 'merkledag/traverse/traverse_test.go': 2, 'merkledag/utils/diff.go': 2, 'merkledag/utils/diffenum.go': 2, 'merkledag/utils/diffenum_test.go': 2, 'merkledag/utils/utils.go': 4, 'mfs/dir.go': 4, 'mfs/file.go': 6, 'mfs/mfs_test.go': 7, 'mfs/ops.go': 3, 'mfs/system.go': 6, 'namesys/namesys.go': 20, 'namesys/pubsub.go': 4, 'namesys/pubsub_test.go': 2, 'namesys/republisher/repub.go': 19, 'namesys/routing.go': 20, 'path/path.go': 2, 'path/resolver.go': 1, 'path/resolver_test.go': 1, 'pin/gc/gc.go': 19, 'pin/pin.go': 21, 'pin/pin_test.go': 19, 'pin/set.go': 18, 'pin/set_test.go': 19, 'plugin/ipld.go': 5, 'plugin/loader/initializer.go': 4, 'plugin/plugins/git/git.go': 5, 'repo/config/init.go': 8, 'repo/fsrepo/fsrepo.go': 32, 'repo/fsrepo/lock/lock.go': 1, 'repo/fsrepo/serialize/serialize.go': 3, 'repo/mock.go': 28, 'repo/repo.go': 29, 'routing/offline/offline.go': 1, 'tar/format.go': 24, 'test/dependencies/ma-pipe-unidir/main.go': 8, 'thirdparty/ds-help/key.go': 1, 'thirdparty/pollEndpoint/main.go': 13, 'thirdparty/posinfo/posinfo.go': 1, 'unixfs/archive/archive.go': 2, 'unixfs/archive/tar/writer.go': 2, 'unixfs/hamt/hamt.go': 2, 'unixfs/io/dagreader.go': 2, 'unixfs/io/dirbuilder.go': 2, 'unixfs/io/resolve.go': 2, 'unixfs/mod/dagmodifier.go': 5, 'unixfs/mod/dagmodifier_test.go': 2, 'unixfs/test/utils.go': 5, 'repo/config/profile.go': 5, 'docs/config.md': 2, 'test/sharness/t0021-config.sh': 3, 'commands/legacy/command.go': 19, 'commands/legacy/legacy.go': 19, 'commands/legacy/legacy_test.go': 20, 'commands/legacy/request.go': 21, 'commands/legacy/response.go': 20, 'commands/legacy/responseemitter.go': 4, 'core/commands/env.go': 9, 'TODO.md': 2, 'core/commands/commands_test.go': 29, 'test/sharness/t0110-gateway.sh': 1, 'test/sharness/t0410-api-add.sh': 1, 'test/sharness/t0063-daemon-init.sh': 1, 'repo/config/discovery.go': 2, 'test/sharness/t0020-init.sh': 4, 'repo/config/config.go': 2, 'repo/config/routing.go': 1, 'core/coreapi/object.go': 22, 'fuse/mount/fuse.go': 3, 'fuse/mount/mount.go': 9, 'keystore/keystore_test.go': 6, 'namesys/dns_test.go': 6, 'namesys/namesys_test.go': 24, 'unixfs/io/pbdagreader.go': 2, 'unixfs/unixfs.go': 1, 'CHANGELOG.md': 1, 'README.md': 2, 'bin/dist_get': 1, 'cmd/ipfs/util/ulimit_freebsd.go': 3, 'contribute.md': 1, 'core/coreapi/interface/options/pin.go': 1, 'docs/experimental-features.md': 1, 'docs/file-transfer.md': 1, 'docs/releases.md': 2, 'exchange/bitswap/README.md': 1, 'plugin/plugin.go': 1, 'repo/fsrepo/migrations/mfsr_test.go': 1, 'repo/fsrepo/migrations/migrations.go': 1, 'test/sharness/README.md': 1, 'thirdparty/dir/dir.go': 1, 'core/commands/files.go': 41, 'blocks/blockstoreutil/remove.go': 11, 'blockservice/test/mock.go': 3, 'cmd/ipfs/util/ulimit.go': 8, 'cmd/seccat/util.go': 8, 'core/coreapi/key.go': 19, 'core/coreapi/name.go': 21, 'core/coreapi/pin.go': 19, 'core/corehttp/logs.go': 8, 'fuse/node/mount_unix.go': 8, 'keystore/keystore.go': 8, 'keystore/memkeystore.go': 5, 'merkledag/test/utils.go': 3, 'namesys/ipns_validate_test.go': 2, 'namesys/validator.go': 2, 'path/resolver/resolver.go': 3, 'plugin/loader/load.go': 6, 'repo/fsrepo/datastores.go': 10, 'repo/fsrepo/fsrepo_test.go': 24, 'thirdparty/verifbs/verifbs.go': 11, 'cmd/ipfs/util/ulimit_unix.go': 2, 'core/coreapi/block.go': 8, 'core/coreapi/block_test.go': 2, 'core/coreapi/dag.go': 4, 'core/coreapi/dag_test.go': 2, 'core/coreapi/interface/coreapi.go': 3, 'core/coreapi/interface/dag.go': 3, 'core/coreapi/interface/object.go': 3, 'core/coreapi/interface/options/block.go': 2, 'core/coreapi/interface/options/dag.go': 3, 'core/coreapi/interface/path.go': 12, 'core/coreapi/interface/unixfs.go': 9, 'fuse/ipns/link_unix.go': 2, 'fuse/node/mount_darwin.go': 2, 'merkledag/errservice.go': 1, 'merkledag/readonly.go': 1, 'merkledag/readonly_test.go': 1, 'merkledag/rwservice.go': 1, 'merkledag/session.go': 1, 'path/resolver/resolver_test.go': 1, 'thirdparty/verifcid/validate.go': 1, 'thirdparty/verifcid/validate_test.go': 1, 'unixfs/hamt/hamt_stress_test.go': 1, 'unixfs/hamt/hamt_test.go': 1, 'namesys/ipns_resolver_validation_test.go': 17, 'test/sharness/t0170-dht.sh': 1, 'core/commands/urlstore.go': 32, 'core/coreapi/interface/key.go': 7, 'core/coreapi/name_test.go': 14, 'core/coreapi/path.go': 21, 'core/coreunix/cat.go': 6, 'core/pathresolver_test.go': 15, 'dagutils/diff.go': 16, 'dagutils/diffenum.go': 15, 'dagutils/diffenum_test.go': 15, 'dagutils/utils.go': 15, 'dagutils/utils_test.go': 15, 'filestore/pb/dataobj.pb.go': 3, 'mfs/fd.go': 2, 'namesys/base.go': 16, 'namesys/cache.go': 15, 'pin/internal/pb/header.pb.go': 3, 'thirdparty/cidv0v1/blockstore.go': 8, 'repo/fsrepo/misc.go': 24, 'cmd/ipfs/Rules.mk': 1, 'core/corehttp/option_test.go': 1, 'docs/windows.md': 1, 'repo/fsrepo/config_test.go': 23, 'repo/version.go': 1, 'test/bench/bench_cli_ipfs_add/main.go': 24, 'test/bench/offline_add/main.go': 24, 'core/commands/cmdenv/env.go': 34, 'core/commands/name/ipns.go': 30, 'core/commands/name/publish.go': 25, 'core/commands/name/ipnsps.go': 25, 'core/commands/name/name.go': 21, 'test/sharness/lib/test-lib.sh': 2, 'core/coreapi/dht.go': 12, 'core/coreapi/dht_test.go': 4, 'core/coreapi/interface/dht.go': 7, 'p2p/listener.go': 10, 'p2p/local.go': 10, 'p2p/remote.go': 10, 'p2p/stream.go': 10, 'core/coreapi/interface/swarm.go': 6, 'core/coreapi/swarm.go': 11, 'core/commands/cid.go': 17, 'core/coreapi/unixfile.go': 10, 'cmd/ipfs/dnsresolve_test.go': 5, 'core/coreapi/interface/options/unixfs.go': 5, 'core/coreapi/interface/pubsub.go': 4, 'core/coreapi/pubsub.go': 11, 'test/sharness/t0180-pubsub.sh': 1, 'test/dependencies/iptb/iptb.go': 11, 'commands/context.go': 18, 'core/corehttp/proxy.go': 7, 'core/commands/cmdenv/file.go': 4, 'core/coreapi/interface/errors.go': 1, 'core/coreapi/test/api_test.go': 9, 'core/coreapi/interface/tests/name.go': 3, 'core/coreapi/interface/tests/unixfs.go': 3, 'core/commands/cmdenv/cidbase.go': 9, 'core/corehttp/ipns_hostname.go': 5, 'plugin/daemon.go': 5, 'plugin/loader/loader.go': 5, 'plugin/plugins/badgerds/badgerds.go': 3, 'plugin/plugins/flatfs/flatfs.go': 3, 'plugin/plugins/levelds/levelds.go': 2, 'core/corerepo/stat.go': 2, 'core/commands/cmdenv/cidbase_test.go': 1, 'core/corehttp/metrics.go': 1, 'core/corehttp/proxy_test.go': 1, 'plugin/tracer.go': 1, 'thirdparty/notifier/notifier.go': 1, 'go.mod': 4, 'go.sum': 4, 'package-list.json': 1, 'test/sharness/t0114-gateway-subdomains.sh': 1, 'cmd/ipfs/rotate.go': 1, 'core/commands/extra.go': 1, 'test/sharness/t0022-init-default.sh': 1, 'test/sharness/t0025-datastores.sh': 1, 'test/sharness/t0160-resolve.sh': 1, 'test/sharness/t0184-http-proxy-over-p2p.sh': 1, 'test/sharness/t0165-keystore.sh': 1, 'core/corehttp/hostname.go': 1, 'core/node/ipns.go': 1}","('core/commands/repo.go', 0.6746987951807228, 0.5233644859813084)"
cmd/ipfs/ipfs.go,63,454,7,"[{'cyclomatic_complexity': 4, 'nloc': 11, 'token_count': 63, 'name': 'init', 'long_name': 'init', 'start_line': 30, 'end_line': 45, 'full_parameters': [], 'filename': '/home/dimi/Documents/Informatik_Studium/FSS/SoftEvo/DataCollection/FFS_SoftEvo/go-ipfs/cmd/ipfs/ipfs.go', 'top_nesting_level': 0, 'length': 16, 'fan_in': 0, 'fan_out': 0, 'general_fan_out': 0}, {'cyclomatic_complexity': 1, 'nloc': 4, 'token_count': 37, 'name': 'String', 'long_name': '(d*cmdDetails)String', 'start_line': 67, 'end_line': 70, 'full_parameters': [], 'filename': '/home/dimi/Documents/Informatik_Studium/FSS/SoftEvo/DataCollection/FFS_SoftEvo/go-ipfs/cmd/ipfs/ipfs.go', 'top_nesting_level': 0, 'length': 4, 'fan_in': 0, 'fan_out': 0, 'general_fan_out': 0}, {'cyclomatic_complexity': 1, 'nloc': 1, 'token_count': 16, 'name': 'Loggable', 'long_name': '(d*cmdDetails)Loggable', 'start_line': 72, 'end_line': 72, 'full_parameters': [], 'filename': '/home/dimi/Documents/Informatik_Studium/FSS/SoftEvo/DataCollection/FFS_SoftEvo/go-ipfs/cmd/ipfs/ipfs.go', 'top_nesting_level': 0, 'length': 1, 'fan_in': 0, 'fan_out': 0, 'general_fan_out': 0}, {'cyclomatic_complexity': 1, 'nloc': 1, 'token_count': 17, 'name': 'usesConfigAsInput', 'long_name': '(d*cmdDetails)usesConfigAsInput', 'start_line': 82, 'end_line': 82, 'full_parameters': [], 'filename': '/home/dimi/Documents/Informatik_Studium/FSS/SoftEvo/DataCollection/FFS_SoftEvo/go-ipfs/cmd/ipfs/ipfs.go', 'top_nesting_level': 0, 'length': 1, 'fan_in': 0, 'fan_out': 0, 'general_fan_out': 0}, {'cyclomatic_complexity': 1, 'nloc': 1, 'token_count': 17, 'name': 'canRunOnClient', 'long_name': '(d*cmdDetails)canRunOnClient', 'start_line': 83, 'end_line': 83, 'full_parameters': [], 'filename': '/home/dimi/Documents/Informatik_Studium/FSS/SoftEvo/DataCollection/FFS_SoftEvo/go-ipfs/cmd/ipfs/ipfs.go', 'top_nesting_level': 0, 'length': 1, 'fan_in': 0, 'fan_out': 0, 'general_fan_out': 0}, {'cyclomatic_complexity': 1, 'nloc': 1, 'token_count': 17, 'name': 'canRunOnDaemon', 'long_name': '(d*cmdDetails)canRunOnDaemon', 'start_line': 84, 'end_line': 84, 'full_parameters': [], 'filename': '/home/dimi/Documents/Informatik_Studium/FSS/SoftEvo/DataCollection/FFS_SoftEvo/go-ipfs/cmd/ipfs/ipfs.go', 'top_nesting_level': 0, 'length': 1, 'fan_in': 0, 'fan_out': 0, 'general_fan_out': 0}, {'cyclomatic_complexity': 1, 'nloc': 1, 'token_count': 17, 'name': 'usesRepo', 'long_name': '(d*cmdDetails)usesRepo', 'start_line': 85, 'end_line': 85, 'full_parameters': [], 'filename': '/home/dimi/Documents/Informatik_Studium/FSS/SoftEvo/DataCollection/FFS_SoftEvo/go-ipfs/cmd/ipfs/ipfs.go', 'top_nesting_level': 0, 'length': 1, 'fan_in': 0, 'fan_out': 0, 'general_fan_out': 0}]",23,116,1,"[{'cyclomatic_complexity': 3, 'nloc': 8, 'token_count': 48, 'name': 'init', 'long_name': 'init', 'start_line': 28, 'end_line': 38, 'full_parameters': [], 'filename': '/home/dimi/Documents/Informatik_Studium/FSS/SoftEvo/DataCollection/FFS_SoftEvo/go-ipfs/cmd/ipfs/ipfs.go', 'top_nesting_level': 0, 'length': 11, 'fan_in': 0, 'fan_out': 0, 'general_fan_out': 0}]",-40,-338,-6,57,57,"[{'timestamp': 1491058697.0, 'added_lines': 19, 'deleted_lines': 15, 'nloc': 69}, {'timestamp': 1508770239.0, 'added_lines': 1, 'deleted_lines': 1, 'nloc': 69}, {'timestamp': 1509016767.0, 'added_lines': 1, 'deleted_lines': 1, 'nloc': 69}, {'timestamp': 1511223906.0, 'added_lines': 1, 'deleted_lines': 1, 'nloc': 69}, {'timestamp': 1511373659.0, 'added_lines': 1, 'deleted_lines': 1, 'nloc': 69}, {'timestamp': 1512365669.0, 'added_lines': 1, 'deleted_lines': 1, 'nloc': 69}, {'timestamp': 1511187070.0, 'added_lines': 3, 'deleted_lines': 10, 'nloc': 63}, {'timestamp': 1512121226.0, 'added_lines': 1, 'deleted_lines': 1, 'nloc': 63}, {'timestamp': 1513436097.0, 'added_lines': 1, 'deleted_lines': 1, 'nloc': 63}, {'timestamp': 1513612261.0, 'added_lines': 1, 'deleted_lines': 1, 'nloc': 63}, {'timestamp': 1513764708.0, 'added_lines': 1, 'deleted_lines': 1, 'nloc': 63}, {'timestamp': 1513765470.0, 'added_lines': 1, 'deleted_lines': 1, 'nloc': 63}, {'timestamp': 1513766201.0, 'added_lines': 1, 'deleted_lines': 1, 'nloc': 63}, {'timestamp': 1513772654.0, 'added_lines': 1, 'deleted_lines': 1, 'nloc': 63}, {'timestamp': 1513773452.0, 'added_lines': 1, 'deleted_lines': 1, 'nloc': 63}, {'timestamp': 1515465466.0, 'added_lines': 1, 'deleted_lines': 1, 'nloc': 63}, {'timestamp': 1515713724.0, 'added_lines': 1, 'deleted_lines': 1, 'nloc': 63}, {'timestamp': 1516341168.0, 'added_lines': 1, 'deleted_lines': 1, 'nloc': 63}, {'timestamp': 1516838128.0, 'added_lines': 1, 'deleted_lines': 1, 'nloc': 63}, {'timestamp': 1517105039.0, 'added_lines': 1, 'deleted_lines': 1, 'nloc': 63}, {'timestamp': 1517453697.0, 'added_lines': 1, 'deleted_lines': 1, 'nloc': 63}, {'timestamp': 1519173780.0, 'added_lines': 1, 'deleted_lines': 1, 'nloc': 63}, {'timestamp': 1521314540.0, 'added_lines': 1, 'deleted_lines': 1, 'nloc': 63}, {'timestamp': 1521500314.0, 'added_lines': 1, 'deleted_lines': 1, 'nloc': 63}, {'timestamp': 1519388503.0, 'added_lines': 1, 'deleted_lines': 2, 'nloc': 62}, {'timestamp': 1524596476.0, 'added_lines': 1, 'deleted_lines': 1, 'nloc': 62}, {'timestamp': 1526509320.0, 'added_lines': 0, 'deleted_lines': 5, 'nloc': 58}, {'timestamp': 1525408792.0, 'added_lines': 1, 'deleted_lines': 1, 'nloc': 58}, {'timestamp': 1528520460.0, 'added_lines': 1, 'deleted_lines': 1, 'nloc': 58}, {'timestamp': 1529984485.0, 'added_lines': 1, 'deleted_lines': 1, 'nloc': 58}, {'timestamp': 1533779477.0, 'added_lines': 1, 'deleted_lines': 1, 'nloc': 58}, {'timestamp': 1533946888.0, 'added_lines': 1, 'deleted_lines': 1, 'nloc': 58}, {'timestamp': 1534896611.0, 'added_lines': 1, 'deleted_lines': 1, 'nloc': 58}, {'timestamp': 1523628870.0, 'added_lines': 1, 'deleted_lines': 1, 'nloc': 58}, {'timestamp': 1535044155.0, 'added_lines': 1, 'deleted_lines': 1, 'nloc': 58}, {'timestamp': 1537193530.0, 'added_lines': 1, 'deleted_lines': 1, 'nloc': 58}, {'timestamp': 1537391809.0, 'added_lines': 1, 'deleted_lines': 1, 'nloc': 58}, {'timestamp': 1537792589.0, 'added_lines': 1, 'deleted_lines': 1, 'nloc': 58}, {'timestamp': 1534377738.0, 'added_lines': 1, 'deleted_lines': 0, 'nloc': 59}, {'timestamp': 1539850591.0, 'added_lines': 1, 'deleted_lines': 1, 'nloc': 59}, {'timestamp': 1540552487.0, 'added_lines': 1, 'deleted_lines': 1, 'nloc': 59}, {'timestamp': 1540597832.0, 'added_lines': 1, 'deleted_lines': 1, 'nloc': 59}, {'timestamp': 1541204121.0, 'added_lines': 1, 'deleted_lines': 1, 'nloc': 59}, {'timestamp': 1544661332.0, 'added_lines': 1, 'deleted_lines': 1, 'nloc': 59}, {'timestamp': 1540556089.0, 'added_lines': 1, 'deleted_lines': 1, 'nloc': 59}, {'timestamp': 1547152271.0, 'added_lines': 1, 'deleted_lines': 1, 'nloc': 59}, {'timestamp': 1548866534.0, 'added_lines': 1, 'deleted_lines': 1, 'nloc': 59}, {'timestamp': 1549903582.0, 'added_lines': 1, 'deleted_lines': 1, 'nloc': 59}, {'timestamp': 1550507829.0, 'added_lines': 1, 'deleted_lines': 1, 'nloc': 59}, {'timestamp': 1550610741.0, 'added_lines': 1, 'deleted_lines': 1, 'nloc': 59}, {'timestamp': 1551138343.0, 'added_lines': 1, 'deleted_lines': 1, 'nloc': 59}, {'timestamp': 1551299964.0, 'added_lines': 1, 'deleted_lines': 1, 'nloc': 59}, {'timestamp': 1551471469.0, 'added_lines': 1, 'deleted_lines': 1, 'nloc': 59}, {'timestamp': 1551551196.0, 'added_lines': 1, 'deleted_lines': 1, 'nloc': 59}, {'timestamp': 1593559244.0, 'added_lines': 1, 'deleted_lines': 0, 'nloc': 60}, {'timestamp': 1595277534.0, 'added_lines': 0, 'deleted_lines': 58, 'nloc': 24}, {'timestamp': 1597660382.0, 'added_lines': 0, 'deleted_lines': 1, 'nloc': 23}]","{'blocks/blockstore/caching.go': 1, 'blocks/blockstore/util/remove.go': 3, 'cmd/ipfs/daemon.go': 53, 'cmd/ipfs/init.go': 35, 'cmd/ipfs/main.go': 53, 'cmd/ipfs/main_test.go': 4, 'cmd/ipfswatch/main.go': 15, 'cmd/seccat/seccat.go': 14, None: 14, 'commands/channelmarshaler.go': 1, 'commands/cli/cmd_suggestion.go': 1, 'commands/cli/helptext.go': 2, 'commands/cli/helptext_test.go': 2, 'commands/cli/parse.go': 2, 'commands/cli/parse_test.go': 2, 'commands/command.go': 28, 'commands/command_test.go': 19, 'commands/http/client.go': 2, 'commands/http/handler.go': 2, 'commands/http/multifilereader.go': 2, 'commands/http/multifilereader_test.go': 2, 'commands/http/parse.go': 2, 'commands/reqlog.go': 1, 'commands/request.go': 36, 'commands/response.go': 23, 'commands/response_test.go': 19, 'core/bootstrap.go': 15, 'core/commands/active.go': 22, 'core/commands/add.go': 51, 'core/commands/bitswap.go': 51, 'core/commands/block.go': 51, 'core/commands/bootstrap.go': 23, 'core/commands/cat.go': 51, 'core/commands/commands.go': 52, 'core/commands/config.go': 25, 'core/commands/dag/dag.go': 27, 'core/commands/dht.go': 29, 'core/commands/diag.go': 21, 'core/commands/dns.go': 23, 'core/commands/e/error.go': 1, 'core/commands/external.go': 22, 'core/commands/files/files.go': 9, 'core/commands/filestore.go': 51, 'core/commands/get.go': 51, 'core/commands/helptext_test.go': 51, 'core/commands/id.go': 31, 'core/commands/ipns.go': 12, 'core/commands/keystore.go': 36, 'core/commands/log.go': 28, 'core/commands/ls.go': 27, 'core/commands/mount_nofuse.go': 21, 'core/commands/mount_unix.go': 23, 'core/commands/mount_windows.go': 20, 'core/commands/name.go': 9, 'core/commands/object/diff.go': 22, 'core/commands/object/object.go': 36, 'core/commands/object/patch.go': 36, 'core/commands/p2p.go': 25, 'core/commands/pin.go': 27, 'core/commands/ping.go': 28, 'core/commands/publish.go': 14, 'core/commands/pubsub.go': 51, 'core/commands/refs.go': 25, 'core/commands/repo.go': 52, 'core/commands/resolve.go': 27, 'core/commands/root.go': 52, 'core/commands/shutdown.go': 30, 'core/commands/stat.go': 51, 'core/commands/swarm.go': 31, 'core/commands/sysdiag.go': 24, 'core/commands/tar.go': 25, 'core/commands/unixfs/ls.go': 24, 'core/commands/unixfs/unixfs.go': 21, 'core/commands/version.go': 24, 'core/core_test.go': 7, 'core/corehttp/commands.go': 51, 'core/corehttp/gateway.go': 17, 'core/coreunix/add.go': 23, 'core/coreunix/add_test.go': 22, 'core/coreunix/metadata_test.go': 18, 'exchange/bitswap/bitswap_test.go': 10, 'exchange/bitswap/decision/engine_test.go': 8, 'exchange/bitswap/message/message_test.go': 4, 'exchange/bitswap/message/pb/Makefile': 1, 'exchange/bitswap/testnet/network_test.go': 8, 'exchange/bitswap/testnet/peernet.go': 9, 'exchange/reprovide/reprovide_test.go': 14, 'fuse/ipns/common.go': 14, 'fuse/node/mount_test.go': 14, 'importer/balanced/balanced_test.go': 6, 'importer/chunk/rabin_test.go': 3, 'importer/helpers/dagbuilder.go': 10, 'importer/importer.go': 10, 'merkledag/utils/utils_test.go': 4, 'mfs/repub_test.go': 9, 'namesys/dns.go': 9, 'namesys/interface.go': 10, 'namesys/ipns_select_test.go': 5, 'namesys/proquint.go': 9, 'namesys/republisher/repub_test.go': 17, 'package.json': 50, 'repo/config/identity.go': 3, 'routing/offline/offline_test.go': 6, 'test/integration/addcat_test.go': 19, 'test/integration/bench_cat_test.go': 18, 'test/integration/bitswap_wo_routing_test.go': 16, 'test/integration/three_legged_cat_test.go': 18, 'test/sharness/t0600-issues-and-regressions-online.sh': 1, 'core/bootstrap_test.go': 13, 'core/commands/dht_test.go': 13, 'core/commands/get_test.go': 48, 'core/core.go': 21, 'core/corehttp/gateway_test.go': 17, 'core/corehttp/metrics_test.go': 15, 'core/mock/mock.go': 15, 'exchange/bitswap/decision/bench_test.go': 7, 'exchange/bitswap/decision/peer_request_queue_test.go': 7, 'exchange/bitswap/message/message.go': 7, 'exchange/bitswap/network/interface.go': 7, 'exchange/bitswap/network/ipfs_impl.go': 7, 'exchange/bitswap/testnet/interface.go': 7, 'exchange/bitswap/testnet/virtual.go': 7, 'exchange/bitswap/testutils.go': 8, 'fuse/ipns/ipns_test.go': 13, 'fuse/readonly/ipfs_test.go': 19, 'namesys/publisher_test.go': 13, 'namesys/resolve_test.go': 14, 'p2p/p2p.go': 13, 'p2p/registry.go': 9, 'repo/config/bootstrap_peers.go': 9, 'routing/mock/centralized_client.go': 4, 'routing/mock/centralized_server.go': 4, 'routing/mock/centralized_test.go': 4, 'routing/mock/interface.go': 4, 'routing/none/none_client.go': 4, 'test/integration/bench_test.go': 13, 'assets/assets.go': 15, 'blocks/blockstore/arc_cache.go': 2, 'blocks/blockstore/arc_cache_test.go': 2, 'blocks/blockstore/blockstore.go': 3, 'blocks/blockstore/blockstore_test.go': 2, 'blocks/blockstore/bloom_cache.go': 2, 'blocks/blockstore/bloom_cache_test.go': 2, 'blocks/blocksutil/block_generator.go': 2, 'blockservice/blockservice.go': 6, 'blockservice/blockservice_test.go': 5, 'blockservice/test/blocks_test.go': 5, 'core/builder.go': 18, 'core/commands/ipnsps.go': 8, 'core/coreapi/coreapi.go': 8, 'core/coreapi/interface/interface.go': 2, 'core/coreapi/unixfs.go': 15, 'core/coreapi/unixfs_test.go': 13, 'core/coredag/cbor.go': 7, 'core/coredag/dagpb.go': 10, 'core/coredag/dagtransl.go': 6, 'core/coredag/raw.go': 10, 'core/corehttp/corehttp.go': 11, 'core/corehttp/gateway_handler.go': 19, 'core/corerepo/gc.go': 18, 'core/corerepo/pinning.go': 8, 'core/coreunix/metadata.go': 15, 'core/pathresolver.go': 13, 'exchange/bitswap/bitswap.go': 6, 'exchange/bitswap/decision/engine.go': 6, 'exchange/bitswap/decision/ledger.go': 6, 'exchange/bitswap/decision/peer_request_queue.go': 6, 'exchange/bitswap/get.go': 5, 'exchange/bitswap/notifications/notifications.go': 3, 'exchange/bitswap/notifications/notifications_test.go': 3, 'exchange/bitswap/session.go': 7, 'exchange/bitswap/session_test.go': 5, 'exchange/bitswap/stat.go': 3, 'exchange/bitswap/wantlist/wantlist.go': 3, 'exchange/bitswap/wantlist/wantlist_test.go': 3, 'exchange/bitswap/wantmanager.go': 6, 'exchange/bitswap/workers.go': 6, 'exchange/interface.go': 2, 'exchange/offline/offline.go': 2, 'exchange/offline/offline_test.go': 2, 'exchange/reprovide/providers.go': 12, 'exchange/reprovide/reprovide.go': 12, 'filestore/filestore.go': 12, 'filestore/filestore_test.go': 12, 'filestore/fsrefstore.go': 11, 'filestore/util.go': 11, 'fuse/ipns/ipns_unix.go': 18, 'fuse/readonly/readonly_unix.go': 19, 'importer/balanced/builder.go': 3, 'importer/chunk/splitting_test.go': 2, 'importer/helpers/helpers.go': 3, 'importer/importer_test.go': 5, 'importer/trickle/trickle_test.go': 5, 'importer/trickle/trickledag.go': 3, 'merkledag/batch.go': 2, 'merkledag/coding.go': 3, 'merkledag/merkledag.go': 3, 'merkledag/merkledag_test.go': 5, 'merkledag/node.go': 3, 'merkledag/node_test.go': 3, 'merkledag/raw.go': 3, 'merkledag/traverse/traverse.go': 3, 'merkledag/traverse/traverse_test.go': 3, 'merkledag/utils/diff.go': 3, 'merkledag/utils/diffenum.go': 3, 'merkledag/utils/diffenum_test.go': 3, 'merkledag/utils/utils.go': 5, 'mfs/dir.go': 5, 'mfs/file.go': 7, 'mfs/mfs_test.go': 7, 'mfs/ops.go': 4, 'mfs/system.go': 8, 'namesys/namesys.go': 15, 'namesys/publisher.go': 18, 'namesys/pubsub.go': 5, 'namesys/pubsub_test.go': 5, 'namesys/republisher/repub.go': 13, 'namesys/routing.go': 14, 'path/path.go': 3, 'path/resolver.go': 3, 'path/resolver_test.go': 2, 'pin/gc/gc.go': 13, 'pin/pin.go': 13, 'pin/pin_test.go': 12, 'pin/set.go': 10, 'pin/set_test.go': 12, 'plugin/ipld.go': 6, 'plugin/loader/initializer.go': 5, 'plugin/plugins/git/git.go': 6, 'repo/config/init.go': 7, 'repo/fsrepo/fsrepo.go': 12, 'repo/fsrepo/lock/lock.go': 3, 'repo/fsrepo/serialize/serialize.go': 3, 'repo/mock.go': 9, 'repo/repo.go': 10, 'routing/offline/offline.go': 3, 'tar/format.go': 18, 'test/dependencies/ma-pipe-unidir/main.go': 6, 'thirdparty/ds-help/key.go': 2, 'thirdparty/pollEndpoint/main.go': 11, 'thirdparty/posinfo/posinfo.go': 2, 'unixfs/archive/archive.go': 3, 'unixfs/archive/tar/writer.go': 3, 'unixfs/hamt/hamt.go': 3, 'unixfs/io/dagreader.go': 3, 'unixfs/io/dirbuilder.go': 3, 'unixfs/io/resolve.go': 3, 'unixfs/mod/dagmodifier.go': 5, 'unixfs/mod/dagmodifier_test.go': 3, 'unixfs/test/utils.go': 5, 'commands/legacy/command.go': 34, 'commands/legacy/legacy.go': 34, 'commands/legacy/legacy_test.go': 34, 'commands/legacy/request.go': 34, 'commands/legacy/response.go': 34, 'commands/legacy/responseemitter.go': 3, 'core/commands/env.go': 4, 'core/commands/commands_test.go': 46, 'test/sharness/t0040-add-and-cat.sh': 1, 'TODO.md': 2, 'test/sharness/t0110-gateway.sh': 1, 'test/sharness/t0410-api-add.sh': 1, 'core/coreapi/dag.go': 5, 'core/coreapi/dag_test.go': 3, 'core/coreapi/interface/options/dag.go': 4, 'core/coreapi/key.go': 13, 'core/coreapi/name.go': 13, 'merkledag/test/utils.go': 4, 'namesys/namesys_test.go': 16, 'repo/fsrepo/datastores.go': 10, 'repo/fsrepo/fsrepo_test.go': 7, 'thirdparty/datastore2/datastore_closer.go': 1, 'thirdparty/datastore2/delayed.go': 1, 'thirdparty/datastore2/threadsafe.go': 1, 'unixfs/io/pbdagreader.go': 2, 'cmd/ipfs/util/ulimit.go': 9, 'cmd/seccat/util.go': 9, 'core/corehttp/logs.go': 9, 'fuse/mount/mount.go': 9, 'fuse/node/mount_unix.go': 9, 'importer/chunk/splitting.go': 1, 'namesys/ipns_validate_test.go': 3, 'plugin/loader/load.go': 7, 'core/commands/files.go': 30, 'core/commands/root_test.go': 1, 'test/sharness/t0090-get.sh': 1, 'blocks/blockstoreutil/remove.go': 9, 'blockservice/test/mock.go': 3, 'core/coreapi/pin.go': 11, 'keystore/keystore.go': 8, 'keystore/keystore_test.go': 5, 'keystore/memkeystore.go': 5, 'namesys/validator.go': 2, 'path/resolver/resolver.go': 3, 'thirdparty/verifbs/verifbs.go': 9, 'cmd/ipfs/util/ulimit_freebsd.go': 2, 'cmd/ipfs/util/ulimit_unix.go': 2, 'core/coreapi/block.go': 7, 'core/coreapi/block_test.go': 2, 'core/coreapi/interface/coreapi.go': 3, 'core/coreapi/interface/dag.go': 3, 'core/coreapi/interface/object.go': 3, 'core/coreapi/interface/options/block.go': 2, 'core/coreapi/interface/path.go': 5, 'core/coreapi/interface/unixfs.go': 6, 'core/coreapi/object.go': 13, 'fuse/ipns/link_unix.go': 2, 'fuse/mount/fuse.go': 2, 'fuse/node/mount_darwin.go': 2, 'merkledag/errservice.go': 1, 'merkledag/readonly.go': 1, 'merkledag/readonly_test.go': 1, 'merkledag/rwservice.go': 1, 'merkledag/session.go': 1, 'path/resolver/resolver_test.go': 1, 'thirdparty/verifcid/validate.go': 1, 'thirdparty/verifcid/validate_test.go': 1, 'unixfs/hamt/hamt_stress_test.go': 1, 'unixfs/hamt/hamt_test.go': 1, 'namesys/ipns_resolver_validation_test.go': 9, 'test/sharness/t0170-dht.sh': 1, 'core/commands/urlstore.go': 23, 'core/coreapi/interface/key.go': 4, 'core/coreapi/name_test.go': 6, 'core/coreapi/path.go': 12, 'core/coreunix/cat.go': 4, 'core/pathresolver_test.go': 7, 'dagutils/diff.go': 8, 'dagutils/diffenum.go': 7, 'dagutils/diffenum_test.go': 7, 'dagutils/utils.go': 7, 'dagutils/utils_test.go': 7, 'filestore/pb/dataobj.pb.go': 3, 'mfs/fd.go': 2, 'namesys/base.go': 8, 'namesys/cache.go': 7, 'pin/internal/pb/header.pb.go': 3, 'thirdparty/cidv0v1/blockstore.go': 6, 'repo/fsrepo/config_test.go': 5, 'repo/fsrepo/misc.go': 5, 'test/bench/bench_cli_ipfs_add/main.go': 6, 'test/bench/offline_add/main.go': 6, 'core/commands/cmdenv/env.go': 20, 'core/commands/name/ipns.go': 20, 'core/commands/name/ipnsps.go': 20, 'core/commands/name/name.go': 20, 'core/commands/name/publish.go': 20, 'test/sharness/lib/test-lib.sh': 2, 'core/coreapi/dht.go': 6, 'core/coreapi/dht_test.go': 2, 'core/coreapi/interface/dht.go': 2, 'p2p/listener.go': 4, 'p2p/local.go': 4, 'p2p/remote.go': 4, 'p2p/stream.go': 4, 'core/commands/cid.go': 17, 'core/coreapi/unixfile.go': 3, 'cmd/ipfs/dnsresolve_test.go': 2, 'core/coreapi/interface/options/unixfs.go': 1, 'core/coreapi/interface/pubsub.go': 1, 'core/coreapi/interface/swarm.go': 1, 'core/coreapi/pubsub.go': 5, 'core/coreapi/swarm.go': 5, 'test/dependencies/iptb/iptb.go': 4, 'commands/context.go': 11, 'core/commands/cmdenv/cidbase.go': 8, 'core/commands/cmdenv/file.go': 3, 'core/coreapi/interface/tests/name.go': 1, 'core/coreapi/interface/tests/unixfs.go': 1, 'core/coreapi/test/api_test.go': 4, 'core/corehttp/ipns_hostname.go': 4, 'namesys/dns_test.go': 4, 'plugin/daemon.go': 4, 'plugin/loader/loader.go': 4, 'core/corehttp/proxy.go': 3, 'plugin/plugins/badgerds/badgerds.go': 3, 'plugin/plugins/flatfs/flatfs.go': 3, 'plugin/plugins/levelds/levelds.go': 2, 'core/corerepo/stat.go': 2, 'core/commands/cmdenv/cidbase_test.go': 1, 'core/corehttp/metrics.go': 1, 'core/corehttp/proxy_test.go': 1, 'plugin/tracer.go': 1, 'thirdparty/notifier/notifier.go': 1, 'cmd/ipfs/rotate.go': 2, 'test/sharness/t0027-rotate.sh': 2, 'core/commands/extra.go': 1, 'go.mod': 1, 'go.sum': 1}","('cmd/ipfs/daemon.go', 0.9298245614035088, 0.3464052287581699)"
cmd/ipfs/main.go,494,2835,35,"[{'cyclomatic_complexity': 1, 'nloc': 3, 'token_count': 14, 'name': 'main', 'long_name': 'main', 'start_line': 63, 'end_line': 65, 'full_parameters': [], 'filename': '/home/dimi/Documents/Informatik_Studium/FSS/SoftEvo/DataCollection/FFS_SoftEvo/go-ipfs/cmd/ipfs/main.go', 'top_nesting_level': 0, 'length': 3, 'fan_in': 0, 'fan_out': 0, 'general_fan_out': 0}, {'cyclomatic_complexity': 1, 'nloc': 3, 'token_count': 23, 'name': '', 'long_name': '(err error)', 'start_line': 76, 'end_line': 78, 'full_parameters': [], 'filename': '/home/dimi/Documents/Informatik_Studium/FSS/SoftEvo/DataCollection/FFS_SoftEvo/go-ipfs/cmd/ipfs/main.go', 'top_nesting_level': 0, 'length': 3, 'fan_in': 0, 'fan_out': 0, 'general_fan_out': 0}, {'cyclomatic_complexity': 2, 'nloc': 7, 'token_count': 38, 'name': '', 'long_name': '(long bool,w io.Writer)', 'start_line': 89, 'end_line': 96, 'full_parameters': [], 'filename': '/home/dimi/Documents/Informatik_Studium/FSS/SoftEvo/DataCollection/FFS_SoftEvo/go-ipfs/cmd/ipfs/main.go', 'top_nesting_level': 0, 'length': 8, 'fan_in': 0, 'fan_out': 0, 'general_fan_out': 0}, {'cyclomatic_complexity': 1, 'nloc': 4, 'token_count': 31, 'name': '', 'long_name': '(w io.Writer)', 'start_line': 99, 'end_line': 102, 'full_parameters': [], 'filename': '/home/dimi/Documents/Informatik_Studium/FSS/SoftEvo/DataCollection/FFS_SoftEvo/go-ipfs/cmd/ipfs/main.go', 'top_nesting_level': 0, 'length': 4, 'fan_in': 0, 'fan_out': 0, 'general_fan_out': 0}, {'cyclomatic_complexity': 16, 'nloc': 64, 'token_count': 342, 'name': 'mainRet', 'long_name': 'mainRet', 'start_line': 67, 'end_line': 175, 'full_parameters': [], 'filename': '/home/dimi/Documents/Informatik_Studium/FSS/SoftEvo/DataCollection/FFS_SoftEvo/go-ipfs/cmd/ipfs/main.go', 'top_nesting_level': 0, 'length': 109, 'fan_in': 0, 'fan_out': 0, 'general_fan_out': 0}, {'cyclomatic_complexity': 7, 'nloc': 21, 'token_count': 141, 'name': 'Run', 'long_name': '(i*cmdInvocation)Run ctx context . Context', 'start_line': 177, 'end_line': 202, 'full_parameters': ['ctx context . Context'], 'filename': '/home/dimi/Documents/Informatik_Studium/FSS/SoftEvo/DataCollection/FFS_SoftEvo/go-ipfs/cmd/ipfs/main.go', 'top_nesting_level': 0, 'length': 26, 'fan_in': 0, 'fan_out': 0, 'general_fan_out': 0}, {'cyclomatic_complexity': 5, 'nloc': 23, 'token_count': 136, 'name': '', 'long_name': '()(*core.IpfsNode,error)', 'start_line': 205, 'end_line': 232, 'full_parameters': [], 'filename': '/home/dimi/Documents/Informatik_Studium/FSS/SoftEvo/DataCollection/FFS_SoftEvo/go-ipfs/cmd/ipfs/main.go', 'top_nesting_level': 0, 'length': 28, 'fan_in': 0, 'fan_out': 0, 'general_fan_out': 0}, {'cyclomatic_complexity': 1, 'nloc': 3, 'token_count': 28, 'name': 'constructNodeFunc', 'long_name': '(i*cmdInvocation)constructNodeFunc ctx context . Context', 'start_line': 204, 'end_line': 233, 'full_parameters': ['ctx context . Context'], 'filename': '/home/dimi/Documents/Informatik_Studium/FSS/SoftEvo/DataCollection/FFS_SoftEvo/go-ipfs/cmd/ipfs/main.go', 'top_nesting_level': 0, 'length': 30, 'fan_in': 0, 'fan_out': 0, 'general_fan_out': 0}, {'cyclomatic_complexity': 2, 'nloc': 6, 'token_count': 32, 'name': 'close', 'long_name': '(i*cmdInvocation)close', 'start_line': 235, 'end_line': 243, 'full_parameters': [], 'filename': '/home/dimi/Documents/Informatik_Studium/FSS/SoftEvo/DataCollection/FFS_SoftEvo/go-ipfs/cmd/ipfs/main.go', 'top_nesting_level': 0, 'length': 9, 'fan_in': 0, 'fan_out': 0, 'general_fan_out': 0}, {'cyclomatic_complexity': 6, 'nloc': 24, 'token_count': 189, 'name': 'Parse', 'long_name': '(i*cmdInvocation)Parse ctx context . Context , args [ ] string', 'start_line': 245, 'end_line': 278, 'full_parameters': ['ctx context . Context', ' args [ ] string'], 'filename': '/home/dimi/Documents/Informatik_Studium/FSS/SoftEvo/DataCollection/FFS_SoftEvo/go-ipfs/cmd/ipfs/main.go', 'top_nesting_level': 0, 'length': 34, 'fan_in': 0, 'fan_out': 0, 'general_fan_out': 0}, {'cyclomatic_complexity': 3, 'nloc': 11, 'token_count': 87, 'name': 'requestedHelp', 'long_name': '(i*cmdInvocation)requestedHelp', 'start_line': 280, 'end_line': 290, 'full_parameters': [], 'filename': '/home/dimi/Documents/Informatik_Studium/FSS/SoftEvo/DataCollection/FFS_SoftEvo/go-ipfs/cmd/ipfs/main.go', 'top_nesting_level': 0, 'length': 11, 'fan_in': 0, 'fan_out': 0, 'general_fan_out': 0}, {'cyclomatic_complexity': 1, 'nloc': 5, 'token_count': 44, 'name': 'callPreCommandHooks', 'long_name': 'callPreCommandHooks ctx context . Context , details cmdDetails , req cmds . Request , root * cmds . Command', 'start_line': 292, 'end_line': 298, 'full_parameters': ['ctx context . Context', ' details cmdDetails', ' req cmds . Request', ' root * cmds . Command'], 'filename': '/home/dimi/Documents/Informatik_Studium/FSS/SoftEvo/DataCollection/FFS_SoftEvo/go-ipfs/cmd/ipfs/main.go', 'top_nesting_level': 0, 'length': 7, 'fan_in': 0, 'fan_out': 0, 'general_fan_out': 0}, {'cyclomatic_complexity': 14, 'nloc': 51, 'token_count': 315, 'name': 'callCommand', 'long_name': 'callCommand ctx context . Context , req cmds . Request , root * cmds . Command , cmd * cmds . Command', 'start_line': 300, 'end_line': 364, 'full_parameters': ['ctx context . Context', ' req cmds . Request', ' root * cmds . Command', ' cmd * cmds . Command'], 'filename': '/home/dimi/Documents/Informatik_Studium/FSS/SoftEvo/DataCollection/FFS_SoftEvo/go-ipfs/cmd/ipfs/main.go', 'top_nesting_level': 0, 'length': 65, 'fan_in': 0, 'fan_out': 0, 'general_fan_out': 0}, {'cyclomatic_complexity': 4, 'nloc': 15, 'token_count': 87, 'name': 'commandDetails', 'long_name': 'commandDetails path [ ] string , root * cmds . Command', 'start_line': 370, 'end_line': 386, 'full_parameters': ['path [ ] string', ' root * cmds . Command'], 'filename': '/home/dimi/Documents/Informatik_Studium/FSS/SoftEvo/DataCollection/FFS_SoftEvo/go-ipfs/cmd/ipfs/main.go', 'top_nesting_level': 0, 'length': 17, 'fan_in': 0, 'fan_out': 0, 'general_fan_out': 0}, {'cyclomatic_complexity': 15, 'nloc': 38, 'token_count': 242, 'name': 'commandShouldRunOnDaemon', 'long_name': 'commandShouldRunOnDaemon details cmdDetails , req cmds . Request , root * cmds . Command', 'start_line': 394, 'end_line': 449, 'full_parameters': ['details cmdDetails', ' req cmds . Request', ' root * cmds . Command'], 'filename': '/home/dimi/Documents/Informatik_Studium/FSS/SoftEvo/DataCollection/FFS_SoftEvo/go-ipfs/cmd/ipfs/main.go', 'top_nesting_level': 0, 'length': 56, 'fan_in': 0, 'fan_out': 0, 'general_fan_out': 0}, {'cyclomatic_complexity': 3, 'nloc': 9, 'token_count': 48, 'name': 'isClientError', 'long_name': 'isClientError err error', 'start_line': 451, 'end_line': 464, 'full_parameters': ['err error'], 'filename': '/home/dimi/Documents/Informatik_Studium/FSS/SoftEvo/DataCollection/FFS_SoftEvo/go-ipfs/cmd/ipfs/main.go', 'top_nesting_level': 0, 'length': 14, 'fan_in': 0, 'fan_out': 0, 'general_fan_out': 0}, {'cyclomatic_complexity': 5, 'nloc': 14, 'token_count': 76, 'name': 'getRepoPath', 'long_name': 'getRepoPath req cmds . Request', 'start_line': 466, 'end_line': 480, 'full_parameters': ['req cmds . Request'], 'filename': '/home/dimi/Documents/Informatik_Studium/FSS/SoftEvo/DataCollection/FFS_SoftEvo/go-ipfs/cmd/ipfs/main.go', 'top_nesting_level': 0, 'length': 15, 'fan_in': 0, 'fan_out': 0, 'general_fan_out': 0}, {'cyclomatic_complexity': 1, 'nloc': 3, 'token_count': 23, 'name': 'loadConfig', 'long_name': 'loadConfig path string', 'start_line': 482, 'end_line': 484, 'full_parameters': ['path string'], 'filename': '/home/dimi/Documents/Informatik_Studium/FSS/SoftEvo/DataCollection/FFS_SoftEvo/go-ipfs/cmd/ipfs/main.go', 'top_nesting_level': 0, 'length': 3, 'fan_in': 0, 'fan_out': 0, 'general_fan_out': 0}, {'cyclomatic_complexity': 3, 'nloc': 8, 'token_count': 38, 'name': '', 'long_name': '()', 'start_line': 496, 'end_line': 503, 'full_parameters': [], 'filename': '/home/dimi/Documents/Informatik_Studium/FSS/SoftEvo/DataCollection/FFS_SoftEvo/go-ipfs/cmd/ipfs/main.go', 'top_nesting_level': 0, 'length': 8, 'fan_in': 0, 'fan_out': 0, 'general_fan_out': 0}, {'cyclomatic_complexity': 1, 'nloc': 4, 'token_count': 16, 'name': '', 'long_name': '()', 'start_line': 505, 'end_line': 508, 'full_parameters': [], 'filename': '/home/dimi/Documents/Informatik_Studium/FSS/SoftEvo/DataCollection/FFS_SoftEvo/go-ipfs/cmd/ipfs/main.go', 'top_nesting_level': 0, 'length': 4, 'fan_in': 0, 'fan_out': 0, 'general_fan_out': 0}, {'cyclomatic_complexity': 2, 'nloc': 10, 'token_count': 50, 'name': 'startProfiling', 'long_name': 'startProfiling', 'start_line': 488, 'end_line': 510, 'full_parameters': [], 'filename': '/home/dimi/Documents/Informatik_Studium/FSS/SoftEvo/DataCollection/FFS_SoftEvo/go-ipfs/cmd/ipfs/main.go', 'top_nesting_level': 0, 'length': 23, 'fan_in': 0, 'fan_out': 0, 'general_fan_out': 0}, {'cyclomatic_complexity': 2, 'nloc': 8, 'token_count': 38, 'name': 'writeHeapProfileToFile', 'long_name': 'writeHeapProfileToFile', 'start_line': 512, 'end_line': 519, 'full_parameters': [], 'filename': '/home/dimi/Documents/Informatik_Studium/FSS/SoftEvo/DataCollection/FFS_SoftEvo/go-ipfs/cmd/ipfs/main.go', 'top_nesting_level': 0, 'length': 8, 'fan_in': 0, 'fan_out': 0, 'general_fan_out': 0}, {'cyclomatic_complexity': 1, 'nloc': 5, 'token_count': 29, 'name': 'NewIntrHandler', 'long_name': 'NewIntrHandler', 'start_line': 528, 'end_line': 532, 'full_parameters': [], 'filename': '/home/dimi/Documents/Informatik_Studium/FSS/SoftEvo/DataCollection/FFS_SoftEvo/go-ipfs/cmd/ipfs/main.go', 'top_nesting_level': 0, 'length': 5, 'fan_in': 0, 'fan_out': 0, 'general_fan_out': 0}, {'cyclomatic_complexity': 1, 'nloc': 5, 'token_count': 27, 'name': 'Close', 'long_name': '(ih*IntrHandler)Close', 'start_line': 534, 'end_line': 538, 'full_parameters': [], 'filename': '/home/dimi/Documents/Informatik_Studium/FSS/SoftEvo/DataCollection/FFS_SoftEvo/go-ipfs/cmd/ipfs/main.go', 'top_nesting_level': 0, 'length': 5, 'fan_in': 0, 'fan_out': 0, 'general_fan_out': 0}, {'cyclomatic_complexity': 2, 'nloc': 9, 'token_count': 39, 'name': '', 'long_name': '()', 'start_line': 548, 'end_line': 556, 'full_parameters': [], 'filename': '/home/dimi/Documents/Informatik_Studium/FSS/SoftEvo/DataCollection/FFS_SoftEvo/go-ipfs/cmd/ipfs/main.go', 'top_nesting_level': 0, 'length': 9, 'fan_in': 0, 'fan_out': 0, 'general_fan_out': 0}, {'cyclomatic_complexity': 1, 'nloc': 5, 'token_count': 50, 'name': 'Handle', 'long_name': '(ih*IntrHandler)Handle handler func count int , ih * IntrHandler , sigs ... os . Signal', 'start_line': 545, 'end_line': 557, 'full_parameters': ['handler func count int', ' ih * IntrHandler', ' sigs ... os . Signal'], 'filename': '/home/dimi/Documents/Informatik_Studium/FSS/SoftEvo/DataCollection/FFS_SoftEvo/go-ipfs/cmd/ipfs/main.go', 'top_nesting_level': 0, 'length': 13, 'fan_in': 0, 'fan_out': 0, 'general_fan_out': 0}, {'cyclomatic_complexity': 1, 'nloc': 4, 'token_count': 16, 'name': '', 'long_name': '()', 'start_line': 570, 'end_line': 573, 'full_parameters': [], 'filename': '/home/dimi/Documents/Informatik_Studium/FSS/SoftEvo/DataCollection/FFS_SoftEvo/go-ipfs/cmd/ipfs/main.go', 'top_nesting_level': 0, 'length': 4, 'fan_in': 0, 'fan_out': 0, 'general_fan_out': 0}, {'cyclomatic_complexity': 2, 'nloc': 11, 'token_count': 50, 'name': '', 'long_name': '(count int,ih*IntrHandler)', 'start_line': 564, 'end_line': 579, 'full_parameters': [], 'filename': '/home/dimi/Documents/Informatik_Studium/FSS/SoftEvo/DataCollection/FFS_SoftEvo/go-ipfs/cmd/ipfs/main.go', 'top_nesting_level': 0, 'length': 16, 'fan_in': 0, 'fan_out': 0, 'general_fan_out': 0}, {'cyclomatic_complexity': 1, 'nloc': 7, 'token_count': 64, 'name': 'SetupInterruptHandler', 'long_name': '(i*cmdInvocation)SetupInterruptHandler ctx context . Context', 'start_line': 559, 'end_line': 584, 'full_parameters': ['ctx context . Context'], 'filename': '/home/dimi/Documents/Informatik_Studium/FSS/SoftEvo/DataCollection/FFS_SoftEvo/go-ipfs/cmd/ipfs/main.go', 'top_nesting_level': 0, 'length': 26, 'fan_in': 0, 'fan_out': 0, 'general_fan_out': 0}, {'cyclomatic_complexity': 1, 'nloc': 1, 'token_count': 5, 'name': '', 'long_name': '()', 'start_line': 596, 'end_line': 596, 'full_parameters': [], 'filename': '/home/dimi/Documents/Informatik_Studium/FSS/SoftEvo/DataCollection/FFS_SoftEvo/go-ipfs/cmd/ipfs/main.go', 'top_nesting_level': 0, 'length': 1, 'fan_in': 0, 'fan_out': 0, 'general_fan_out': 0}, {'cyclomatic_complexity': 3, 'nloc': 10, 'token_count': 49, 'name': 'profileIfEnabled', 'long_name': 'profileIfEnabled', 'start_line': 586, 'end_line': 597, 'full_parameters': [], 'filename': '/home/dimi/Documents/Informatik_Studium/FSS/SoftEvo/DataCollection/FFS_SoftEvo/go-ipfs/cmd/ipfs/main.go', 'top_nesting_level': 0, 'length': 12, 'fan_in': 0, 'fan_out': 0, 'general_fan_out': 0}, {'cyclomatic_complexity': 9, 'nloc': 34, 'token_count': 190, 'name': 'getApiClient', 'long_name': 'getApiClient repoPath , apiAddrStr string', 'start_line': 609, 'end_line': 644, 'full_parameters': ['repoPath', ' apiAddrStr string'], 'filename': '/home/dimi/Documents/Informatik_Studium/FSS/SoftEvo/DataCollection/FFS_SoftEvo/go-ipfs/cmd/ipfs/main.go', 'top_nesting_level': 0, 'length': 36, 'fan_in': 0, 'fan_out': 0, 'general_fan_out': 0}, {'cyclomatic_complexity': 2, 'nloc': 7, 'token_count': 48, 'name': 'apiClientForAddr', 'long_name': 'apiClientForAddr addr ma . Multiaddr', 'start_line': 646, 'end_line': 653, 'full_parameters': ['addr ma . Multiaddr'], 'filename': '/home/dimi/Documents/Informatik_Studium/FSS/SoftEvo/DataCollection/FFS_SoftEvo/go-ipfs/cmd/ipfs/main.go', 'top_nesting_level': 0, 'length': 8, 'fan_in': 0, 'fan_out': 0, 'general_fan_out': 0}, {'cyclomatic_complexity': 3, 'nloc': 10, 'token_count': 56, 'name': 'isConnRefused', 'long_name': 'isConnRefused err error', 'start_line': 655, 'end_line': 667, 'full_parameters': ['err error'], 'filename': '/home/dimi/Documents/Informatik_Studium/FSS/SoftEvo/DataCollection/FFS_SoftEvo/go-ipfs/cmd/ipfs/main.go', 'top_nesting_level': 0, 'length': 13, 'fan_in': 0, 'fan_out': 0, 'general_fan_out': 0}, {'cyclomatic_complexity': 2, 'nloc': 6, 'token_count': 29, 'name': 'wrapContextCanceled', 'long_name': 'wrapContextCanceled err error', 'start_line': 669, 'end_line': 674, 'full_parameters': ['err error'], 'filename': '/home/dimi/Documents/Informatik_Studium/FSS/SoftEvo/DataCollection/FFS_SoftEvo/go-ipfs/cmd/ipfs/main.go', 'top_nesting_level': 0, 'length': 6, 'fan_in': 0, 'fan_out': 0, 'general_fan_out': 0}]",282,1594,20,"[{'cyclomatic_complexity': 4, 'nloc': 13, 'token_count': 97, 'name': 'loadPlugins', 'long_name': 'loadPlugins repoPath string', 'start_line': 48, 'end_line': 62, 'full_parameters': ['repoPath string'], 'filename': '/home/dimi/Documents/Informatik_Studium/FSS/SoftEvo/DataCollection/FFS_SoftEvo/go-ipfs/cmd/ipfs/main.go', 'top_nesting_level': 0, 'length': 15, 'fan_in': 0, 'fan_out': 0, 'general_fan_out': 0}, {'cyclomatic_complexity': 1, 'nloc': 3, 'token_count': 14, 'name': 'main', 'long_name': 'main', 'start_line': 70, 'end_line': 72, 'full_parameters': [], 'filename': '/home/dimi/Documents/Informatik_Studium/FSS/SoftEvo/DataCollection/FFS_SoftEvo/go-ipfs/cmd/ipfs/main.go', 'top_nesting_level': 0, 'length': 3, 'fan_in': 0, 'fan_out': 0, 'general_fan_out': 0}, {'cyclomatic_complexity': 1, 'nloc': 3, 'token_count': 23, 'name': '', 'long_name': '(err error)', 'start_line': 81, 'end_line': 83, 'full_parameters': [], 'filename': '/home/dimi/Documents/Informatik_Studium/FSS/SoftEvo/DataCollection/FFS_SoftEvo/go-ipfs/cmd/ipfs/main.go', 'top_nesting_level': 0, 'length': 3, 'fan_in': 0, 'fan_out': 0, 'general_fan_out': 0}, {'cyclomatic_complexity': 4, 'nloc': 16, 'token_count': 85, 'name': '', 'long_name': '()(n*core.IpfsNode,err error)', 'start_line': 144, 'end_line': 164, 'full_parameters': [], 'filename': '/home/dimi/Documents/Informatik_Studium/FSS/SoftEvo/DataCollection/FFS_SoftEvo/go-ipfs/cmd/ipfs/main.go', 'top_nesting_level': 0, 'length': 21, 'fan_in': 0, 'fan_out': 0, 'general_fan_out': 0}, {'cyclomatic_complexity': 3, 'nloc': 19, 'token_count': 104, 'name': '', 'long_name': '(ctx context.Context,req*cmds.Request)(cmds.Environment,error)', 'start_line': 124, 'end_line': 166, 'full_parameters': [], 'filename': '/home/dimi/Documents/Informatik_Studium/FSS/SoftEvo/DataCollection/FFS_SoftEvo/go-ipfs/cmd/ipfs/main.go', 'top_nesting_level': 0, 'length': 43, 'fan_in': 0, 'fan_out': 0, 'general_fan_out': 0}, {'cyclomatic_complexity': 9, 'nloc': 38, 'token_count': 266, 'name': 'mainRet', 'long_name': 'mainRet', 'start_line': 74, 'end_line': 175, 'full_parameters': [], 'filename': '/home/dimi/Documents/Informatik_Studium/FSS/SoftEvo/DataCollection/FFS_SoftEvo/go-ipfs/cmd/ipfs/main.go', 'top_nesting_level': 0, 'length': 102, 'fan_in': 0, 'fan_out': 0, 'general_fan_out': 0}, {'cyclomatic_complexity': 1, 'nloc': 3, 'token_count': 13, 'name': 'insideGUI', 'long_name': 'insideGUI', 'start_line': 177, 'end_line': 179, 'full_parameters': [], 'filename': '/home/dimi/Documents/Informatik_Studium/FSS/SoftEvo/DataCollection/FFS_SoftEvo/go-ipfs/cmd/ipfs/main.go', 'top_nesting_level': 0, 'length': 3, 'fan_in': 0, 'fan_out': 0, 'general_fan_out': 0}, {'cyclomatic_complexity': 4, 'nloc': 10, 'token_count': 62, 'name': 'checkDebug', 'long_name': 'checkDebug req * cmds . Request', 'start_line': 181, 'end_line': 191, 'full_parameters': ['req * cmds . Request'], 'filename': '/home/dimi/Documents/Informatik_Studium/FSS/SoftEvo/DataCollection/FFS_SoftEvo/go-ipfs/cmd/ipfs/main.go', 'top_nesting_level': 0, 'length': 11, 'fan_in': 0, 'fan_out': 0, 'general_fan_out': 0}, {'cyclomatic_complexity': 2, 'nloc': 7, 'token_count': 50, 'name': 'apiAddrOption', 'long_name': 'apiAddrOption req * cmds . Request', 'start_line': 193, 'end_line': 199, 'full_parameters': ['req * cmds . Request'], 'filename': '/home/dimi/Documents/Informatik_Studium/FSS/SoftEvo/DataCollection/FFS_SoftEvo/go-ipfs/cmd/ipfs/main.go', 'top_nesting_level': 0, 'length': 7, 'fan_in': 0, 'fan_out': 0, 'general_fan_out': 0}, {'cyclomatic_complexity': 1, 'nloc': 3, 'token_count': 30, 'name': '', 'long_name': '(_context.Context,_,_string)(net.Conn,error)', 'start_line': 284, 'end_line': 286, 'full_parameters': [], 'filename': '/home/dimi/Documents/Informatik_Studium/FSS/SoftEvo/DataCollection/FFS_SoftEvo/go-ipfs/cmd/ipfs/main.go', 'top_nesting_level': 0, 'length': 3, 'fan_in': 0, 'fan_out': 0, 'general_fan_out': 0}, {'cyclomatic_complexity': 20, 'nloc': 66, 'token_count': 392, 'name': 'makeExecutor', 'long_name': 'makeExecutor req * cmds . Request , env interface { }', 'start_line': 201, 'end_line': 294, 'full_parameters': ['req * cmds . Request', ' env interface { }'], 'filename': '/home/dimi/Documents/Informatik_Studium/FSS/SoftEvo/DataCollection/FFS_SoftEvo/go-ipfs/cmd/ipfs/main.go', 'top_nesting_level': 0, 'length': 94, 'fan_in': 0, 'fan_out': 0, 'general_fan_out': 0}, {'cyclomatic_complexity': 4, 'nloc': 11, 'token_count': 65, 'name': 'getRepoPath', 'long_name': 'getRepoPath req * cmds . Request', 'start_line': 296, 'end_line': 307, 'full_parameters': ['req * cmds . Request'], 'filename': '/home/dimi/Documents/Informatik_Studium/FSS/SoftEvo/DataCollection/FFS_SoftEvo/go-ipfs/cmd/ipfs/main.go', 'top_nesting_level': 0, 'length': 12, 'fan_in': 0, 'fan_out': 0, 'general_fan_out': 0}, {'cyclomatic_complexity': 1, 'nloc': 3, 'token_count': 23, 'name': 'loadConfig', 'long_name': 'loadConfig path string', 'start_line': 309, 'end_line': 311, 'full_parameters': ['path string'], 'filename': '/home/dimi/Documents/Informatik_Studium/FSS/SoftEvo/DataCollection/FFS_SoftEvo/go-ipfs/cmd/ipfs/main.go', 'top_nesting_level': 0, 'length': 3, 'fan_in': 0, 'fan_out': 0, 'general_fan_out': 0}, {'cyclomatic_complexity': 3, 'nloc': 8, 'token_count': 38, 'name': '', 'long_name': '()', 'start_line': 326, 'end_line': 333, 'full_parameters': [], 'filename': '/home/dimi/Documents/Informatik_Studium/FSS/SoftEvo/DataCollection/FFS_SoftEvo/go-ipfs/cmd/ipfs/main.go', 'top_nesting_level': 0, 'length': 8, 'fan_in': 0, 'fan_out': 0, 'general_fan_out': 0}, {'cyclomatic_complexity': 1, 'nloc': 4, 'token_count': 15, 'name': '', 'long_name': '()', 'start_line': 335, 'end_line': 338, 'full_parameters': [], 'filename': '/home/dimi/Documents/Informatik_Studium/FSS/SoftEvo/DataCollection/FFS_SoftEvo/go-ipfs/cmd/ipfs/main.go', 'top_nesting_level': 0, 'length': 4, 'fan_in': 0, 'fan_out': 0, 'general_fan_out': 0}, {'cyclomatic_complexity': 3, 'nloc': 14, 'token_count': 67, 'name': 'startProfiling', 'long_name': 'startProfiling', 'start_line': 315, 'end_line': 340, 'full_parameters': [], 'filename': '/home/dimi/Documents/Informatik_Studium/FSS/SoftEvo/DataCollection/FFS_SoftEvo/go-ipfs/cmd/ipfs/main.go', 'top_nesting_level': 0, 'length': 26, 'fan_in': 0, 'fan_out': 0, 'general_fan_out': 0}, {'cyclomatic_complexity': 2, 'nloc': 8, 'token_count': 38, 'name': 'writeHeapProfileToFile', 'long_name': 'writeHeapProfileToFile', 'start_line': 342, 'end_line': 349, 'full_parameters': [], 'filename': '/home/dimi/Documents/Informatik_Studium/FSS/SoftEvo/DataCollection/FFS_SoftEvo/go-ipfs/cmd/ipfs/main.go', 'top_nesting_level': 0, 'length': 8, 'fan_in': 0, 'fan_out': 0, 'general_fan_out': 0}, {'cyclomatic_complexity': 1, 'nloc': 1, 'token_count': 5, 'name': '', 'long_name': '()', 'start_line': 361, 'end_line': 361, 'full_parameters': [], 'filename': '/home/dimi/Documents/Informatik_Studium/FSS/SoftEvo/DataCollection/FFS_SoftEvo/go-ipfs/cmd/ipfs/main.go', 'top_nesting_level': 0, 'length': 1, 'fan_in': 0, 'fan_out': 0, 'general_fan_out': 0}, {'cyclomatic_complexity': 3, 'nloc': 10, 'token_count': 49, 'name': 'profileIfEnabled', 'long_name': 'profileIfEnabled', 'start_line': 351, 'end_line': 362, 'full_parameters': [], 'filename': '/home/dimi/Documents/Informatik_Studium/FSS/SoftEvo/DataCollection/FFS_SoftEvo/go-ipfs/cmd/ipfs/main.go', 'top_nesting_level': 0, 'length': 12, 'fan_in': 0, 'fan_out': 0, 'general_fan_out': 0}, {'cyclomatic_complexity': 3, 'nloc': 12, 'token_count': 89, 'name': 'resolveAddr', 'long_name': 'resolveAddr ctx context . Context , addr ma . Multiaddr', 'start_line': 364, 'end_line': 378, 'full_parameters': ['ctx context . Context', ' addr ma . Multiaddr'], 'filename': '/home/dimi/Documents/Informatik_Studium/FSS/SoftEvo/DataCollection/FFS_SoftEvo/go-ipfs/cmd/ipfs/main.go', 'top_nesting_level': 0, 'length': 15, 'fan_in': 0, 'fan_out': 0, 'general_fan_out': 0}]",-212,-1241,-15,105,105,"[{'timestamp': 1491058697.0, 'added_lines': 90, 'deleted_lines': 63, 'nloc': 517}, {'timestamp': 1508770239.0, 'added_lines': 3, 'deleted_lines': 3, 'nloc': 517}, {'timestamp': 1509016767.0, 'added_lines': 3, 'deleted_lines': 3, 'nloc': 517}, {'timestamp': 1511223906.0, 'added_lines': 4, 'deleted_lines': 4, 'nloc': 517}, {'timestamp': 1511373659.0, 'added_lines': 3, 'deleted_lines': 3, 'nloc': 517}, {'timestamp': 1511789750.0, 'added_lines': 5, 'deleted_lines': 2, 'nloc': 520}, {'timestamp': 1512365669.0, 'added_lines': 8, 'deleted_lines': 8, 'nloc': 520}, {'timestamp': 1511187070.0, 'added_lines': 60, 'deleted_lines': 77, 'nloc': 500}, {'timestamp': 1512058290.0, 'added_lines': 0, 'deleted_lines': 4, 'nloc': 496}, {'timestamp': 1512121226.0, 'added_lines': 9, 'deleted_lines': 8, 'nloc': 497}, {'timestamp': 1512671605.0, 'added_lines': 58, 'deleted_lines': 262, 'nloc': 354}, {'timestamp': 1513436097.0, 'added_lines': 3, 'deleted_lines': 3, 'nloc': 354}, {'timestamp': 1513588982.0, 'added_lines': 26, 'deleted_lines': 3, 'nloc': 371}, {'timestamp': 1513612261.0, 'added_lines': 3, 'deleted_lines': 3, 'nloc': 371}, {'timestamp': 1513764708.0, 'added_lines': 3, 'deleted_lines': 3, 'nloc': 371}, {'timestamp': 1513765470.0, 'added_lines': 3, 'deleted_lines': 3, 'nloc': 371}, {'timestamp': 1513766201.0, 'added_lines': 3, 'deleted_lines': 3, 'nloc': 371}, {'timestamp': 1513772371.0, 'added_lines': 0, 'deleted_lines': 3, 'nloc': 371}, {'timestamp': 1513772654.0, 'added_lines': 3, 'deleted_lines': 3, 'nloc': 371}, {'timestamp': 1513773452.0, 'added_lines': 3, 'deleted_lines': 3, 'nloc': 371}, {'timestamp': 1513791482.0, 'added_lines': 4, 'deleted_lines': 0, 'nloc': 372}, {'timestamp': 1515277696.0, 'added_lines': 1, 'deleted_lines': 1, 'nloc': 372}, {'timestamp': 1515465466.0, 'added_lines': 4, 'deleted_lines': 4, 'nloc': 372}, {'timestamp': 1515713724.0, 'added_lines': 3, 'deleted_lines': 3, 'nloc': 372}, {'timestamp': 1516341168.0, 'added_lines': 3, 'deleted_lines': 3, 'nloc': 372}, {'timestamp': 1516766361.0, 'added_lines': 0, 'deleted_lines': 3, 'nloc': 372}, {'timestamp': 1516838128.0, 'added_lines': 7, 'deleted_lines': 7, 'nloc': 372}, {'timestamp': 1517105039.0, 'added_lines': 4, 'deleted_lines': 4, 'nloc': 372}, {'timestamp': 1517453697.0, 'added_lines': 5, 'deleted_lines': 5, 'nloc': 372}, {'timestamp': 1517670651.0, 'added_lines': 1, 'deleted_lines': 1, 'nloc': 372}, {'timestamp': 1519173780.0, 'added_lines': 3, 'deleted_lines': 3, 'nloc': 372}, {'timestamp': 1521314540.0, 'added_lines': 3, 'deleted_lines': 3, 'nloc': 372}, {'timestamp': 1521500314.0, 'added_lines': 3, 'deleted_lines': 3, 'nloc': 372}, {'timestamp': 1521421769.0, 'added_lines': 2, 'deleted_lines': 37, 'nloc': 345}, {'timestamp': 1521427288.0, 'added_lines': 3, 'deleted_lines': 3, 'nloc': 372}, {'timestamp': 1524596476.0, 'added_lines': 3, 'deleted_lines': 3, 'nloc': 345}, {'timestamp': 1525193062.0, 'added_lines': 1, 'deleted_lines': 1, 'nloc': 345}, {'timestamp': 1526509320.0, 'added_lines': 8, 'deleted_lines': 21, 'nloc': 337}, {'timestamp': 1525408792.0, 'added_lines': 5, 'deleted_lines': 5, 'nloc': 337}, {'timestamp': 1528268108.0, 'added_lines': 1, 'deleted_lines': 1, 'nloc': 337}, {'timestamp': 1528520460.0, 'added_lines': 8, 'deleted_lines': 8, 'nloc': 337}, {'timestamp': 1529984485.0, 'added_lines': 7, 'deleted_lines': 7, 'nloc': 337}, {'timestamp': 1531125361.0, 'added_lines': 2, 'deleted_lines': 2, 'nloc': 337}, {'timestamp': 1533779477.0, 'added_lines': 5, 'deleted_lines': 5, 'nloc': 337}, {'timestamp': 1532357069.0, 'added_lines': 1, 'deleted_lines': 1, 'nloc': 337}, {'timestamp': 1532365899.0, 'added_lines': 1, 'deleted_lines': 1, 'nloc': 337}, {'timestamp': 1532388583.0, 'added_lines': 1, 'deleted_lines': 1, 'nloc': 337}, {'timestamp': 1533809170.0, 'added_lines': 1, 'deleted_lines': 1, 'nloc': 337}, {'timestamp': 1533946888.0, 'added_lines': 3, 'deleted_lines': 3, 'nloc': 337}, {'timestamp': 1534072974.0, 'added_lines': 1, 'deleted_lines': 1, 'nloc': 337}, {'timestamp': 1534896611.0, 'added_lines': 5, 'deleted_lines': 5, 'nloc': 337}, {'timestamp': 1533990597.0, 'added_lines': 27, 'deleted_lines': 6, 'nloc': 354}, {'timestamp': 1534026376.0, 'added_lines': 22, 'deleted_lines': 18, 'nloc': 355}, {'timestamp': 1534027741.0, 'added_lines': 3, 'deleted_lines': 3, 'nloc': 355}, {'timestamp': 1535255498.0, 'added_lines': 1, 'deleted_lines': 1, 'nloc': 355}, {'timestamp': 1535601896.0, 'added_lines': 1, 'deleted_lines': 1, 'nloc': 355}, {'timestamp': 1536388808.0, 'added_lines': 1, 'deleted_lines': 1, 'nloc': 355}, {'timestamp': 1523628870.0, 'added_lines': 3, 'deleted_lines': 3, 'nloc': 355}, {'timestamp': 1535044155.0, 'added_lines': 3, 'deleted_lines': 3, 'nloc': 355}, {'timestamp': 1537193530.0, 'added_lines': 3, 'deleted_lines': 3, 'nloc': 355}, {'timestamp': 1537391809.0, 'added_lines': 3, 'deleted_lines': 3, 'nloc': 355}, {'timestamp': 1537792589.0, 'added_lines': 6, 'deleted_lines': 6, 'nloc': 355}, {'timestamp': 1538544957.0, 'added_lines': 1, 'deleted_lines': 1, 'nloc': 355}, {'timestamp': 1538547366.0, 'added_lines': 1, 'deleted_lines': 1, 'nloc': 355}, {'timestamp': 1539850591.0, 'added_lines': 3, 'deleted_lines': 3, 'nloc': 355}, {'timestamp': 1540400358.0, 'added_lines': 5, 'deleted_lines': 5, 'nloc': 355}, {'timestamp': 1540489644.0, 'added_lines': 1, 'deleted_lines': 1, 'nloc': 355}, {'timestamp': 1540552487.0, 'added_lines': 3, 'deleted_lines': 3, 'nloc': 355}, {'timestamp': 1540597832.0, 'added_lines': 3, 'deleted_lines': 3, 'nloc': 355}, {'timestamp': 1539053523.0, 'added_lines': 14, 'deleted_lines': 5, 'nloc': 361}, {'timestamp': 1539072145.0, 'added_lines': 6, 'deleted_lines': 2, 'nloc': 363}, {'timestamp': 1541204121.0, 'added_lines': 10, 'deleted_lines': 10, 'nloc': 355}, {'timestamp': 1541368117.0, 'added_lines': 5, 'deleted_lines': 4, 'nloc': 356}, {'timestamp': 1543282933.0, 'added_lines': 1, 'deleted_lines': 1, 'nloc': 364}, {'timestamp': 1544225843.0, 'added_lines': 2, 'deleted_lines': 2, 'nloc': 364}, {'timestamp': 1544661332.0, 'added_lines': 3, 'deleted_lines': 3, 'nloc': 364}, {'timestamp': 1520714446.0, 'added_lines': 33, 'deleted_lines': 15, 'nloc': 379}, {'timestamp': 1540556089.0, 'added_lines': 3, 'deleted_lines': 3, 'nloc': 379}, {'timestamp': 1545323704.0, 'added_lines': 1, 'deleted_lines': 1, 'nloc': 379}, {'timestamp': 1545585065.0, 'added_lines': 2, 'deleted_lines': 69, 'nloc': 329}, {'timestamp': 1546553605.0, 'added_lines': 1, 'deleted_lines': 1, 'nloc': 329}, {'timestamp': 1547003974.0, 'added_lines': 5, 'deleted_lines': 5, 'nloc': 329}, {'timestamp': 1547152271.0, 'added_lines': 3, 'deleted_lines': 3, 'nloc': 329}, {'timestamp': 1548866534.0, 'added_lines': 3, 'deleted_lines': 3, 'nloc': 329}, {'timestamp': 1548794514.0, 'added_lines': 1, 'deleted_lines': 1, 'nloc': 329}, {'timestamp': 1549588289.0, 'added_lines': 2, 'deleted_lines': 2, 'nloc': 329}, {'timestamp': 1549903582.0, 'added_lines': 3, 'deleted_lines': 3, 'nloc': 329}, {'timestamp': 1550507829.0, 'added_lines': 6, 'deleted_lines': 6, 'nloc': 329}, {'timestamp': 1550610741.0, 'added_lines': 3, 'deleted_lines': 3, 'nloc': 329}, {'timestamp': 1551138343.0, 'added_lines': 3, 'deleted_lines': 3, 'nloc': 329}, {'timestamp': 1551229859.0, 'added_lines': 5, 'deleted_lines': 5, 'nloc': 329}, {'timestamp': 1551299964.0, 'added_lines': 3, 'deleted_lines': 3, 'nloc': 329}, {'timestamp': 1551471469.0, 'added_lines': 3, 'deleted_lines': 3, 'nloc': 329}, {'timestamp': 1551754781.0, 'added_lines': 0, 'deleted_lines': 1, 'nloc': 328}, {'timestamp': 1551551196.0, 'added_lines': 11, 'deleted_lines': 11, 'nloc': 328}, {'timestamp': 1553697989.0, 'added_lines': 5, 'deleted_lines': 3, 'nloc': 331}, {'timestamp': 1557947359.0, 'added_lines': 3, 'deleted_lines': 3, 'nloc': 331}, {'timestamp': 1561704149.0, 'added_lines': 9, 'deleted_lines': 7, 'nloc': 332}, {'timestamp': 1561797137.0, 'added_lines': 82, 'deleted_lines': 131, 'nloc': 292}, {'timestamp': 1562188256.0, 'added_lines': 5, 'deleted_lines': 5, 'nloc': 292}, {'timestamp': 1567106571.0, 'added_lines': 2, 'deleted_lines': 30, 'nloc': 272}, {'timestamp': 1569462092.0, 'added_lines': 24, 'deleted_lines': 6, 'nloc': 289}, {'timestamp': 1568575969.0, 'added_lines': 9, 'deleted_lines': 2, 'nloc': 294}, {'timestamp': 1595277534.0, 'added_lines': 7, 'deleted_lines': 23, 'nloc': 282}, {'timestamp': 1597895573.0, 'added_lines': 1, 'deleted_lines': 1, 'nloc': 282}]","{'blocks/blockstore/caching.go': 1, 'blocks/blockstore/util/remove.go': 3, 'cmd/ipfs/daemon.go': 64, 'cmd/ipfs/init.go': 55, 'cmd/ipfs/ipfs.go': 53, 'cmd/ipfs/main_test.go': 4, 'cmd/ipfswatch/main.go': 36, 'cmd/seccat/seccat.go': 25, None: 17, 'commands/channelmarshaler.go': 1, 'commands/cli/cmd_suggestion.go': 1, 'commands/cli/helptext.go': 2, 'commands/cli/helptext_test.go': 2, 'commands/cli/parse.go': 2, 'commands/cli/parse_test.go': 2, 'commands/command.go': 29, 'commands/command_test.go': 20, 'commands/http/client.go': 2, 'commands/http/handler.go': 2, 'commands/http/multifilereader.go': 2, 'commands/http/multifilereader_test.go': 2, 'commands/http/parse.go': 2, 'commands/reqlog.go': 2, 'commands/request.go': 53, 'commands/response.go': 24, 'commands/response_test.go': 20, 'core/bootstrap.go': 35, 'core/commands/active.go': 23, 'core/commands/add.go': 61, 'core/commands/bitswap.go': 62, 'core/commands/block.go': 54, 'core/commands/bootstrap.go': 43, 'core/commands/cat.go': 54, 'core/commands/commands.go': 55, 'core/commands/config.go': 46, 'core/commands/dag/dag.go': 39, 'core/commands/dht.go': 40, 'core/commands/diag.go': 22, 'core/commands/dns.go': 25, 'core/commands/e/error.go': 1, 'core/commands/external.go': 23, 'core/commands/files/files.go': 11, 'core/commands/filestore.go': 53, 'core/commands/get.go': 61, 'core/commands/helptext_test.go': 51, 'core/commands/id.go': 43, 'core/commands/ipns.go': 14, 'core/commands/keystore.go': 37, 'core/commands/log.go': 29, 'core/commands/ls.go': 35, 'core/commands/mount_nofuse.go': 22, 'core/commands/mount_unix.go': 45, 'core/commands/mount_windows.go': 21, 'core/commands/name.go': 10, 'core/commands/object/diff.go': 24, 'core/commands/object/object.go': 46, 'core/commands/object/patch.go': 39, 'core/commands/p2p.go': 34, 'core/commands/pin.go': 38, 'core/commands/ping.go': 38, 'core/commands/publish.go': 15, 'core/commands/pubsub.go': 57, 'core/commands/refs.go': 35, 'core/commands/repo.go': 73, 'core/commands/resolve.go': 36, 'core/commands/root.go': 52, 'core/commands/shutdown.go': 32, 'core/commands/stat.go': 59, 'core/commands/swarm.go': 53, 'core/commands/sysdiag.go': 33, 'core/commands/tar.go': 34, 'core/commands/unixfs/ls.go': 33, 'core/commands/unixfs/unixfs.go': 22, 'core/commands/version.go': 27, 'core/core_test.go': 25, 'core/corehttp/commands.go': 71, 'core/corehttp/gateway.go': 28, 'core/coreunix/add.go': 33, 'core/coreunix/add_test.go': 42, 'core/coreunix/metadata_test.go': 27, 'exchange/bitswap/bitswap_test.go': 11, 'exchange/bitswap/decision/engine_test.go': 8, 'exchange/bitswap/message/message_test.go': 4, 'exchange/bitswap/message/pb/Makefile': 1, 'exchange/bitswap/testnet/network_test.go': 9, 'exchange/bitswap/testnet/peernet.go': 10, 'exchange/reprovide/reprovide_test.go': 24, 'fuse/ipns/common.go': 22, 'fuse/node/mount_test.go': 23, 'importer/balanced/balanced_test.go': 6, 'importer/chunk/rabin_test.go': 3, 'importer/helpers/dagbuilder.go': 12, 'importer/importer.go': 12, 'merkledag/utils/utils_test.go': 4, 'mfs/repub_test.go': 9, 'namesys/dns.go': 17, 'namesys/interface.go': 18, 'namesys/ipns_select_test.go': 5, 'namesys/proquint.go': 17, 'namesys/republisher/repub_test.go': 27, 'package.json': 72, 'repo/config/identity.go': 3, 'routing/offline/offline_test.go': 6, 'test/integration/addcat_test.go': 29, 'test/integration/bench_cat_test.go': 28, 'test/integration/bitswap_wo_routing_test.go': 26, 'test/integration/three_legged_cat_test.go': 28, 'test/sharness/t0600-issues-and-regressions-online.sh': 1, 'core/bootstrap_test.go': 32, 'core/commands/dht_test.go': 20, 'core/commands/get_test.go': 50, 'core/core.go': 44, 'core/corehttp/gateway_test.go': 37, 'core/corehttp/metrics_test.go': 24, 'core/mock/mock.go': 34, 'exchange/bitswap/decision/bench_test.go': 7, 'exchange/bitswap/decision/peer_request_queue_test.go': 7, 'exchange/bitswap/message/message.go': 8, 'exchange/bitswap/network/interface.go': 8, 'exchange/bitswap/network/ipfs_impl.go': 8, 'exchange/bitswap/testnet/interface.go': 7, 'exchange/bitswap/testnet/virtual.go': 8, 'exchange/bitswap/testutils.go': 10, 'fuse/ipns/ipns_test.go': 23, 'fuse/readonly/ipfs_test.go': 28, 'namesys/publisher_test.go': 22, 'namesys/resolve_test.go': 23, 'p2p/p2p.go': 22, 'p2p/registry.go': 12, 'repo/config/bootstrap_peers.go': 10, 'routing/mock/centralized_client.go': 4, 'routing/mock/centralized_server.go': 4, 'routing/mock/centralized_test.go': 4, 'routing/mock/interface.go': 4, 'routing/none/none_client.go': 4, 'test/integration/bench_test.go': 18, 'assets/assets.go': 22, 'blocks/blockstore/arc_cache.go': 2, 'blocks/blockstore/arc_cache_test.go': 2, 'blocks/blockstore/blockstore.go': 3, 'blocks/blockstore/blockstore_test.go': 2, 'blocks/blockstore/bloom_cache.go': 2, 'blocks/blockstore/bloom_cache_test.go': 2, 'blocks/blocksutil/block_generator.go': 2, 'blockservice/blockservice.go': 6, 'blockservice/blockservice_test.go': 5, 'blockservice/test/blocks_test.go': 5, 'core/builder.go': 41, 'core/commands/ipnsps.go': 10, 'core/coreapi/coreapi.go': 15, 'core/coreapi/interface/interface.go': 2, 'core/coreapi/unixfs.go': 23, 'core/coreapi/unixfs_test.go': 27, 'core/coredag/cbor.go': 7, 'core/coredag/dagpb.go': 18, 'core/coredag/dagtransl.go': 7, 'core/coredag/raw.go': 18, 'core/corehttp/corehttp.go': 16, 'core/corehttp/gateway_handler.go': 29, 'core/corerepo/gc.go': 27, 'core/corerepo/pinning.go': 11, 'core/coreunix/metadata.go': 23, 'core/pathresolver.go': 22, 'exchange/bitswap/bitswap.go': 8, 'exchange/bitswap/decision/engine.go': 6, 'exchange/bitswap/decision/ledger.go': 7, 'exchange/bitswap/decision/peer_request_queue.go': 6, 'exchange/bitswap/get.go': 5, 'exchange/bitswap/notifications/notifications.go': 3, 'exchange/bitswap/notifications/notifications_test.go': 3, 'exchange/bitswap/session.go': 7, 'exchange/bitswap/session_test.go': 5, 'exchange/bitswap/stat.go': 3, 'exchange/bitswap/wantlist/wantlist.go': 3, 'exchange/bitswap/wantlist/wantlist_test.go': 3, 'exchange/bitswap/wantmanager.go': 6, 'exchange/bitswap/workers.go': 6, 'exchange/interface.go': 2, 'exchange/offline/offline.go': 2, 'exchange/offline/offline_test.go': 2, 'exchange/reprovide/providers.go': 20, 'exchange/reprovide/reprovide.go': 20, 'filestore/filestore.go': 14, 'filestore/filestore_test.go': 20, 'filestore/fsrefstore.go': 13, 'filestore/util.go': 13, 'fuse/ipns/ipns_unix.go': 26, 'fuse/readonly/readonly_unix.go': 27, 'importer/balanced/builder.go': 3, 'importer/chunk/splitting_test.go': 2, 'importer/helpers/helpers.go': 4, 'importer/importer_test.go': 5, 'importer/trickle/trickle_test.go': 5, 'importer/trickle/trickledag.go': 4, 'merkledag/batch.go': 2, 'merkledag/coding.go': 3, 'merkledag/merkledag.go': 4, 'merkledag/merkledag_test.go': 5, 'merkledag/node.go': 3, 'merkledag/node_test.go': 3, 'merkledag/raw.go': 4, 'merkledag/traverse/traverse.go': 3, 'merkledag/traverse/traverse_test.go': 3, 'merkledag/utils/diff.go': 3, 'merkledag/utils/diffenum.go': 3, 'merkledag/utils/diffenum_test.go': 3, 'merkledag/utils/utils.go': 5, 'mfs/dir.go': 5, 'mfs/file.go': 7, 'mfs/mfs_test.go': 7, 'mfs/ops.go': 4, 'mfs/system.go': 8, 'namesys/namesys.go': 25, 'namesys/publisher.go': 27, 'namesys/pubsub.go': 6, 'namesys/pubsub_test.go': 5, 'namesys/republisher/repub.go': 21, 'namesys/routing.go': 24, 'path/path.go': 4, 'path/resolver.go': 3, 'path/resolver_test.go': 2, 'pin/gc/gc.go': 21, 'pin/pin.go': 22, 'pin/pin_test.go': 21, 'pin/set.go': 19, 'pin/set_test.go': 20, 'plugin/ipld.go': 6, 'plugin/loader/initializer.go': 5, 'plugin/plugins/git/git.go': 7, 'repo/config/init.go': 8, 'repo/fsrepo/fsrepo.go': 32, 'repo/fsrepo/lock/lock.go': 3, 'repo/fsrepo/serialize/serialize.go': 3, 'repo/mock.go': 28, 'repo/repo.go': 29, 'routing/offline/offline.go': 3, 'tar/format.go': 26, 'test/dependencies/ma-pipe-unidir/main.go': 11, 'thirdparty/ds-help/key.go': 2, 'thirdparty/pollEndpoint/main.go': 15, 'thirdparty/posinfo/posinfo.go': 2, 'unixfs/archive/archive.go': 4, 'unixfs/archive/tar/writer.go': 4, 'unixfs/hamt/hamt.go': 3, 'unixfs/io/dagreader.go': 3, 'unixfs/io/dirbuilder.go': 3, 'unixfs/io/resolve.go': 3, 'unixfs/mod/dagmodifier.go': 6, 'unixfs/mod/dagmodifier_test.go': 3, 'unixfs/test/utils.go': 5, 'commands/legacy/command.go': 34, 'commands/legacy/legacy.go': 35, 'commands/legacy/legacy_test.go': 36, 'commands/legacy/request.go': 36, 'commands/legacy/response.go': 35, 'commands/legacy/responseemitter.go': 4, 'core/commands/env.go': 9, 'core/commands/commands_test.go': 44, 'test/sharness/t0040-add-and-cat.sh': 2, 'TODO.md': 2, 'test/sharness/t0110-gateway.sh': 2, 'test/sharness/t0410-api-add.sh': 1, 'test/sharness/t0020-init.sh': 2, 'core/coreapi/dag.go': 5, 'core/coreapi/dag_test.go': 3, 'core/coreapi/interface/options/dag.go': 4, 'core/coreapi/key.go': 21, 'core/coreapi/name.go': 22, 'merkledag/test/utils.go': 4, 'namesys/namesys_test.go': 26, 'repo/fsrepo/datastores.go': 12, 'repo/fsrepo/fsrepo_test.go': 25, 'thirdparty/datastore2/datastore_closer.go': 1, 'thirdparty/datastore2/delayed.go': 1, 'thirdparty/datastore2/threadsafe.go': 1, 'unixfs/io/pbdagreader.go': 2, 'cmd/ipfs/util/ulimit.go': 9, 'cmd/seccat/util.go': 9, 'core/corehttp/logs.go': 9, 'fuse/mount/mount.go': 9, 'fuse/node/mount_unix.go': 11, 'importer/chunk/splitting.go': 1, 'namesys/ipns_validate_test.go': 4, 'plugin/loader/load.go': 8, 'core/commands/files.go': 39, 'core/commands/root_test.go': 1, 'test/sharness/t0090-get.sh': 1, 'path/path_test.go': 1, 'test/api-startup/main.go': 1, 'CHANGELOG.md': 1, 'README.md': 1, 'bin/dist_get': 1, 'cmd/ipfs/util/ulimit_freebsd.go': 3, 'contribute.md': 1, 'core/coreapi/interface/options/pin.go': 1, 'docs/experimental-features.md': 1, 'docs/file-transfer.md': 1, 'docs/releases.md': 2, 'exchange/bitswap/README.md': 1, 'plugin/plugin.go': 2, 'repo/fsrepo/migrations/mfsr_test.go': 1, 'repo/fsrepo/migrations/migrations.go': 1, 'test/sharness/README.md': 1, 'thirdparty/dir/dir.go': 1, 'blocks/blockstoreutil/remove.go': 11, 'blockservice/test/mock.go': 4, 'core/coreapi/pin.go': 19, 'keystore/keystore.go': 8, 'keystore/keystore_test.go': 6, 'keystore/memkeystore.go': 5, 'namesys/validator.go': 3, 'path/resolver/resolver.go': 3, 'thirdparty/verifbs/verifbs.go': 11, 'cmd/ipfs/util/ulimit_unix.go': 2, 'core/coreapi/block.go': 8, 'core/coreapi/block_test.go': 2, 'core/coreapi/interface/coreapi.go': 3, 'core/coreapi/interface/dag.go': 3, 'core/coreapi/interface/object.go': 3, 'core/coreapi/interface/options/block.go': 2, 'core/coreapi/interface/path.go': 12, 'core/coreapi/interface/unixfs.go': 7, 'core/coreapi/object.go': 21, 'fuse/ipns/link_unix.go': 2, 'fuse/mount/fuse.go': 3, 'fuse/node/mount_darwin.go': 2, 'merkledag/errservice.go': 1, 'merkledag/readonly.go': 1, 'merkledag/readonly_test.go': 1, 'merkledag/rwservice.go': 1, 'merkledag/session.go': 1, 'path/resolver/resolver_test.go': 1, 'thirdparty/verifcid/validate.go': 1, 'thirdparty/verifcid/validate_test.go': 1, 'unixfs/hamt/hamt_stress_test.go': 1, 'unixfs/hamt/hamt_test.go': 1, 'namesys/ipns_resolver_validation_test.go': 17, 'test/sharness/t0170-dht.sh': 1, 'core/commands/urlstore.go': 31, 'core/coreapi/interface/key.go': 7, 'core/coreapi/name_test.go': 11, 'core/coreapi/path.go': 20, 'core/coreunix/cat.go': 6, 'core/pathresolver_test.go': 15, 'dagutils/diff.go': 17, 'dagutils/diffenum.go': 15, 'dagutils/diffenum_test.go': 15, 'dagutils/utils.go': 16, 'dagutils/utils_test.go': 15, 'filestore/pb/dataobj.pb.go': 3, 'mfs/fd.go': 2, 'namesys/base.go': 16, 'namesys/cache.go': 15, 'pin/internal/pb/header.pb.go': 3, 'thirdparty/cidv0v1/blockstore.go': 8, 'repo/fsrepo/misc.go': 24, 'cmd/ipfs/Rules.mk': 1, 'core/corehttp/option_test.go': 2, 'docs/windows.md': 1, 'repo/fsrepo/config_test.go': 28, 'repo/version.go': 1, 'test/bench/bench_cli_ipfs_add/main.go': 25, 'test/bench/offline_add/main.go': 25, 'cmd/ipfs/dnsresolve_test.go': 6, 'core/commands/cmdenv/env.go': 34, 'core/commands/name/ipns.go': 28, 'core/commands/name/publish.go': 24, 'core/commands/name/ipnsps.go': 24, 'core/commands/name/name.go': 20, 'test/sharness/lib/test-lib.sh': 2, 'core/coreapi/dht.go': 12, 'core/coreapi/dht_test.go': 4, 'core/coreapi/interface/dht.go': 7, 'p2p/listener.go': 10, 'p2p/local.go': 11, 'p2p/remote.go': 12, 'p2p/stream.go': 12, 'core/coreapi/interface/swarm.go': 6, 'core/coreapi/swarm.go': 12, 'core/commands/cid.go': 17, 'core/coreapi/unixfile.go': 6, 'core/coreapi/interface/options/unixfs.go': 5, 'core/coreapi/interface/pubsub.go': 4, 'core/coreapi/pubsub.go': 12, 'test/sharness/t0180-pubsub.sh': 1, 'test/sharness/t0010-basic-commands.sh': 2, 'test/sharness/t0060-daemon.sh': 3, 'test/sharness/t0100-name.sh': 2, 'test/dependencies/iptb/iptb.go': 11, 'commands/context.go': 19, 'core/corehttp/proxy.go': 7, 'plugin/loader/loader.go': 10, 'cmd/ipfs/util/signal.go': 1, 'cmd/ipfs/util/signal_wasm.go': 1, 'core/coreapi/test/api_test.go': 8, 'core/coreapi/interface/tests/name.go': 3, 'core/coreapi/interface/tests/unixfs.go': 3, 'core/commands/cmdenv/cidbase.go': 8, 'core/commands/cmdenv/file.go': 3, 'core/corehttp/ipns_hostname.go': 5, 'namesys/dns_test.go': 5, 'plugin/daemon.go': 5, 'plugin/plugins/badgerds/badgerds.go': 4, 'plugin/plugins/flatfs/flatfs.go': 4, 'plugin/plugins/levelds/levelds.go': 3, 'core/corerepo/stat.go': 2, 'core/commands/cmdenv/cidbase_test.go': 1, 'core/corehttp/metrics.go': 1, 'core/corehttp/proxy_test.go': 1, 'plugin/tracer.go': 1, 'thirdparty/notifier/notifier.go': 1, 'core/corehttp/mutex_profile.go': 1, 'provider/queue.go': 1, 'provider/queue_test.go': 1, 'go.mod': 5, 'go.sum': 5, 'docs/plugins.md': 1, 'test/sharness/t0280-plugin-data/example.go': 1, 'test/sharness/t0280-plugin.sh': 1, 'docs/config.md': 1, 'test/dependencies/pollEndpoint/main.go': 1, 'test/sharness/t0067-unix-api.sh': 1, 'test/sharness/t0111-gateway-writeable.sh': 1, 'cmd/ipfs/util/ui.go': 1, 'cmd/ipfs/util/ui_windows.go': 1, 'cmd/ipfs/rotate.go': 1, 'core/commands/extra.go': 1}","('core/commands/repo.go', 0.6952380952380952, 0.6822429906542056)"
cmd/ipfswatch/ipfswatch_test.go,10,57,1,"[{'cyclomatic_complexity': 1, 'nloc': 5, 'token_count': 50, 'name': 'TestIsHidden', 'long_name': 'TestIsHidden t * testing . T', 'start_line': 9, 'end_line': 13, 'full_parameters': ['t * testing . T'], 'filename': '/home/dimi/Documents/Informatik_Studium/FSS/SoftEvo/DataCollection/FFS_SoftEvo/go-ipfs/cmd/ipfswatch/ipfswatch_test.go', 'top_nesting_level': 0, 'length': 5, 'fan_in': 0, 'fan_out': 0, 'general_fan_out': 0}]",10,57,1,"[{'cyclomatic_complexity': 1, 'nloc': 5, 'token_count': 50, 'name': 'TestIsHidden', 'long_name': 'TestIsHidden t * testing . T', 'start_line': 11, 'end_line': 15, 'full_parameters': ['t * testing . T'], 'filename': '/home/dimi/Documents/Informatik_Studium/FSS/SoftEvo/DataCollection/FFS_SoftEvo/go-ipfs/cmd/ipfswatch/ipfswatch_test.go', 'top_nesting_level': 0, 'length': 5, 'fan_in': 0, 'fan_out': 0, 'general_fan_out': 0}]",0,0,0,1,1,"[{'timestamp': 1600726105.0, 'added_lines': 2, 'deleted_lines': 0, 'nloc': 10}]","{'cmd/ipfs/util/ulimit_test.go': 1, 'cmd/ipfswatch/main.go': 1, 'cmd/seccat/seccat.go': 1, 'cmd/seccat/seccat_plan9.go': 1, 'cmd/seccat/seccat_posix.go': 1, 'core/commands/add.go': 1, 'core/commands/dag/dag.go': 1, 'core/commands/get.go': 1, 'fuse/ipns/ipns_test.go': 1, 'fuse/ipns/ipns_unix.go': 1, 'fuse/ipns/link_unix.go': 1, 'fuse/mount/fuse.go': 1, 'fuse/node/mount_notsupp.go': 1, 'fuse/node/mount_test.go': 1, 'fuse/node/mount_unix.go': 1, 'fuse/readonly/ipfs_test.go': 1, 'go.mod': 1, 'go.sum': 1}","('fuse/ipns/ipns_test.go', 1.0, 0.019230769230769232)"
cmd/ipfswatch/main.go,171,877,10,"[{'cyclomatic_complexity': 4, 'nloc': 16, 'token_count': 74, 'name': 'main', 'long_name': 'main', 'start_line': 30, 'end_line': 51, 'full_parameters': [], 'filename': '/home/dimi/Documents/Informatik_Studium/FSS/SoftEvo/DataCollection/FFS_SoftEvo/go-ipfs/cmd/ipfswatch/main.go', 'top_nesting_level': 0, 'length': 22, 'fan_in': 0, 'fan_out': 0, 'general_fan_out': 0}, {'cyclomatic_complexity': 2, 'nloc': 5, 'token_count': 30, 'name': '', 'long_name': '(p process.Process)', 'start_line': 95, 'end_line': 99, 'full_parameters': [], 'filename': '/home/dimi/Documents/Informatik_Studium/FSS/SoftEvo/DataCollection/FFS_SoftEvo/go-ipfs/cmd/ipfswatch/main.go', 'top_nesting_level': 0, 'length': 5, 'fan_in': 0, 'fan_out': 0, 'general_fan_out': 0}, {'cyclomatic_complexity': 3, 'nloc': 12, 'token_count': 75, 'name': '', 'long_name': '(p process.Process)', 'start_line': 131, 'end_line': 142, 'full_parameters': [], 'filename': '/home/dimi/Documents/Informatik_Studium/FSS/SoftEvo/DataCollection/FFS_SoftEvo/go-ipfs/cmd/ipfswatch/main.go', 'top_nesting_level': 0, 'length': 12, 'fan_in': 0, 'fan_out': 0, 'general_fan_out': 0}, {'cyclomatic_complexity': 17, 'nloc': 69, 'token_count': 353, 'name': 'run', 'long_name': 'run ipfsPath , watchPath string', 'start_line': 53, 'end_line': 148, 'full_parameters': ['ipfsPath', ' watchPath string'], 'filename': '/home/dimi/Documents/Informatik_Studium/FSS/SoftEvo/DataCollection/FFS_SoftEvo/go-ipfs/cmd/ipfswatch/main.go', 'top_nesting_level': 0, 'length': 96, 'fan_in': 0, 'fan_out': 0, 'general_fan_out': 0}, {'cyclomatic_complexity': 6, 'nloc': 20, 'token_count': 91, 'name': 'error', 'long_name': '(path string,info os.FileInfo,err error)error', 'start_line': 151, 'end_line': 170, 'full_parameters': [], 'filename': '/home/dimi/Documents/Informatik_Studium/FSS/SoftEvo/DataCollection/FFS_SoftEvo/go-ipfs/cmd/ipfswatch/main.go', 'top_nesting_level': 0, 'length': 20, 'fan_in': 0, 'fan_out': 0, 'general_fan_out': 0}, {'cyclomatic_complexity': 1, 'nloc': 4, 'token_count': 31, 'name': 'IsDirectory', 'long_name': 'IsDirectory path string', 'start_line': 174, 'end_line': 177, 'full_parameters': ['path string'], 'filename': '/home/dimi/Documents/Informatik_Studium/FSS/SoftEvo/DataCollection/FFS_SoftEvo/go-ipfs/cmd/ipfswatch/main.go', 'top_nesting_level': 0, 'length': 4, 'fan_in': 0, 'fan_out': 0, 'general_fan_out': 0}, {'cyclomatic_complexity': 4, 'nloc': 10, 'token_count': 48, 'name': 'IsHidden', 'long_name': 'IsHidden path string', 'start_line': 179, 'end_line': 188, 'full_parameters': ['path string'], 'filename': '/home/dimi/Documents/Informatik_Studium/FSS/SoftEvo/DataCollection/FFS_SoftEvo/go-ipfs/cmd/ipfswatch/main.go', 'top_nesting_level': 0, 'length': 10, 'fan_in': 0, 'fan_out': 0, 'general_fan_out': 0}, {'cyclomatic_complexity': 1, 'nloc': 3, 'token_count': 23, 'name': '', 'long_name': '(path string)(*config.Config,error)', 'start_line': 194, 'end_line': 196, 'full_parameters': [], 'filename': '/home/dimi/Documents/Informatik_Studium/FSS/SoftEvo/DataCollection/FFS_SoftEvo/go-ipfs/cmd/ipfswatch/main.go', 'top_nesting_level': 0, 'length': 3, 'fan_in': 0, 'fan_out': 0, 'general_fan_out': 0}, {'cyclomatic_complexity': 1, 'nloc': 3, 'token_count': 17, 'name': '', 'long_name': '()(*core.IpfsNode,error)', 'start_line': 197, 'end_line': 199, 'full_parameters': [], 'filename': '/home/dimi/Documents/Informatik_Studium/FSS/SoftEvo/DataCollection/FFS_SoftEvo/go-ipfs/cmd/ipfswatch/main.go', 'top_nesting_level': 0, 'length': 3, 'fan_in': 0, 'fan_out': 0, 'general_fan_out': 0}, {'cyclomatic_complexity': 1, 'nloc': 8, 'token_count': 39, 'name': 'cmdCtx', 'long_name': 'cmdCtx node * core . IpfsNode , repoPath string', 'start_line': 190, 'end_line': 201, 'full_parameters': ['node * core . IpfsNode', ' repoPath string'], 'filename': '/home/dimi/Documents/Informatik_Studium/FSS/SoftEvo/DataCollection/FFS_SoftEvo/go-ipfs/cmd/ipfswatch/main.go', 'top_nesting_level': 0, 'length': 12, 'fan_in': 0, 'fan_out': 0, 'general_fan_out': 0}]",192,980,10,"[{'cyclomatic_complexity': 4, 'nloc': 16, 'token_count': 74, 'name': 'main', 'long_name': 'main', 'start_line': 31, 'end_line': 52, 'full_parameters': [], 'filename': '/home/dimi/Documents/Informatik_Studium/FSS/SoftEvo/DataCollection/FFS_SoftEvo/go-ipfs/cmd/ipfswatch/main.go', 'top_nesting_level': 0, 'length': 22, 'fan_in': 0, 'fan_out': 0, 'general_fan_out': 0}, {'cyclomatic_complexity': 2, 'nloc': 5, 'token_count': 30, 'name': '', 'long_name': '(p process.Process)', 'start_line': 101, 'end_line': 105, 'full_parameters': [], 'filename': '/home/dimi/Documents/Informatik_Studium/FSS/SoftEvo/DataCollection/FFS_SoftEvo/go-ipfs/cmd/ipfswatch/main.go', 'top_nesting_level': 0, 'length': 5, 'fan_in': 0, 'fan_out': 0, 'general_fan_out': 0}, {'cyclomatic_complexity': 5, 'nloc': 23, 'token_count': 135, 'name': '', 'long_name': '(p process.Process)', 'start_line': 139, 'end_line': 164, 'full_parameters': [], 'filename': '/home/dimi/Documents/Informatik_Studium/FSS/SoftEvo/DataCollection/FFS_SoftEvo/go-ipfs/cmd/ipfswatch/main.go', 'top_nesting_level': 0, 'length': 26, 'fan_in': 0, 'fan_out': 0, 'general_fan_out': 0}, {'cyclomatic_complexity': 19, 'nloc': 75, 'token_count': 384, 'name': 'run', 'long_name': 'run ipfsPath , watchPath string', 'start_line': 54, 'end_line': 170, 'full_parameters': ['ipfsPath', ' watchPath string'], 'filename': '/home/dimi/Documents/Informatik_Studium/FSS/SoftEvo/DataCollection/FFS_SoftEvo/go-ipfs/cmd/ipfswatch/main.go', 'top_nesting_level': 0, 'length': 117, 'fan_in': 0, 'fan_out': 0, 'general_fan_out': 0}, {'cyclomatic_complexity': 7, 'nloc': 24, 'token_count': 105, 'name': 'error', 'long_name': '(path string,info os.FileInfo,err error)error', 'start_line': 173, 'end_line': 196, 'full_parameters': [], 'filename': '/home/dimi/Documents/Informatik_Studium/FSS/SoftEvo/DataCollection/FFS_SoftEvo/go-ipfs/cmd/ipfswatch/main.go', 'top_nesting_level': 0, 'length': 24, 'fan_in': 0, 'fan_out': 0, 'general_fan_out': 0}, {'cyclomatic_complexity': 1, 'nloc': 4, 'token_count': 31, 'name': 'IsDirectory', 'long_name': 'IsDirectory path string', 'start_line': 200, 'end_line': 203, 'full_parameters': ['path string'], 'filename': '/home/dimi/Documents/Informatik_Studium/FSS/SoftEvo/DataCollection/FFS_SoftEvo/go-ipfs/cmd/ipfswatch/main.go', 'top_nesting_level': 0, 'length': 4, 'fan_in': 0, 'fan_out': 0, 'general_fan_out': 0}, {'cyclomatic_complexity': 4, 'nloc': 10, 'token_count': 48, 'name': 'IsHidden', 'long_name': 'IsHidden path string', 'start_line': 205, 'end_line': 214, 'full_parameters': ['path string'], 'filename': '/home/dimi/Documents/Informatik_Studium/FSS/SoftEvo/DataCollection/FFS_SoftEvo/go-ipfs/cmd/ipfswatch/main.go', 'top_nesting_level': 0, 'length': 10, 'fan_in': 0, 'fan_out': 0, 'general_fan_out': 0}, {'cyclomatic_complexity': 1, 'nloc': 3, 'token_count': 23, 'name': '', 'long_name': '(path string)(*config.Config,error)', 'start_line': 219, 'end_line': 221, 'full_parameters': [], 'filename': '/home/dimi/Documents/Informatik_Studium/FSS/SoftEvo/DataCollection/FFS_SoftEvo/go-ipfs/cmd/ipfswatch/main.go', 'top_nesting_level': 0, 'length': 3, 'fan_in': 0, 'fan_out': 0, 'general_fan_out': 0}, {'cyclomatic_complexity': 1, 'nloc': 3, 'token_count': 17, 'name': '', 'long_name': '()(*core.IpfsNode,error)', 'start_line': 222, 'end_line': 224, 'full_parameters': [], 'filename': '/home/dimi/Documents/Informatik_Studium/FSS/SoftEvo/DataCollection/FFS_SoftEvo/go-ipfs/cmd/ipfswatch/main.go', 'top_nesting_level': 0, 'length': 3, 'fan_in': 0, 'fan_out': 0, 'general_fan_out': 0}, {'cyclomatic_complexity': 1, 'nloc': 7, 'token_count': 35, 'name': 'cmdCtx', 'long_name': 'cmdCtx node * core . IpfsNode , repoPath string', 'start_line': 216, 'end_line': 226, 'full_parameters': ['node * core . IpfsNode', ' repoPath string'], 'filename': '/home/dimi/Documents/Informatik_Studium/FSS/SoftEvo/DataCollection/FFS_SoftEvo/go-ipfs/cmd/ipfswatch/main.go', 'top_nesting_level': 0, 'length': 11, 'fan_in': 0, 'fan_out': 0, 'general_fan_out': 0}]",21,103,0,43,43,"[{'timestamp': 1491058697.0, 'added_lines': 1, 'deleted_lines': 2, 'nloc': 171}, {'timestamp': 1508770239.0, 'added_lines': 1, 'deleted_lines': 1, 'nloc': 171}, {'timestamp': 1509016767.0, 'added_lines': 1, 'deleted_lines': 1, 'nloc': 171}, {'timestamp': 1511223906.0, 'added_lines': 1, 'deleted_lines': 1, 'nloc': 171}, {'timestamp': 1511373659.0, 'added_lines': 1, 'deleted_lines': 1, 'nloc': 171}, {'timestamp': 1512365669.0, 'added_lines': 1, 'deleted_lines': 1, 'nloc': 171}, {'timestamp': 1511187070.0, 'added_lines': 1, 'deleted_lines': 0, 'nloc': 172}, {'timestamp': 1512058290.0, 'added_lines': 0, 'deleted_lines': 1, 'nloc': 171}, {'timestamp': 1513788060.0, 'added_lines': 2, 'deleted_lines': 2, 'nloc': 171}, {'timestamp': 1513791994.0, 'added_lines': 2, 'deleted_lines': 2, 'nloc': 171}, {'timestamp': 1528006520.0, 'added_lines': 1, 'deleted_lines': 1, 'nloc': 171}, {'timestamp': 1528520460.0, 'added_lines': 1, 'deleted_lines': 1, 'nloc': 171}, {'timestamp': 1532357069.0, 'added_lines': 1, 'deleted_lines': 1, 'nloc': 171}, {'timestamp': 1532365899.0, 'added_lines': 1, 'deleted_lines': 1, 'nloc': 171}, {'timestamp': 1532388583.0, 'added_lines': 1, 'deleted_lines': 1, 'nloc': 171}, {'timestamp': 1533809170.0, 'added_lines': 1, 'deleted_lines': 1, 'nloc': 171}, {'timestamp': 1534072974.0, 'added_lines': 1, 'deleted_lines': 1, 'nloc': 171}, {'timestamp': 1534896611.0, 'added_lines': 1, 'deleted_lines': 1, 'nloc': 171}, {'timestamp': 1535255498.0, 'added_lines': 1, 'deleted_lines': 1, 'nloc': 171}, {'timestamp': 1535601896.0, 'added_lines': 1, 'deleted_lines': 1, 'nloc': 171}, {'timestamp': 1536388808.0, 'added_lines': 1, 'deleted_lines': 1, 'nloc': 171}, {'timestamp': 1536357700.0, 'added_lines': 2, 'deleted_lines': 3, 'nloc': 171}, {'timestamp': 1537792589.0, 'added_lines': 1, 'deleted_lines': 1, 'nloc': 171}, {'timestamp': 1538544957.0, 'added_lines': 1, 'deleted_lines': 1, 'nloc': 171}, {'timestamp': 1538547366.0, 'added_lines': 1, 'deleted_lines': 1, 'nloc': 171}, {'timestamp': 1540400358.0, 'added_lines': 1, 'deleted_lines': 1, 'nloc': 171}, {'timestamp': 1540489644.0, 'added_lines': 1, 'deleted_lines': 1, 'nloc': 171}, {'timestamp': 1541204121.0, 'added_lines': 1, 'deleted_lines': 1, 'nloc': 171}, {'timestamp': 1543282933.0, 'added_lines': 1, 'deleted_lines': 1, 'nloc': 171}, {'timestamp': 1544225843.0, 'added_lines': 1, 'deleted_lines': 1, 'nloc': 171}, {'timestamp': 1545323704.0, 'added_lines': 1, 'deleted_lines': 1, 'nloc': 171}, {'timestamp': 1546553605.0, 'added_lines': 1, 'deleted_lines': 1, 'nloc': 171}, {'timestamp': 1547003974.0, 'added_lines': 1, 'deleted_lines': 1, 'nloc': 171}, {'timestamp': 1548165641.0, 'added_lines': 22, 'deleted_lines': 2, 'nloc': 187}, {'timestamp': 1548866534.0, 'added_lines': 1, 'deleted_lines': 1, 'nloc': 187}, {'timestamp': 1549588289.0, 'added_lines': 1, 'deleted_lines': 1, 'nloc': 187}, {'timestamp': 1549903582.0, 'added_lines': 1, 'deleted_lines': 1, 'nloc': 187}, {'timestamp': 1550507829.0, 'added_lines': 1, 'deleted_lines': 1, 'nloc': 187}, {'timestamp': 1551229859.0, 'added_lines': 1, 'deleted_lines': 1, 'nloc': 187}, {'timestamp': 1551754061.0, 'added_lines': 0, 'deleted_lines': 1, 'nloc': 186}, {'timestamp': 1551551196.0, 'added_lines': 5, 'deleted_lines': 5, 'nloc': 186}, {'timestamp': 1553697989.0, 'added_lines': 8, 'deleted_lines': 2, 'nloc': 192}, {'timestamp': 1600726105.0, 'added_lines': 2, 'deleted_lines': 0, 'nloc': 192}]","{'blocks/blockstore/caching.go': 1, 'blocks/blockstore/util/remove.go': 2, 'cmd/ipfs/daemon.go': 22, 'cmd/ipfs/init.go': 32, 'cmd/ipfs/ipfs.go': 15, 'cmd/ipfs/main.go': 36, 'cmd/ipfs/main_test.go': 4, 'cmd/seccat/seccat.go': 19, None: 41, 'commands/channelmarshaler.go': 1, 'commands/cli/cmd_suggestion.go': 1, 'commands/cli/helptext.go': 2, 'commands/cli/helptext_test.go': 2, 'commands/cli/parse.go': 2, 'commands/cli/parse_test.go': 2, 'commands/command.go': 8, 'commands/command_test.go': 4, 'commands/http/client.go': 2, 'commands/http/handler.go': 2, 'commands/http/multifilereader.go': 2, 'commands/http/multifilereader_test.go': 2, 'commands/http/parse.go': 2, 'commands/reqlog.go': 2, 'commands/request.go': 21, 'commands/response.go': 6, 'commands/response_test.go': 4, 'core/bootstrap.go': 28, 'core/commands/active.go': 10, 'core/commands/add.go': 22, 'core/commands/bitswap.go': 24, 'core/commands/block.go': 16, 'core/commands/bootstrap.go': 31, 'core/commands/cat.go': 16, 'core/commands/commands.go': 16, 'core/commands/config.go': 33, 'core/commands/dag/dag.go': 21, 'core/commands/dht.go': 20, 'core/commands/diag.go': 10, 'core/commands/dns.go': 12, 'core/commands/e/error.go': 1, 'core/commands/external.go': 11, 'core/commands/files/files.go': 5, 'core/commands/filestore.go': 15, 'core/commands/get.go': 24, 'core/commands/helptext_test.go': 15, 'core/commands/id.go': 21, 'core/commands/ipns.go': 6, 'core/commands/keystore.go': 13, 'core/commands/log.go': 12, 'core/commands/ls.go': 19, 'core/commands/mount_nofuse.go': 10, 'core/commands/mount_unix.go': 31, 'core/commands/mount_windows.go': 9, 'core/commands/name.go': 6, 'core/commands/object/diff.go': 12, 'core/commands/object/object.go': 20, 'core/commands/object/patch.go': 13, 'core/commands/p2p.go': 19, 'core/commands/pin.go': 21, 'core/commands/ping.go': 19, 'core/commands/publish.go': 6, 'core/commands/pubsub.go': 19, 'core/commands/refs.go': 20, 'core/commands/repo.go': 35, 'core/commands/resolve.go': 20, 'core/commands/root.go': 15, 'core/commands/shutdown.go': 12, 'core/commands/stat.go': 20, 'core/commands/swarm.go': 32, 'core/commands/sysdiag.go': 16, 'core/commands/tar.go': 20, 'core/commands/unixfs/ls.go': 20, 'core/commands/unixfs/unixfs.go': 10, 'core/commands/version.go': 13, 'core/core_test.go': 24, 'core/corehttp/commands.go': 36, 'core/corehttp/gateway.go': 20, 'core/coreunix/add.go': 21, 'core/coreunix/add_test.go': 32, 'core/coreunix/metadata_test.go': 19, 'exchange/bitswap/bitswap_test.go': 5, 'exchange/bitswap/decision/engine_test.go': 4, 'exchange/bitswap/message/message_test.go': 3, 'exchange/bitswap/message/pb/Makefile': 1, 'exchange/bitswap/testnet/network_test.go': 4, 'exchange/bitswap/testnet/peernet.go': 4, 'exchange/reprovide/reprovide_test.go': 18, 'fuse/ipns/common.go': 16, 'fuse/node/mount_test.go': 18, 'importer/balanced/balanced_test.go': 3, 'importer/chunk/rabin_test.go': 2, 'importer/helpers/dagbuilder.go': 5, 'importer/importer.go': 5, 'merkledag/utils/utils_test.go': 3, 'mfs/repub_test.go': 4, 'namesys/dns.go': 15, 'namesys/interface.go': 15, 'namesys/ipns_select_test.go': 3, 'namesys/proquint.go': 15, 'namesys/republisher/repub_test.go': 19, 'package.json': 35, 'repo/config/identity.go': 1, 'routing/offline/offline_test.go': 4, 'test/integration/addcat_test.go': 22, 'test/integration/bench_cat_test.go': 21, 'test/integration/bitswap_wo_routing_test.go': 18, 'test/integration/three_legged_cat_test.go': 21, 'test/sharness/t0600-issues-and-regressions-online.sh': 1, 'core/bootstrap_test.go': 26, 'core/commands/dht_test.go': 15, 'core/commands/get_test.go': 12, 'core/core.go': 30, 'core/corehttp/gateway_test.go': 30, 'core/corehttp/metrics_test.go': 16, 'core/mock/mock.go': 27, 'exchange/bitswap/decision/bench_test.go': 3, 'exchange/bitswap/decision/peer_request_queue_test.go': 3, 'exchange/bitswap/message/message.go': 3, 'exchange/bitswap/network/interface.go': 3, 'exchange/bitswap/network/ipfs_impl.go': 3, 'exchange/bitswap/testnet/interface.go': 3, 'exchange/bitswap/testnet/virtual.go': 3, 'exchange/bitswap/testutils.go': 3, 'fuse/ipns/ipns_test.go': 19, 'fuse/readonly/ipfs_test.go': 21, 'namesys/publisher_test.go': 16, 'namesys/resolve_test.go': 16, 'p2p/p2p.go': 16, 'p2p/registry.go': 6, 'repo/config/bootstrap_peers.go': 3, 'routing/mock/centralized_client.go': 2, 'routing/mock/centralized_server.go': 2, 'routing/mock/centralized_test.go': 2, 'routing/mock/interface.go': 2, 'routing/none/none_client.go': 2, 'test/integration/bench_test.go': 13, 'assets/assets.go': 17, 'blocks/blockstore/arc_cache.go': 1, 'blocks/blockstore/arc_cache_test.go': 1, 'blocks/blockstore/blockstore.go': 1, 'blocks/blockstore/blockstore_test.go': 1, 'blocks/blockstore/bloom_cache.go': 1, 'blocks/blockstore/bloom_cache_test.go': 1, 'blocks/blocksutil/block_generator.go': 1, 'blockservice/blockservice.go': 2, 'blockservice/blockservice_test.go': 2, 'blockservice/test/blocks_test.go': 2, 'core/builder.go': 29, 'core/commands/ipnsps.go': 4, 'core/coreapi/coreapi.go': 11, 'core/coreapi/interface/interface.go': 1, 'core/coreapi/unixfs.go': 17, 'core/coreapi/unixfs_test.go': 19, 'core/coredag/cbor.go': 6, 'core/coredag/dagpb.go': 15, 'core/coredag/dagtransl.go': 5, 'core/coredag/raw.go': 15, 'core/corehttp/corehttp.go': 9, 'core/corehttp/gateway_handler.go': 17, 'core/corerepo/gc.go': 18, 'core/corerepo/pinning.go': 7, 'core/coreunix/metadata.go': 17, 'core/pathresolver.go': 15, 'exchange/bitswap/bitswap.go': 2, 'exchange/bitswap/decision/engine.go': 2, 'exchange/bitswap/decision/ledger.go': 2, 'exchange/bitswap/decision/peer_request_queue.go': 2, 'exchange/bitswap/get.go': 2, 'exchange/bitswap/notifications/notifications.go': 2, 'exchange/bitswap/notifications/notifications_test.go': 2, 'exchange/bitswap/session.go': 2, 'exchange/bitswap/session_test.go': 2, 'exchange/bitswap/stat.go': 2, 'exchange/bitswap/wantlist/wantlist.go': 2, 'exchange/bitswap/wantlist/wantlist_test.go': 2, 'exchange/bitswap/wantmanager.go': 2, 'exchange/bitswap/workers.go': 2, 'exchange/interface.go': 1, 'exchange/offline/offline.go': 1, 'exchange/offline/offline_test.go': 1, 'exchange/reprovide/providers.go': 15, 'exchange/reprovide/reprovide.go': 14, 'filestore/filestore.go': 9, 'filestore/filestore_test.go': 15, 'filestore/fsrefstore.go': 9, 'filestore/util.go': 9, 'fuse/ipns/ipns_unix.go': 19, 'fuse/readonly/readonly_unix.go': 18, 'importer/balanced/builder.go': 2, 'importer/chunk/splitting_test.go': 1, 'importer/helpers/helpers.go': 2, 'importer/importer_test.go': 2, 'importer/trickle/trickle_test.go': 2, 'importer/trickle/trickledag.go': 2, 'merkledag/batch.go': 1, 'merkledag/coding.go': 2, 'merkledag/merkledag.go': 2, 'merkledag/merkledag_test.go': 2, 'merkledag/node.go': 2, 'merkledag/node_test.go': 2, 'merkledag/raw.go': 2, 'merkledag/traverse/traverse.go': 2, 'merkledag/traverse/traverse_test.go': 2, 'merkledag/utils/diff.go': 2, 'merkledag/utils/diffenum.go': 2, 'merkledag/utils/diffenum_test.go': 2, 'merkledag/utils/utils.go': 2, 'mfs/dir.go': 2, 'mfs/file.go': 2, 'mfs/mfs_test.go': 2, 'mfs/ops.go': 2, 'mfs/system.go': 2, 'namesys/namesys.go': 17, 'namesys/publisher.go': 17, 'namesys/pubsub.go': 1, 'namesys/pubsub_test.go': 1, 'namesys/republisher/repub.go': 15, 'namesys/routing.go': 17, 'path/path.go': 2, 'path/resolver.go': 1, 'path/resolver_test.go': 1, 'pin/gc/gc.go': 15, 'pin/pin.go': 15, 'pin/pin_test.go': 16, 'pin/set.go': 15, 'pin/set_test.go': 15, 'plugin/ipld.go': 5, 'plugin/loader/initializer.go': 4, 'plugin/plugins/git/git.go': 5, 'repo/config/init.go': 2, 'repo/fsrepo/fsrepo.go': 27, 'repo/fsrepo/lock/lock.go': 1, 'repo/fsrepo/serialize/serialize.go': 2, 'repo/mock.go': 26, 'repo/repo.go': 26, 'routing/offline/offline.go': 1, 'tar/format.go': 17, 'test/dependencies/ma-pipe-unidir/main.go': 8, 'thirdparty/ds-help/key.go': 1, 'thirdparty/pollEndpoint/main.go': 9, 'thirdparty/posinfo/posinfo.go': 1, 'unixfs/archive/archive.go': 2, 'unixfs/archive/tar/writer.go': 2, 'unixfs/hamt/hamt.go': 2, 'unixfs/io/dagreader.go': 2, 'unixfs/io/dirbuilder.go': 2, 'unixfs/io/resolve.go': 2, 'unixfs/mod/dagmodifier.go': 2, 'unixfs/mod/dagmodifier_test.go': 2, 'unixfs/test/utils.go': 2, 'commands/legacy/command.go': 5, 'commands/legacy/legacy.go': 5, 'commands/legacy/legacy_test.go': 5, 'commands/legacy/request.go': 5, 'commands/legacy/response.go': 5, 'commands/legacy/responseemitter.go': 1, 'core/commands/env.go': 7, 'fuse/ipns/link_unix.go': 4, 'fuse/mount/fuse.go': 5, 'blocks/blockstoreutil/remove.go': 8, 'blockservice/test/mock.go': 1, 'cmd/ipfs/util/ulimit.go': 5, 'cmd/ipfs/util/ulimit_freebsd.go': 2, 'cmd/ipfs/util/ulimit_unix.go': 2, 'cmd/seccat/util.go': 5, 'core/commands/commands_test.go': 8, 'core/commands/files.go': 17, 'core/coreapi/block.go': 7, 'core/coreapi/block_test.go': 2, 'core/coreapi/dag.go': 4, 'core/coreapi/dag_test.go': 2, 'core/coreapi/interface/coreapi.go': 3, 'core/coreapi/interface/dag.go': 3, 'core/coreapi/interface/object.go': 3, 'core/coreapi/interface/options/block.go': 2, 'core/coreapi/interface/options/dag.go': 3, 'core/coreapi/interface/path.go': 11, 'core/coreapi/interface/unixfs.go': 5, 'core/coreapi/key.go': 15, 'core/coreapi/name.go': 15, 'core/coreapi/object.go': 16, 'core/coreapi/pin.go': 15, 'core/corehttp/logs.go': 5, 'fuse/mount/mount.go': 5, 'fuse/node/mount_darwin.go': 2, 'fuse/node/mount_unix.go': 7, 'keystore/keystore.go': 5, 'merkledag/errservice.go': 1, 'merkledag/readonly.go': 1, 'merkledag/readonly_test.go': 1, 'merkledag/rwservice.go': 1, 'merkledag/session.go': 1, 'merkledag/test/utils.go': 1, 'namesys/ipns_validate_test.go': 1, 'namesys/namesys_test.go': 17, 'namesys/validator.go': 1, 'path/resolver/resolver.go': 1, 'path/resolver/resolver_test.go': 1, 'plugin/loader/load.go': 3, 'repo/fsrepo/datastores.go': 7, 'thirdparty/verifbs/verifbs.go': 8, 'thirdparty/verifcid/validate.go': 1, 'thirdparty/verifcid/validate_test.go': 1, 'unixfs/hamt/hamt_stress_test.go': 1, 'unixfs/hamt/hamt_test.go': 1, 'unixfs/io/pbdagreader.go': 1, 'repo/fsrepo/misc.go': 25, 'cmd/ipfs/Rules.mk': 2, 'core/corehttp/option_test.go': 2, 'docs/releases.md': 1, 'docs/windows.md': 1, 'repo/fsrepo/config_test.go': 23, 'repo/fsrepo/fsrepo_test.go': 23, 'repo/version.go': 1, 'test/bench/bench_cli_ipfs_add/main.go': 25, 'test/bench/offline_add/main.go': 25, 'core/commands/urlstore.go': 15, 'core/coreapi/interface/key.go': 6, 'core/coreapi/name_test.go': 8, 'core/coreapi/path.go': 15, 'core/coreunix/cat.go': 4, 'core/pathresolver_test.go': 13, 'dagutils/diff.go': 15, 'dagutils/diffenum.go': 13, 'dagutils/diffenum_test.go': 13, 'dagutils/utils.go': 14, 'dagutils/utils_test.go': 13, 'namesys/base.go': 14, 'namesys/cache.go': 13, 'namesys/ipns_resolver_validation_test.go': 14, 'thirdparty/cidv0v1/blockstore.go': 7, 'core/commands/cmdenv/env.go': 20, 'core/commands/name/ipns.go': 14, 'core/commands/name/publish.go': 10, 'coverage/Rules.mk': 1, 'mk/golang.mk': 1, 'pin/internal/pb/doc.go': 1, 'test/3nodetest/Makefile': 1, 'test/bin/Rules.mk': 1, 'test/bin/verify-go-fmt.sh': 1, 'core/commands/name/ipnsps.go': 10, 'core/commands/name/name.go': 6, 'core/coreapi/dht.go': 11, 'core/coreapi/dht_test.go': 4, 'core/coreapi/interface/dht.go': 7, 'p2p/listener.go': 10, 'p2p/local.go': 10, 'p2p/remote.go': 11, 'p2p/stream.go': 11, 'core/coreapi/interface/swarm.go': 6, 'core/coreapi/swarm.go': 11, 'cmd/ipfs/dnsresolve_test.go': 5, 'core/coreapi/interface/options/unixfs.go': 5, 'core/coreapi/interface/pubsub.go': 4, 'core/coreapi/pubsub.go': 11, 'core/coreapi/unixfile.go': 4, 'test/sharness/t0180-pubsub.sh': 1, 'core/commands/cid.go': 6, 'keystore/keystore_test.go': 4, 'keystore/memkeystore.go': 3, 'test/dependencies/iptb/iptb.go': 10, 'commands/context.go': 11, 'core/corehttp/proxy.go': 6, 'core/coreapi/test/api_test.go': 7, 'core/coreapi/interface/tests/name.go': 3, 'core/coreapi/interface/tests/unixfs.go': 3, 'core/commands/cmdenv/cidbase.go': 4, 'core/commands/cmdenv/file.go': 3, 'core/corehttp/ipns_hostname.go': 4, 'namesys/dns_test.go': 4, 'plugin/daemon.go': 4, 'plugin/loader/loader.go': 5, 'filestore/pb/dataobj.pb.go': 2, 'pin/internal/pb/header.pb.go': 2, 'plugin/plugins/badgerds/badgerds.go': 2, 'plugin/plugins/flatfs/flatfs.go': 2, 'plugin/plugins/levelds/levelds.go': 2, 'core/commands/cmdenv/cidbase_test.go': 1, 'core/corehttp/metrics.go': 1, 'core/corehttp/proxy_test.go': 1, 'core/corerepo/stat.go': 1, 'plugin/tracer.go': 1, 'thirdparty/notifier/notifier.go': 1, 'core/corehttp/mutex_profile.go': 1, 'provider/queue.go': 1, 'provider/queue_test.go': 1, 'cmd/ipfs/util/ulimit_test.go': 1, 'cmd/ipfswatch/ipfswatch_test.go': 1, 'cmd/seccat/seccat_plan9.go': 1, 'cmd/seccat/seccat_posix.go': 1, 'fuse/node/mount_notsupp.go': 1, 'go.mod': 1, 'go.sum': 1}","('cmd/ipfs/main.go', 0.8372093023255814, 0.34285714285714286)"
commands/reqlog.go,94,541,8,"[{'cyclomatic_complexity': 1, 'nloc': 10, 'token_count': 62, 'name': 'Finish', 'long_name': '(r*ReqLogEntry)Finish', 'start_line': 22, 'end_line': 35, 'full_parameters': [], 'filename': '/home/dimi/Documents/Informatik_Studium/FSS/SoftEvo/DataCollection/FFS_SoftEvo/go-ipfs/commands/reqlog.go', 'top_nesting_level': 0, 'length': 14, 'fan_in': 0, 'fan_out': 0, 'general_fan_out': 0}, {'cyclomatic_complexity': 1, 'nloc': 5, 'token_count': 25, 'name': 'Copy', 'long_name': '(r*ReqLogEntry)Copy', 'start_line': 37, 'end_line': 41, 'full_parameters': [], 'filename': '/home/dimi/Documents/Informatik_Studium/FSS/SoftEvo/DataCollection/FFS_SoftEvo/go-ipfs/commands/reqlog.go', 'top_nesting_level': 0, 'length': 5, 'fan_in': 0, 'fan_out': 0, 'general_fan_out': 0}, {'cyclomatic_complexity': 1, 'nloc': 17, 'token_count': 111, 'name': 'Add', 'long_name': '(rl*ReqLog)Add req Request', 'start_line': 50, 'end_line': 68, 'full_parameters': ['req Request'], 'filename': '/home/dimi/Documents/Informatik_Studium/FSS/SoftEvo/DataCollection/FFS_SoftEvo/go-ipfs/commands/reqlog.go', 'top_nesting_level': 0, 'length': 19, 'fan_in': 0, 'fan_out': 0, 'general_fan_out': 0}, {'cyclomatic_complexity': 1, 'nloc': 8, 'token_count': 46, 'name': 'ClearInactive', 'long_name': '(rl*ReqLog)ClearInactive', 'start_line': 70, 'end_line': 77, 'full_parameters': [], 'filename': '/home/dimi/Documents/Informatik_Studium/FSS/SoftEvo/DataCollection/FFS_SoftEvo/go-ipfs/commands/reqlog.go', 'top_nesting_level': 0, 'length': 8, 'fan_in': 0, 'fan_out': 0, 'general_fan_out': 0}, {'cyclomatic_complexity': 2, 'nloc': 5, 'token_count': 29, 'name': 'maybeCleanup', 'long_name': '(rl*ReqLog)maybeCleanup', 'start_line': 79, 'end_line': 85, 'full_parameters': [], 'filename': '/home/dimi/Documents/Informatik_Studium/FSS/SoftEvo/DataCollection/FFS_SoftEvo/go-ipfs/commands/reqlog.go', 'top_nesting_level': 0, 'length': 7, 'fan_in': 0, 'fan_out': 0, 'general_fan_out': 0}, {'cyclomatic_complexity': 4, 'nloc': 12, 'token_count': 100, 'name': 'cleanup', 'long_name': '(rl*ReqLog)cleanup', 'start_line': 87, 'end_line': 98, 'full_parameters': [], 'filename': '/home/dimi/Documents/Informatik_Studium/FSS/SoftEvo/DataCollection/FFS_SoftEvo/go-ipfs/commands/reqlog.go', 'top_nesting_level': 0, 'length': 12, 'fan_in': 0, 'fan_out': 0, 'general_fan_out': 0}, {'cyclomatic_complexity': 1, 'nloc': 5, 'token_count': 35, 'name': 'SetKeepTime', 'long_name': '(rl*ReqLog)SetKeepTime t time . Duration', 'start_line': 100, 'end_line': 104, 'full_parameters': ['t time . Duration'], 'filename': '/home/dimi/Documents/Informatik_Studium/FSS/SoftEvo/DataCollection/FFS_SoftEvo/go-ipfs/commands/reqlog.go', 'top_nesting_level': 0, 'length': 5, 'fan_in': 0, 'fan_out': 0, 'general_fan_out': 0}, {'cyclomatic_complexity': 2, 'nloc': 9, 'token_count': 69, 'name': 'Report', 'long_name': '(rl*ReqLog)Report', 'start_line': 107, 'end_line': 117, 'full_parameters': [], 'filename': '/home/dimi/Documents/Informatik_Studium/FSS/SoftEvo/DataCollection/FFS_SoftEvo/go-ipfs/commands/reqlog.go', 'top_nesting_level': 0, 'length': 11, 'fan_in': 0, 'fan_out': 0, 'general_fan_out': 0}]",82,481,8,"[{'cyclomatic_complexity': 1, 'nloc': 5, 'token_count': 25, 'name': 'Copy', 'long_name': '(r*ReqLogEntry)Copy', 'start_line': 22, 'end_line': 26, 'full_parameters': [], 'filename': '/home/dimi/Documents/Informatik_Studium/FSS/SoftEvo/DataCollection/FFS_SoftEvo/go-ipfs/commands/reqlog.go', 'top_nesting_level': 0, 'length': 5, 'fan_in': 0, 'fan_out': 0, 'general_fan_out': 0}, {'cyclomatic_complexity': 3, 'nloc': 10, 'token_count': 68, 'name': 'AddEntry', 'long_name': '(rl*ReqLog)AddEntry rle * ReqLogEntry', 'start_line': 37, 'end_line': 48, 'full_parameters': ['rle * ReqLogEntry'], 'filename': '/home/dimi/Documents/Informatik_Studium/FSS/SoftEvo/DataCollection/FFS_SoftEvo/go-ipfs/commands/reqlog.go', 'top_nesting_level': 0, 'length': 12, 'fan_in': 0, 'fan_out': 0, 'general_fan_out': 0}, {'cyclomatic_complexity': 1, 'nloc': 8, 'token_count': 46, 'name': 'ClearInactive', 'long_name': '(rl*ReqLog)ClearInactive', 'start_line': 51, 'end_line': 59, 'full_parameters': [], 'filename': '/home/dimi/Documents/Informatik_Studium/FSS/SoftEvo/DataCollection/FFS_SoftEvo/go-ipfs/commands/reqlog.go', 'top_nesting_level': 0, 'length': 9, 'fan_in': 0, 'fan_out': 0, 'general_fan_out': 0}, {'cyclomatic_complexity': 2, 'nloc': 5, 'token_count': 29, 'name': 'maybeCleanup', 'long_name': '(rl*ReqLog)maybeCleanup', 'start_line': 61, 'end_line': 67, 'full_parameters': [], 'filename': '/home/dimi/Documents/Informatik_Studium/FSS/SoftEvo/DataCollection/FFS_SoftEvo/go-ipfs/commands/reqlog.go', 'top_nesting_level': 0, 'length': 7, 'fan_in': 0, 'fan_out': 0, 'general_fan_out': 0}, {'cyclomatic_complexity': 4, 'nloc': 12, 'token_count': 100, 'name': 'cleanup', 'long_name': '(rl*ReqLog)cleanup', 'start_line': 69, 'end_line': 80, 'full_parameters': [], 'filename': '/home/dimi/Documents/Informatik_Studium/FSS/SoftEvo/DataCollection/FFS_SoftEvo/go-ipfs/commands/reqlog.go', 'top_nesting_level': 0, 'length': 12, 'fan_in': 0, 'fan_out': 0, 'general_fan_out': 0}, {'cyclomatic_complexity': 1, 'nloc': 5, 'token_count': 35, 'name': 'SetKeepTime', 'long_name': '(rl*ReqLog)SetKeepTime t time . Duration', 'start_line': 83, 'end_line': 87, 'full_parameters': ['t time . Duration'], 'filename': '/home/dimi/Documents/Informatik_Studium/FSS/SoftEvo/DataCollection/FFS_SoftEvo/go-ipfs/commands/reqlog.go', 'top_nesting_level': 0, 'length': 5, 'fan_in': 0, 'fan_out': 0, 'general_fan_out': 0}, {'cyclomatic_complexity': 2, 'nloc': 9, 'token_count': 69, 'name': 'Report', 'long_name': '(rl*ReqLog)Report', 'start_line': 90, 'end_line': 100, 'full_parameters': [], 'filename': '/home/dimi/Documents/Informatik_Studium/FSS/SoftEvo/DataCollection/FFS_SoftEvo/go-ipfs/commands/reqlog.go', 'top_nesting_level': 0, 'length': 11, 'fan_in': 0, 'fan_out': 0, 'general_fan_out': 0}, {'cyclomatic_complexity': 1, 'nloc': 7, 'token_count': 48, 'name': 'Finish', 'long_name': '(rl*ReqLog)Finish rle * ReqLogEntry', 'start_line': 103, 'end_line': 111, 'full_parameters': ['rle * ReqLogEntry'], 'filename': '/home/dimi/Documents/Informatik_Studium/FSS/SoftEvo/DataCollection/FFS_SoftEvo/go-ipfs/commands/reqlog.go', 'top_nesting_level': 0, 'length': 9, 'fan_in': 0, 'fan_out': 0, 'general_fan_out': 0}]",-12,-60,0,4,4,"[{'timestamp': 1491058697.0, 'added_lines': 33, 'deleted_lines': 21, 'nloc': 96}, {'timestamp': 1542797887.0, 'added_lines': 0, 'deleted_lines': 17, 'nloc': 82}, {'timestamp': 1553697989.0, 'added_lines': 0, 'deleted_lines': 2, 'nloc': 81}, {'timestamp': 1614421993.0, 'added_lines': 1, 'deleted_lines': 0, 'nloc': 82}]","{'blocks/blockstore/caching.go': 1, 'blocks/blockstore/util/remove.go': 1, 'cmd/ipfs/daemon.go': 2, 'cmd/ipfs/init.go': 1, 'cmd/ipfs/ipfs.go': 1, 'cmd/ipfs/main.go': 2, 'cmd/ipfs/main_test.go': 1, 'cmd/ipfswatch/main.go': 2, 'cmd/seccat/seccat.go': 2, None: 19, 'commands/channelmarshaler.go': 1, 'commands/cli/cmd_suggestion.go': 1, 'commands/cli/helptext.go': 1, 'commands/cli/helptext_test.go': 1, 'commands/cli/parse.go': 1, 'commands/cli/parse_test.go': 1, 'commands/command.go': 1, 'commands/command_test.go': 1, 'commands/http/client.go': 1, 'commands/http/handler.go': 1, 'commands/http/multifilereader.go': 1, 'commands/http/multifilereader_test.go': 1, 'commands/http/parse.go': 1, 'commands/request.go': 1, 'commands/response.go': 1, 'commands/response_test.go': 1, 'core/bootstrap.go': 1, 'core/commands/active.go': 1, 'core/commands/add.go': 2, 'core/commands/bitswap.go': 1, 'core/commands/block.go': 1, 'core/commands/bootstrap.go': 1, 'core/commands/cat.go': 1, 'core/commands/commands.go': 2, 'core/commands/config.go': 2, 'core/commands/dag/dag.go': 1, 'core/commands/dht.go': 1, 'core/commands/diag.go': 1, 'core/commands/dns.go': 1, 'core/commands/e/error.go': 1, 'core/commands/external.go': 1, 'core/commands/files/files.go': 1, 'core/commands/filestore.go': 1, 'core/commands/get.go': 2, 'core/commands/helptext_test.go': 1, 'core/commands/id.go': 1, 'core/commands/ipns.go': 1, 'core/commands/keystore.go': 1, 'core/commands/log.go': 1, 'core/commands/ls.go': 1, 'core/commands/mount_nofuse.go': 1, 'core/commands/mount_unix.go': 1, 'core/commands/mount_windows.go': 1, 'core/commands/name.go': 1, 'core/commands/object/diff.go': 1, 'core/commands/object/object.go': 1, 'core/commands/object/patch.go': 1, 'core/commands/p2p.go': 2, 'core/commands/pin.go': 1, 'core/commands/ping.go': 1, 'core/commands/publish.go': 1, 'core/commands/pubsub.go': 1, 'core/commands/refs.go': 1, 'core/commands/repo.go': 2, 'core/commands/resolve.go': 1, 'core/commands/root.go': 1, 'core/commands/shutdown.go': 1, 'core/commands/stat.go': 1, 'core/commands/swarm.go': 2, 'core/commands/sysdiag.go': 1, 'core/commands/tar.go': 1, 'core/commands/unixfs/ls.go': 1, 'core/commands/unixfs/unixfs.go': 1, 'core/commands/version.go': 1, 'core/core_test.go': 1, 'core/corehttp/commands.go': 1, 'core/corehttp/gateway.go': 1, 'core/coreunix/add.go': 1, 'core/coreunix/add_test.go': 2, 'core/coreunix/metadata_test.go': 2, 'exchange/bitswap/bitswap_test.go': 1, 'exchange/bitswap/decision/engine_test.go': 1, 'exchange/bitswap/message/message_test.go': 1, 'exchange/bitswap/message/pb/Makefile': 1, 'exchange/bitswap/testnet/network_test.go': 1, 'exchange/bitswap/testnet/peernet.go': 1, 'exchange/reprovide/reprovide_test.go': 2, 'fuse/ipns/common.go': 1, 'fuse/node/mount_test.go': 1, 'importer/balanced/balanced_test.go': 1, 'importer/chunk/rabin_test.go': 1, 'importer/helpers/dagbuilder.go': 1, 'importer/importer.go': 1, 'merkledag/utils/utils_test.go': 1, 'mfs/repub_test.go': 1, 'namesys/dns.go': 1, 'namesys/interface.go': 1, 'namesys/ipns_select_test.go': 1, 'namesys/proquint.go': 1, 'namesys/republisher/repub_test.go': 2, 'package.json': 1, 'repo/config/identity.go': 1, 'routing/offline/offline_test.go': 1, 'test/integration/addcat_test.go': 2, 'test/integration/bench_cat_test.go': 2, 'test/integration/bitswap_wo_routing_test.go': 2, 'test/integration/three_legged_cat_test.go': 2, 'commands/context.go': 2, 'core/commands/cmdenv/env.go': 1, 'core/builder.go': 1, 'core/commands/cid.go': 1, 'core/commands/files.go': 1, 'core/core.go': 1, 'core/coreapi/pubsub.go': 1, 'core/coreapi/swarm.go': 1, 'core/corehttp/gateway_test.go': 1, 'core/corehttp/mutex_profile.go': 1, 'core/corehttp/option_test.go': 1, 'core/corerepo/gc.go': 1, 'dagutils/diff.go': 1, 'dagutils/utils.go': 1, 'fuse/ipns/ipns_test.go': 1, 'fuse/mount/fuse.go': 1, 'fuse/node/mount_unix.go': 1, 'fuse/readonly/ipfs_test.go': 1, 'keystore/keystore_test.go': 1, 'namesys/namesys.go': 1, 'namesys/namesys_test.go': 1, 'namesys/routing.go': 1, 'p2p/remote.go': 1, 'p2p/stream.go': 1, 'pin/pin_test.go': 1, 'plugin/loader/loader.go': 1, 'provider/queue.go': 1, 'provider/queue_test.go': 1, 'test/bench/bench_cli_ipfs_add/main.go': 1, 'test/bench/offline_add/main.go': 1, 'test/dependencies/ma-pipe-unidir/main.go': 1}","('test/integration/addcat_test.go', 0.5, 0.0392156862745098)"
core/builder.go,184,1028,6,"[{'cyclomatic_complexity': 2, 'nloc': 6, 'token_count': 31, 'name': 'getOpt', 'long_name': '(cfg*BuildCfg)getOpt key string', 'start_line': 52, 'end_line': 58, 'full_parameters': ['key string'], 'filename': '/home/dimi/Documents/Informatik_Studium/FSS/SoftEvo/DataCollection/FFS_SoftEvo/go-ipfs/core/builder.go', 'top_nesting_level': 0, 'length': 7, 'fan_in': 0, 'fan_out': 0, 'general_fan_out': 0}, {'cyclomatic_complexity': 8, 'nloc': 24, 'token_count': 118, 'name': 'fillDefaults', 'long_name': '(cfg*BuildCfg)fillDefaults', 'start_line': 60, 'end_line': 88, 'full_parameters': [], 'filename': '/home/dimi/Documents/Informatik_Studium/FSS/SoftEvo/DataCollection/FFS_SoftEvo/go-ipfs/core/builder.go', 'top_nesting_level': 0, 'length': 29, 'fan_in': 0, 'fan_out': 0, 'general_fan_out': 0}, {'cyclomatic_complexity': 4, 'nloc': 23, 'token_count': 154, 'name': 'defaultRepo', 'long_name': 'defaultRepo dstore repo . Datastore', 'start_line': 90, 'end_line': 116, 'full_parameters': ['dstore repo . Datastore'], 'filename': '/home/dimi/Documents/Informatik_Studium/FSS/SoftEvo/DataCollection/FFS_SoftEvo/go-ipfs/core/builder.go', 'top_nesting_level': 0, 'length': 27, 'fan_in': 0, 'fan_out': 0, 'general_fan_out': 0}, {'cyclomatic_complexity': 5, 'nloc': 25, 'token_count': 142, 'name': 'NewNode', 'long_name': 'NewNode ctx context . Context , cfg * BuildCfg', 'start_line': 118, 'end_line': 148, 'full_parameters': ['ctx context . Context', ' cfg * BuildCfg'], 'filename': '/home/dimi/Documents/Informatik_Studium/FSS/SoftEvo/DataCollection/FFS_SoftEvo/go-ipfs/core/builder.go', 'top_nesting_level': 0, 'length': 31, 'fan_in': 0, 'fan_out': 0, 'general_fan_out': 0}, {'cyclomatic_complexity': 3, 'nloc': 7, 'token_count': 37, 'name': 'isTooManyFDError', 'long_name': 'isTooManyFDError err error', 'start_line': 150, 'end_line': 157, 'full_parameters': ['err error'], 'filename': '/home/dimi/Documents/Informatik_Studium/FSS/SoftEvo/DataCollection/FFS_SoftEvo/go-ipfs/core/builder.go', 'top_nesting_level': 0, 'length': 8, 'fan_in': 0, 'fan_out': 0, 'general_fan_out': 0}, {'cyclomatic_complexity': 13, 'nloc': 62, 'token_count': 473, 'name': 'setupNode', 'long_name': 'setupNode ctx context . Context , n * IpfsNode , cfg * BuildCfg', 'start_line': 159, 'end_line': 241, 'full_parameters': ['ctx context . Context', ' n * IpfsNode', ' cfg * BuildCfg'], 'filename': '/home/dimi/Documents/Informatik_Studium/FSS/SoftEvo/DataCollection/FFS_SoftEvo/go-ipfs/core/builder.go', 'top_nesting_level': 0, 'length': 83, 'fan_in': 0, 'fan_out': 0, 'general_fan_out': 0}]",63,332,6,"[{'cyclomatic_complexity': 1, 'nloc': 1, 'token_count': 19, 'name': 'Deadline', 'long_name': '(valueContext)Deadline', 'start_line': 20, 'end_line': 20, 'full_parameters': [], 'filename': '/home/dimi/Documents/Informatik_Studium/FSS/SoftEvo/DataCollection/FFS_SoftEvo/go-ipfs/core/builder.go', 'top_nesting_level': 0, 'length': 1, 'fan_in': 0, 'fan_out': 0, 'general_fan_out': 0}, {'cyclomatic_complexity': 1, 'nloc': 1, 'token_count': 13, 'name': 'Done', 'long_name': '(valueContext)Done', 'start_line': 21, 'end_line': 21, 'full_parameters': [], 'filename': '/home/dimi/Documents/Informatik_Studium/FSS/SoftEvo/DataCollection/FFS_SoftEvo/go-ipfs/core/builder.go', 'top_nesting_level': 0, 'length': 1, 'fan_in': 0, 'fan_out': 0, 'general_fan_out': 0}, {'cyclomatic_complexity': 1, 'nloc': 1, 'token_count': 12, 'name': 'Err', 'long_name': '(valueContext)Err', 'start_line': 22, 'end_line': 22, 'full_parameters': [], 'filename': '/home/dimi/Documents/Informatik_Studium/FSS/SoftEvo/DataCollection/FFS_SoftEvo/go-ipfs/core/builder.go', 'top_nesting_level': 0, 'length': 1, 'fan_in': 0, 'fan_out': 0, 'general_fan_out': 0}, {'cyclomatic_complexity': 2, 'nloc': 7, 'token_count': 34, 'name': '', 'long_name': '()', 'start_line': 51, 'end_line': 58, 'full_parameters': [], 'filename': '/home/dimi/Documents/Informatik_Studium/FSS/SoftEvo/DataCollection/FFS_SoftEvo/go-ipfs/core/builder.go', 'top_nesting_level': 0, 'length': 8, 'fan_in': 0, 'fan_out': 0, 'general_fan_out': 0}, {'cyclomatic_complexity': 1, 'nloc': 4, 'token_count': 14, 'name': 'error', 'long_name': '()error', 'start_line': 50, 'end_line': 60, 'full_parameters': [], 'filename': '/home/dimi/Documents/Informatik_Studium/FSS/SoftEvo/DataCollection/FFS_SoftEvo/go-ipfs/core/builder.go', 'top_nesting_level': 0, 'length': 11, 'fan_in': 0, 'fan_out': 0, 'general_fan_out': 0}, {'cyclomatic_complexity': 4, 'nloc': 10, 'token_count': 47, 'name': '', 'long_name': '()', 'start_line': 63, 'end_line': 75, 'full_parameters': [], 'filename': '/home/dimi/Documents/Informatik_Studium/FSS/SoftEvo/DataCollection/FFS_SoftEvo/go-ipfs/core/builder.go', 'top_nesting_level': 0, 'length': 13, 'fan_in': 0, 'fan_out': 0, 'general_fan_out': 0}]",-121,-696,0,113,113,"[{'timestamp': 1499441579.0, 'added_lines': 1, 'deleted_lines': 1, 'nloc': 184}, {'timestamp': 1511062375.0, 'added_lines': 3, 'deleted_lines': 3, 'nloc': 184}, {'timestamp': 1512365669.0, 'added_lines': 2, 'deleted_lines': 2, 'nloc': 184}, {'timestamp': 1514450040.0, 'added_lines': 3, 'deleted_lines': 3, 'nloc': 184}, {'timestamp': 1516660897.0, 'added_lines': 1, 'deleted_lines': 0, 'nloc': 184}, {'timestamp': 1516838128.0, 'added_lines': 5, 'deleted_lines': 5, 'nloc': 184}, {'timestamp': 1517453697.0, 'added_lines': 2, 'deleted_lines': 2, 'nloc': 184}, {'timestamp': 1518714221.0, 'added_lines': 1, 'deleted_lines': 1, 'nloc': 184}, {'timestamp': 1518736190.0, 'added_lines': 2, 'deleted_lines': 2, 'nloc': 184}, {'timestamp': 1519935671.0, 'added_lines': 5, 'deleted_lines': 0, 'nloc': 187}, {'timestamp': 1519943472.0, 'added_lines': 1, 'deleted_lines': 1, 'nloc': 187}, {'timestamp': 1519944077.0, 'added_lines': 2, 'deleted_lines': 2, 'nloc': 187}, {'timestamp': 1521687673.0, 'added_lines': 2, 'deleted_lines': 2, 'nloc': 187}, {'timestamp': 1519761835.0, 'added_lines': 4, 'deleted_lines': 4, 'nloc': 187}, {'timestamp': 1521427288.0, 'added_lines': 1, 'deleted_lines': 1, 'nloc': 187}, {'timestamp': 1522765832.0, 'added_lines': 1, 'deleted_lines': 1, 'nloc': 187}, {'timestamp': 1525408792.0, 'added_lines': 8, 'deleted_lines': 8, 'nloc': 187}, {'timestamp': 1520489177.0, 'added_lines': 18, 'deleted_lines': 1, 'nloc': 199}, {'timestamp': 1528268108.0, 'added_lines': 3, 'deleted_lines': 3, 'nloc': 199}, {'timestamp': 1528520460.0, 'added_lines': 6, 'deleted_lines': 6, 'nloc': 199}, {'timestamp': 1529044381.0, 'added_lines': 1, 'deleted_lines': 1, 'nloc': 199}, {'timestamp': 1528945488.0, 'added_lines': 8, 'deleted_lines': 0, 'nloc': 205}, {'timestamp': 1529984485.0, 'added_lines': 8, 'deleted_lines': 8, 'nloc': 205}, {'timestamp': 1529787837.0, 'added_lines': 1, 'deleted_lines': 1, 'nloc': 205}, {'timestamp': 1531779409.0, 'added_lines': 2, 'deleted_lines': 2, 'nloc': 205}, {'timestamp': 1529635557.0, 'added_lines': 6, 'deleted_lines': 4, 'nloc': 206}, {'timestamp': 1532146078.0, 'added_lines': 4, 'deleted_lines': 4, 'nloc': 206}, {'timestamp': 1532740866.0, 'added_lines': 1, 'deleted_lines': 1, 'nloc': 206}, {'timestamp': 1532764253.0, 'added_lines': 1, 'deleted_lines': 1, 'nloc': 206}, {'timestamp': 1532847462.0, 'added_lines': 1, 'deleted_lines': 1, 'nloc': 206}, {'timestamp': 1532986515.0, 'added_lines': 1, 'deleted_lines': 1, 'nloc': 206}, {'timestamp': 1533500571.0, 'added_lines': 4, 'deleted_lines': 4, 'nloc': 206}, {'timestamp': 1533607930.0, 'added_lines': 3, 'deleted_lines': 0, 'nloc': 208}, {'timestamp': 1533618653.0, 'added_lines': 6, 'deleted_lines': 6, 'nloc': 206}, {'timestamp': 1533779477.0, 'added_lines': 14, 'deleted_lines': 14, 'nloc': 208}, {'timestamp': 1532357069.0, 'added_lines': 2, 'deleted_lines': 2, 'nloc': 208}, {'timestamp': 1532365899.0, 'added_lines': 1, 'deleted_lines': 1, 'nloc': 208}, {'timestamp': 1532388583.0, 'added_lines': 1, 'deleted_lines': 1, 'nloc': 208}, {'timestamp': 1533809170.0, 'added_lines': 2, 'deleted_lines': 2, 'nloc': 208}, {'timestamp': 1533946888.0, 'added_lines': 1, 'deleted_lines': 1, 'nloc': 208}, {'timestamp': 1534115707.0, 'added_lines': 6, 'deleted_lines': 6, 'nloc': 208}, {'timestamp': 1534195762.0, 'added_lines': 9, 'deleted_lines': 9, 'nloc': 208}, {'timestamp': 1534347022.0, 'added_lines': 6, 'deleted_lines': 6, 'nloc': 208}, {'timestamp': 1534072974.0, 'added_lines': 1, 'deleted_lines': 1, 'nloc': 208}, {'timestamp': 1534896611.0, 'added_lines': 13, 'deleted_lines': 13, 'nloc': 208}, {'timestamp': 1535255498.0, 'added_lines': 1, 'deleted_lines': 1, 'nloc': 208}, {'timestamp': 1535601896.0, 'added_lines': 7, 'deleted_lines': 7, 'nloc': 208}, {'timestamp': 1535743290.0, 'added_lines': 10, 'deleted_lines': 8, 'nloc': 210}, {'timestamp': 1536388808.0, 'added_lines': 14, 'deleted_lines': 14, 'nloc': 210}, {'timestamp': 1536389172.0, 'added_lines': 2, 'deleted_lines': 1, 'nloc': 211}, {'timestamp': 1536718784.0, 'added_lines': 6, 'deleted_lines': 6, 'nloc': 211}, {'timestamp': 1536723292.0, 'added_lines': 6, 'deleted_lines': 6, 'nloc': 211}, {'timestamp': 1537790637.0, 'added_lines': 4, 'deleted_lines': 4, 'nloc': 211}, {'timestamp': 1537792589.0, 'added_lines': 17, 'deleted_lines': 17, 'nloc': 211}, {'timestamp': 1538544957.0, 'added_lines': 15, 'deleted_lines': 15, 'nloc': 211}, {'timestamp': 1538547366.0, 'added_lines': 1, 'deleted_lines': 1, 'nloc': 211}, {'timestamp': 1538694687.0, 'added_lines': 4, 'deleted_lines': 4, 'nloc': 211}, {'timestamp': 1538695953.0, 'added_lines': 5, 'deleted_lines': 5, 'nloc': 211}, {'timestamp': 1538773916.0, 'added_lines': 14, 'deleted_lines': 14, 'nloc': 211}, {'timestamp': 1539176817.0, 'added_lines': 9, 'deleted_lines': 9, 'nloc': 211}, {'timestamp': 1539357340.0, 'added_lines': 5, 'deleted_lines': 5, 'nloc': 211}, {'timestamp': 1539850591.0, 'added_lines': 1, 'deleted_lines': 1, 'nloc': 211}, {'timestamp': 1540400358.0, 'added_lines': 12, 'deleted_lines': 12, 'nloc': 211}, {'timestamp': 1540410565.0, 'added_lines': 5, 'deleted_lines': 5, 'nloc': 211}, {'timestamp': 1540418491.0, 'added_lines': 5, 'deleted_lines': 5, 'nloc': 211}, {'timestamp': 1540489644.0, 'added_lines': 1, 'deleted_lines': 1, 'nloc': 211}, {'timestamp': 1540603818.0, 'added_lines': 3, 'deleted_lines': 3, 'nloc': 211}, {'timestamp': 1540916861.0, 'added_lines': 1, 'deleted_lines': 1, 'nloc': 211}, {'timestamp': 1541106379.0, 'added_lines': 1, 'deleted_lines': 1, 'nloc': 211}, {'timestamp': 1541189794.0, 'added_lines': 3, 'deleted_lines': 3, 'nloc': 211}, {'timestamp': 1541204121.0, 'added_lines': 15, 'deleted_lines': 15, 'nloc': 211}, {'timestamp': 1541903826.0, 'added_lines': 14, 'deleted_lines': 14, 'nloc': 211}, {'timestamp': 1543282933.0, 'added_lines': 1, 'deleted_lines': 1, 'nloc': 211}, {'timestamp': 1543443696.0, 'added_lines': 3, 'deleted_lines': 3, 'nloc': 211}, {'timestamp': 1544225843.0, 'added_lines': 12, 'deleted_lines': 12, 'nloc': 211}, {'timestamp': 1544667474.0, 'added_lines': 14, 'deleted_lines': 5, 'nloc': 218}, {'timestamp': 1540556089.0, 'added_lines': 1, 'deleted_lines': 1, 'nloc': 218}, {'timestamp': 1545323704.0, 'added_lines': 1, 'deleted_lines': 1, 'nloc': 218}, {'timestamp': 1546553605.0, 'added_lines': 1, 'deleted_lines': 1, 'nloc': 218}, {'timestamp': 1547003974.0, 'added_lines': 11, 'deleted_lines': 11, 'nloc': 218}, {'timestamp': 1547499910.0, 'added_lines': 4, 'deleted_lines': 4, 'nloc': 218}, {'timestamp': 1548866534.0, 'added_lines': 1, 'deleted_lines': 1, 'nloc': 218}, {'timestamp': 1549588289.0, 'added_lines': 13, 'deleted_lines': 13, 'nloc': 218}, {'timestamp': 1549903582.0, 'added_lines': 1, 'deleted_lines': 1, 'nloc': 218}, {'timestamp': 1550185115.0, 'added_lines': 5, 'deleted_lines': 5, 'nloc': 218}, {'timestamp': 1550507829.0, 'added_lines': 19, 'deleted_lines': 19, 'nloc': 218}, {'timestamp': 1550711994.0, 'added_lines': 4, 'deleted_lines': 4, 'nloc': 218}, {'timestamp': 1550723346.0, 'added_lines': 8, 'deleted_lines': 8, 'nloc': 218}, {'timestamp': 1551229859.0, 'added_lines': 13, 'deleted_lines': 13, 'nloc': 218}, {'timestamp': 1551299964.0, 'added_lines': 5, 'deleted_lines': 5, 'nloc': 218}, {'timestamp': 1551754781.0, 'added_lines': 1, 'deleted_lines': 5, 'nloc': 215}, {'timestamp': 1551551196.0, 'added_lines': 21, 'deleted_lines': 21, 'nloc': 215}, {'timestamp': 1552083569.0, 'added_lines': 8, 'deleted_lines': 0, 'nloc': 221}, {'timestamp': 1552093097.0, 'added_lines': 1, 'deleted_lines': 1, 'nloc': 221}, {'timestamp': 1553697989.0, 'added_lines': 2, 'deleted_lines': 2, 'nloc': 222}, {'timestamp': 1553734162.0, 'added_lines': 73, 'deleted_lines': 12, 'nloc': 250}, {'timestamp': 1553734925.0, 'added_lines': 45, 'deleted_lines': 17, 'nloc': 276}, {'timestamp': 1553735318.0, 'added_lines': 2, 'deleted_lines': 1, 'nloc': 277}, {'timestamp': 1553738233.0, 'added_lines': 19, 'deleted_lines': 12, 'nloc': 282}, {'timestamp': 1553871352.0, 'added_lines': 13, 'deleted_lines': 3, 'nloc': 288}, {'timestamp': 1554119110.0, 'added_lines': 24, 'deleted_lines': 15, 'nloc': 294}, {'timestamp': 1554136790.0, 'added_lines': 7, 'deleted_lines': 0, 'nloc': 299}, {'timestamp': 1554137376.0, 'added_lines': 1, 'deleted_lines': 1, 'nloc': 299}, {'timestamp': 1554147257.0, 'added_lines': 2, 'deleted_lines': 152, 'nloc': 198}, {'timestamp': 1554255872.0, 'added_lines': 20, 'deleted_lines': 110, 'nloc': 134}, {'timestamp': 1554300808.0, 'added_lines': 12, 'deleted_lines': 8, 'nloc': 138}, {'timestamp': 1554302054.0, 'added_lines': 3, 'deleted_lines': 132, 'nloc': 34}, {'timestamp': 1554303405.0, 'added_lines': 3, 'deleted_lines': 0, 'nloc': 36}, {'timestamp': 1557557624.0, 'added_lines': 4, 'deleted_lines': 1, 'nloc': 39}, {'timestamp': 1558801722.0, 'added_lines': 12, 'deleted_lines': 4, 'nloc': 47}, {'timestamp': 1555520888.0, 'added_lines': 2, 'deleted_lines': 3, 'nloc': 47}, {'timestamp': 1557165820.0, 'added_lines': 1, 'deleted_lines': 0, 'nloc': 47}, {'timestamp': 1585540123.0, 'added_lines': 32, 'deleted_lines': 6, 'nloc': 63}]","{'cmd/ipfs/daemon.go': 30, 'core/commands/ipnsps.go': 7, 'core/commands/mount_windows.go': 12, 'core/commands/name.go': 5, 'core/core.go': 90, 'core/corehttp/gateway_test.go': 63, 'namesys/interface.go': 43, 'namesys/namesys.go': 53, 'namesys/namesys_test.go': 59, 'namesys/pubsub.go': 8, 'namesys/pubsub_test.go': 7, 'test/sharness/t0183-namesys-pubsub.sh': 1, 'blocks/blockstore/arc_cache.go': 3, 'blocks/blockstore/arc_cache_test.go': 3, 'blocks/blockstore/blockstore.go': 4, 'blocks/blockstore/blockstore_test.go': 3, 'blocks/blockstore/bloom_cache_test.go': 3, 'blocks/blockstore/util/remove.go': 3, 'blockservice/blockservice_test.go': 11, 'blockservice/test/blocks_test.go': 11, 'core/commands/dht.go': 57, 'core/coreunix/add.go': 59, 'core/coreunix/metadata_test.go': 59, 'exchange/bitswap/decision/engine_test.go': 11, 'exchange/bitswap/testnet/peernet.go': 12, 'exchange/bitswap/testutils.go': 12, 'exchange/offline/offline_test.go': 5, 'exchange/reprovide/reprovide_test.go': 39, 'filestore/filestore.go': 30, 'filestore/filestore_test.go': 50, 'filestore/fsrefstore.go': 32, 'filestore/util.go': 27, 'merkledag/test/utils.go': 11, 'merkledag/utils/utils.go': 12, 'mfs/mfs_test.go': 22, 'namesys/publisher.go': 58, 'namesys/publisher_test.go': 35, 'namesys/republisher/repub.go': 49, 'namesys/resolve_test.go': 51, 'package.json': 74, 'pin/pin.go': 49, 'pin/pin_test.go': 52, 'pin/set_test.go': 51, 'repo/fsrepo/datastores.go': 18, 'repo/fsrepo/fsrepo.go': 40, 'repo/fsrepo/fsrepo_test.go': 30, 'repo/repo.go': 34, 'routing/mock/centralized_client.go': 4, 'routing/mock/centralized_server.go': 4, 'routing/mock/interface.go': 4, 'routing/offline/offline.go': 4, 'routing/offline/offline_test.go': 4, 'thirdparty/datastore2/datastore_closer.go': 3, 'thirdparty/datastore2/delayed.go': 3, 'thirdparty/datastore2/threadsafe.go': 3, 'thirdparty/ds-help/key.go': 3, 'assets/assets.go': 48, 'blocks/blockstore/bloom_cache.go': 2, 'blocks/blocksutil/block_generator.go': 2, 'blockservice/blockservice.go': 13, 'cmd/ipfs/init.go': 37, 'cmd/ipfs/ipfs.go': 18, 'cmd/ipfs/main.go': 41, 'cmd/ipfs/main_test.go': 1, 'cmd/ipfswatch/main.go': 29, 'cmd/seccat/seccat.go': 29, 'commands/command.go': 12, 'commands/command_test.go': 3, 'commands/request.go': 26, 'commands/response.go': 7, 'commands/response_test.go': 3, 'core/bootstrap.go': 35, 'core/bootstrap_test.go': 34, 'core/commands/active.go': 11, 'core/commands/add.go': 47, 'core/commands/bitswap.go': 49, 'core/commands/block.go': 28, 'core/commands/bootstrap.go': 32, 'core/commands/cat.go': 23, 'core/commands/commands.go': 19, 'core/commands/config.go': 33, 'core/commands/dag/dag.go': 51, 'core/commands/dht_test.go': 23, 'core/commands/diag.go': 11, 'core/commands/dns.go': 16, 'core/commands/external.go': 11, 'core/commands/files/files.go': 3, 'core/commands/filestore.go': 23, 'core/commands/get.go': 54, 'core/commands/get_test.go': 18, 'core/commands/helptext_test.go': 18, 'core/commands/id.go': 39, 'core/commands/ipns.go': 14, 'core/commands/keystore.go': 22, 'core/commands/log.go': 17, 'core/commands/ls.go': 56, 'core/commands/mount_nofuse.go': 11, 'core/commands/mount_unix.go': 34, 'core/commands/object/diff.go': 17, 'core/commands/object/object.go': 52, 'core/commands/object/patch.go': 24, 'core/commands/p2p.go': 26, 'core/commands/pin.go': 56, 'core/commands/ping.go': 32, 'core/commands/publish.go': 15, 'core/commands/pubsub.go': 33, 'core/commands/refs.go': 50, 'core/commands/repo.go': 51, 'core/commands/resolve.go': 48, 'core/commands/root.go': 18, 'core/commands/shutdown.go': 16, 'core/commands/stat.go': 24, 'core/commands/swarm.go': 47, 'core/commands/sysdiag.go': 21, 'core/commands/tar.go': 48, 'core/commands/unixfs/ls.go': 50, 'core/commands/unixfs/unixfs.go': 11, 'core/commands/version.go': 14, 'core/coreapi/coreapi.go': 31, 'core/coreapi/interface/interface.go': 2, 'core/coreapi/unixfs.go': 51, 'core/coreapi/unixfs_test.go': 51, 'core/coredag/cbor.go': 17, 'core/coredag/dagpb.go': 43, 'core/coredag/dagtransl.go': 14, 'core/coredag/raw.go': 43, 'core/corehttp/commands.go': 63, 'core/corehttp/corehttp.go': 17, 'core/corehttp/gateway.go': 36, 'core/corehttp/gateway_handler.go': 58, 'core/corehttp/metrics_test.go': 33, 'core/corerepo/gc.go': 49, 'core/corerepo/pinning.go': 23, 'core/coreunix/add_test.go': 66, 'core/coreunix/metadata.go': 50, 'core/mock/mock.go': 45, 'core/pathresolver.go': 49, 'exchange/bitswap/bitswap.go': 11, 'exchange/bitswap/bitswap_test.go': 12, 'exchange/bitswap/decision/bench_test.go': 7, 'exchange/bitswap/decision/engine.go': 10, 'exchange/bitswap/decision/ledger.go': 8, 'exchange/bitswap/decision/peer_request_queue.go': 7, 'exchange/bitswap/decision/peer_request_queue_test.go': 7, 'exchange/bitswap/get.go': 9, 'exchange/bitswap/message/message.go': 8, 'exchange/bitswap/message/message_test.go': 4, 'exchange/bitswap/network/interface.go': 8, 'exchange/bitswap/network/ipfs_impl.go': 9, 'exchange/bitswap/notifications/notifications.go': 4, 'exchange/bitswap/notifications/notifications_test.go': 4, 'exchange/bitswap/session.go': 7, 'exchange/bitswap/session_test.go': 6, 'exchange/bitswap/stat.go': 4, 'exchange/bitswap/testnet/interface.go': 6, 'exchange/bitswap/testnet/network_test.go': 10, 'exchange/bitswap/testnet/virtual.go': 10, 'exchange/bitswap/wantlist/wantlist.go': 4, 'exchange/bitswap/wantlist/wantlist_test.go': 4, 'exchange/bitswap/wantmanager.go': 8, 'exchange/bitswap/workers.go': 7, 'exchange/interface.go': 2, 'exchange/offline/offline.go': 4, 'exchange/reprovide/providers.go': 48, 'exchange/reprovide/reprovide.go': 30, 'fuse/ipns/ipns_test.go': 35, 'fuse/ipns/ipns_unix.go': 56, 'fuse/node/mount_test.go': 34, 'fuse/readonly/ipfs_test.go': 54, 'fuse/readonly/readonly_unix.go': 55, 'importer/balanced/balanced_test.go': 7, 'importer/balanced/builder.go': 4, 'importer/chunk/rabin_test.go': 2, 'importer/chunk/splitting_test.go': 2, 'importer/helpers/dagbuilder.go': 8, 'importer/helpers/helpers.go': 5, 'importer/importer.go': 6, 'importer/importer_test.go': 7, 'importer/trickle/trickle_test.go': 7, 'importer/trickle/trickledag.go': 6, 'merkledag/batch.go': 2, 'merkledag/coding.go': 4, 'merkledag/merkledag.go': 5, 'merkledag/merkledag_test.go': 9, 'merkledag/node.go': 4, 'merkledag/node_test.go': 4, 'merkledag/raw.go': 5, 'merkledag/traverse/traverse.go': 4, 'merkledag/traverse/traverse_test.go': 4, 'merkledag/utils/diff.go': 4, 'merkledag/utils/diffenum.go': 4, 'merkledag/utils/diffenum_test.go': 4, 'merkledag/utils/utils_test.go': 4, 'mfs/dir.go': 13, 'mfs/file.go': 15, 'mfs/ops.go': 11, 'mfs/repub_test.go': 10, 'mfs/system.go': 16, 'namesys/ipns_select_test.go': 4, 'namesys/republisher/repub_test.go': 50, 'namesys/routing.go': 52, 'p2p/p2p.go': 24, 'p2p/registry.go': 11, 'path/path.go': 5, 'path/resolver.go': 3, 'path/resolver_test.go': 2, 'pin/gc/gc.go': 51, 'pin/set.go': 44, 'plugin/ipld.go': 13, 'plugin/loader/initializer.go': 10, 'plugin/plugins/git/git.go': 13, 'repo/config/bootstrap_peers.go': 9, 'repo/config/init.go': 7, 'repo/fsrepo/lock/lock.go': 3, 'repo/fsrepo/serialize/serialize.go': 3, 'repo/mock.go': 28, 'routing/mock/centralized_test.go': 3, 'routing/none/none_client.go': 3, 'tar/format.go': 55, 'test/dependencies/ma-pipe-unidir/main.go': 11, 'test/integration/addcat_test.go': 36, 'test/integration/bench_cat_test.go': 36, 'test/integration/bench_test.go': 17, 'test/integration/bitswap_wo_routing_test.go': 38, 'test/integration/three_legged_cat_test.go': 36, 'thirdparty/pollEndpoint/main.go': 15, 'thirdparty/posinfo/posinfo.go': 2, 'unixfs/archive/archive.go': 5, 'unixfs/archive/tar/writer.go': 6, 'unixfs/hamt/hamt.go': 6, 'unixfs/io/dagreader.go': 6, 'unixfs/io/dirbuilder.go': 3, 'unixfs/io/resolve.go': 6, 'unixfs/mod/dagmodifier.go': 9, 'unixfs/mod/dagmodifier_test.go': 4, 'unixfs/test/utils.go': 8, 'commands/legacy/command.go': 11, 'commands/legacy/legacy.go': 11, 'commands/legacy/legacy_test.go': 11, 'commands/legacy/request.go': 11, 'commands/legacy/response.go': 11, 'core/commands/commands_test.go': 17, 'core/coreapi/dag.go': 12, 'core/coreapi/dag_test.go': 3, 'core/coreapi/interface/options/dag.go': 8, 'core/coreapi/key.go': 46, 'core/coreapi/name.go': 51, 'unixfs/io/pbdagreader.go': 5, 'cmd/ipfs/util/ulimit.go': 9, 'cmd/seccat/util.go': 10, 'core/corehttp/logs.go': 9, 'fuse/mount/mount.go': 9, 'fuse/node/mount_unix.go': 11, 'importer/chunk/splitting.go': 1, 'namesys/ipns_validate_test.go': 5, 'plugin/loader/load.go': 7, None: 41, 'blocks/blockstoreutil/remove.go': 24, 'core/coreapi/block.go': 16, 'core/commands/files.go': 57, 'core/coreunix/cat.go': 17, 'path/resolver/resolver.go': 6, 'path/resolver/resolver_test.go': 4, 'removeme/verifbs/verifbs.go': 1, 'test/sharness/t0050-block.sh': 1, 'thirdparty/verifbs/verifbs.go': 24, 'thirdparty/verifcid/validate.go': 3, 'thirdparty/verifcid/validate_test.go': 3, 'test/dependencies/go-timeout/main.go': 1, 'thirdparty/notifier/notifier.go': 2, 'blockservice/test/mock.go': 7, 'namesys/validator.go': 4, 'CHANGELOG.md': 1, 'README.md': 1, 'bin/dist_get': 1, 'cmd/ipfs/util/ulimit_freebsd.go': 3, 'contribute.md': 1, 'core/coreapi/interface/options/pin.go': 1, 'docs/experimental-features.md': 2, 'docs/file-transfer.md': 1, 'docs/releases.md': 2, 'exchange/bitswap/README.md': 1, 'plugin/plugin.go': 1, 'repo/fsrepo/migrations/mfsr_test.go': 1, 'repo/fsrepo/migrations/migrations.go': 1, 'test/sharness/README.md': 1, 'thirdparty/dir/dir.go': 1, 'core/coreapi/pin.go': 48, 'core/core_test.go': 27, 'fuse/ipns/common.go': 48, 'keystore/keystore.go': 8, 'keystore/keystore_test.go': 6, 'keystore/memkeystore.go': 5, 'repo/config/identity.go': 2, 'cmd/ipfs/util/ulimit_unix.go': 2, 'core/coreapi/block_test.go': 2, 'core/coreapi/interface/coreapi.go': 9, 'core/coreapi/interface/dag.go': 9, 'core/coreapi/interface/object.go': 9, 'core/coreapi/interface/options/block.go': 3, 'core/coreapi/interface/path.go': 35, 'core/coreapi/interface/unixfs.go': 13, 'core/coreapi/object.go': 48, 'fuse/ipns/link_unix.go': 2, 'fuse/mount/fuse.go': 3, 'fuse/node/mount_darwin.go': 2, 'merkledag/errservice.go': 2, 'merkledag/readonly.go': 2, 'merkledag/readonly_test.go': 2, 'merkledag/rwservice.go': 2, 'merkledag/session.go': 2, 'unixfs/hamt/hamt_stress_test.go': 4, 'unixfs/hamt/hamt_test.go': 4, 'namesys/ipns_resolver_validation_test.go': 45, 'test/sharness/t0170-dht.sh': 1, 'repo/config/experiments.go': 1, 'core/commands/urlstore.go': 46, 'unixfs/io/directory.go': 3, 'test/sharness/t0046-id-hash.sh': 1, 'core/corehttp/metrics.go': 2, 'Rules.mk': 1, 'dagutils/diff.go': 41, 'dagutils/diffenum.go': 39, 'dagutils/diffenum_test.go': 39, 'dagutils/utils.go': 42, 'dagutils/utils_test.go': 41, 'unixfs/io/dagreader_test.go': 2, 'unixfs/io/directory_test.go': 2, 'unixfs/unixfs.go': 2, 'core/coreapi/name_test.go': 32, 'core/coreapi/path.go': 48, 'core/pathresolver_test.go': 40, 'namesys/base.go': 41, 'namesys/cache.go': 40, 'namesys/dns.go': 41, 'namesys/proquint.go': 41, 'mfs/fd.go': 8, 'unixfs/importer/balanced/balanced_test.go': 1, 'unixfs/importer/balanced/builder.go': 1, 'unixfs/importer/helpers/dagbuilder.go': 1, 'unixfs/importer/helpers/helpers.go': 1, 'unixfs/importer/importer.go': 1, 'unixfs/importer/importer_test.go': 1, 'unixfs/importer/trickle/trickle_test.go': 1, 'unixfs/importer/trickle/trickledag.go': 1, 'unixfs/unixfs_test.go': 1, 'test/sharness/t0276-cidv0v1.sh': 1, 'thirdparty/cidv0v1/blockstore.go': 17, 'core/commands/env.go': 8, 'core/coreapi/interface/key.go': 7, 'filestore/pb/dataobj.pb.go': 3, 'pin/internal/pb/header.pb.go': 3, 'repo/fsrepo/misc.go': 24, 'cmd/ipfs/Rules.mk': 1, 'core/corehttp/option_test.go': 2, 'docs/windows.md': 1, 'repo/fsrepo/config_test.go': 23, 'repo/version.go': 1, 'test/bench/bench_cli_ipfs_add/main.go': 24, 'test/bench/offline_add/main.go': 24, 'core/commands/cmdenv/env.go': 26, 'core/commands/name/ipns.go': 36, 'core/commands/name/publish.go': 19, 'core/coreapi/dht.go': 30, 'core/coreapi/dht_test.go': 5, 'test/sharness/t0275-cid-security.sh': 1, 'core/commands/name/ipnsps.go': 13, 'core/commands/name/name.go': 9, 'core/coreapi/interface/dht.go': 10, 'p2p/listener.go': 13, 'p2p/local.go': 13, 'p2p/remote.go': 14, 'p2p/stream.go': 14, 'core/coreapi/interface/swarm.go': 9, 'core/coreapi/swarm.go': 21, 'core/coreapi/interface/options/unixfs.go': 15, 'core/coreapi/pubsub.go': 20, 'core/coreapi/unixfile.go': 17, 'core/commands/cid.go': 10, 'cmd/ipfs/dnsresolve_test.go': 5, 'core/coreapi/interface/pubsub.go': 4, 'test/sharness/t0180-pubsub.sh': 1, 'test/dependencies/iptb/iptb.go': 15, 'plugin/plugins/badgerds/badgerds.go': 3, 'plugin/plugins/flatfs/flatfs.go': 3, 'plugin/plugins/levelds/levelds.go': 3, 'commands/context.go': 15, 'core/corehttp/proxy.go': 9, 'core/coreapi/test/api_test.go': 12, 'core/coreapi/interface/tests/name.go': 4, 'core/coreapi/interface/tests/unixfs.go': 4, 'plugin/loader/loader.go': 10, 'core/commands/cmdenv/cidbase.go': 6, 'core/commands/cmdenv/file.go': 3, 'core/corehttp/ipns_hostname.go': 8, 'namesys/dns_test.go': 8, 'plugin/daemon.go': 8, 'core/commands/cmdenv/cidbase_test.go': 2, 'core/corehttp/proxy_test.go': 1, 'core/corerepo/stat.go': 1, 'plugin/tracer.go': 1, 'core/coreapi/provider.go': 2, 'provider/provider.go': 3, 'provider/queue.go': 3, 'provider/offline.go': 2, 'commands/reqlog.go': 1, 'core/corehttp/mutex_profile.go': 1, 'provider/queue_test.go': 1, 'core/ncore.go': 8, 'fuse/ipns/mount_unix.go': 1, 'fuse/readonly/mount_unix.go': 1, 'core/bootstrap/bootstrap.go': 1, 'core/bootstrap/bootstrap_test.go': 1, 'core/node/builder.go': 4, 'core/node/core.go': 3, 'core/node/discovery.go': 1, 'core/node/groups.go': 5, 'core/node/helpers.go': 2, 'core/node/identity.go': 1, 'core/node/ipns.go': 1, 'core/node/libp2p.go': 4, 'core/node/provider.go': 2, 'core/node/storage.go': 3, 'namesys/resolve/resolve.go': 1, 'cmd/ipfs/util/ulimit_test.go': 1, 'go.mod': 1, 'go.sum': 1, 'provider/queue/queue.go': 1, 'provider/queue/queue_test.go': 1, 'provider/simple/provider.go': 1, 'provider/simple/provider_test.go': 1, 'provider/simple/reprovide.go': 1, 'provider/simple/reprovide_test.go': 1, 'provider/system.go': 1, 'test/sharness/lib/iptb-lib.sh': 1, 'test/sharness/t0175-provider.sh': 1, 'test/sharness/t0175-reprovider.sh': 1, 'test/sharness/t0175-strategic-provider.sh': 1}","('core/core.go', 0.7964601769911505, 0.5027932960893855)"
core/core.go,704,4179,25,"[{'cyclomatic_complexity': 1, 'nloc': 3, 'token_count': 21, 'name': 'init', 'long_name': 'init', 'start_line': 94, 'end_line': 96, 'full_parameters': [], 'filename': '/home/dimi/Documents/Informatik_Studium/FSS/SoftEvo/DataCollection/FFS_SoftEvo/go-ipfs/core/core.go', 'top_nesting_level': 0, 'length': 3, 'fan_in': 0, 'fan_out': 0, 'general_fan_out': 0}, {'cyclomatic_complexity': 6, 'nloc': 18, 'token_count': 95, 'name': '', 'long_name': '()', 'start_line': 197, 'end_line': 214, 'full_parameters': [], 'filename': '/home/dimi/Documents/Informatik_Studium/FSS/SoftEvo/DataCollection/FFS_SoftEvo/go-ipfs/core/core.go', 'top_nesting_level': 0, 'length': 18, 'fan_in': 0, 'fan_out': 0, 'general_fan_out': 0}, {'cyclomatic_complexity': 17, 'nloc': 72, 'token_count': 443, 'name': 'startOnlineServices', 'long_name': '(n*IpfsNode)startOnlineServices ctx context . Context , routingOption RoutingOption , hostOption HostOption , do DiscoveryOption , pubsub , mplex bool', 'start_line': 153, 'end_line': 262, 'full_parameters': ['ctx context . Context', ' routingOption RoutingOption', ' hostOption HostOption', ' do DiscoveryOption', ' pubsub', ' mplex bool'], 'filename': '/home/dimi/Documents/Informatik_Studium/FSS/SoftEvo/DataCollection/FFS_SoftEvo/go-ipfs/core/core.go', 'top_nesting_level': 0, 'length': 110, 'fan_in': 0, 'fan_out': 0, 'general_fan_out': 0}, {'cyclomatic_complexity': 8, 'nloc': 30, 'token_count': 183, 'name': 'startLateOnlineServices', 'long_name': '(n*IpfsNode)startLateOnlineServices ctx context . Context', 'start_line': 264, 'end_line': 299, 'full_parameters': ['ctx context . Context'], 'filename': '/home/dimi/Documents/Informatik_Studium/FSS/SoftEvo/DataCollection/FFS_SoftEvo/go-ipfs/core/core.go', 'top_nesting_level': 0, 'length': 36, 'fan_in': 0, 'fan_out': 0, 'general_fan_out': 0}, {'cyclomatic_complexity': 5, 'nloc': 17, 'token_count': 95, 'name': '[', 'long_name': '(allAddrs[]ma.Multiaddr)[', 'start_line': 326, 'end_line': 345, 'full_parameters': [], 'filename': '/home/dimi/Documents/Informatik_Studium/FSS/SoftEvo/DataCollection/FFS_SoftEvo/go-ipfs/core/core.go', 'top_nesting_level': 0, 'length': 20, 'fan_in': 0, 'fan_out': 0, 'general_fan_out': 0}, {'cyclomatic_complexity': 4, 'nloc': 22, 'token_count': 132, 'name': 'makeSmuxTransport', 'long_name': 'makeSmuxTransport mplexExp bool', 'start_line': 347, 'end_line': 375, 'full_parameters': ['mplexExp bool'], 'filename': '/home/dimi/Documents/Informatik_Studium/FSS/SoftEvo/DataCollection/FFS_SoftEvo/go-ipfs/core/core.go', 'top_nesting_level': 0, 'length': 29, 'fan_in': 0, 'fan_out': 0, 'general_fan_out': 0}, {'cyclomatic_complexity': 2, 'nloc': 6, 'token_count': 62, 'name': '', 'long_name': '(ctx context.Context,h p2phost.Host)(discovery.Service,error)', 'start_line': 379, 'end_line': 384, 'full_parameters': [], 'filename': '/home/dimi/Documents/Informatik_Studium/FSS/SoftEvo/DataCollection/FFS_SoftEvo/go-ipfs/core/core.go', 'top_nesting_level': 0, 'length': 6, 'fan_in': 0, 'fan_out': 0, 'general_fan_out': 0}, {'cyclomatic_complexity': 2, 'nloc': 6, 'token_count': 23, 'name': 'setupDiscoveryOption', 'long_name': 'setupDiscoveryOption d config . Discovery', 'start_line': 377, 'end_line': 387, 'full_parameters': ['d config . Discovery'], 'filename': '/home/dimi/Documents/Informatik_Studium/FSS/SoftEvo/DataCollection/FFS_SoftEvo/go-ipfs/core/core.go', 'top_nesting_level': 0, 'length': 11, 'fan_in': 0, 'fan_out': 0, 'general_fan_out': 0}, {'cyclomatic_complexity': 2, 'nloc': 8, 'token_count': 70, 'name': 'HandlePeerFound', 'long_name': '(n*IpfsNode)HandlePeerFound p pstore . PeerInfo', 'start_line': 389, 'end_line': 396, 'full_parameters': ['p pstore . PeerInfo'], 'filename': '/home/dimi/Documents/Informatik_Studium/FSS/SoftEvo/DataCollection/FFS_SoftEvo/go-ipfs/core/core.go', 'top_nesting_level': 0, 'length': 8, 'fan_in': 0, 'fan_out': 0, 'general_fan_out': 0}, {'cyclomatic_complexity': 3, 'nloc': 18, 'token_count': 164, 'name': 'startOnlineServicesWithHost', 'long_name': '(n*IpfsNode)startOnlineServicesWithHost ctx context . Context , host p2phost . Host , routingOption RoutingOption', 'start_line': 400, 'end_line': 429, 'full_parameters': ['ctx context . Context', ' host p2phost . Host', ' routingOption RoutingOption'], 'filename': '/home/dimi/Documents/Informatik_Studium/FSS/SoftEvo/DataCollection/FFS_SoftEvo/go-ipfs/core/core.go', 'top_nesting_level': 0, 'length': 30, 'fan_in': 0, 'fan_out': 0, 'general_fan_out': 0}, {'cyclomatic_complexity': 4, 'nloc': 14, 'token_count': 72, 'name': 'getCacheSize', 'long_name': '(n*IpfsNode)getCacheSize', 'start_line': 432, 'end_line': 446, 'full_parameters': [], 'filename': '/home/dimi/Documents/Informatik_Studium/FSS/SoftEvo/DataCollection/FFS_SoftEvo/go-ipfs/core/core.go', 'top_nesting_level': 0, 'length': 15, 'fan_in': 0, 'fan_out': 0, 'general_fan_out': 0}, {'cyclomatic_complexity': 9, 'nloc': 26, 'token_count': 205, 'name': 'setupIpnsRepublisher', 'long_name': '(n*IpfsNode)setupIpnsRepublisher', 'start_line': 448, 'end_line': 481, 'full_parameters': [], 'filename': '/home/dimi/Documents/Informatik_Studium/FSS/SoftEvo/DataCollection/FFS_SoftEvo/go-ipfs/core/core.go', 'top_nesting_level': 0, 'length': 34, 'fan_in': 0, 'fan_out': 0, 'general_fan_out': 0}, {'cyclomatic_complexity': 1, 'nloc': 3, 'token_count': 18, 'name': 'Process', 'long_name': '(n*IpfsNode)Process', 'start_line': 484, 'end_line': 486, 'full_parameters': [], 'filename': '/home/dimi/Documents/Informatik_Studium/FSS/SoftEvo/DataCollection/FFS_SoftEvo/go-ipfs/core/core.go', 'top_nesting_level': 0, 'length': 3, 'fan_in': 0, 'fan_out': 0, 'general_fan_out': 0}, {'cyclomatic_complexity': 1, 'nloc': 3, 'token_count': 20, 'name': 'Close', 'long_name': '(n*IpfsNode)Close', 'start_line': 489, 'end_line': 491, 'full_parameters': [], 'filename': '/home/dimi/Documents/Informatik_Studium/FSS/SoftEvo/DataCollection/FFS_SoftEvo/go-ipfs/core/core.go', 'top_nesting_level': 0, 'length': 3, 'fan_in': 0, 'fan_out': 0, 'general_fan_out': 0}, {'cyclomatic_complexity': 2, 'nloc': 6, 'token_count': 35, 'name': 'Context', 'long_name': '(n*IpfsNode)Context', 'start_line': 494, 'end_line': 499, 'full_parameters': [], 'filename': '/home/dimi/Documents/Informatik_Studium/FSS/SoftEvo/DataCollection/FFS_SoftEvo/go-ipfs/core/core.go', 'top_nesting_level': 0, 'length': 6, 'fan_in': 0, 'fan_out': 0, 'general_fan_out': 0}, {'cyclomatic_complexity': 14, 'nloc': 39, 'token_count': 284, 'name': 'teardown', 'long_name': '(n*IpfsNode)teardown', 'start_line': 503, 'end_line': 557, 'full_parameters': [], 'filename': '/home/dimi/Documents/Informatik_Studium/FSS/SoftEvo/DataCollection/FFS_SoftEvo/go-ipfs/core/core.go', 'top_nesting_level': 0, 'length': 55, 'fan_in': 0, 'fan_out': 0, 'general_fan_out': 0}, {'cyclomatic_complexity': 2, 'nloc': 8, 'token_count': 27, 'name': 'OnlineMode', 'long_name': '(n*IpfsNode)OnlineMode', 'start_line': 559, 'end_line': 566, 'full_parameters': [], 'filename': '/home/dimi/Documents/Informatik_Studium/FSS/SoftEvo/DataCollection/FFS_SoftEvo/go-ipfs/core/core.go', 'top_nesting_level': 0, 'length': 8, 'fan_in': 0, 'fan_out': 0, 'general_fan_out': 0}, {'cyclomatic_complexity': 2, 'nloc': 6, 'token_count': 27, 'name': 'SetLocal', 'long_name': '(n*IpfsNode)SetLocal isLocal bool', 'start_line': 568, 'end_line': 573, 'full_parameters': ['isLocal bool'], 'filename': '/home/dimi/Documents/Informatik_Studium/FSS/SoftEvo/DataCollection/FFS_SoftEvo/go-ipfs/core/core.go', 'top_nesting_level': 0, 'length': 6, 'fan_in': 0, 'fan_out': 0, 'general_fan_out': 0}, {'cyclomatic_complexity': 3, 'nloc': 11, 'token_count': 38, 'name': 'LocalMode', 'long_name': '(n*IpfsNode)LocalMode', 'start_line': 575, 'end_line': 586, 'full_parameters': [], 'filename': '/home/dimi/Documents/Informatik_Studium/FSS/SoftEvo/DataCollection/FFS_SoftEvo/go-ipfs/core/core.go', 'top_nesting_level': 0, 'length': 12, 'fan_in': 0, 'fan_out': 0, 'general_fan_out': 0}, {'cyclomatic_complexity': 2, 'nloc': 13, 'token_count': 54, 'name': '[', 'long_name': '()[', 'start_line': 602, 'end_line': 615, 'full_parameters': [], 'filename': '/home/dimi/Documents/Informatik_Studium/FSS/SoftEvo/DataCollection/FFS_SoftEvo/go-ipfs/core/core.go', 'top_nesting_level': 0, 'length': 14, 'fan_in': 0, 'fan_out': 0, 'general_fan_out': 0}, {'cyclomatic_complexity': 5, 'nloc': 18, 'token_count': 99, 'name': 'loadID', 'long_name': '(n*IpfsNode)loadID', 'start_line': 617, 'end_line': 637, 'full_parameters': [], 'filename': '/home/dimi/Documents/Informatik_Studium/FSS/SoftEvo/DataCollection/FFS_SoftEvo/go-ipfs/core/core.go', 'top_nesting_level': 0, 'length': 21, 'fan_in': 0, 'fan_out': 0, 'general_fan_out': 0}, {'cyclomatic_complexity': 2, 'nloc': 7, 'token_count': 48, 'name': 'GetKey', 'long_name': '(n*IpfsNode)GetKey name string', 'start_line': 639, 'end_line': 645, 'full_parameters': ['name string'], 'filename': '/home/dimi/Documents/Informatik_Studium/FSS/SoftEvo/DataCollection/FFS_SoftEvo/go-ipfs/core/core.go', 'top_nesting_level': 0, 'length': 7, 'fan_in': 0, 'fan_out': 0, 'general_fan_out': 0}, {'cyclomatic_complexity': 6, 'nloc': 20, 'token_count': 127, 'name': 'LoadPrivateKey', 'long_name': '(n*IpfsNode)LoadPrivateKey', 'start_line': 647, 'end_line': 670, 'full_parameters': [], 'filename': '/home/dimi/Documents/Informatik_Studium/FSS/SoftEvo/DataCollection/FFS_SoftEvo/go-ipfs/core/core.go', 'top_nesting_level': 0, 'length': 24, 'fan_in': 0, 'fan_out': 0, 'general_fan_out': 0}, {'cyclomatic_complexity': 3, 'nloc': 11, 'token_count': 67, 'name': 'loadBootstrapPeers', 'long_name': '(n*IpfsNode)loadBootstrapPeers', 'start_line': 672, 'end_line': 683, 'full_parameters': [], 'filename': '/home/dimi/Documents/Informatik_Studium/FSS/SoftEvo/DataCollection/FFS_SoftEvo/go-ipfs/core/core.go', 'top_nesting_level': 0, 'length': 12, 'fan_in': 0, 'fan_out': 0, 'general_fan_out': 0}, {'cyclomatic_complexity': 1, 'nloc': 3, 'token_count': 35, 'name': 'error', 'long_name': '(ctx context.Context,c*cid.Cid)error', 'start_line': 687, 'end_line': 689, 'full_parameters': [], 'filename': '/home/dimi/Documents/Informatik_Studium/FSS/SoftEvo/DataCollection/FFS_SoftEvo/go-ipfs/core/core.go', 'top_nesting_level': 0, 'length': 3, 'fan_in': 0, 'fan_out': 0, 'general_fan_out': 0}]",132,612,4,"[{'cyclomatic_complexity': 1, 'nloc': 3, 'token_count': 18, 'name': 'Close', 'long_name': '(n*IpfsNode)Close', 'start_line': 127, 'end_line': 129, 'full_parameters': [], 'filename': '/home/dimi/Documents/Informatik_Studium/FSS/SoftEvo/DataCollection/FFS_SoftEvo/go-ipfs/core/core.go', 'top_nesting_level': 0, 'length': 3, 'fan_in': 0, 'fan_out': 0, 'general_fan_out': 0}, {'cyclomatic_complexity': 2, 'nloc': 6, 'token_count': 35, 'name': 'Context', 'long_name': '(n*IpfsNode)Context', 'start_line': 132, 'end_line': 137, 'full_parameters': [], 'filename': '/home/dimi/Documents/Informatik_Studium/FSS/SoftEvo/DataCollection/FFS_SoftEvo/go-ipfs/core/core.go', 'top_nesting_level': 0, 'length': 6, 'fan_in': 0, 'fan_out': 0, 'general_fan_out': 0}, {'cyclomatic_complexity': 2, 'nloc': 13, 'token_count': 66, 'name': '[', 'long_name': '()[', 'start_line': 153, 'end_line': 166, 'full_parameters': [], 'filename': '/home/dimi/Documents/Informatik_Studium/FSS/SoftEvo/DataCollection/FFS_SoftEvo/go-ipfs/core/core.go', 'top_nesting_level': 0, 'length': 14, 'fan_in': 0, 'fan_out': 0, 'general_fan_out': 0}, {'cyclomatic_complexity': 2, 'nloc': 7, 'token_count': 47, 'name': 'loadBootstrapPeers', 'long_name': '(n*IpfsNode)loadBootstrapPeers', 'start_line': 168, 'end_line': 175, 'full_parameters': [], 'filename': '/home/dimi/Documents/Informatik_Studium/FSS/SoftEvo/DataCollection/FFS_SoftEvo/go-ipfs/core/core.go', 'top_nesting_level': 0, 'length': 8, 'fan_in': 0, 'fan_out': 0, 'general_fan_out': 0}]",-572,-3567,-21,179,179,"[{'timestamp': 1507204270.0, 'added_lines': 1, 'deleted_lines': 1, 'nloc': 704}, {'timestamp': 1507304579.0, 'added_lines': 9, 'deleted_lines': 9, 'nloc': 704}, {'timestamp': 1505421817.0, 'added_lines': 29, 'deleted_lines': 1, 'nloc': 729}, {'timestamp': 1508424715.0, 'added_lines': 9, 'deleted_lines': 9, 'nloc': 729}, {'timestamp': 1508440269.0, 'added_lines': 1, 'deleted_lines': 1, 'nloc': 729}, {'timestamp': 1508429712.0, 'added_lines': 4, 'deleted_lines': 1, 'nloc': 731}, {'timestamp': 1509196304.0, 'added_lines': 1, 'deleted_lines': 1, 'nloc': 731}, {'timestamp': 1509224406.0, 'added_lines': 1, 'deleted_lines': 1, 'nloc': 731}, {'timestamp': 1511223906.0, 'added_lines': 17, 'deleted_lines': 17, 'nloc': 731}, {'timestamp': 1499441579.0, 'added_lines': 9, 'deleted_lines': 2, 'nloc': 737}, {'timestamp': 1511062375.0, 'added_lines': 2, 'deleted_lines': 2, 'nloc': 737}, {'timestamp': 1512365669.0, 'added_lines': 23, 'deleted_lines': 23, 'nloc': 737}, {'timestamp': 1516660948.0, 'added_lines': 7, 'deleted_lines': 0, 'nloc': 737}, {'timestamp': 1516838128.0, 'added_lines': 24, 'deleted_lines': 24, 'nloc': 737}, {'timestamp': 1516838710.0, 'added_lines': 6, 'deleted_lines': 2, 'nloc': 740}, {'timestamp': 1516911711.0, 'added_lines': 3, 'deleted_lines': 2, 'nloc': 741}, {'timestamp': 1517105039.0, 'added_lines': 9, 'deleted_lines': 9, 'nloc': 741}, {'timestamp': 1517108398.0, 'added_lines': 5, 'deleted_lines': 1, 'nloc': 745}, {'timestamp': 1517255734.0, 'added_lines': 2, 'deleted_lines': 2, 'nloc': 745}, {'timestamp': 1517453697.0, 'added_lines': 21, 'deleted_lines': 21, 'nloc': 745}, {'timestamp': 1517369532.0, 'added_lines': 2, 'deleted_lines': 2, 'nloc': 745}, {'timestamp': 1518185191.0, 'added_lines': 5, 'deleted_lines': 5, 'nloc': 745}, {'timestamp': 1518714221.0, 'added_lines': 1, 'deleted_lines': 1, 'nloc': 745}, {'timestamp': 1518736190.0, 'added_lines': 2, 'deleted_lines': 2, 'nloc': 745}, {'timestamp': 1519900596.0, 'added_lines': 5, 'deleted_lines': 5, 'nloc': 745}, {'timestamp': 1521421769.0, 'added_lines': 3, 'deleted_lines': 4, 'nloc': 744}, {'timestamp': 1519761835.0, 'added_lines': 5, 'deleted_lines': 5, 'nloc': 745}, {'timestamp': 1519999272.0, 'added_lines': 3, 'deleted_lines': 3, 'nloc': 745}, {'timestamp': 1521399286.0, 'added_lines': 2, 'deleted_lines': 2, 'nloc': 745}, {'timestamp': 1522759157.0, 'added_lines': 1, 'deleted_lines': 1, 'nloc': 745}, {'timestamp': 1524184312.0, 'added_lines': 1, 'deleted_lines': 1, 'nloc': 744}, {'timestamp': 1525872845.0, 'added_lines': 1, 'deleted_lines': 1, 'nloc': 744}, {'timestamp': 1526509320.0, 'added_lines': 2, 'deleted_lines': 13, 'nloc': 734}, {'timestamp': 1525408792.0, 'added_lines': 26, 'deleted_lines': 26, 'nloc': 734}, {'timestamp': 1525409738.0, 'added_lines': 55, 'deleted_lines': 29, 'nloc': 758}, {'timestamp': 1525854115.0, 'added_lines': 1, 'deleted_lines': 1, 'nloc': 758}, {'timestamp': 1528059336.0, 'added_lines': 0, 'deleted_lines': 1, 'nloc': 758}, {'timestamp': 1528131220.0, 'added_lines': 17, 'deleted_lines': 17, 'nloc': 758}, {'timestamp': 1520489177.0, 'added_lines': 54, 'deleted_lines': 87, 'nloc': 735}, {'timestamp': 1528268108.0, 'added_lines': 22, 'deleted_lines': 22, 'nloc': 735}, {'timestamp': 1528520460.0, 'added_lines': 32, 'deleted_lines': 32, 'nloc': 735}, {'timestamp': 1529106827.0, 'added_lines': 2, 'deleted_lines': 1, 'nloc': 736}, {'timestamp': 1528945488.0, 'added_lines': 21, 'deleted_lines': 25, 'nloc': 732}, {'timestamp': 1529984485.0, 'added_lines': 27, 'deleted_lines': 27, 'nloc': 732}, {'timestamp': 1530945148.0, 'added_lines': 2, 'deleted_lines': 2, 'nloc': 732}, {'timestamp': 1530945222.0, 'added_lines': 20, 'deleted_lines': 2, 'nloc': 736}, {'timestamp': 1531779409.0, 'added_lines': 11, 'deleted_lines': 11, 'nloc': 736}, {'timestamp': 1532146078.0, 'added_lines': 12, 'deleted_lines': 12, 'nloc': 736}, {'timestamp': 1532728052.0, 'added_lines': 2, 'deleted_lines': 2, 'nloc': 736}, {'timestamp': 1532740866.0, 'added_lines': 1, 'deleted_lines': 1, 'nloc': 736}, {'timestamp': 1532764253.0, 'added_lines': 1, 'deleted_lines': 1, 'nloc': 736}, {'timestamp': 1532847462.0, 'added_lines': 1, 'deleted_lines': 1, 'nloc': 736}, {'timestamp': 1532986515.0, 'added_lines': 1, 'deleted_lines': 1, 'nloc': 736}, {'timestamp': 1533500571.0, 'added_lines': 6, 'deleted_lines': 6, 'nloc': 736}, {'timestamp': 1533618653.0, 'added_lines': 7, 'deleted_lines': 7, 'nloc': 736}, {'timestamp': 1533779477.0, 'added_lines': 34, 'deleted_lines': 34, 'nloc': 736}, {'timestamp': 1532357069.0, 'added_lines': 3, 'deleted_lines': 3, 'nloc': 736}, {'timestamp': 1532365899.0, 'added_lines': 2, 'deleted_lines': 2, 'nloc': 736}, {'timestamp': 1532388583.0, 'added_lines': 1, 'deleted_lines': 1, 'nloc': 736}, {'timestamp': 1532507240.0, 'added_lines': 4, 'deleted_lines': 1, 'nloc': 739}, {'timestamp': 1533809170.0, 'added_lines': 6, 'deleted_lines': 8, 'nloc': 737}, {'timestamp': 1533946888.0, 'added_lines': 1, 'deleted_lines': 1, 'nloc': 737}, {'timestamp': 1534115707.0, 'added_lines': 18, 'deleted_lines': 18, 'nloc': 737}, {'timestamp': 1534195762.0, 'added_lines': 14, 'deleted_lines': 14, 'nloc': 737}, {'timestamp': 1534347022.0, 'added_lines': 17, 'deleted_lines': 17, 'nloc': 737}, {'timestamp': 1534072974.0, 'added_lines': 1, 'deleted_lines': 1, 'nloc': 737}, {'timestamp': 1534067285.0, 'added_lines': 20, 'deleted_lines': 1, 'nloc': 751}, {'timestamp': 1534771694.0, 'added_lines': 1, 'deleted_lines': 1, 'nloc': 751}, {'timestamp': 1534896611.0, 'added_lines': 34, 'deleted_lines': 34, 'nloc': 751}, {'timestamp': 1535255498.0, 'added_lines': 1, 'deleted_lines': 1, 'nloc': 751}, {'timestamp': 1533628922.0, 'added_lines': 5, 'deleted_lines': 0, 'nloc': 755}, {'timestamp': 1535601896.0, 'added_lines': 24, 'deleted_lines': 24, 'nloc': 755}, {'timestamp': 1535752387.0, 'added_lines': 3, 'deleted_lines': 0, 'nloc': 756}, {'timestamp': 1535752436.0, 'added_lines': 3, 'deleted_lines': 0, 'nloc': 757}, {'timestamp': 1536388808.0, 'added_lines': 30, 'deleted_lines': 30, 'nloc': 757}, {'timestamp': 1536718784.0, 'added_lines': 19, 'deleted_lines': 19, 'nloc': 757}, {'timestamp': 1536723292.0, 'added_lines': 11, 'deleted_lines': 11, 'nloc': 757}, {'timestamp': 1537260123.0, 'added_lines': 2, 'deleted_lines': 1, 'nloc': 758}, {'timestamp': 1537790637.0, 'added_lines': 14, 'deleted_lines': 14, 'nloc': 758}, {'timestamp': 1537792589.0, 'added_lines': 35, 'deleted_lines': 35, 'nloc': 758}, {'timestamp': 1537963315.0, 'added_lines': 11, 'deleted_lines': 8, 'nloc': 761}, {'timestamp': 1538544957.0, 'added_lines': 30, 'deleted_lines': 30, 'nloc': 758}, {'timestamp': 1538630728.0, 'added_lines': 7, 'deleted_lines': 5, 'nloc': 760}, {'timestamp': 1538547366.0, 'added_lines': 1, 'deleted_lines': 1, 'nloc': 760}, {'timestamp': 1538694687.0, 'added_lines': 9, 'deleted_lines': 9, 'nloc': 760}, {'timestamp': 1538695953.0, 'added_lines': 18, 'deleted_lines': 18, 'nloc': 760}, {'timestamp': 1538773916.0, 'added_lines': 32, 'deleted_lines': 32, 'nloc': 760}, {'timestamp': 1539176817.0, 'added_lines': 30, 'deleted_lines': 30, 'nloc': 760}, {'timestamp': 1539357340.0, 'added_lines': 19, 'deleted_lines': 19, 'nloc': 760}, {'timestamp': 1539850591.0, 'added_lines': 2, 'deleted_lines': 2, 'nloc': 760}, {'timestamp': 1540399032.0, 'added_lines': 11, 'deleted_lines': 11, 'nloc': 761}, {'timestamp': 1540400358.0, 'added_lines': 34, 'deleted_lines': 34, 'nloc': 761}, {'timestamp': 1540403365.0, 'added_lines': 11, 'deleted_lines': 7, 'nloc': 763}, {'timestamp': 1540410565.0, 'added_lines': 15, 'deleted_lines': 15, 'nloc': 763}, {'timestamp': 1540418491.0, 'added_lines': 19, 'deleted_lines': 19, 'nloc': 763}, {'timestamp': 1540511926.0, 'added_lines': 1, 'deleted_lines': 1, 'nloc': 763}, {'timestamp': 1540489644.0, 'added_lines': 14, 'deleted_lines': 5, 'nloc': 770}, {'timestamp': 1540558663.0, 'added_lines': 2, 'deleted_lines': 2, 'nloc': 770}, {'timestamp': 1540820079.0, 'added_lines': 2, 'deleted_lines': 2, 'nloc': 770}, {'timestamp': 1540603818.0, 'added_lines': 5, 'deleted_lines': 5, 'nloc': 770}, {'timestamp': 1540907741.0, 'added_lines': 1, 'deleted_lines': 6, 'nloc': 767}, {'timestamp': 1540916861.0, 'added_lines': 2, 'deleted_lines': 2, 'nloc': 767}, {'timestamp': 1541106379.0, 'added_lines': 2, 'deleted_lines': 2, 'nloc': 767}, {'timestamp': 1541189794.0, 'added_lines': 4, 'deleted_lines': 4, 'nloc': 767}, {'timestamp': 1541204121.0, 'added_lines': 40, 'deleted_lines': 40, 'nloc': 767}, {'timestamp': 1541903826.0, 'added_lines': 28, 'deleted_lines': 28, 'nloc': 767}, {'timestamp': 1543282933.0, 'added_lines': 1, 'deleted_lines': 1, 'nloc': 767}, {'timestamp': 1543443696.0, 'added_lines': 4, 'deleted_lines': 4, 'nloc': 767}, {'timestamp': 1544225843.0, 'added_lines': 30, 'deleted_lines': 30, 'nloc': 767}, {'timestamp': 1544667474.0, 'added_lines': 6, 'deleted_lines': 33, 'nloc': 750}, {'timestamp': 1544731305.0, 'added_lines': 7, 'deleted_lines': 0, 'nloc': 756}, {'timestamp': 1542635999.0, 'added_lines': 20, 'deleted_lines': 9, 'nloc': 764}, {'timestamp': 1543409646.0, 'added_lines': 10, 'deleted_lines': 7, 'nloc': 766}, {'timestamp': 1543410576.0, 'added_lines': 12, 'deleted_lines': 2, 'nloc': 775}, {'timestamp': 1543504832.0, 'added_lines': 6, 'deleted_lines': 1, 'nloc': 779}, {'timestamp': 1544521781.0, 'added_lines': 1, 'deleted_lines': 1, 'nloc': 779}, {'timestamp': 1544522106.0, 'added_lines': 11, 'deleted_lines': 10, 'nloc': 780}, {'timestamp': 1544687781.0, 'added_lines': 10, 'deleted_lines': 10, 'nloc': 780}, {'timestamp': 1545197835.0, 'added_lines': 3, 'deleted_lines': 3, 'nloc': 780}, {'timestamp': 1540556089.0, 'added_lines': 2, 'deleted_lines': 2, 'nloc': 780}, {'timestamp': 1545321731.0, 'added_lines': 2, 'deleted_lines': 1, 'nloc': 781}, {'timestamp': 1545323704.0, 'added_lines': 1, 'deleted_lines': 1, 'nloc': 781}, {'timestamp': 1546553605.0, 'added_lines': 1, 'deleted_lines': 1, 'nloc': 781}, {'timestamp': 1547003974.0, 'added_lines': 29, 'deleted_lines': 29, 'nloc': 781}, {'timestamp': 1547499910.0, 'added_lines': 8, 'deleted_lines': 8, 'nloc': 781}, {'timestamp': 1548866534.0, 'added_lines': 2, 'deleted_lines': 2, 'nloc': 781}, {'timestamp': 1549588289.0, 'added_lines': 30, 'deleted_lines': 30, 'nloc': 781}, {'timestamp': 1549903582.0, 'added_lines': 2, 'deleted_lines': 2, 'nloc': 781}, {'timestamp': 1550185115.0, 'added_lines': 15, 'deleted_lines': 15, 'nloc': 781}, {'timestamp': 1550507829.0, 'added_lines': 38, 'deleted_lines': 38, 'nloc': 781}, {'timestamp': 1550711994.0, 'added_lines': 9, 'deleted_lines': 9, 'nloc': 781}, {'timestamp': 1550723346.0, 'added_lines': 23, 'deleted_lines': 23, 'nloc': 781}, {'timestamp': 1551229859.0, 'added_lines': 32, 'deleted_lines': 32, 'nloc': 781}, {'timestamp': 1551245415.0, 'added_lines': 2, 'deleted_lines': 2, 'nloc': 781}, {'timestamp': 1551299964.0, 'added_lines': 19, 'deleted_lines': 19, 'nloc': 781}, {'timestamp': 1551492008.0, 'added_lines': 2, 'deleted_lines': 2, 'nloc': 781}, {'timestamp': 1551754781.0, 'added_lines': 3, 'deleted_lines': 33, 'nloc': 760}, {'timestamp': 1551752155.0, 'added_lines': 1, 'deleted_lines': 1, 'nloc': 781}, {'timestamp': 1551551196.0, 'added_lines': 46, 'deleted_lines': 46, 'nloc': 760}, {'timestamp': 1552083569.0, 'added_lines': 8, 'deleted_lines': 0, 'nloc': 763}, {'timestamp': 1552091511.0, 'added_lines': 1, 'deleted_lines': 1, 'nloc': 763}, {'timestamp': 1552093097.0, 'added_lines': 1, 'deleted_lines': 1, 'nloc': 763}, {'timestamp': 1553116410.0, 'added_lines': 1, 'deleted_lines': 1, 'nloc': 763}, {'timestamp': 1553697989.0, 'added_lines': 7, 'deleted_lines': 3, 'nloc': 767}, {'timestamp': 1553738069.0, 'added_lines': 2, 'deleted_lines': 2, 'nloc': 767}, {'timestamp': 1554483132.0, 'added_lines': 4, 'deleted_lines': 0, 'nloc': 770}, {'timestamp': 1553734162.0, 'added_lines': 8, 'deleted_lines': 10, 'nloc': 769}, {'timestamp': 1553738233.0, 'added_lines': 18, 'deleted_lines': 14, 'nloc': 771}, {'timestamp': 1553871352.0, 'added_lines': 5, 'deleted_lines': 10, 'nloc': 764}, {'timestamp': 1554119110.0, 'added_lines': 20, 'deleted_lines': 20, 'nloc': 764}, {'timestamp': 1554131843.0, 'added_lines': 1, 'deleted_lines': 1, 'nloc': 764}, {'timestamp': 1554137376.0, 'added_lines': 2, 'deleted_lines': 2, 'nloc': 764}, {'timestamp': 1554147257.0, 'added_lines': 15, 'deleted_lines': 631, 'nloc': 302}, {'timestamp': 1554255872.0, 'added_lines': 10, 'deleted_lines': 211, 'nloc': 135}, {'timestamp': 1556015751.0, 'added_lines': 5, 'deleted_lines': 4, 'nloc': 136}, {'timestamp': 1556023260.0, 'added_lines': 4, 'deleted_lines': 4, 'nloc': 136}, {'timestamp': 1556573857.0, 'added_lines': 2, 'deleted_lines': 2, 'nloc': 136}, {'timestamp': 1558801722.0, 'added_lines': 2, 'deleted_lines': 4, 'nloc': 135}, {'timestamp': 1555520888.0, 'added_lines': 1, 'deleted_lines': 3, 'nloc': 133}, {'timestamp': 1559060517.0, 'added_lines': 14, 'deleted_lines': 14, 'nloc': 133}, {'timestamp': 1559347612.0, 'added_lines': 1, 'deleted_lines': 5, 'nloc': 129}, {'timestamp': 1562188975.0, 'added_lines': 1, 'deleted_lines': 1, 'nloc': 129}, {'timestamp': 1563198626.0, 'added_lines': 1, 'deleted_lines': 1, 'nloc': 129}, {'timestamp': 1566973868.0, 'added_lines': 2, 'deleted_lines': 1, 'nloc': 130}, {'timestamp': 1569537492.0, 'added_lines': 0, 'deleted_lines': 7, 'nloc': 124}, {'timestamp': 1574264289.0, 'added_lines': 10, 'deleted_lines': 9, 'nloc': 124}, {'timestamp': 1576143745.0, 'added_lines': 10, 'deleted_lines': 10, 'nloc': 124}, {'timestamp': 1579218500.0, 'added_lines': 1, 'deleted_lines': 1, 'nloc': 124}, {'timestamp': 1581477630.0, 'added_lines': 9, 'deleted_lines': 7, 'nloc': 126}, {'timestamp': 1585086401.0, 'added_lines': 0, 'deleted_lines': 2, 'nloc': 124}, {'timestamp': 1586818692.0, 'added_lines': 2, 'deleted_lines': 2, 'nloc': 124}, {'timestamp': 1589955086.0, 'added_lines': 2, 'deleted_lines': 0, 'nloc': 126}, {'timestamp': 1590423981.0, 'added_lines': 2, 'deleted_lines': 0, 'nloc': 128}, {'timestamp': 1613691223.0, 'added_lines': 2, 'deleted_lines': 2, 'nloc': 128}, {'timestamp': 1618224384.0, 'added_lines': 2, 'deleted_lines': 0, 'nloc': 130}, {'timestamp': 1617641312.0, 'added_lines': 5, 'deleted_lines': 2, 'nloc': 131}, {'timestamp': 1628318970.0, 'added_lines': 1, 'deleted_lines': 1, 'nloc': 131}, {'timestamp': 1629221569.0, 'added_lines': 14, 'deleted_lines': 13, 'nloc': 132}, {'timestamp': 1629304396.0, 'added_lines': 2, 'deleted_lines': 2, 'nloc': 132}]","{'core/coreapi/unixfs_test.go': 53, 'core/coredag/cbor.go': 19, 'merkledag/merkledag.go': 10, 'package.json': 101, 'core/bootstrap.go': 39, 'core/bootstrap_test.go': 36, 'core/commands/dht.go': 72, 'core/commands/dht_test.go': 28, 'core/commands/id.go': 48, 'core/commands/pubsub.go': 40, 'core/corehttp/gateway.go': 43, 'core/corehttp/gateway_test.go': 73, 'core/corehttp/metrics_test.go': 40, 'core/mock/mock.go': 52, 'exchange/bitswap/bitswap_test.go': 19, 'exchange/bitswap/decision/bench_test.go': 9, 'exchange/bitswap/decision/engine_test.go': 13, 'exchange/bitswap/decision/peer_request_queue_test.go': 9, 'exchange/bitswap/network/ipfs_impl.go': 12, 'exchange/bitswap/testnet/interface.go': 8, 'exchange/bitswap/testnet/network_test.go': 15, 'exchange/bitswap/testnet/peernet.go': 19, 'exchange/bitswap/testnet/virtual.go': 16, 'exchange/bitswap/testutils.go': 18, 'exchange/reprovide/reprovide_test.go': 44, 'fuse/ipns/ipns_test.go': 41, 'fuse/node/mount_test.go': 40, 'fuse/readonly/ipfs_test.go': 60, 'mfs/repub_test.go': 12, 'namesys/publisher_test.go': 44, 'namesys/republisher/repub_test.go': 57, 'namesys/resolve_test.go': 60, 'p2p/p2p.go': 28, 'routing/mock/centralized_client.go': 6, 'routing/mock/centralized_server.go': 6, 'routing/mock/centralized_test.go': 5, 'routing/mock/interface.go': 6, 'routing/none/none_client.go': 5, 'routing/offline/offline_test.go': 6, 'test/integration/addcat_test.go': 42, 'test/integration/bench_cat_test.go': 42, 'test/integration/bench_test.go': 20, 'test/integration/bitswap_wo_routing_test.go': 44, 'test/integration/three_legged_cat_test.go': 42, 'thirdparty/ipfsaddr/ipfsaddr.go': 2, 'docs/config.md': 2, 'repo/config/swarm.go': 1, 'core/commands/swarm.go': 55, 'repo/config/init.go': 9, 'cmd/ipfs/daemon.go': 39, 'cmd/ipfs/init.go': 39, 'cmd/ipfs/ipfs.go': 21, 'cmd/ipfs/main.go': 44, 'cmd/ipfs/main_test.go': 2, 'cmd/ipfswatch/main.go': 30, 'cmd/seccat/seccat.go': 30, 'commands/cli/helptext.go': 1, 'commands/cli/helptext_test.go': 1, 'commands/cli/parse.go': 1, 'commands/cli/parse_test.go': 1, 'commands/command.go': 14, 'commands/command_test.go': 5, 'commands/http/client.go': 1, 'commands/http/handler.go': 1, 'commands/http/multifilereader.go': 1, 'commands/http/multifilereader_test.go': 1, 'commands/http/parse.go': 1, 'commands/request.go': 27, 'commands/response.go': 9, 'commands/response_test.go': 5, 'core/commands/active.go': 12, 'core/commands/add.go': 47, 'core/commands/bitswap.go': 53, 'core/commands/block.go': 29, 'core/commands/bootstrap.go': 34, 'core/commands/cat.go': 27, 'core/commands/commands.go': 21, 'core/commands/config.go': 35, 'core/commands/dag/dag.go': 55, 'core/commands/diag.go': 12, 'core/commands/dns.go': 20, 'core/commands/external.go': 12, 'core/commands/files/files.go': 6, 'core/commands/filestore.go': 27, 'core/commands/get.go': 57, 'core/commands/get_test.go': 20, 'core/commands/helptext_test.go': 20, 'core/commands/ipns.go': 18, 'core/commands/keystore.go': 23, 'core/commands/log.go': 18, 'core/commands/ls.go': 58, 'core/commands/mount_nofuse.go': 12, 'core/commands/mount_unix.go': 34, 'core/commands/name.go': 6, 'core/commands/object/diff.go': 19, 'core/commands/object/object.go': 57, 'core/commands/object/patch.go': 26, 'core/commands/p2p.go': 29, 'core/commands/pin.go': 60, 'core/commands/ping.go': 36, 'core/commands/publish.go': 17, 'core/commands/refs.go': 52, 'core/commands/repo.go': 53, 'core/commands/resolve.go': 50, 'core/commands/root.go': 20, 'core/commands/shutdown.go': 17, 'core/commands/stat.go': 27, 'core/commands/sysdiag.go': 23, 'core/commands/tar.go': 50, 'core/commands/unixfs/ls.go': 51, 'core/commands/unixfs/unixfs.go': 12, 'core/commands/version.go': 17, 'core/corehttp/commands.go': 67, 'core/coreunix/add.go': 64, 'core/coreunix/add_test.go': 68, 'exchange/bitswap/message/message.go': 9, 'exchange/bitswap/network/interface.go': 9, 'importer/helpers/dagbuilder.go': 10, 'importer/importer.go': 10, 'p2p/registry.go': 12, 'repo/config/bootstrap_peers.go': 12, 'core/builder.go': 90, 'core/commands/ipnsps.go': 8, 'core/commands/mount_windows.go': 12, 'namesys/interface.go': 46, 'namesys/namesys.go': 57, 'namesys/namesys_test.go': 64, 'namesys/pubsub.go': 10, 'namesys/pubsub_test.go': 11, 'test/sharness/t0183-namesys-pubsub.sh': 2, 'blocks/blockstore/arc_cache.go': 3, 'blocks/blockstore/arc_cache_test.go': 3, 'blocks/blockstore/blockstore.go': 4, 'blocks/blockstore/blockstore_test.go': 3, 'blocks/blockstore/bloom_cache_test.go': 3, 'blocks/blockstore/util/remove.go': 3, 'blockservice/blockservice_test.go': 10, 'blockservice/test/blocks_test.go': 11, 'core/coreunix/metadata_test.go': 60, 'exchange/offline/offline_test.go': 5, 'filestore/filestore.go': 30, 'filestore/filestore_test.go': 49, 'filestore/fsrefstore.go': 29, 'filestore/util.go': 27, 'merkledag/test/utils.go': 12, 'merkledag/utils/utils.go': 13, 'mfs/mfs_test.go': 24, 'namesys/publisher.go': 65, 'namesys/republisher/repub.go': 53, 'pin/pin.go': 51, 'pin/pin_test.go': 52, 'pin/set_test.go': 50, 'repo/fsrepo/datastores.go': 18, 'repo/fsrepo/fsrepo.go': 41, 'repo/fsrepo/fsrepo_test.go': 30, 'repo/repo.go': 36, 'routing/offline/offline.go': 4, 'thirdparty/datastore2/datastore_closer.go': 3, 'thirdparty/datastore2/delayed.go': 3, 'thirdparty/datastore2/threadsafe.go': 3, 'thirdparty/ds-help/key.go': 3, 'assets/assets.go': 48, 'blocks/blockstore/bloom_cache.go': 2, 'blocks/blocksutil/block_generator.go': 2, 'blockservice/blockservice.go': 12, 'core/coreapi/coreapi.go': 38, 'core/coreapi/interface/interface.go': 2, 'core/coreapi/unixfs.go': 52, 'core/coredag/dagpb.go': 44, 'core/coredag/dagtransl.go': 14, 'core/coredag/raw.go': 44, 'core/corehttp/corehttp.go': 17, 'core/corehttp/gateway_handler.go': 63, 'core/corerepo/gc.go': 54, 'core/corerepo/pinning.go': 22, 'core/coreunix/metadata.go': 51, 'core/pathresolver.go': 49, 'exchange/bitswap/bitswap.go': 12, 'exchange/bitswap/decision/engine.go': 10, 'exchange/bitswap/decision/ledger.go': 7, 'exchange/bitswap/decision/peer_request_queue.go': 7, 'exchange/bitswap/get.go': 9, 'exchange/bitswap/message/message_test.go': 4, 'exchange/bitswap/notifications/notifications.go': 4, 'exchange/bitswap/notifications/notifications_test.go': 4, 'exchange/bitswap/session.go': 8, 'exchange/bitswap/session_test.go': 6, 'exchange/bitswap/stat.go': 4, 'exchange/bitswap/wantlist/wantlist.go': 4, 'exchange/bitswap/wantlist/wantlist_test.go': 4, 'exchange/bitswap/wantmanager.go': 8, 'exchange/bitswap/workers.go': 7, 'exchange/interface.go': 2, 'exchange/offline/offline.go': 5, 'exchange/reprovide/providers.go': 50, 'exchange/reprovide/reprovide.go': 31, 'fuse/ipns/ipns_unix.go': 59, 'fuse/readonly/readonly_unix.go': 61, 'importer/balanced/balanced_test.go': 10, 'importer/balanced/builder.go': 5, 'importer/chunk/rabin_test.go': 2, 'importer/chunk/splitting_test.go': 2, 'importer/helpers/helpers.go': 8, 'importer/importer_test.go': 9, 'importer/trickle/trickle_test.go': 10, 'importer/trickle/trickledag.go': 7, 'merkledag/batch.go': 2, 'merkledag/coding.go': 6, 'merkledag/merkledag_test.go': 11, 'merkledag/node.go': 6, 'merkledag/node_test.go': 6, 'merkledag/raw.go': 5, 'merkledag/traverse/traverse.go': 5, 'merkledag/traverse/traverse_test.go': 6, 'merkledag/utils/diff.go': 6, 'merkledag/utils/diffenum.go': 5, 'merkledag/utils/diffenum_test.go': 6, 'merkledag/utils/utils_test.go': 6, 'mfs/dir.go': 15, 'mfs/file.go': 17, 'mfs/ops.go': 12, 'mfs/system.go': 18, 'namesys/ipns_select_test.go': 4, 'namesys/routing.go': 58, 'path/path.go': 6, 'path/resolver.go': 5, 'path/resolver_test.go': 4, 'pin/gc/gc.go': 52, 'pin/set.go': 45, 'plugin/ipld.go': 15, 'plugin/loader/initializer.go': 11, 'plugin/plugins/git/git.go': 14, 'repo/fsrepo/lock/lock.go': 3, 'repo/fsrepo/serialize/serialize.go': 4, 'repo/mock.go': 30, 'tar/format.go': 58, 'test/dependencies/ma-pipe-unidir/main.go': 11, 'thirdparty/pollEndpoint/main.go': 16, 'thirdparty/posinfo/posinfo.go': 3, 'unixfs/archive/archive.go': 8, 'unixfs/archive/tar/writer.go': 9, 'unixfs/hamt/hamt.go': 8, 'unixfs/io/dagreader.go': 8, 'unixfs/io/dirbuilder.go': 5, 'unixfs/io/resolve.go': 8, 'unixfs/mod/dagmodifier.go': 10, 'unixfs/mod/dagmodifier_test.go': 4, 'unixfs/test/utils.go': 11, 'commands/legacy/command.go': 12, 'commands/legacy/legacy.go': 12, 'commands/legacy/legacy_test.go': 12, 'commands/legacy/request.go': 13, 'commands/legacy/response.go': 12, 'core/commands/commands_test.go': 18, 'core/coreapi/dag.go': 14, 'core/coreapi/dag_test.go': 3, 'core/coreapi/interface/options/dag.go': 8, 'core/coreapi/key.go': 47, 'core/coreapi/name.go': 57, 'unixfs/io/pbdagreader.go': 8, None: 129, 'mfs/fd.go': 9, 'unixfs/hamt/hamt_stress_test.go': 6, 'unixfs/hamt/hamt_test.go': 6, 'unixfs/io/dagreader_test.go': 3, 'unixfs/io/dirbuilder_test.go': 1, 'cmd/ipfs/util/ulimit.go': 9, 'cmd/seccat/util.go': 10, 'core/corehttp/logs.go': 9, 'fuse/mount/mount.go': 11, 'fuse/node/mount_unix.go': 11, 'importer/chunk/splitting.go': 1, 'namesys/ipns_validate_test.go': 10, 'plugin/loader/load.go': 7, 'namesys/selector.go': 1, 'namesys/validator.go': 7, 'blockservice/test/mock.go': 11, 'blocks/blockstoreutil/remove.go': 25, 'core/coreapi/block.go': 17, 'core/commands/files.go': 57, 'core/coreunix/cat.go': 17, 'path/resolver/resolver.go': 6, 'path/resolver/resolver_test.go': 4, 'path/path_test.go': 1, 'test/api-startup/main.go': 1, 'core/coreapi/object.go': 50, 'fuse/mount/fuse.go': 5, 'keystore/keystore_test.go': 8, 'namesys/dns_test.go': 9, 'repo/config/config.go': 1, 'unixfs/unixfs.go': 3, 'core/core_test.go': 28, 'core/coreapi/pin.go': 48, 'fuse/ipns/common.go': 50, 'keystore/keystore.go': 10, 'keystore/memkeystore.go': 6, 'repo/config/identity.go': 2, 'thirdparty/verifbs/verifbs.go': 23, 'core/corehttp/ipns_hostname.go': 9, 'cmd/ipfs/util/ulimit_freebsd.go': 2, 'cmd/ipfs/util/ulimit_unix.go': 2, 'core/coreapi/block_test.go': 2, 'core/coreapi/interface/coreapi.go': 9, 'core/coreapi/interface/dag.go': 9, 'core/coreapi/interface/object.go': 9, 'core/coreapi/interface/options/block.go': 3, 'core/coreapi/interface/path.go': 35, 'core/coreapi/interface/unixfs.go': 13, 'fuse/ipns/link_unix.go': 2, 'fuse/node/mount_darwin.go': 2, 'merkledag/errservice.go': 2, 'merkledag/readonly.go': 2, 'merkledag/readonly_test.go': 2, 'merkledag/rwservice.go': 2, 'merkledag/session.go': 2, 'thirdparty/verifcid/validate.go': 2, 'thirdparty/verifcid/validate_test.go': 2, 'Rules.mk': 4, 'namesys/ipns_resolver_validation_test.go': 46, 'test/sharness/t0170-dht.sh': 2, 'core/commands/urlstore.go': 47, 'unixfs/io/directory.go': 3, 'core/corehttp/metrics.go': 2, 'dagutils/diff.go': 41, 'dagutils/diffenum.go': 39, 'dagutils/diffenum_test.go': 39, 'dagutils/utils.go': 42, 'dagutils/utils_test.go': 41, 'unixfs/io/directory_test.go': 2, 'core/coreapi/name_test.go': 32, 'core/coreapi/path.go': 49, 'core/pathresolver_test.go': 40, 'namesys/base.go': 41, 'namesys/cache.go': 40, 'namesys/dns.go': 41, 'namesys/proquint.go': 41, 'unixfs/importer/balanced/balanced_test.go': 1, 'unixfs/importer/balanced/builder.go': 1, 'unixfs/importer/helpers/dagbuilder.go': 1, 'unixfs/importer/helpers/helpers.go': 1, 'unixfs/importer/importer.go': 1, 'unixfs/importer/importer_test.go': 1, 'unixfs/importer/trickle/trickle_test.go': 1, 'unixfs/importer/trickle/trickledag.go': 1, 'unixfs/unixfs_test.go': 1, 'core/commands/env.go': 8, 'core/coreapi/interface/key.go': 7, 'filestore/pb/dataobj.pb.go': 3, 'pin/internal/pb/header.pb.go': 3, 'thirdparty/cidv0v1/blockstore.go': 16, 'repo/fsrepo/misc.go': 24, 'cmd/ipfs/Rules.mk': 1, 'core/corehttp/option_test.go': 3, 'docs/releases.md': 2, 'docs/windows.md': 2, 'repo/fsrepo/config_test.go': 23, 'repo/version.go': 1, 'test/bench/bench_cli_ipfs_add/main.go': 24, 'test/bench/offline_add/main.go': 24, 'version.go': 2, 'core/commands/cmdenv/env.go': 26, 'docs/experimental-features.md': 2, 'core/commands/name/ipns.go': 38, 'core/commands/name/publish.go': 20, 'core/coreapi/dht.go': 31, 'core/coreapi/dht_test.go': 5, 'test/sharness/t0275-cid-security.sh': 1, 'core/commands/name/ipnsps.go': 14, 'core/commands/name/name.go': 9, 'core/coreapi/interface/dht.go': 10, 'p2p/listener.go': 14, 'p2p/local.go': 15, 'p2p/remote.go': 15, 'p2p/stream.go': 15, 'core/coreapi/interface/swarm.go': 9, 'core/coreapi/swarm.go': 23, 'core/coreapi/interface/options/unixfs.go': 15, 'core/coreapi/pubsub.go': 25, 'core/coreapi/unixfile.go': 17, 'core/commands/cid.go': 10, 'README.md': 1, 'cmd/ipfs/dnsresolve_test.go': 5, 'core/coreapi/interface/pubsub.go': 4, 'test/sharness/t0180-pubsub.sh': 1, 'test/dependencies/iptb/iptb.go': 16, 'plugin/plugins/badgerds/badgerds.go': 3, 'plugin/plugins/flatfs/flatfs.go': 4, 'plugin/plugins/levelds/levelds.go': 3, 'commands/context.go': 15, 'core/corehttp/proxy.go': 10, 'core/coreapi/test/api_test.go': 15, 'core/coreapi/interface/tests/name.go': 4, 'core/coreapi/interface/tests/unixfs.go': 4, 'plugin/loader/loader.go': 11, 'core/commands/cmdenv/cidbase.go': 6, 'core/commands/cmdenv/file.go': 3, 'plugin/daemon.go': 8, 'core/commands/cmdenv/cidbase_test.go': 2, 'core/corehttp/proxy_test.go': 2, 'core/corerepo/stat.go': 1, 'plugin/tracer.go': 1, 'thirdparty/notifier/notifier.go': 1, 'core/coreapi/provider.go': 2, 'provider/provider.go': 6, 'provider/queue.go': 4, 'provider/offline.go': 4, 'commands/reqlog.go': 1, 'core/corehttp/mutex_profile.go': 1, 'provider/queue_test.go': 1, 'core/ncore.go': 7, 'fuse/ipns/mount_unix.go': 1, 'fuse/readonly/mount_unix.go': 1, 'test/sharness/t0270-filestore.sh': 1, 'core/bootstrap/bootstrap.go': 4, 'core/bootstrap/bootstrap_test.go': 3, 'core/node/builder.go': 3, 'core/node/core.go': 7, 'core/node/discovery.go': 1, 'core/node/groups.go': 12, 'core/node/helpers.go': 3, 'core/node/identity.go': 3, 'core/node/ipns.go': 5, 'core/node/libp2p.go': 1, 'core/node/provider.go': 9, 'core/node/storage.go': 4, 'core/node/helpers/helpers.go': 1, 'core/node/libp2p/discovery.go': 5, 'core/node/libp2p/libp2p.go': 4, 'reprovide/providers.go': 2, 'reprovide/reprovide.go': 1, 'reprovide/reprovide_test.go': 1, 'go.mod': 13, 'go.sum': 13, 'provider/queue/queue.go': 1, 'provider/queue/queue_test.go': 1, 'provider/simple/provider.go': 2, 'provider/simple/provider_test.go': 2, 'provider/simple/reprovide.go': 2, 'provider/simple/reprovide_test.go': 2, 'provider/system.go': 1, 'test/sharness/lib/iptb-lib.sh': 1, 'test/sharness/t0175-provider.sh': 1, 'test/sharness/t0175-reprovider.sh': 1, 'test/sharness/t0175-strategic-provider.sh': 1, 'core/node/libp2p/addrs.go': 2, 'core/node/libp2p/host.go': 2, 'core/node/libp2p/hostopt.go': 1, 'core/node/libp2p/nat.go': 2, 'core/node/libp2p/pnet.go': 2, 'core/node/libp2p/pubsub.go': 1, 'core/node/libp2p/routing.go': 3, 'core/node/libp2p/routingopt.go': 2, 'core/node/libp2p/smux.go': 2, 'core/node/libp2p/transport.go': 4, 'gc/gc.go': 1, 'plugin/loader/load_unix.go': 1, 'core/node/graphsync.go': 1, 'core/node/peering.go': 1, 'peering/peering.go': 1, 'peering/peering_test.go': 1, 'test/sharness/t0171-peering.sh': 1, 'core/corehttp/hostname.go': 1, 'core/node/dns.go': 1, 'core/node/libp2p/dns.go': 1, 'core/commands/stat_dht.go': 1, 'CHANGELOG.md': 1, 'core/commands/dag/get.go': 1, 'core/commands/dag/put.go': 1, 'test/sharness/t0053-dag.sh': 1, 'test/sharness/t0055-dag-put-json-new-line.sh': 1, 'test/sharness/t0280-plugin-git.sh': 1}","('core/builder.go', 0.5027932960893855, 0.7964601769911505)"
core/core_test.go,55,259,1,"[{'cyclomatic_complexity': 7, 'nloc': 43, 'token_count': 230, 'name': 'TestInitialization', 'long_name': 'TestInitialization t * testing . T', 'start_line': 12, 'end_line': 59, 'full_parameters': ['t * testing . T'], 'filename': '/home/dimi/Documents/Informatik_Studium/FSS/SoftEvo/DataCollection/FFS_SoftEvo/go-ipfs/core/core_test.go', 'top_nesting_level': 0, 'length': 48, 'fan_in': 0, 'fan_out': 0, 'general_fan_out': 0}]",56,285,1,"[{'cyclomatic_complexity': 7, 'nloc': 43, 'token_count': 254, 'name': 'TestInitialization', 'long_name': 'TestInitialization t * testing . T', 'start_line': 15, 'end_line': 62, 'full_parameters': ['t * testing . T'], 'filename': '/home/dimi/Documents/Informatik_Studium/FSS/SoftEvo/DataCollection/FFS_SoftEvo/go-ipfs/core/core_test.go', 'top_nesting_level': 0, 'length': 48, 'fan_in': 0, 'fan_out': 0, 'general_fan_out': 0}]",1,26,0,31,31,"[{'timestamp': 1491058697.0, 'added_lines': 1, 'deleted_lines': 0, 'nloc': 55}, {'timestamp': 1519765635.0, 'added_lines': 5, 'deleted_lines': 3, 'nloc': 56}, {'timestamp': 1525408792.0, 'added_lines': 2, 'deleted_lines': 2, 'nloc': 56}, {'timestamp': 1532365899.0, 'added_lines': 1, 'deleted_lines': 1, 'nloc': 56}, {'timestamp': 1532388583.0, 'added_lines': 1, 'deleted_lines': 1, 'nloc': 56}, {'timestamp': 1533809170.0, 'added_lines': 1, 'deleted_lines': 1, 'nloc': 56}, {'timestamp': 1534195762.0, 'added_lines': 2, 'deleted_lines': 2, 'nloc': 56}, {'timestamp': 1534072974.0, 'added_lines': 1, 'deleted_lines': 1, 'nloc': 56}, {'timestamp': 1534896611.0, 'added_lines': 1, 'deleted_lines': 1, 'nloc': 56}, {'timestamp': 1535255498.0, 'added_lines': 1, 'deleted_lines': 1, 'nloc': 56}, {'timestamp': 1535601896.0, 'added_lines': 1, 'deleted_lines': 1, 'nloc': 56}, {'timestamp': 1536388808.0, 'added_lines': 3, 'deleted_lines': 3, 'nloc': 56}, {'timestamp': 1537792589.0, 'added_lines': 3, 'deleted_lines': 3, 'nloc': 56}, {'timestamp': 1538544957.0, 'added_lines': 3, 'deleted_lines': 3, 'nloc': 56}, {'timestamp': 1538630728.0, 'added_lines': 2, 'deleted_lines': 2, 'nloc': 56}, {'timestamp': 1538547366.0, 'added_lines': 1, 'deleted_lines': 1, 'nloc': 56}, {'timestamp': 1538773916.0, 'added_lines': 2, 'deleted_lines': 2, 'nloc': 56}, {'timestamp': 1540400358.0, 'added_lines': 1, 'deleted_lines': 1, 'nloc': 56}, {'timestamp': 1540489644.0, 'added_lines': 1, 'deleted_lines': 1, 'nloc': 56}, {'timestamp': 1541204121.0, 'added_lines': 1, 'deleted_lines': 1, 'nloc': 56}, {'timestamp': 1541903826.0, 'added_lines': 2, 'deleted_lines': 2, 'nloc': 56}, {'timestamp': 1543282933.0, 'added_lines': 1, 'deleted_lines': 1, 'nloc': 56}, {'timestamp': 1544225843.0, 'added_lines': 1, 'deleted_lines': 1, 'nloc': 56}, {'timestamp': 1545323704.0, 'added_lines': 1, 'deleted_lines': 1, 'nloc': 56}, {'timestamp': 1546553605.0, 'added_lines': 1, 'deleted_lines': 1, 'nloc': 56}, {'timestamp': 1547003974.0, 'added_lines': 1, 'deleted_lines': 1, 'nloc': 56}, {'timestamp': 1549588289.0, 'added_lines': 1, 'deleted_lines': 1, 'nloc': 56}, {'timestamp': 1550507829.0, 'added_lines': 3, 'deleted_lines': 3, 'nloc': 56}, {'timestamp': 1551229859.0, 'added_lines': 1, 'deleted_lines': 1, 'nloc': 56}, {'timestamp': 1551551196.0, 'added_lines': 3, 'deleted_lines': 3, 'nloc': 56}, {'timestamp': 1590112139.0, 'added_lines': 2, 'deleted_lines': 2, 'nloc': 56}]","{'blocks/blockstore/caching.go': 1, 'blocks/blockstore/util/remove.go': 1, 'cmd/ipfs/daemon.go': 11, 'cmd/ipfs/init.go': 25, 'cmd/ipfs/ipfs.go': 7, 'cmd/ipfs/main.go': 25, 'cmd/ipfs/main_test.go': 1, 'cmd/ipfswatch/main.go': 24, 'cmd/seccat/seccat.go': 17, None: 14, 'commands/channelmarshaler.go': 1, 'commands/cli/cmd_suggestion.go': 1, 'commands/cli/helptext.go': 1, 'commands/cli/helptext_test.go': 1, 'commands/cli/parse.go': 1, 'commands/cli/parse_test.go': 1, 'commands/command.go': 5, 'commands/command_test.go': 1, 'commands/http/client.go': 1, 'commands/http/handler.go': 1, 'commands/http/multifilereader.go': 1, 'commands/http/multifilereader_test.go': 1, 'commands/http/parse.go': 1, 'commands/reqlog.go': 1, 'commands/request.go': 17, 'commands/response.go': 2, 'commands/response_test.go': 1, 'core/bootstrap.go': 27, 'core/commands/active.go': 4, 'core/commands/add.go': 12, 'core/commands/bitswap.go': 18, 'core/commands/block.go': 8, 'core/commands/bootstrap.go': 24, 'core/commands/cat.go': 8, 'core/commands/commands.go': 7, 'core/commands/config.go': 24, 'core/commands/dag/dag.go': 17, 'core/commands/dht.go': 18, 'core/commands/diag.go': 4, 'core/commands/dns.go': 6, 'core/commands/e/error.go': 1, 'core/commands/external.go': 4, 'core/commands/files/files.go': 1, 'core/commands/filestore.go': 7, 'core/commands/get.go': 17, 'core/commands/helptext_test.go': 7, 'core/commands/id.go': 17, 'core/commands/ipns.go': 4, 'core/commands/keystore.go': 8, 'core/commands/log.go': 7, 'core/commands/ls.go': 17, 'core/commands/mount_nofuse.go': 4, 'core/commands/mount_unix.go': 24, 'core/commands/mount_windows.go': 4, 'core/commands/name.go': 2, 'core/commands/object/diff.go': 6, 'core/commands/object/object.go': 18, 'core/commands/object/patch.go': 8, 'core/commands/p2p.go': 14, 'core/commands/pin.go': 18, 'core/commands/ping.go': 16, 'core/commands/publish.go': 4, 'core/commands/pubsub.go': 11, 'core/commands/refs.go': 17, 'core/commands/repo.go': 28, 'core/commands/resolve.go': 17, 'core/commands/root.go': 7, 'core/commands/shutdown.go': 6, 'core/commands/stat.go': 11, 'core/commands/swarm.go': 27, 'core/commands/sysdiag.go': 9, 'core/commands/tar.go': 17, 'core/commands/unixfs/ls.go': 17, 'core/commands/unixfs/unixfs.go': 4, 'core/commands/version.go': 6, 'core/corehttp/commands.go': 28, 'core/corehttp/gateway.go': 18, 'core/coreunix/add.go': 18, 'core/coreunix/add_test.go': 29, 'core/coreunix/metadata_test.go': 18, 'exchange/bitswap/bitswap_test.go': 2, 'exchange/bitswap/decision/engine_test.go': 2, 'exchange/bitswap/message/message_test.go': 1, 'exchange/bitswap/message/pb/Makefile': 1, 'exchange/bitswap/testnet/network_test.go': 2, 'exchange/bitswap/testnet/peernet.go': 2, 'exchange/reprovide/reprovide_test.go': 18, 'fuse/ipns/common.go': 18, 'fuse/node/mount_test.go': 18, 'importer/balanced/balanced_test.go': 2, 'importer/chunk/rabin_test.go': 1, 'importer/helpers/dagbuilder.go': 2, 'importer/importer.go': 2, 'merkledag/utils/utils_test.go': 1, 'mfs/repub_test.go': 2, 'namesys/dns.go': 17, 'namesys/interface.go': 18, 'namesys/ipns_select_test.go': 2, 'namesys/proquint.go': 17, 'namesys/republisher/repub_test.go': 18, 'package.json': 27, 'repo/config/identity.go': 2, 'routing/offline/offline_test.go': 1, 'test/integration/addcat_test.go': 17, 'test/integration/bench_cat_test.go': 17, 'test/integration/bitswap_wo_routing_test.go': 17, 'test/integration/three_legged_cat_test.go': 17, 'core/coreapi/unixfs_test.go': 22, 'core/corehttp/gateway_test.go': 28, 'core/mock/mock.go': 28, 'repo/fsrepo/config_test.go': 24, 'blocks/blockstoreutil/remove.go': 11, 'blockservice/blockservice.go': 1, 'blockservice/blockservice_test.go': 1, 'blockservice/test/blocks_test.go': 1, 'blockservice/test/mock.go': 1, 'cmd/ipfs/util/ulimit.go': 5, 'cmd/seccat/util.go': 5, 'commands/legacy/command.go': 4, 'commands/legacy/legacy.go': 4, 'commands/legacy/legacy_test.go': 4, 'commands/legacy/request.go': 4, 'commands/legacy/response.go': 4, 'core/bootstrap_test.go': 26, 'core/builder.go': 27, 'core/commands/commands_test.go': 6, 'core/commands/dht_test.go': 15, 'core/commands/files.go': 17, 'core/commands/get_test.go': 6, 'core/core.go': 28, 'core/coreapi/key.go': 17, 'core/coreapi/name.go': 17, 'core/coreapi/pin.go': 17, 'core/corehttp/corehttp.go': 8, 'core/corehttp/gateway_handler.go': 17, 'core/corehttp/logs.go': 5, 'core/corehttp/metrics_test.go': 16, 'core/corerepo/gc.go': 16, 'core/pathresolver.go': 17, 'exchange/bitswap/bitswap.go': 1, 'exchange/bitswap/decision/bench_test.go': 1, 'exchange/bitswap/decision/engine.go': 1, 'exchange/bitswap/decision/ledger.go': 1, 'exchange/bitswap/decision/peer_request_queue.go': 1, 'exchange/bitswap/decision/peer_request_queue_test.go': 1, 'exchange/bitswap/get.go': 1, 'exchange/bitswap/message/message.go': 1, 'exchange/bitswap/network/interface.go': 1, 'exchange/bitswap/network/ipfs_impl.go': 1, 'exchange/bitswap/session.go': 1, 'exchange/bitswap/session_test.go': 1, 'exchange/bitswap/testnet/interface.go': 1, 'exchange/bitswap/testnet/virtual.go': 1, 'exchange/bitswap/testutils.go': 1, 'exchange/bitswap/wantmanager.go': 1, 'exchange/bitswap/workers.go': 1, 'exchange/reprovide/providers.go': 17, 'exchange/reprovide/reprovide.go': 15, 'filestore/filestore.go': 11, 'filestore/filestore_test.go': 17, 'filestore/fsrefstore.go': 11, 'filestore/util.go': 11, 'fuse/ipns/ipns_test.go': 17, 'fuse/ipns/ipns_unix.go': 17, 'fuse/mount/mount.go': 5, 'fuse/node/mount_unix.go': 5, 'fuse/readonly/ipfs_test.go': 17, 'fuse/readonly/readonly_unix.go': 17, 'importer/importer_test.go': 1, 'importer/trickle/trickle_test.go': 1, 'keystore/keystore.go': 5, 'keystore/keystore_test.go': 4, 'keystore/memkeystore.go': 4, 'merkledag/merkledag_test.go': 1, 'merkledag/test/utils.go': 1, 'merkledag/utils/utils.go': 1, 'mfs/file.go': 2, 'mfs/mfs_test.go': 2, 'mfs/system.go': 2, 'namesys/ipns_validate_test.go': 1, 'namesys/namesys.go': 17, 'namesys/namesys_test.go': 17, 'namesys/publisher.go': 17, 'namesys/publisher_test.go': 17, 'namesys/pubsub.go': 1, 'namesys/pubsub_test.go': 1, 'namesys/republisher/repub.go': 17, 'namesys/resolve_test.go': 17, 'namesys/routing.go': 17, 'namesys/validator.go': 1, 'p2p/p2p.go': 16, 'p2p/registry.go': 4, 'path/resolver/resolver.go': 1, 'pin/gc/gc.go': 17, 'pin/pin.go': 17, 'pin/pin_test.go': 17, 'pin/set_test.go': 17, 'plugin/loader/load.go': 3, 'repo/config/bootstrap_peers.go': 1, 'repo/config/init.go': 1, 'repo/fsrepo/datastores.go': 10, 'repo/fsrepo/fsrepo.go': 27, 'repo/fsrepo/fsrepo_test.go': 27, 'repo/repo.go': 27, 'tar/format.go': 17, 'test/integration/bench_test.go': 11, 'thirdparty/pollEndpoint/main.go': 8, 'thirdparty/verifbs/verifbs.go': 11, 'unixfs/mod/dagmodifier.go': 1, 'unixfs/test/utils.go': 1, 'cmd/ipfs/Rules.mk': 1, 'core/commands/env.go': 5, 'core/corehttp/option_test.go': 1, 'docs/releases.md': 1, 'docs/windows.md': 1, 'repo/fsrepo/misc.go': 23, 'repo/mock.go': 23, 'repo/version.go': 1, 'test/bench/bench_cli_ipfs_add/main.go': 23, 'test/bench/offline_add/main.go': 23, 'assets/assets.go': 15, 'core/commands/urlstore.go': 16, 'core/coreapi/interface/path.go': 13, 'core/coreapi/name_test.go': 11, 'core/coreapi/object.go': 16, 'core/coreapi/path.go': 16, 'core/coreapi/unixfs.go': 16, 'core/coredag/dagpb.go': 16, 'core/coredag/raw.go': 16, 'core/corerepo/pinning.go': 6, 'core/coreunix/cat.go': 5, 'core/coreunix/metadata.go': 16, 'core/pathresolver_test.go': 16, 'dagutils/diff.go': 16, 'dagutils/diffenum.go': 16, 'dagutils/diffenum_test.go': 16, 'dagutils/utils.go': 16, 'dagutils/utils_test.go': 16, 'mfs/dir.go': 1, 'mfs/fd.go': 1, 'mfs/ops.go': 1, 'namesys/base.go': 16, 'namesys/cache.go': 16, 'namesys/ipns_resolver_validation_test.go': 16, 'pin/set.go': 16, 'thirdparty/cidv0v1/blockstore.go': 10, 'core/commands/ipnsps.go': 1, 'core/coreapi/block.go': 5, 'core/coreapi/dag.go': 3, 'core/coreapi/interface/coreapi.go': 2, 'core/coreapi/interface/dag.go': 2, 'core/coreapi/interface/key.go': 6, 'core/coreapi/interface/object.go': 2, 'core/coreapi/interface/options/dag.go': 2, 'core/coreapi/interface/unixfs.go': 3, 'core/coredag/cbor.go': 4, 'core/coredag/dagtransl.go': 3, 'plugin/ipld.go': 3, 'plugin/loader/initializer.go': 2, 'plugin/plugins/git/git.go': 3, 'core/commands/cmdenv/env.go': 18, 'core/commands/name/ipns.go': 15, 'core/commands/name/publish.go': 9, 'core/commands/name/ipnsps.go': 8, 'core/commands/name/name.go': 4, 'core/coreapi/dht.go': 12, 'core/coreapi/dht_test.go': 4, 'core/coreapi/interface/dht.go': 9, 'p2p/listener.go': 12, 'p2p/local.go': 12, 'p2p/remote.go': 12, 'p2p/stream.go': 12, 'core/coreapi/interface/swarm.go': 8, 'core/coreapi/swarm.go': 11, 'core/coreapi/interface/options/unixfs.go': 7, 'core/coreapi/pubsub.go': 11, 'core/coreapi/unixfile.go': 6, 'cmd/ipfs/dnsresolve_test.go': 5, 'core/coreapi/coreapi.go': 9, 'core/coreapi/interface/pubsub.go': 4, 'test/dependencies/ma-pipe-unidir/main.go': 5, 'test/sharness/t0180-pubsub.sh': 1, 'core/commands/cid.go': 3, 'core/coreapi/block_test.go': 1, 'core/coreapi/dag_test.go': 1, 'core/coreapi/interface/options/block.go': 1, 'test/dependencies/iptb/iptb.go': 11, 'plugin/plugins/badgerds/badgerds.go': 3, 'plugin/plugins/flatfs/flatfs.go': 3, 'plugin/plugins/levelds/levelds.go': 3, 'commands/context.go': 8, 'core/corehttp/proxy.go': 6, 'core/coreapi/test/api_test.go': 6, 'core/coreapi/interface/tests/name.go': 2, 'core/coreapi/interface/tests/unixfs.go': 2, 'core/commands/cmdenv/cidbase.go': 2, 'core/corehttp/ipns_hostname.go': 3, 'filestore/pb/dataobj.pb.go': 2, 'namesys/dns_test.go': 3, 'pin/internal/pb/header.pb.go': 2, 'plugin/daemon.go': 3, 'plugin/loader/loader.go': 3, 'cmd/ipfs/util/ulimit_freebsd.go': 1, 'cmd/ipfs/util/ulimit_unix.go': 1, 'core/commands/cmdenv/cidbase_test.go': 1, 'core/commands/cmdenv/file.go': 1, 'core/corehttp/metrics.go': 1, 'core/corehttp/proxy_test.go': 1, 'core/corerepo/stat.go': 1, 'fuse/ipns/link_unix.go': 1, 'fuse/mount/fuse.go': 1, 'fuse/node/mount_darwin.go': 1, 'plugin/tracer.go': 1, 'thirdparty/notifier/notifier.go': 1, 'Dockerfile': 1, 'README.md': 1, 'core/node/builder.go': 1, 'core/node/groups.go': 1, 'core/node/libp2p/transport.go': 1, 'docs/config.md': 1, 'docs/examples/go-ipfs-as-a-library/main.go': 1, 'docs/examples/library-experimental-features/README.md': 1, 'docs/experimental-features.md': 1, 'docs/file-transfer.md': 1, 'test/sharness/t0125-twonode.sh': 1, 'test/sharness/t0142-testfilter.sh': 1, 'test/sharness/t0190-quic-ping.sh': 1}","('core/coreunix/add_test.go', 0.9354838709677419, 0.29896907216494845)"
core/commands/active.go,101,647,4,"[{'cyclomatic_complexity': 1, 'nloc': 3, 'token_count': 30, 'name': '', 'long_name': '(req cmds.Request,res cmds.Response)', 'start_line': 21, 'end_line': 23, 'full_parameters': [], 'filename': '/home/dimi/Documents/Informatik_Studium/FSS/SoftEvo/DataCollection/FFS_SoftEvo/go-ipfs/core/commands/active.go', 'top_nesting_level': 0, 'length': 3, 'fan_in': 0, 'fan_out': 0, 'general_fan_out': 0}, {'cyclomatic_complexity': 10, 'nloc': 46, 'token_count': 335, 'name': '', 'long_name': '(res cmds.Response)(io.Reader,error)', 'start_line': 32, 'end_line': 83, 'full_parameters': [], 'filename': '/home/dimi/Documents/Informatik_Studium/FSS/SoftEvo/DataCollection/FFS_SoftEvo/go-ipfs/core/commands/active.go', 'top_nesting_level': 0, 'length': 52, 'fan_in': 0, 'fan_out': 0, 'general_fan_out': 0}, {'cyclomatic_complexity': 1, 'nloc': 3, 'token_count': 25, 'name': '', 'long_name': '(req cmds.Request,res cmds.Response)', 'start_line': 92, 'end_line': 94, 'full_parameters': [], 'filename': '/home/dimi/Documents/Informatik_Studium/FSS/SoftEvo/DataCollection/FFS_SoftEvo/go-ipfs/core/commands/active.go', 'top_nesting_level': 0, 'length': 3, 'fan_in': 0, 'fan_out': 0, 'general_fan_out': 0}, {'cyclomatic_complexity': 2, 'nloc': 8, 'token_count': 60, 'name': '', 'long_name': '(req cmds.Request,res cmds.Response)', 'start_line': 104, 'end_line': 112, 'full_parameters': [], 'filename': '/home/dimi/Documents/Informatik_Studium/FSS/SoftEvo/DataCollection/FFS_SoftEvo/go-ipfs/core/commands/active.go', 'top_nesting_level': 0, 'length': 9, 'fan_in': 0, 'fan_out': 0, 'general_fan_out': 0}]",103,636,0,[],2,-11,-4,32,32,"[{'timestamp': 1491058697.0, 'added_lines': 19, 'deleted_lines': 12, 'nloc': 106}, {'timestamp': 1499331469.0, 'added_lines': 1, 'deleted_lines': 1, 'nloc': 106}, {'timestamp': 1511223906.0, 'added_lines': 1, 'deleted_lines': 1, 'nloc': 106}, {'timestamp': 1512365669.0, 'added_lines': 1, 'deleted_lines': 1, 'nloc': 106}, {'timestamp': 1511187070.0, 'added_lines': 1, 'deleted_lines': 1, 'nloc': 106}, {'timestamp': 1513436097.0, 'added_lines': 1, 'deleted_lines': 1, 'nloc': 106}, {'timestamp': 1513612261.0, 'added_lines': 1, 'deleted_lines': 1, 'nloc': 106}, {'timestamp': 1515277696.0, 'added_lines': 1, 'deleted_lines': 1, 'nloc': 106}, {'timestamp': 1528520460.0, 'added_lines': 1, 'deleted_lines': 1, 'nloc': 106}, {'timestamp': 1533946888.0, 'added_lines': 1, 'deleted_lines': 1, 'nloc': 106}, {'timestamp': 1534896611.0, 'added_lines': 1, 'deleted_lines': 1, 'nloc': 106}, {'timestamp': 1538662493.0, 'added_lines': 6, 'deleted_lines': 2, 'nloc': 109}, {'timestamp': 1539850591.0, 'added_lines': 1, 'deleted_lines': 1, 'nloc': 109}, {'timestamp': 1540564653.0, 'added_lines': 31, 'deleted_lines': 42, 'nloc': 102}, {'timestamp': 1540565575.0, 'added_lines': 1, 'deleted_lines': 1, 'nloc': 102}, {'timestamp': 1540572903.0, 'added_lines': 12, 'deleted_lines': 4, 'nloc': 106}, {'timestamp': 1540619689.0, 'added_lines': 2, 'deleted_lines': 7, 'nloc': 103}, {'timestamp': 1540951823.0, 'added_lines': 2, 'deleted_lines': 2, 'nloc': 103}, {'timestamp': 1544661332.0, 'added_lines': 1, 'deleted_lines': 1, 'nloc': 103}, {'timestamp': 1540556089.0, 'added_lines': 1, 'deleted_lines': 1, 'nloc': 103}, {'timestamp': 1547152271.0, 'added_lines': 1, 'deleted_lines': 1, 'nloc': 103}, {'timestamp': 1548271513.0, 'added_lines': 2, 'deleted_lines': 2, 'nloc': 103}, {'timestamp': 1548866534.0, 'added_lines': 1, 'deleted_lines': 1, 'nloc': 103}, {'timestamp': 1549903582.0, 'added_lines': 1, 'deleted_lines': 1, 'nloc': 103}, {'timestamp': 1550507829.0, 'added_lines': 1, 'deleted_lines': 1, 'nloc': 103}, {'timestamp': 1550610741.0, 'added_lines': 1, 'deleted_lines': 1, 'nloc': 103}, {'timestamp': 1551138343.0, 'added_lines': 1, 'deleted_lines': 1, 'nloc': 103}, {'timestamp': 1551299964.0, 'added_lines': 1, 'deleted_lines': 1, 'nloc': 103}, {'timestamp': 1551471469.0, 'added_lines': 1, 'deleted_lines': 1, 'nloc': 103}, {'timestamp': 1551551196.0, 'added_lines': 2, 'deleted_lines': 2, 'nloc': 103}, {'timestamp': 1557554420.0, 'added_lines': 7, 'deleted_lines': 8, 'nloc': 102}, {'timestamp': 1595277534.0, 'added_lines': 1, 'deleted_lines': 0, 'nloc': 103}]","{'blocks/blockstore/caching.go': 1, 'blocks/blockstore/util/remove.go': 2, 'cmd/ipfs/daemon.go': 25, 'cmd/ipfs/init.go': 25, 'cmd/ipfs/ipfs.go': 22, 'cmd/ipfs/main.go': 23, 'cmd/ipfs/main_test.go': 4, 'cmd/ipfswatch/main.go': 10, 'cmd/seccat/seccat.go': 7, None: 13, 'commands/channelmarshaler.go': 1, 'commands/cli/cmd_suggestion.go': 1, 'commands/cli/helptext.go': 2, 'commands/cli/helptext_test.go': 2, 'commands/cli/parse.go': 2, 'commands/cli/parse_test.go': 2, 'commands/command.go': 11, 'commands/command_test.go': 7, 'commands/http/client.go': 2, 'commands/http/handler.go': 2, 'commands/http/multifilereader.go': 2, 'commands/http/multifilereader_test.go': 2, 'commands/http/parse.go': 2, 'commands/reqlog.go': 1, 'commands/request.go': 11, 'commands/response.go': 11, 'commands/response_test.go': 7, 'core/bootstrap.go': 7, 'core/commands/add.go': 23, 'core/commands/bitswap.go': 24, 'core/commands/block.go': 25, 'core/commands/bootstrap.go': 24, 'core/commands/cat.go': 24, 'core/commands/commands.go': 25, 'core/commands/config.go': 28, 'core/commands/dag/dag.go': 24, 'core/commands/dht.go': 25, 'core/commands/diag.go': 27, 'core/commands/dns.go': 25, 'core/commands/e/error.go': 1, 'core/commands/external.go': 24, 'core/commands/files/files.go': 8, 'core/commands/filestore.go': 24, 'core/commands/get.go': 25, 'core/commands/helptext_test.go': 21, 'core/commands/id.go': 24, 'core/commands/ipns.go': 11, 'core/commands/keystore.go': 25, 'core/commands/log.go': 25, 'core/commands/ls.go': 25, 'core/commands/mount_nofuse.go': 26, 'core/commands/mount_unix.go': 24, 'core/commands/mount_windows.go': 25, 'core/commands/name.go': 10, 'core/commands/object/diff.go': 23, 'core/commands/object/object.go': 24, 'core/commands/object/patch.go': 24, 'core/commands/p2p.go': 25, 'core/commands/pin.go': 25, 'core/commands/ping.go': 24, 'core/commands/publish.go': 10, 'core/commands/pubsub.go': 24, 'core/commands/refs.go': 25, 'core/commands/repo.go': 26, 'core/commands/resolve.go': 25, 'core/commands/root.go': 26, 'core/commands/shutdown.go': 23, 'core/commands/stat.go': 25, 'core/commands/swarm.go': 25, 'core/commands/sysdiag.go': 26, 'core/commands/tar.go': 23, 'core/commands/unixfs/ls.go': 23, 'core/commands/unixfs/unixfs.go': 23, 'core/commands/version.go': 26, 'core/core_test.go': 4, 'core/corehttp/commands.go': 22, 'core/corehttp/gateway.go': 9, 'core/coreunix/add.go': 17, 'core/coreunix/add_test.go': 17, 'core/coreunix/metadata_test.go': 12, 'exchange/bitswap/bitswap_test.go': 4, 'exchange/bitswap/decision/engine_test.go': 4, 'exchange/bitswap/message/message_test.go': 3, 'exchange/bitswap/message/pb/Makefile': 1, 'exchange/bitswap/testnet/network_test.go': 4, 'exchange/bitswap/testnet/peernet.go': 4, 'exchange/reprovide/reprovide_test.go': 7, 'fuse/ipns/common.go': 10, 'fuse/node/mount_test.go': 7, 'importer/balanced/balanced_test.go': 3, 'importer/chunk/rabin_test.go': 2, 'importer/helpers/dagbuilder.go': 8, 'importer/importer.go': 8, 'merkledag/utils/utils_test.go': 3, 'mfs/repub_test.go': 4, 'namesys/dns.go': 6, 'namesys/interface.go': 6, 'namesys/ipns_select_test.go': 3, 'namesys/proquint.go': 6, 'namesys/republisher/repub_test.go': 8, 'package.json': 21, 'repo/config/identity.go': 1, 'routing/offline/offline_test.go': 3, 'test/integration/addcat_test.go': 11, 'test/integration/bench_cat_test.go': 10, 'test/integration/bitswap_wo_routing_test.go': 8, 'test/integration/three_legged_cat_test.go': 10, 'core/bootstrap_test.go': 6, 'core/commands/dht_test.go': 6, 'core/commands/get_test.go': 22, 'core/core.go': 12, 'core/corehttp/gateway_test.go': 9, 'core/corehttp/metrics_test.go': 7, 'core/mock/mock.go': 7, 'exchange/bitswap/decision/bench_test.go': 3, 'exchange/bitswap/decision/peer_request_queue_test.go': 3, 'exchange/bitswap/message/message.go': 3, 'exchange/bitswap/network/interface.go': 3, 'exchange/bitswap/network/ipfs_impl.go': 3, 'exchange/bitswap/testnet/interface.go': 3, 'exchange/bitswap/testnet/virtual.go': 3, 'exchange/bitswap/testutils.go': 3, 'fuse/ipns/ipns_test.go': 6, 'fuse/readonly/ipfs_test.go': 12, 'namesys/publisher_test.go': 6, 'namesys/resolve_test.go': 7, 'p2p/p2p.go': 6, 'p2p/registry.go': 4, 'repo/config/bootstrap_peers.go': 3, 'routing/mock/centralized_client.go': 2, 'routing/mock/centralized_server.go': 2, 'routing/mock/centralized_test.go': 2, 'routing/mock/interface.go': 2, 'routing/none/none_client.go': 2, 'test/integration/bench_test.go': 6, 'assets/assets.go': 11, 'blocks/blockstore/arc_cache.go': 1, 'blocks/blockstore/arc_cache_test.go': 1, 'blocks/blockstore/blockstore.go': 1, 'blocks/blockstore/blockstore_test.go': 1, 'blocks/blockstore/bloom_cache.go': 1, 'blocks/blockstore/bloom_cache_test.go': 1, 'blocks/blocksutil/block_generator.go': 1, 'blockservice/blockservice.go': 2, 'blockservice/blockservice_test.go': 2, 'blockservice/test/blocks_test.go': 2, 'core/builder.go': 11, 'core/commands/ipnsps.go': 7, 'core/coreapi/coreapi.go': 6, 'core/coreapi/interface/interface.go': 1, 'core/coreapi/unixfs.go': 12, 'core/coreapi/unixfs_test.go': 6, 'core/coredag/cbor.go': 4, 'core/coredag/dagpb.go': 6, 'core/coredag/dagtransl.go': 4, 'core/coredag/raw.go': 6, 'core/corehttp/corehttp.go': 4, 'core/corehttp/gateway_handler.go': 12, 'core/corerepo/gc.go': 11, 'core/corerepo/pinning.go': 4, 'core/coreunix/metadata.go': 11, 'core/pathresolver.go': 6, 'exchange/bitswap/bitswap.go': 2, 'exchange/bitswap/decision/engine.go': 2, 'exchange/bitswap/decision/ledger.go': 2, 'exchange/bitswap/decision/peer_request_queue.go': 2, 'exchange/bitswap/get.go': 2, 'exchange/bitswap/notifications/notifications.go': 2, 'exchange/bitswap/notifications/notifications_test.go': 2, 'exchange/bitswap/session.go': 2, 'exchange/bitswap/session_test.go': 2, 'exchange/bitswap/stat.go': 2, 'exchange/bitswap/wantlist/wantlist.go': 2, 'exchange/bitswap/wantlist/wantlist_test.go': 2, 'exchange/bitswap/wantmanager.go': 2, 'exchange/bitswap/workers.go': 2, 'exchange/interface.go': 1, 'exchange/offline/offline.go': 1, 'exchange/offline/offline_test.go': 1, 'exchange/reprovide/providers.go': 6, 'exchange/reprovide/reprovide.go': 5, 'filestore/filestore.go': 5, 'filestore/filestore_test.go': 6, 'filestore/fsrefstore.go': 5, 'filestore/util.go': 5, 'fuse/ipns/ipns_unix.go': 11, 'fuse/readonly/readonly_unix.go': 11, 'importer/balanced/builder.go': 2, 'importer/chunk/splitting_test.go': 1, 'importer/helpers/helpers.go': 2, 'importer/importer_test.go': 2, 'importer/trickle/trickle_test.go': 2, 'importer/trickle/trickledag.go': 2, 'merkledag/batch.go': 1, 'merkledag/coding.go': 2, 'merkledag/merkledag.go': 2, 'merkledag/merkledag_test.go': 2, 'merkledag/node.go': 2, 'merkledag/node_test.go': 2, 'merkledag/raw.go': 2, 'merkledag/traverse/traverse.go': 2, 'merkledag/traverse/traverse_test.go': 2, 'merkledag/utils/diff.go': 2, 'merkledag/utils/diffenum.go': 2, 'merkledag/utils/diffenum_test.go': 2, 'merkledag/utils/utils.go': 2, 'mfs/dir.go': 3, 'mfs/file.go': 3, 'mfs/mfs_test.go': 3, 'mfs/ops.go': 2, 'mfs/system.go': 3, 'namesys/namesys.go': 7, 'namesys/publisher.go': 11, 'namesys/pubsub.go': 1, 'namesys/pubsub_test.go': 1, 'namesys/republisher/repub.go': 6, 'namesys/routing.go': 7, 'path/path.go': 2, 'path/resolver.go': 1, 'path/resolver_test.go': 1, 'pin/gc/gc.go': 6, 'pin/pin.go': 6, 'pin/pin_test.go': 6, 'pin/set.go': 6, 'pin/set_test.go': 6, 'plugin/ipld.go': 4, 'plugin/loader/initializer.go': 3, 'plugin/plugins/git/git.go': 4, 'repo/config/init.go': 2, 'repo/fsrepo/fsrepo.go': 5, 'repo/fsrepo/lock/lock.go': 1, 'repo/fsrepo/serialize/serialize.go': 2, 'repo/mock.go': 5, 'repo/repo.go': 5, 'routing/offline/offline.go': 1, 'tar/format.go': 11, 'test/dependencies/ma-pipe-unidir/main.go': 3, 'thirdparty/ds-help/key.go': 1, 'thirdparty/pollEndpoint/main.go': 4, 'thirdparty/posinfo/posinfo.go': 1, 'unixfs/archive/archive.go': 2, 'unixfs/archive/tar/writer.go': 2, 'unixfs/hamt/hamt.go': 2, 'unixfs/io/dagreader.go': 2, 'unixfs/io/dirbuilder.go': 2, 'unixfs/io/resolve.go': 2, 'unixfs/mod/dagmodifier.go': 2, 'unixfs/mod/dagmodifier_test.go': 2, 'unixfs/test/utils.go': 2, 'commands/legacy/command.go': 7, 'commands/legacy/legacy.go': 7, 'commands/legacy/legacy_test.go': 8, 'commands/legacy/request.go': 8, 'commands/legacy/response.go': 8, 'commands/legacy/responseemitter.go': 4, 'core/commands/env.go': 3, 'TODO.md': 2, 'core/commands/commands_test.go': 17, 'test/sharness/t0110-gateway.sh': 1, 'test/sharness/t0410-api-add.sh': 1, 'blocks/blockstoreutil/remove.go': 4, 'blockservice/test/mock.go': 1, 'cmd/ipfs/util/ulimit.go': 3, 'cmd/ipfs/util/ulimit_freebsd.go': 2, 'cmd/ipfs/util/ulimit_unix.go': 2, 'cmd/seccat/util.go': 3, 'core/commands/files.go': 17, 'core/coreapi/block.go': 6, 'core/coreapi/block_test.go': 1, 'core/coreapi/dag.go': 3, 'core/coreapi/dag_test.go': 1, 'core/coreapi/interface/coreapi.go': 2, 'core/coreapi/interface/dag.go': 2, 'core/coreapi/interface/object.go': 2, 'core/coreapi/interface/options/block.go': 1, 'core/coreapi/interface/options/dag.go': 2, 'core/coreapi/interface/path.go': 2, 'core/coreapi/interface/unixfs.go': 5, 'core/coreapi/key.go': 6, 'core/coreapi/name.go': 6, 'core/coreapi/object.go': 10, 'core/coreapi/pin.go': 6, 'core/corehttp/logs.go': 3, 'fuse/ipns/link_unix.go': 2, 'fuse/mount/fuse.go': 2, 'fuse/mount/mount.go': 3, 'fuse/node/mount_darwin.go': 2, 'fuse/node/mount_unix.go': 3, 'keystore/keystore.go': 3, 'merkledag/errservice.go': 1, 'merkledag/readonly.go': 1, 'merkledag/readonly_test.go': 1, 'merkledag/rwservice.go': 1, 'merkledag/session.go': 1, 'merkledag/test/utils.go': 1, 'namesys/ipns_validate_test.go': 1, 'namesys/namesys_test.go': 10, 'namesys/validator.go': 1, 'path/resolver/resolver.go': 1, 'path/resolver/resolver_test.go': 1, 'plugin/loader/load.go': 1, 'repo/fsrepo/datastores.go': 3, 'thirdparty/verifbs/verifbs.go': 4, 'thirdparty/verifcid/validate.go': 1, 'thirdparty/verifcid/validate_test.go': 1, 'unixfs/hamt/hamt_stress_test.go': 1, 'unixfs/hamt/hamt_test.go': 1, 'unixfs/io/pbdagreader.go': 1, 'core/commands/urlstore.go': 15, 'core/coreapi/path.go': 9, 'core/coreunix/cat.go': 2, 'mfs/fd.go': 1, 'core/coreapi/interface/key.go': 1, 'core/coreapi/name_test.go': 3, 'core/pathresolver_test.go': 4, 'dagutils/diff.go': 5, 'dagutils/diffenum.go': 4, 'dagutils/diffenum_test.go': 4, 'dagutils/utils.go': 4, 'dagutils/utils_test.go': 4, 'namesys/base.go': 5, 'namesys/cache.go': 4, 'namesys/ipns_resolver_validation_test.go': 5, 'repo/fsrepo/config_test.go': 3, 'repo/fsrepo/fsrepo_test.go': 3, 'repo/fsrepo/misc.go': 3, 'test/bench/bench_cli_ipfs_add/main.go': 4, 'test/bench/offline_add/main.go': 4, 'thirdparty/cidv0v1/blockstore.go': 3, 'core/commands/cid.go': 15, 'core/commands/cmdenv/env.go': 12, 'core/commands/name/ipns.go': 13, 'core/commands/name/ipnsps.go': 13, 'core/commands/name/name.go': 13, 'core/commands/name/publish.go': 13, 'core/coreapi/unixfile.go': 2, 'commands/context.go': 11, 'core/commands/cmdenv/cidbase.go': 9, 'core/commands/cmdenv/file.go': 3, 'core/coreapi/interface/tests/name.go': 1, 'core/coreapi/interface/tests/unixfs.go': 1, 'core/coreapi/dht.go': 4, 'core/coreapi/pubsub.go': 4, 'core/coreapi/swarm.go': 4, 'core/coreapi/test/api_test.go': 4, 'core/corehttp/ipns_hostname.go': 4, 'namesys/dns_test.go': 4, 'plugin/daemon.go': 4, 'plugin/loader/loader.go': 4, 'core/corehttp/proxy.go': 3, 'filestore/pb/dataobj.pb.go': 2, 'keystore/keystore_test.go': 2, 'keystore/memkeystore.go': 2, 'p2p/listener.go': 2, 'p2p/local.go': 2, 'p2p/remote.go': 2, 'p2p/stream.go': 2, 'pin/internal/pb/header.pb.go': 2, 'plugin/plugins/badgerds/badgerds.go': 3, 'plugin/plugins/flatfs/flatfs.go': 3, 'plugin/plugins/levelds/levelds.go': 2, 'test/dependencies/iptb/iptb.go': 3, 'core/corerepo/stat.go': 2, 'cmd/ipfs/dnsresolve_test.go': 1, 'core/commands/cmdenv/cidbase_test.go': 1, 'core/corehttp/metrics.go': 1, 'core/corehttp/proxy_test.go': 1, 'plugin/tracer.go': 1, 'thirdparty/notifier/notifier.go': 1, 'README.md': 1, 'go.mod': 2, 'go.sum': 2, 'package-list.json': 1, 'cmd/ipfs/rotate.go': 1, 'core/commands/extra.go': 1}","('core/commands/config.go', 0.875, 0.345679012345679)"
core/commands/add.go,334,2072,4,"[{'cyclomatic_complexity': 2, 'nloc': 9, 'token_count': 41, 'name': '', 'long_name': '()', 'start_line': 125, 'end_line': 135, 'full_parameters': [], 'filename': '/home/dimi/Documents/Informatik_Studium/FSS/SoftEvo/DataCollection/FFS_SoftEvo/go-ipfs/core/commands/add.go', 'top_nesting_level': 0, 'length': 11, 'fan_in': 0, 'fan_out': 0, 'general_fan_out': 0}, {'cyclomatic_complexity': 7, 'nloc': 21, 'token_count': 86, 'name': 'error', 'long_name': '(f files.File)error', 'start_line': 270, 'end_line': 298, 'full_parameters': [], 'filename': '/home/dimi/Documents/Informatik_Studium/FSS/SoftEvo/DataCollection/FFS_SoftEvo/go-ipfs/core/commands/add.go', 'top_nesting_level': 0, 'length': 29, 'fan_in': 0, 'fan_out': 0, 'general_fan_out': 0}, {'cyclomatic_complexity': 2, 'nloc': 7, 'token_count': 38, 'name': '', 'long_name': '()', 'start_line': 300, 'end_line': 307, 'full_parameters': [], 'filename': '/home/dimi/Documents/Informatik_Studium/FSS/SoftEvo/DataCollection/FFS_SoftEvo/go-ipfs/core/commands/add.go', 'top_nesting_level': 0, 'length': 8, 'fan_in': 0, 'fan_out': 0, 'general_fan_out': 0}, {'cyclomatic_complexity': 1, 'nloc': 1, 'token_count': 2, 'name': '', 'long_name': '(', 'start_line': 309, 'end_line': 309, 'full_parameters': [], 'filename': '/home/dimi/Documents/Informatik_Studium/FSS/SoftEvo/DataCollection/FFS_SoftEvo/go-ipfs/core/commands/add.go', 'top_nesting_level': 0, 'length': 1, 'fan_in': 0, 'fan_out': 0, 'general_fan_out': 0}]",408,633,0,[],74,-1439,-4,145,145,"[{'timestamp': 1508002355.0, 'added_lines': 1, 'deleted_lines': 1, 'nloc': 334}, {'timestamp': 1508056187.0, 'added_lines': 1, 'deleted_lines': 1, 'nloc': 334}, {'timestamp': 1509099715.0, 'added_lines': 24, 'deleted_lines': 0, 'nloc': 354}, {'timestamp': 1509176070.0, 'added_lines': 12, 'deleted_lines': 11, 'nloc': 355}, {'timestamp': 1509217599.0, 'added_lines': 13, 'deleted_lines': 14, 'nloc': 354}, {'timestamp': 1491058697.0, 'added_lines': 174, 'deleted_lines': 126, 'nloc': 388}, {'timestamp': 1508770239.0, 'added_lines': 1, 'deleted_lines': 1, 'nloc': 388}, {'timestamp': 1509016767.0, 'added_lines': 1, 'deleted_lines': 1, 'nloc': 388}, {'timestamp': 1511235891.0, 'added_lines': 8, 'deleted_lines': 4, 'nloc': 391}, {'timestamp': 1511223906.0, 'added_lines': 3, 'deleted_lines': 3, 'nloc': 388}, {'timestamp': 1511245249.0, 'added_lines': 4, 'deleted_lines': 4, 'nloc': 388}, {'timestamp': 1511373659.0, 'added_lines': 1, 'deleted_lines': 1, 'nloc': 391}, {'timestamp': 1512394054.0, 'added_lines': 2, 'deleted_lines': 13, 'nloc': 383}, {'timestamp': 1512365669.0, 'added_lines': 4, 'deleted_lines': 4, 'nloc': 383}, {'timestamp': 1515366530.0, 'added_lines': 1, 'deleted_lines': 1, 'nloc': 383}, {'timestamp': 1511187070.0, 'added_lines': 45, 'deleted_lines': 48, 'nloc': 382}, {'timestamp': 1512058290.0, 'added_lines': 0, 'deleted_lines': 1, 'nloc': 381}, {'timestamp': 1512121226.0, 'added_lines': 10, 'deleted_lines': 6, 'nloc': 383}, {'timestamp': 1512671605.0, 'added_lines': 1, 'deleted_lines': 1, 'nloc': 382}, {'timestamp': 1513436097.0, 'added_lines': 3, 'deleted_lines': 3, 'nloc': 382}, {'timestamp': 1513612261.0, 'added_lines': 3, 'deleted_lines': 3, 'nloc': 382}, {'timestamp': 1513764708.0, 'added_lines': 1, 'deleted_lines': 1, 'nloc': 382}, {'timestamp': 1513765470.0, 'added_lines': 1, 'deleted_lines': 1, 'nloc': 382}, {'timestamp': 1513766201.0, 'added_lines': 1, 'deleted_lines': 1, 'nloc': 382}, {'timestamp': 1513772371.0, 'added_lines': 3, 'deleted_lines': 1, 'nloc': 382}, {'timestamp': 1513772654.0, 'added_lines': 1, 'deleted_lines': 1, 'nloc': 382}, {'timestamp': 1513773452.0, 'added_lines': 1, 'deleted_lines': 1, 'nloc': 382}, {'timestamp': 1515277696.0, 'added_lines': 2, 'deleted_lines': 2, 'nloc': 382}, {'timestamp': 1515465466.0, 'added_lines': 3, 'deleted_lines': 3, 'nloc': 382}, {'timestamp': 1515703187.0, 'added_lines': 21, 'deleted_lines': 27, 'nloc': 378}, {'timestamp': 1515713724.0, 'added_lines': 1, 'deleted_lines': 1, 'nloc': 378}, {'timestamp': 1516341168.0, 'added_lines': 1, 'deleted_lines': 1, 'nloc': 378}, {'timestamp': 1516739455.0, 'added_lines': 57, 'deleted_lines': 18, 'nloc': 396}, {'timestamp': 1516772578.0, 'added_lines': 10, 'deleted_lines': 27, 'nloc': 388}, {'timestamp': 1516838128.0, 'added_lines': 2, 'deleted_lines': 2, 'nloc': 388}, {'timestamp': 1517105039.0, 'added_lines': 1, 'deleted_lines': 1, 'nloc': 388}, {'timestamp': 1517453697.0, 'added_lines': 1, 'deleted_lines': 1, 'nloc': 388}, {'timestamp': 1518714221.0, 'added_lines': 5, 'deleted_lines': 5, 'nloc': 388}, {'timestamp': 1519173780.0, 'added_lines': 1, 'deleted_lines': 1, 'nloc': 388}, {'timestamp': 1519958744.0, 'added_lines': 4, 'deleted_lines': 1, 'nloc': 390}, {'timestamp': 1519935671.0, 'added_lines': 1, 'deleted_lines': 1, 'nloc': 388}, {'timestamp': 1519944077.0, 'added_lines': 1, 'deleted_lines': 1, 'nloc': 388}, {'timestamp': 1521314540.0, 'added_lines': 1, 'deleted_lines': 1, 'nloc': 388}, {'timestamp': 1521500314.0, 'added_lines': 1, 'deleted_lines': 1, 'nloc': 388}, {'timestamp': 1519761835.0, 'added_lines': 1, 'deleted_lines': 1, 'nloc': 390}, {'timestamp': 1521427288.0, 'added_lines': 1, 'deleted_lines': 1, 'nloc': 390}, {'timestamp': 1522765832.0, 'added_lines': 1, 'deleted_lines': 1, 'nloc': 390}, {'timestamp': 1524596476.0, 'added_lines': 1, 'deleted_lines': 1, 'nloc': 390}, {'timestamp': 1525408792.0, 'added_lines': 4, 'deleted_lines': 4, 'nloc': 390}, {'timestamp': 1528520460.0, 'added_lines': 7, 'deleted_lines': 7, 'nloc': 390}, {'timestamp': 1529984485.0, 'added_lines': 3, 'deleted_lines': 3, 'nloc': 390}, {'timestamp': 1530066615.0, 'added_lines': 2, 'deleted_lines': 2, 'nloc': 390}, {'timestamp': 1531779409.0, 'added_lines': 2, 'deleted_lines': 2, 'nloc': 390}, {'timestamp': 1532146078.0, 'added_lines': 2, 'deleted_lines': 2, 'nloc': 390}, {'timestamp': 1532740866.0, 'added_lines': 1, 'deleted_lines': 1, 'nloc': 390}, {'timestamp': 1532764253.0, 'added_lines': 2, 'deleted_lines': 2, 'nloc': 390}, {'timestamp': 1532986515.0, 'added_lines': 1, 'deleted_lines': 1, 'nloc': 390}, {'timestamp': 1533500571.0, 'added_lines': 4, 'deleted_lines': 4, 'nloc': 390}, {'timestamp': 1533618653.0, 'added_lines': 6, 'deleted_lines': 6, 'nloc': 390}, {'timestamp': 1533779477.0, 'added_lines': 7, 'deleted_lines': 7, 'nloc': 390}, {'timestamp': 1533946888.0, 'added_lines': 4, 'deleted_lines': 4, 'nloc': 390}, {'timestamp': 1534115707.0, 'added_lines': 7, 'deleted_lines': 7, 'nloc': 390}, {'timestamp': 1534121389.0, 'added_lines': 2, 'deleted_lines': 2, 'nloc': 390}, {'timestamp': 1534195762.0, 'added_lines': 6, 'deleted_lines': 6, 'nloc': 390}, {'timestamp': 1534347022.0, 'added_lines': 6, 'deleted_lines': 6, 'nloc': 390}, {'timestamp': 1534771694.0, 'added_lines': 1, 'deleted_lines': 1, 'nloc': 390}, {'timestamp': 1534896611.0, 'added_lines': 10, 'deleted_lines': 10, 'nloc': 390}, {'timestamp': 1534902144.0, 'added_lines': 14, 'deleted_lines': 1, 'nloc': 402}, {'timestamp': 1534903410.0, 'added_lines': 2, 'deleted_lines': 1, 'nloc': 391}, {'timestamp': 1534906080.0, 'added_lines': 6, 'deleted_lines': 5, 'nloc': 403}, {'timestamp': 1535141214.0, 'added_lines': 1, 'deleted_lines': 1, 'nloc': 403}, {'timestamp': 1535023055.0, 'added_lines': 4, 'deleted_lines': 0, 'nloc': 408}, {'timestamp': 1535601896.0, 'added_lines': 5, 'deleted_lines': 5, 'nloc': 404}, {'timestamp': 1535943422.0, 'added_lines': 4, 'deleted_lines': 4, 'nloc': 408}, {'timestamp': 1536110744.0, 'added_lines': 1, 'deleted_lines': 1, 'nloc': 408}, {'timestamp': 1536388808.0, 'added_lines': 7, 'deleted_lines': 7, 'nloc': 404}, {'timestamp': 1536702949.0, 'added_lines': 3, 'deleted_lines': 3, 'nloc': 408}, {'timestamp': 1536718784.0, 'added_lines': 8, 'deleted_lines': 8, 'nloc': 404}, {'timestamp': 1536723292.0, 'added_lines': 8, 'deleted_lines': 8, 'nloc': 404}, {'timestamp': 1523628870.0, 'added_lines': 38, 'deleted_lines': 66, 'nloc': 383}, {'timestamp': 1535044155.0, 'added_lines': 1, 'deleted_lines': 1, 'nloc': 383}, {'timestamp': 1537193530.0, 'added_lines': 1, 'deleted_lines': 1, 'nloc': 383}, {'timestamp': 1537391809.0, 'added_lines': 1, 'deleted_lines': 1, 'nloc': 383}, {'timestamp': 1537790637.0, 'added_lines': 5, 'deleted_lines': 5, 'nloc': 383}, {'timestamp': 1537792589.0, 'added_lines': 8, 'deleted_lines': 8, 'nloc': 383}, {'timestamp': 1537512915.0, 'added_lines': 2, 'deleted_lines': 31, 'nloc': 363}, {'timestamp': 1537712792.0, 'added_lines': 1, 'deleted_lines': 2, 'nloc': 362}, {'timestamp': 1538525337.0, 'added_lines': 1, 'deleted_lines': 1, 'nloc': 362}, {'timestamp': 1538607626.0, 'added_lines': 3, 'deleted_lines': 2, 'nloc': 363}, {'timestamp': 1538611045.0, 'added_lines': 31, 'deleted_lines': 125, 'nloc': 300}, {'timestamp': 1538544957.0, 'added_lines': 7, 'deleted_lines': 7, 'nloc': 362}, {'timestamp': 1538694687.0, 'added_lines': 5, 'deleted_lines': 5, 'nloc': 362}, {'timestamp': 1538695953.0, 'added_lines': 5, 'deleted_lines': 5, 'nloc': 362}, {'timestamp': 1539850591.0, 'added_lines': 3, 'deleted_lines': 3, 'nloc': 300}, {'timestamp': 1540552487.0, 'added_lines': 1, 'deleted_lines': 1, 'nloc': 300}, {'timestamp': 1540597832.0, 'added_lines': 1, 'deleted_lines': 1, 'nloc': 300}, {'timestamp': 1541204121.0, 'added_lines': 2, 'deleted_lines': 2, 'nloc': 300}, {'timestamp': 1541489001.0, 'added_lines': 8, 'deleted_lines': 0, 'nloc': 307}, {'timestamp': 1544661332.0, 'added_lines': 1, 'deleted_lines': 1, 'nloc': 307}, {'timestamp': 1524529347.0, 'added_lines': 1, 'deleted_lines': 0, 'nloc': 308}, {'timestamp': 1540556089.0, 'added_lines': 2, 'deleted_lines': 2, 'nloc': 308}, {'timestamp': 1540562190.0, 'added_lines': 12, 'deleted_lines': 19, 'nloc': 303}, {'timestamp': 1542594282.0, 'added_lines': 0, 'deleted_lines': 1, 'nloc': 302}, {'timestamp': 1544451987.0, 'added_lines': 1, 'deleted_lines': 3, 'nloc': 300}, {'timestamp': 1545582404.0, 'added_lines': 1, 'deleted_lines': 1, 'nloc': 300}, {'timestamp': 1545139435.0, 'added_lines': 27, 'deleted_lines': 5, 'nloc': 319}, {'timestamp': 1547152271.0, 'added_lines': 1, 'deleted_lines': 1, 'nloc': 319}, {'timestamp': 1547355910.0, 'added_lines': 9, 'deleted_lines': 5, 'nloc': 365}, {'timestamp': 1542878205.0, 'added_lines': 6, 'deleted_lines': 1, 'nloc': 323}, {'timestamp': 1548866534.0, 'added_lines': 1, 'deleted_lines': 1, 'nloc': 370}, {'timestamp': 1549672857.0, 'added_lines': 2, 'deleted_lines': 2, 'nloc': 370}, {'timestamp': 1549673846.0, 'added_lines': 2, 'deleted_lines': 2, 'nloc': 370}, {'timestamp': 1549903582.0, 'added_lines': 3, 'deleted_lines': 3, 'nloc': 370}, {'timestamp': 1550185115.0, 'added_lines': 2, 'deleted_lines': 2, 'nloc': 370}, {'timestamp': 1550507829.0, 'added_lines': 3, 'deleted_lines': 3, 'nloc': 370}, {'timestamp': 1550576884.0, 'added_lines': 2, 'deleted_lines': 2, 'nloc': 370}, {'timestamp': 1550610741.0, 'added_lines': 1, 'deleted_lines': 1, 'nloc': 370}, {'timestamp': 1550711994.0, 'added_lines': 2, 'deleted_lines': 2, 'nloc': 370}, {'timestamp': 1550723346.0, 'added_lines': 2, 'deleted_lines': 2, 'nloc': 370}, {'timestamp': 1551138343.0, 'added_lines': 1, 'deleted_lines': 1, 'nloc': 370}, {'timestamp': 1551229859.0, 'added_lines': 2, 'deleted_lines': 2, 'nloc': 370}, {'timestamp': 1551299964.0, 'added_lines': 3, 'deleted_lines': 3, 'nloc': 370}, {'timestamp': 1551471469.0, 'added_lines': 1, 'deleted_lines': 1, 'nloc': 370}, {'timestamp': 1551551196.0, 'added_lines': 6, 'deleted_lines': 6, 'nloc': 370}, {'timestamp': 1551708626.0, 'added_lines': 1, 'deleted_lines': 1, 'nloc': 370}, {'timestamp': 1551709270.0, 'added_lines': 18, 'deleted_lines': 2, 'nloc': 386}, {'timestamp': 1552254637.0, 'added_lines': 16, 'deleted_lines': 6, 'nloc': 396}, {'timestamp': 1552308045.0, 'added_lines': 1, 'deleted_lines': 1, 'nloc': 396}, {'timestamp': 1552316561.0, 'added_lines': 8, 'deleted_lines': 4, 'nloc': 400}, {'timestamp': 1553211935.0, 'added_lines': 4, 'deleted_lines': 16, 'nloc': 388}, {'timestamp': 1553212365.0, 'added_lines': 0, 'deleted_lines': 1, 'nloc': 387}, {'timestamp': 1553697989.0, 'added_lines': 5, 'deleted_lines': 3, 'nloc': 389}, {'timestamp': 1556197427.0, 'added_lines': 55, 'deleted_lines': 43, 'nloc': 401}, {'timestamp': 1556198635.0, 'added_lines': 23, 'deleted_lines': 29, 'nloc': 395}, {'timestamp': 1556381438.0, 'added_lines': 4, 'deleted_lines': 0, 'nloc': 399}, {'timestamp': 1557554420.0, 'added_lines': 20, 'deleted_lines': 21, 'nloc': 398}, {'timestamp': 1570471063.0, 'added_lines': 5, 'deleted_lines': 5, 'nloc': 398}, {'timestamp': 1579218500.0, 'added_lines': 1, 'deleted_lines': 1, 'nloc': 398}, {'timestamp': 1581442170.0, 'added_lines': 5, 'deleted_lines': 0, 'nloc': 403}, {'timestamp': 1581816895.0, 'added_lines': 2, 'deleted_lines': 0, 'nloc': 405}, {'timestamp': 1593284238.0, 'added_lines': 4, 'deleted_lines': 0, 'nloc': 408}, {'timestamp': 1600726105.0, 'added_lines': 1, 'deleted_lines': 1, 'nloc': 408}, {'timestamp': 1608253728.0, 'added_lines': 1, 'deleted_lines': 1, 'nloc': 408}, {'timestamp': 1616604074.0, 'added_lines': 5, 'deleted_lines': 5, 'nloc': 408}, {'timestamp': 1617132175.0, 'added_lines': 2, 'deleted_lines': 2, 'nloc': 408}]","{'blocks/blockstore/caching.go': 1, 'blocks/blockstore/util/remove.go': 3, 'cmd/ipfs/daemon.go': 60, 'cmd/ipfs/init.go': 43, 'cmd/ipfs/ipfs.go': 51, 'cmd/ipfs/main.go': 61, 'cmd/ipfs/main_test.go': 4, 'cmd/ipfswatch/main.go': 22, 'cmd/seccat/seccat.go': 22, None: 54, 'commands/channelmarshaler.go': 1, 'commands/cli/cmd_suggestion.go': 1, 'commands/cli/helptext.go': 3, 'commands/cli/helptext_test.go': 2, 'commands/cli/parse.go': 2, 'commands/cli/parse_test.go': 2, 'commands/command.go': 29, 'commands/command_test.go': 20, 'commands/http/client.go': 2, 'commands/http/handler.go': 2, 'commands/http/multifilereader.go': 2, 'commands/http/multifilereader_test.go': 2, 'commands/http/parse.go': 2, 'commands/reqlog.go': 2, 'commands/request.go': 44, 'commands/response.go': 24, 'commands/response_test.go': 20, 'core/bootstrap.go': 19, 'core/commands/active.go': 23, 'core/commands/bitswap.go': 74, 'core/commands/block.go': 70, 'core/commands/bootstrap.go': 29, 'core/commands/cat.go': 64, 'core/commands/commands.go': 55, 'core/commands/config.go': 34, 'core/commands/dag/dag.go': 58, 'core/commands/dht.go': 53, 'core/commands/diag.go': 23, 'core/commands/dns.go': 33, 'core/commands/e/error.go': 1, 'core/commands/external.go': 23, 'core/commands/files/files.go': 12, 'core/commands/filestore.go': 61, 'core/commands/get.go': 83, 'core/commands/helptext_test.go': 51, 'core/commands/id.go': 43, 'core/commands/ipns.go': 18, 'core/commands/keystore.go': 47, 'core/commands/log.go': 29, 'core/commands/ls.go': 59, 'core/commands/mount_nofuse.go': 23, 'core/commands/mount_unix.go': 32, 'core/commands/mount_windows.go': 22, 'core/commands/name.go': 10, 'core/commands/object/diff.go': 33, 'core/commands/object/object.go': 68, 'core/commands/object/patch.go': 53, 'core/commands/p2p.go': 32, 'core/commands/pin.go': 59, 'core/commands/ping.go': 37, 'core/commands/publish.go': 21, 'core/commands/pubsub.go': 73, 'core/commands/refs.go': 48, 'core/commands/repo.go': 70, 'core/commands/resolve.go': 51, 'core/commands/root.go': 56, 'core/commands/shutdown.go': 34, 'core/commands/stat.go': 58, 'core/commands/swarm.go': 42, 'core/commands/sysdiag.go': 27, 'core/commands/tar.go': 51, 'core/commands/unixfs/ls.go': 50, 'core/commands/unixfs/unixfs.go': 23, 'core/commands/version.go': 26, 'core/core_test.go': 12, 'core/corehttp/commands.go': 70, 'core/corehttp/gateway.go': 29, 'core/coreunix/add.go': 66, 'core/coreunix/add_test.go': 56, 'core/coreunix/metadata_test.go': 44, 'exchange/bitswap/bitswap_test.go': 14, 'exchange/bitswap/decision/engine_test.go': 12, 'exchange/bitswap/message/message_test.go': 5, 'exchange/bitswap/message/pb/Makefile': 1, 'exchange/bitswap/testnet/network_test.go': 10, 'exchange/bitswap/testnet/peernet.go': 12, 'exchange/reprovide/reprovide_test.go': 31, 'fuse/ipns/common.go': 32, 'fuse/node/mount_test.go': 27, 'importer/balanced/balanced_test.go': 8, 'importer/chunk/rabin_test.go': 3, 'importer/helpers/dagbuilder.go': 14, 'importer/importer.go': 12, 'merkledag/utils/utils_test.go': 5, 'mfs/repub_test.go': 12, 'namesys/dns.go': 29, 'namesys/interface.go': 30, 'namesys/ipns_select_test.go': 5, 'namesys/proquint.go': 29, 'namesys/republisher/repub_test.go': 36, 'package.json': 79, 'repo/config/identity.go': 3, 'routing/offline/offline_test.go': 6, 'test/integration/addcat_test.go': 29, 'test/integration/bench_cat_test.go': 28, 'test/integration/bitswap_wo_routing_test.go': 29, 'test/integration/three_legged_cat_test.go': 28, 'test/sharness/t0600-issues-and-regressions-online.sh': 1, 'core/bootstrap_test.go': 17, 'core/commands/dht_test.go': 16, 'core/commands/get_test.go': 51, 'core/core.go': 47, 'core/corehttp/gateway_test.go': 41, 'core/corehttp/metrics_test.go': 23, 'core/mock/mock.go': 24, 'exchange/bitswap/decision/bench_test.go': 8, 'exchange/bitswap/decision/peer_request_queue_test.go': 8, 'exchange/bitswap/message/message.go': 8, 'exchange/bitswap/network/interface.go': 8, 'exchange/bitswap/network/ipfs_impl.go': 8, 'exchange/bitswap/testnet/interface.go': 7, 'exchange/bitswap/testnet/virtual.go': 9, 'exchange/bitswap/testutils.go': 12, 'fuse/ipns/ipns_test.go': 27, 'fuse/readonly/ipfs_test.go': 45, 'namesys/publisher_test.go': 26, 'namesys/resolve_test.go': 34, 'p2p/p2p.go': 17, 'p2p/registry.go': 11, 'repo/config/bootstrap_peers.go': 10, 'routing/mock/centralized_client.go': 4, 'routing/mock/centralized_server.go': 4, 'routing/mock/centralized_test.go': 4, 'routing/mock/interface.go': 4, 'routing/none/none_client.go': 4, 'test/integration/bench_test.go': 14, 'assets/assets.go': 37, 'blocks/blockstore/arc_cache.go': 2, 'blocks/blockstore/arc_cache_test.go': 2, 'blocks/blockstore/blockstore.go': 3, 'blocks/blockstore/blockstore_test.go': 2, 'blocks/blockstore/bloom_cache.go': 2, 'blocks/blockstore/bloom_cache_test.go': 2, 'blocks/blocksutil/block_generator.go': 2, 'blockservice/blockservice.go': 12, 'blockservice/blockservice_test.go': 10, 'blockservice/test/blocks_test.go': 10, 'core/builder.go': 47, 'core/commands/ipnsps.go': 10, 'core/coreapi/coreapi.go': 18, 'core/coreapi/interface/interface.go': 2, 'core/coreapi/unixfs.go': 47, 'core/coreapi/unixfs_test.go': 34, 'core/coredag/cbor.go': 13, 'core/coredag/dagpb.go': 29, 'core/coredag/dagtransl.go': 12, 'core/coredag/raw.go': 29, 'core/corehttp/corehttp.go': 12, 'core/corehttp/gateway_handler.go': 45, 'core/corerepo/gc.go': 36, 'core/corerepo/pinning.go': 21, 'core/coreunix/metadata.go': 35, 'core/pathresolver.go': 32, 'exchange/bitswap/bitswap.go': 11, 'exchange/bitswap/decision/engine.go': 10, 'exchange/bitswap/decision/ledger.go': 8, 'exchange/bitswap/decision/peer_request_queue.go': 7, 'exchange/bitswap/get.go': 9, 'exchange/bitswap/notifications/notifications.go': 4, 'exchange/bitswap/notifications/notifications_test.go': 4, 'exchange/bitswap/session.go': 8, 'exchange/bitswap/session_test.go': 6, 'exchange/bitswap/stat.go': 4, 'exchange/bitswap/wantlist/wantlist.go': 4, 'exchange/bitswap/wantlist/wantlist_test.go': 4, 'exchange/bitswap/wantmanager.go': 8, 'exchange/bitswap/workers.go': 7, 'exchange/interface.go': 2, 'exchange/offline/offline.go': 4, 'exchange/offline/offline_test.go': 4, 'exchange/reprovide/providers.go': 34, 'exchange/reprovide/reprovide.go': 22, 'filestore/filestore.go': 26, 'filestore/filestore_test.go': 34, 'filestore/fsrefstore.go': 25, 'filestore/util.go': 25, 'fuse/ipns/ipns_unix.go': 41, 'fuse/readonly/readonly_unix.go': 40, 'importer/balanced/builder.go': 4, 'importer/chunk/splitting_test.go': 2, 'importer/helpers/helpers.go': 5, 'importer/importer_test.go': 7, 'importer/trickle/trickle_test.go': 7, 'importer/trickle/trickledag.go': 6, 'merkledag/batch.go': 2, 'merkledag/coding.go': 4, 'merkledag/merkledag.go': 5, 'merkledag/merkledag_test.go': 9, 'merkledag/node.go': 4, 'merkledag/node_test.go': 4, 'merkledag/raw.go': 5, 'merkledag/traverse/traverse.go': 4, 'merkledag/traverse/traverse_test.go': 4, 'merkledag/utils/diff.go': 4, 'merkledag/utils/diffenum.go': 4, 'merkledag/utils/diffenum_test.go': 4, 'merkledag/utils/utils.go': 11, 'mfs/dir.go': 14, 'mfs/file.go': 15, 'mfs/mfs_test.go': 20, 'mfs/ops.go': 11, 'mfs/system.go': 16, 'namesys/namesys.go': 38, 'namesys/publisher.go': 39, 'namesys/pubsub.go': 7, 'namesys/pubsub_test.go': 6, 'namesys/republisher/repub.go': 31, 'namesys/routing.go': 37, 'path/path.go': 4, 'path/resolver.go': 3, 'path/resolver_test.go': 2, 'pin/gc/gc.go': 37, 'pin/pin.go': 34, 'pin/pin_test.go': 37, 'pin/set.go': 30, 'pin/set_test.go': 36, 'plugin/ipld.go': 11, 'plugin/loader/initializer.go': 9, 'plugin/plugins/git/git.go': 11, 'repo/config/init.go': 8, 'repo/fsrepo/fsrepo.go': 21, 'repo/fsrepo/lock/lock.go': 3, 'repo/fsrepo/serialize/serialize.go': 3, 'repo/mock.go': 13, 'repo/repo.go': 16, 'routing/offline/offline.go': 3, 'tar/format.go': 38, 'test/dependencies/ma-pipe-unidir/main.go': 8, 'thirdparty/ds-help/key.go': 2, 'thirdparty/pollEndpoint/main.go': 12, 'thirdparty/posinfo/posinfo.go': 2, 'unixfs/archive/archive.go': 5, 'unixfs/archive/tar/writer.go': 6, 'unixfs/hamt/hamt.go': 6, 'unixfs/io/dagreader.go': 6, 'unixfs/io/dirbuilder.go': 3, 'unixfs/io/resolve.go': 6, 'unixfs/mod/dagmodifier.go': 9, 'unixfs/mod/dagmodifier_test.go': 4, 'unixfs/test/utils.go': 8, 'commands/legacy/command.go': 34, 'commands/legacy/legacy.go': 35, 'commands/legacy/legacy_test.go': 36, 'commands/legacy/request.go': 36, 'commands/legacy/response.go': 35, 'commands/legacy/responseemitter.go': 4, 'core/commands/env.go': 4, 'core/commands/commands_test.go': 44, 'test/sharness/t0040-add-and-cat.sh': 7, 'TODO.md': 2, 'test/sharness/t0110-gateway.sh': 2, 'test/sharness/t0410-api-add.sh': 1, 'core/coreapi/dag.go': 10, 'core/coreapi/dag_test.go': 3, 'core/coreapi/interface/options/dag.go': 8, 'core/coreapi/key.go': 33, 'core/coreapi/name.go': 35, 'merkledag/test/utils.go': 10, 'namesys/namesys_test.go': 40, 'repo/fsrepo/datastores.go': 15, 'repo/fsrepo/fsrepo_test.go': 13, 'thirdparty/datastore2/datastore_closer.go': 2, 'thirdparty/datastore2/delayed.go': 2, 'thirdparty/datastore2/threadsafe.go': 2, 'unixfs/io/pbdagreader.go': 5, 'cmd/ipfs/util/ulimit.go': 9, 'cmd/seccat/util.go': 9, 'core/corehttp/logs.go': 9, 'fuse/mount/mount.go': 10, 'fuse/node/mount_unix.go': 11, 'importer/chunk/splitting.go': 1, 'namesys/ipns_validate_test.go': 4, 'plugin/loader/load.go': 7, 'blocks/blockstoreutil/remove.go': 22, 'core/coreapi/block.go': 19, 'core/commands/files.go': 66, 'test/sharness/t0043-add-w.sh': 1, 'removeme/verifbs/verifbs.go': 1, 'test/sharness/t0050-block.sh': 1, 'core/commands/root_test.go': 1, 'test/sharness/t0090-get.sh': 1, 'blockservice/test/mock.go': 5, 'namesys/validator.go': 3, 'CHANGELOG.md': 1, 'README.md': 3, 'bin/dist_get': 1, 'cmd/ipfs/util/ulimit_freebsd.go': 3, 'contribute.md': 1, 'core/coreapi/interface/options/pin.go': 1, 'docs/experimental-features.md': 1, 'docs/file-transfer.md': 1, 'docs/releases.md': 1, 'exchange/bitswap/README.md': 1, 'plugin/plugin.go': 1, 'repo/fsrepo/migrations/mfsr_test.go': 1, 'repo/fsrepo/migrations/migrations.go': 1, 'test/sharness/README.md': 1, 'thirdparty/dir/dir.go': 1, 'core/coreapi/pin.go': 36, 'keystore/keystore.go': 9, 'keystore/keystore_test.go': 6, 'keystore/memkeystore.go': 5, 'path/resolver/resolver.go': 5, 'thirdparty/verifbs/verifbs.go': 21, 'cmd/ipfs/util/ulimit_unix.go': 2, 'core/coreapi/block_test.go': 2, 'core/coreapi/interface/coreapi.go': 7, 'core/coreapi/interface/dag.go': 7, 'core/coreapi/interface/object.go': 7, 'core/coreapi/interface/options/block.go': 3, 'core/coreapi/interface/path.go': 20, 'core/coreapi/interface/unixfs.go': 14, 'core/coreapi/object.go': 36, 'fuse/ipns/link_unix.go': 3, 'fuse/mount/fuse.go': 5, 'fuse/node/mount_darwin.go': 2, 'merkledag/errservice.go': 2, 'merkledag/readonly.go': 2, 'merkledag/readonly_test.go': 2, 'merkledag/rwservice.go': 2, 'merkledag/session.go': 2, 'path/resolver/resolver_test.go': 3, 'thirdparty/verifcid/validate.go': 2, 'thirdparty/verifcid/validate_test.go': 2, 'unixfs/hamt/hamt_stress_test.go': 4, 'unixfs/hamt/hamt_test.go': 4, 'namesys/ipns_resolver_validation_test.go': 30, 'test/sharness/t0170-dht.sh': 1, 'core/commands/urlstore.go': 46, 'unixfs/io/directory.go': 3, 'core/corehttp/metrics.go': 2, 'Rules.mk': 1, 'dagutils/diff.go': 30, 'dagutils/diffenum.go': 25, 'dagutils/diffenum_test.go': 25, 'dagutils/utils.go': 26, 'dagutils/utils_test.go': 25, 'unixfs/io/dagreader_test.go': 2, 'unixfs/io/directory_test.go': 2, 'unixfs/unixfs.go': 2, 'core/coreapi/path.go': 33, 'core/coreunix/cat.go': 15, 'mfs/fd.go': 8, 'unixfs/importer/balanced/balanced_test.go': 1, 'unixfs/importer/balanced/builder.go': 1, 'unixfs/importer/helpers/dagbuilder.go': 1, 'unixfs/importer/helpers/helpers.go': 1, 'unixfs/importer/importer.go': 1, 'unixfs/importer/importer_test.go': 1, 'unixfs/importer/trickle/trickle_test.go': 1, 'unixfs/importer/trickle/trickledag.go': 1, 'unixfs/unixfs_test.go': 1, 'core/coreapi/name_test.go': 20, 'core/pathresolver_test.go': 24, 'namesys/base.go': 28, 'namesys/cache.go': 24, 'core/coreapi/interface/key.go': 4, 'filestore/pb/dataobj.pb.go': 3, 'pin/internal/pb/header.pb.go': 3, 'thirdparty/cidv0v1/blockstore.go': 14, 'repo/fsrepo/config_test.go': 9, 'repo/fsrepo/misc.go': 9, 'test/bench/bench_cli_ipfs_add/main.go': 11, 'test/bench/offline_add/main.go': 11, 'test/sharness/t0046-id-hash.sh': 1, 'core/commands/cmdenv/env.go': 33, 'core/commands/name/ipns.go': 38, 'core/commands/name/ipnsps.go': 24, 'core/commands/name/name.go': 22, 'core/commands/name/publish.go': 37, 'core/coreapi/dht.go': 19, 'core/coreapi/dht_test.go': 3, 'test/sharness/t0275-cid-security.sh': 1, 'test/sharness/lib/test-lib.sh': 1, 'core/coreapi/interface/dht.go': 3, 'p2p/listener.go': 6, 'p2p/local.go': 7, 'p2p/remote.go': 7, 'p2p/stream.go': 7, 'core/coreapi/interface/options/unixfs.go': 3, 'core/coreapi/interface/swarm.go': 2, 'core/coreapi/swarm.go': 15, 'core/commands/cid.go': 18, 'core/coreapi/unixfile.go': 5, 'cmd/ipfs/dnsresolve_test.go': 3, 'core/coreapi/interface/pubsub.go': 1, 'core/coreapi/pubsub.go': 13, 'test/dependencies/iptb/iptb.go': 8, 'commands/context.go': 18, 'core/commands/cmdenv/cidbase.go': 11, 'core/commands/cmdenv/cidbase_test.go': 3, 'test/sharness/t0045-ls.sh': 1, 'test/sharness/t0051-object-data/mixed.json': 1, 'test/sharness/t0051-object.sh': 1, 'test/sharness/t0053-dag.sh': 1, 'test/sharness/t0085-pins.sh': 1, 'test/sharness/t0095-refs.sh': 1, 'test/sharness/t0160-resolve.sh': 1, 'test/sharness/t0210-tar.sh': 1, 'test/sharness/t0250-files-api.sh': 1, 'test/sharness/t0271-filestore-utils.sh': 1, 'test/sharness/t0272-urlstore.sh': 1, 'core/commands/cmdenv/file.go': 3, 'core/coreapi/interface/tests/name.go': 1, 'core/coreapi/interface/tests/unixfs.go': 1, 'core/coreapi/test/api_test.go': 11, 'core/corehttp/ipns_hostname.go': 11, 'namesys/dns_test.go': 10, 'plugin/daemon.go': 10, 'plugin/loader/loader.go': 12, 'core/corehttp/proxy.go': 6, 'plugin/plugins/badgerds/badgerds.go': 3, 'plugin/plugins/flatfs/flatfs.go': 3, 'plugin/plugins/levelds/levelds.go': 2, 'core/corerepo/stat.go': 2, 'core/corehttp/proxy_test.go': 1, 'plugin/tracer.go': 1, 'thirdparty/notifier/notifier.go': 1, 'go.mod': 4, 'go.sum': 4, 'core/corehttp/mutex_profile.go': 1, 'core/corehttp/option_test.go': 1, 'provider/queue.go': 1, 'provider/queue_test.go': 1, 'package-list.json': 1, 'core/bootstrap/bootstrap.go': 1, 'core/node/libp2p/discovery.go': 1, 'core/node/libp2p/pnet.go': 1, 'core/node/libp2p/smux.go': 1, 'core/node/libp2p/transport.go': 1, 'plugin/loader/load_unix.go': 1, 'test/sharness/t0042-add-skip.sh': 1, 'cmd/ipfs/util/ulimit_test.go': 1, 'cmd/ipfswatch/ipfswatch_test.go': 1, 'cmd/seccat/seccat_plan9.go': 1, 'cmd/seccat/seccat_posix.go': 1, 'fuse/node/mount_notsupp.go': 1, 'core/commands/pin/remotepin.go': 1, 'core/commands/pin/pin.go': 1, 'core/commands/stat_dht.go': 1}","('core/commands/get.go', 0.5724137931034483, 0.6916666666666667)"
core/commands/bitswap.go,241,1485,7,"[{'cyclomatic_complexity': 6, 'nloc': 26, 'token_count': 162, 'name': '', 'long_name': '(req cmds.Request,res cmds.Response)', 'start_line': 39, 'end_line': 73, 'full_parameters': [], 'filename': '/home/dimi/Documents/Informatik_Studium/FSS/SoftEvo/DataCollection/FFS_SoftEvo/go-ipfs/core/commands/bitswap.go', 'top_nesting_level': 0, 'length': 35, 'fan_in': 0, 'fan_out': 0, 'general_fan_out': 0}, {'cyclomatic_complexity': 8, 'nloc': 35, 'token_count': 217, 'name': '', 'long_name': '(req cmds.Request,res cmds.Response)', 'start_line': 86, 'end_line': 124, 'full_parameters': [], 'filename': '/home/dimi/Documents/Informatik_Studium/FSS/SoftEvo/DataCollection/FFS_SoftEvo/go-ipfs/core/commands/bitswap.go', 'top_nesting_level': 0, 'length': 39, 'fan_in': 0, 'fan_out': 0, 'general_fan_out': 0}, {'cyclomatic_complexity': 5, 'nloc': 22, 'token_count': 130, 'name': '', 'long_name': '(req cmds.Request,res cmds.Response)', 'start_line': 136, 'end_line': 161, 'full_parameters': [], 'filename': '/home/dimi/Documents/Informatik_Studium/FSS/SoftEvo/DataCollection/FFS_SoftEvo/go-ipfs/core/commands/bitswap.go', 'top_nesting_level': 0, 'length': 26, 'fan_in': 0, 'fan_out': 0, 'general_fan_out': 0}, {'cyclomatic_complexity': 4, 'nloc': 24, 'token_count': 234, 'name': '', 'long_name': '(res cmds.Response)(io.Reader,error)', 'start_line': 163, 'end_line': 186, 'full_parameters': [], 'filename': '/home/dimi/Documents/Informatik_Studium/FSS/SoftEvo/DataCollection/FFS_SoftEvo/go-ipfs/core/commands/bitswap.go', 'top_nesting_level': 0, 'length': 24, 'fan_in': 0, 'fan_out': 0, 'general_fan_out': 0}, {'cyclomatic_complexity': 5, 'nloc': 22, 'token_count': 143, 'name': '', 'long_name': '(req cmds.Request,res cmds.Response)', 'start_line': 203, 'end_line': 227, 'full_parameters': [], 'filename': '/home/dimi/Documents/Informatik_Studium/FSS/SoftEvo/DataCollection/FFS_SoftEvo/go-ipfs/core/commands/bitswap.go', 'top_nesting_level': 0, 'length': 25, 'fan_in': 0, 'fan_out': 0, 'general_fan_out': 0}, {'cyclomatic_complexity': 2, 'nloc': 15, 'token_count': 93, 'name': '', 'long_name': '(res cmds.Response)(io.Reader,error)', 'start_line': 229, 'end_line': 243, 'full_parameters': [], 'filename': '/home/dimi/Documents/Informatik_Studium/FSS/SoftEvo/DataCollection/FFS_SoftEvo/go-ipfs/core/commands/bitswap.go', 'top_nesting_level': 0, 'length': 15, 'fan_in': 0, 'fan_out': 0, 'general_fan_out': 0}, {'cyclomatic_complexity': 4, 'nloc': 16, 'token_count': 95, 'name': '', 'long_name': '(req cmds.Request,res cmds.Response)', 'start_line': 254, 'end_line': 271, 'full_parameters': [], 'filename': '/home/dimi/Documents/Informatik_Studium/FSS/SoftEvo/DataCollection/FFS_SoftEvo/go-ipfs/core/commands/bitswap.go', 'top_nesting_level': 0, 'length': 18, 'fan_in': 0, 'fan_out': 0, 'general_fan_out': 0}]",213,1320,0,[],-28,-165,-7,99,99,"[{'timestamp': 1491058697.0, 'added_lines': 84, 'deleted_lines': 70, 'nloc': 249}, {'timestamp': 1508770239.0, 'added_lines': 4, 'deleted_lines': 2, 'nloc': 250}, {'timestamp': 1509016767.0, 'added_lines': 1, 'deleted_lines': 1, 'nloc': 250}, {'timestamp': 1511223906.0, 'added_lines': 2, 'deleted_lines': 2, 'nloc': 250}, {'timestamp': 1511373659.0, 'added_lines': 1, 'deleted_lines': 1, 'nloc': 250}, {'timestamp': 1512365669.0, 'added_lines': 4, 'deleted_lines': 4, 'nloc': 250}, {'timestamp': 1511187070.0, 'added_lines': 11, 'deleted_lines': 11, 'nloc': 250}, {'timestamp': 1512058290.0, 'added_lines': 0, 'deleted_lines': 1, 'nloc': 249}, {'timestamp': 1512121226.0, 'added_lines': 1, 'deleted_lines': 1, 'nloc': 249}, {'timestamp': 1513436097.0, 'added_lines': 2, 'deleted_lines': 2, 'nloc': 249}, {'timestamp': 1513612261.0, 'added_lines': 2, 'deleted_lines': 2, 'nloc': 249}, {'timestamp': 1513764708.0, 'added_lines': 1, 'deleted_lines': 1, 'nloc': 249}, {'timestamp': 1513765470.0, 'added_lines': 1, 'deleted_lines': 1, 'nloc': 249}, {'timestamp': 1513766201.0, 'added_lines': 1, 'deleted_lines': 1, 'nloc': 249}, {'timestamp': 1513772654.0, 'added_lines': 1, 'deleted_lines': 1, 'nloc': 249}, {'timestamp': 1513773452.0, 'added_lines': 1, 'deleted_lines': 1, 'nloc': 249}, {'timestamp': 1515277696.0, 'added_lines': 1, 'deleted_lines': 1, 'nloc': 249}, {'timestamp': 1515465466.0, 'added_lines': 2, 'deleted_lines': 2, 'nloc': 249}, {'timestamp': 1515713724.0, 'added_lines': 1, 'deleted_lines': 1, 'nloc': 249}, {'timestamp': 1516341168.0, 'added_lines': 1, 'deleted_lines': 1, 'nloc': 249}, {'timestamp': 1516838128.0, 'added_lines': 3, 'deleted_lines': 3, 'nloc': 249}, {'timestamp': 1517105039.0, 'added_lines': 1, 'deleted_lines': 1, 'nloc': 249}, {'timestamp': 1517453697.0, 'added_lines': 2, 'deleted_lines': 2, 'nloc': 249}, {'timestamp': 1519173780.0, 'added_lines': 1, 'deleted_lines': 1, 'nloc': 249}, {'timestamp': 1521314540.0, 'added_lines': 1, 'deleted_lines': 1, 'nloc': 249}, {'timestamp': 1521500314.0, 'added_lines': 1, 'deleted_lines': 1, 'nloc': 249}, {'timestamp': 1524596476.0, 'added_lines': 1, 'deleted_lines': 1, 'nloc': 249}, {'timestamp': 1525408792.0, 'added_lines': 2, 'deleted_lines': 2, 'nloc': 249}, {'timestamp': 1528520460.0, 'added_lines': 4, 'deleted_lines': 4, 'nloc': 249}, {'timestamp': 1529984485.0, 'added_lines': 2, 'deleted_lines': 2, 'nloc': 249}, {'timestamp': 1531779409.0, 'added_lines': 1, 'deleted_lines': 1, 'nloc': 249}, {'timestamp': 1532728052.0, 'added_lines': 2, 'deleted_lines': 2, 'nloc': 249}, {'timestamp': 1533500571.0, 'added_lines': 2, 'deleted_lines': 2, 'nloc': 249}, {'timestamp': 1533618653.0, 'added_lines': 2, 'deleted_lines': 2, 'nloc': 249}, {'timestamp': 1533779477.0, 'added_lines': 4, 'deleted_lines': 4, 'nloc': 249}, {'timestamp': 1533946888.0, 'added_lines': 2, 'deleted_lines': 2, 'nloc': 249}, {'timestamp': 1534115707.0, 'added_lines': 3, 'deleted_lines': 3, 'nloc': 249}, {'timestamp': 1534195762.0, 'added_lines': 2, 'deleted_lines': 2, 'nloc': 249}, {'timestamp': 1534347022.0, 'added_lines': 3, 'deleted_lines': 3, 'nloc': 249}, {'timestamp': 1534896611.0, 'added_lines': 6, 'deleted_lines': 6, 'nloc': 249}, {'timestamp': 1534903410.0, 'added_lines': 7, 'deleted_lines': 6, 'nloc': 250}, {'timestamp': 1532889722.0, 'added_lines': 0, 'deleted_lines': 48, 'nloc': 213}, {'timestamp': 1535601896.0, 'added_lines': 2, 'deleted_lines': 2, 'nloc': 213}, {'timestamp': 1536388808.0, 'added_lines': 2, 'deleted_lines': 2, 'nloc': 213}, {'timestamp': 1536718784.0, 'added_lines': 2, 'deleted_lines': 2, 'nloc': 213}, {'timestamp': 1536723292.0, 'added_lines': 2, 'deleted_lines': 2, 'nloc': 213}, {'timestamp': 1523628870.0, 'added_lines': 7, 'deleted_lines': 11, 'nloc': 209}, {'timestamp': 1535044155.0, 'added_lines': 1, 'deleted_lines': 1, 'nloc': 209}, {'timestamp': 1537193530.0, 'added_lines': 1, 'deleted_lines': 1, 'nloc': 209}, {'timestamp': 1537391809.0, 'added_lines': 1, 'deleted_lines': 1, 'nloc': 209}, {'timestamp': 1537790637.0, 'added_lines': 2, 'deleted_lines': 2, 'nloc': 209}, {'timestamp': 1537792589.0, 'added_lines': 4, 'deleted_lines': 4, 'nloc': 209}, {'timestamp': 1538544957.0, 'added_lines': 2, 'deleted_lines': 2, 'nloc': 209}, {'timestamp': 1538694687.0, 'added_lines': 2, 'deleted_lines': 2, 'nloc': 209}, {'timestamp': 1538695953.0, 'added_lines': 2, 'deleted_lines': 2, 'nloc': 209}, {'timestamp': 1538662493.0, 'added_lines': 6, 'deleted_lines': 2, 'nloc': 212}, {'timestamp': 1538773916.0, 'added_lines': 2, 'deleted_lines': 2, 'nloc': 212}, {'timestamp': 1539176817.0, 'added_lines': 2, 'deleted_lines': 2, 'nloc': 212}, {'timestamp': 1539357340.0, 'added_lines': 2, 'deleted_lines': 2, 'nloc': 212}, {'timestamp': 1539850591.0, 'added_lines': 2, 'deleted_lines': 2, 'nloc': 212}, {'timestamp': 1540400358.0, 'added_lines': 3, 'deleted_lines': 3, 'nloc': 212}, {'timestamp': 1540410565.0, 'added_lines': 2, 'deleted_lines': 2, 'nloc': 212}, {'timestamp': 1540418491.0, 'added_lines': 2, 'deleted_lines': 2, 'nloc': 212}, {'timestamp': 1540552487.0, 'added_lines': 1, 'deleted_lines': 1, 'nloc': 212}, {'timestamp': 1540597832.0, 'added_lines': 1, 'deleted_lines': 1, 'nloc': 212}, {'timestamp': 1541204121.0, 'added_lines': 4, 'deleted_lines': 4, 'nloc': 212}, {'timestamp': 1540615630.0, 'added_lines': 47, 'deleted_lines': 69, 'nloc': 191}, {'timestamp': 1540865726.0, 'added_lines': 4, 'deleted_lines': 7, 'nloc': 188}, {'timestamp': 1541822268.0, 'added_lines': 13, 'deleted_lines': 17, 'nloc': 184}, {'timestamp': 1541816573.0, 'added_lines': 7, 'deleted_lines': 5, 'nloc': 189}, {'timestamp': 1541903826.0, 'added_lines': 2, 'deleted_lines': 2, 'nloc': 185}, {'timestamp': 1544225843.0, 'added_lines': 3, 'deleted_lines': 3, 'nloc': 185}, {'timestamp': 1544661332.0, 'added_lines': 1, 'deleted_lines': 1, 'nloc': 185}, {'timestamp': 1540556089.0, 'added_lines': 1, 'deleted_lines': 1, 'nloc': 185}, {'timestamp': 1547003974.0, 'added_lines': 2, 'deleted_lines': 2, 'nloc': 185}, {'timestamp': 1547152271.0, 'added_lines': 1, 'deleted_lines': 1, 'nloc': 185}, {'timestamp': 1542852136.0, 'added_lines': 1, 'deleted_lines': 1, 'nloc': 185}, {'timestamp': 1542878205.0, 'added_lines': 10, 'deleted_lines': 3, 'nloc': 193}, {'timestamp': 1547499910.0, 'added_lines': 2, 'deleted_lines': 2, 'nloc': 193}, {'timestamp': 1548866534.0, 'added_lines': 1, 'deleted_lines': 1, 'nloc': 193}, {'timestamp': 1549588289.0, 'added_lines': 3, 'deleted_lines': 3, 'nloc': 193}, {'timestamp': 1549903582.0, 'added_lines': 1, 'deleted_lines': 1, 'nloc': 193}, {'timestamp': 1550185115.0, 'added_lines': 2, 'deleted_lines': 2, 'nloc': 193}, {'timestamp': 1550507829.0, 'added_lines': 4, 'deleted_lines': 4, 'nloc': 193}, {'timestamp': 1550610741.0, 'added_lines': 2, 'deleted_lines': 2, 'nloc': 193}, {'timestamp': 1550711994.0, 'added_lines': 2, 'deleted_lines': 2, 'nloc': 193}, {'timestamp': 1550723346.0, 'added_lines': 3, 'deleted_lines': 3, 'nloc': 193}, {'timestamp': 1551138343.0, 'added_lines': 1, 'deleted_lines': 1, 'nloc': 193}, {'timestamp': 1551229859.0, 'added_lines': 3, 'deleted_lines': 3, 'nloc': 193}, {'timestamp': 1551299964.0, 'added_lines': 3, 'deleted_lines': 3, 'nloc': 193}, {'timestamp': 1551471469.0, 'added_lines': 1, 'deleted_lines': 1, 'nloc': 193}, {'timestamp': 1551754781.0, 'added_lines': 4, 'deleted_lines': 4, 'nloc': 193}, {'timestamp': 1543991660.0, 'added_lines': 14, 'deleted_lines': 2, 'nloc': 202}, {'timestamp': 1551551196.0, 'added_lines': 7, 'deleted_lines': 7, 'nloc': 202}, {'timestamp': 1556212269.0, 'added_lines': 15, 'deleted_lines': 3, 'nloc': 214}, {'timestamp': 1557554420.0, 'added_lines': 13, 'deleted_lines': 14, 'nloc': 213}, {'timestamp': 1555520888.0, 'added_lines': 1, 'deleted_lines': 1, 'nloc': 213}, {'timestamp': 1559060517.0, 'added_lines': 1, 'deleted_lines': 1, 'nloc': 213}, {'timestamp': 1576349311.0, 'added_lines': 2, 'deleted_lines': 2, 'nloc': 213}]","{'blocks/blockstore/caching.go': 1, 'blocks/blockstore/util/remove.go': 3, 'cmd/ipfs/daemon.go': 58, 'cmd/ipfs/init.go': 43, 'cmd/ipfs/ipfs.go': 51, 'cmd/ipfs/main.go': 62, 'cmd/ipfs/main_test.go': 4, 'cmd/ipfswatch/main.go': 24, 'cmd/seccat/seccat.go': 27, None: 47, 'commands/channelmarshaler.go': 1, 'commands/cli/cmd_suggestion.go': 1, 'commands/cli/helptext.go': 2, 'commands/cli/helptext_test.go': 2, 'commands/cli/parse.go': 2, 'commands/cli/parse_test.go': 2, 'commands/command.go': 29, 'commands/command_test.go': 20, 'commands/http/client.go': 2, 'commands/http/handler.go': 2, 'commands/http/multifilereader.go': 2, 'commands/http/multifilereader_test.go': 2, 'commands/http/parse.go': 2, 'commands/reqlog.go': 1, 'commands/request.go': 41, 'commands/response.go': 24, 'commands/response_test.go': 20, 'core/bootstrap.go': 26, 'core/commands/active.go': 24, 'core/commands/add.go': 74, 'core/commands/block.go': 63, 'core/commands/bootstrap.go': 34, 'core/commands/cat.go': 59, 'core/commands/commands.go': 53, 'core/commands/config.go': 35, 'core/commands/dag/dag.go': 59, 'core/commands/dht.go': 65, 'core/commands/diag.go': 23, 'core/commands/dns.go': 32, 'core/commands/e/error.go': 1, 'core/commands/external.go': 23, 'core/commands/files/files.go': 10, 'core/commands/filestore.go': 61, 'core/commands/get.go': 82, 'core/commands/helptext_test.go': 51, 'core/commands/id.go': 55, 'core/commands/ipns.go': 17, 'core/commands/keystore.go': 43, 'core/commands/log.go': 29, 'core/commands/ls.go': 59, 'core/commands/mount_nofuse.go': 23, 'core/commands/mount_unix.go': 35, 'core/commands/mount_windows.go': 22, 'core/commands/name.go': 10, 'core/commands/object/diff.go': 28, 'core/commands/object/object.go': 68, 'core/commands/object/patch.go': 43, 'core/commands/p2p.go': 40, 'core/commands/pin.go': 61, 'core/commands/ping.go': 47, 'core/commands/publish.go': 20, 'core/commands/pubsub.go': 69, 'core/commands/refs.go': 58, 'core/commands/repo.go': 74, 'core/commands/resolve.go': 61, 'core/commands/root.go': 55, 'core/commands/shutdown.go': 34, 'core/commands/stat.go': 63, 'core/commands/swarm.go': 51, 'core/commands/sysdiag.go': 30, 'core/commands/tar.go': 56, 'core/commands/unixfs/ls.go': 54, 'core/commands/unixfs/unixfs.go': 23, 'core/commands/version.go': 26, 'core/core_test.go': 18, 'core/corehttp/commands.go': 80, 'core/corehttp/gateway.go': 35, 'core/coreunix/add.go': 53, 'core/coreunix/add_test.go': 52, 'core/coreunix/metadata_test.go': 47, 'exchange/bitswap/bitswap_test.go': 11, 'exchange/bitswap/decision/engine_test.go': 9, 'exchange/bitswap/message/message_test.go': 5, 'exchange/bitswap/message/pb/Makefile': 1, 'exchange/bitswap/testnet/network_test.go': 9, 'exchange/bitswap/testnet/peernet.go': 10, 'exchange/reprovide/reprovide_test.go': 34, 'fuse/ipns/common.go': 43, 'fuse/node/mount_test.go': 33, 'importer/balanced/balanced_test.go': 7, 'importer/chunk/rabin_test.go': 3, 'importer/helpers/dagbuilder.go': 12, 'importer/importer.go': 12, 'merkledag/utils/utils_test.go': 5, 'mfs/repub_test.go': 12, 'namesys/dns.go': 37, 'namesys/interface.go': 39, 'namesys/ipns_select_test.go': 5, 'namesys/proquint.go': 37, 'namesys/republisher/repub_test.go': 46, 'package.json': 82, 'repo/config/identity.go': 3, 'routing/offline/offline_test.go': 6, 'test/integration/addcat_test.go': 37, 'test/integration/bench_cat_test.go': 36, 'test/integration/bitswap_wo_routing_test.go': 37, 'test/integration/three_legged_cat_test.go': 36, 'test/sharness/t0600-issues-and-regressions-online.sh': 1, 'core/bootstrap_test.go': 24, 'core/commands/dht_test.go': 24, 'core/commands/get_test.go': 50, 'core/core.go': 53, 'core/corehttp/gateway_test.go': 46, 'core/corehttp/metrics_test.go': 33, 'core/mock/mock.go': 34, 'exchange/bitswap/decision/bench_test.go': 8, 'exchange/bitswap/decision/peer_request_queue_test.go': 8, 'exchange/bitswap/message/message.go': 8, 'exchange/bitswap/network/interface.go': 8, 'exchange/bitswap/network/ipfs_impl.go': 8, 'exchange/bitswap/testnet/interface.go': 7, 'exchange/bitswap/testnet/virtual.go': 8, 'exchange/bitswap/testutils.go': 9, 'fuse/ipns/ipns_test.go': 32, 'fuse/readonly/ipfs_test.go': 49, 'namesys/publisher_test.go': 33, 'namesys/resolve_test.go': 44, 'p2p/p2p.go': 25, 'p2p/registry.go': 11, 'repo/config/bootstrap_peers.go': 9, 'routing/mock/centralized_client.go': 4, 'routing/mock/centralized_server.go': 4, 'routing/mock/centralized_test.go': 4, 'routing/mock/interface.go': 4, 'routing/none/none_client.go': 4, 'test/integration/bench_test.go': 19, 'assets/assets.go': 43, 'blocks/blockstore/arc_cache.go': 2, 'blocks/blockstore/arc_cache_test.go': 2, 'blocks/blockstore/blockstore.go': 3, 'blocks/blockstore/blockstore_test.go': 2, 'blocks/blockstore/bloom_cache.go': 2, 'blocks/blockstore/bloom_cache_test.go': 2, 'blocks/blocksutil/block_generator.go': 2, 'blockservice/blockservice.go': 7, 'blockservice/blockservice_test.go': 6, 'blockservice/test/blocks_test.go': 6, 'core/builder.go': 49, 'core/commands/ipnsps.go': 10, 'core/coreapi/coreapi.go': 24, 'core/coreapi/interface/interface.go': 2, 'core/coreapi/unixfs.go': 46, 'core/coreapi/unixfs_test.go': 35, 'core/coredag/cbor.go': 15, 'core/coredag/dagpb.go': 39, 'core/coredag/dagtransl.go': 12, 'core/coredag/raw.go': 39, 'core/corehttp/corehttp.go': 14, 'core/corehttp/gateway_handler.go': 50, 'core/corerepo/gc.go': 44, 'core/corerepo/pinning.go': 19, 'core/coreunix/metadata.go': 44, 'core/pathresolver.go': 42, 'exchange/bitswap/bitswap.go': 7, 'exchange/bitswap/decision/engine.go': 7, 'exchange/bitswap/decision/ledger.go': 7, 'exchange/bitswap/decision/peer_request_queue.go': 7, 'exchange/bitswap/get.go': 6, 'exchange/bitswap/notifications/notifications.go': 4, 'exchange/bitswap/notifications/notifications_test.go': 4, 'exchange/bitswap/session.go': 8, 'exchange/bitswap/session_test.go': 6, 'exchange/bitswap/stat.go': 4, 'exchange/bitswap/wantlist/wantlist.go': 4, 'exchange/bitswap/wantlist/wantlist_test.go': 4, 'exchange/bitswap/wantmanager.go': 7, 'exchange/bitswap/workers.go': 7, 'exchange/interface.go': 2, 'exchange/offline/offline.go': 2, 'exchange/offline/offline_test.go': 2, 'exchange/reprovide/providers.go': 42, 'exchange/reprovide/reprovide.go': 28, 'filestore/filestore.go': 25, 'filestore/filestore_test.go': 41, 'filestore/fsrefstore.go': 24, 'filestore/util.go': 24, 'fuse/ipns/ipns_unix.go': 48, 'fuse/readonly/readonly_unix.go': 48, 'importer/balanced/builder.go': 4, 'importer/chunk/splitting_test.go': 2, 'importer/helpers/helpers.go': 4, 'importer/importer_test.go': 6, 'importer/trickle/trickle_test.go': 6, 'importer/trickle/trickledag.go': 4, 'merkledag/batch.go': 2, 'merkledag/coding.go': 4, 'merkledag/merkledag.go': 4, 'merkledag/merkledag_test.go': 6, 'merkledag/node.go': 4, 'merkledag/node_test.go': 4, 'merkledag/raw.go': 4, 'merkledag/traverse/traverse.go': 4, 'merkledag/traverse/traverse_test.go': 4, 'merkledag/utils/diff.go': 4, 'merkledag/utils/diffenum.go': 4, 'merkledag/utils/diffenum_test.go': 4, 'merkledag/utils/utils.go': 6, 'mfs/dir.go': 11, 'mfs/file.go': 13, 'mfs/mfs_test.go': 13, 'mfs/ops.go': 10, 'mfs/system.go': 14, 'namesys/namesys.go': 46, 'namesys/publisher.go': 48, 'namesys/pubsub.go': 5, 'namesys/pubsub_test.go': 5, 'namesys/republisher/repub.go': 42, 'namesys/routing.go': 45, 'path/path.go': 4, 'path/resolver.go': 3, 'path/resolver_test.go': 2, 'pin/gc/gc.go': 42, 'pin/pin.go': 42, 'pin/pin_test.go': 41, 'pin/set.go': 39, 'pin/set_test.go': 41, 'plugin/ipld.go': 12, 'plugin/loader/initializer.go': 9, 'plugin/plugins/git/git.go': 12, 'repo/config/init.go': 7, 'repo/fsrepo/fsrepo.go': 23, 'repo/fsrepo/lock/lock.go': 3, 'repo/fsrepo/serialize/serialize.go': 3, 'repo/mock.go': 17, 'repo/repo.go': 21, 'routing/offline/offline.go': 3, 'tar/format.go': 47, 'test/dependencies/ma-pipe-unidir/main.go': 9, 'thirdparty/ds-help/key.go': 2, 'thirdparty/pollEndpoint/main.go': 14, 'thirdparty/posinfo/posinfo.go': 2, 'unixfs/archive/archive.go': 4, 'unixfs/archive/tar/writer.go': 4, 'unixfs/hamt/hamt.go': 4, 'unixfs/io/dagreader.go': 4, 'unixfs/io/dirbuilder.go': 3, 'unixfs/io/resolve.go': 4, 'unixfs/mod/dagmodifier.go': 6, 'unixfs/mod/dagmodifier_test.go': 3, 'unixfs/test/utils.go': 6, 'commands/legacy/command.go': 34, 'commands/legacy/legacy.go': 34, 'commands/legacy/legacy_test.go': 35, 'commands/legacy/request.go': 35, 'commands/legacy/response.go': 35, 'commands/legacy/responseemitter.go': 4, 'core/commands/env.go': 4, 'core/commands/commands_test.go': 45, 'test/sharness/t0040-add-and-cat.sh': 2, 'TODO.md': 2, 'test/sharness/t0110-gateway.sh': 1, 'test/sharness/t0410-api-add.sh': 1, 'core/coreapi/dag.go': 11, 'core/coreapi/dag_test.go': 3, 'core/coreapi/interface/options/dag.go': 8, 'core/coreapi/key.go': 42, 'core/coreapi/name.go': 43, 'merkledag/test/utils.go': 5, 'namesys/namesys_test.go': 46, 'repo/fsrepo/datastores.go': 15, 'repo/fsrepo/fsrepo_test.go': 18, 'thirdparty/datastore2/datastore_closer.go': 1, 'thirdparty/datastore2/delayed.go': 1, 'thirdparty/datastore2/threadsafe.go': 1, 'unixfs/io/pbdagreader.go': 3, 'cmd/ipfs/util/ulimit.go': 9, 'cmd/seccat/util.go': 9, 'core/corehttp/logs.go': 9, 'fuse/mount/mount.go': 9, 'fuse/node/mount_unix.go': 10, 'importer/chunk/splitting.go': 1, 'namesys/ipns_validate_test.go': 3, 'plugin/loader/load.go': 7, 'core/commands/files.go': 63, 'core/commands/root_test.go': 1, 'test/sharness/t0090-get.sh': 1, 'blocks/blockstoreutil/remove.go': 21, 'blockservice/test/mock.go': 5, 'core/coreapi/pin.go': 40, 'keystore/keystore.go': 9, 'keystore/keystore_test.go': 6, 'keystore/memkeystore.go': 6, 'namesys/validator.go': 2, 'path/resolver/resolver.go': 4, 'thirdparty/verifbs/verifbs.go': 21, 'cmd/ipfs/util/ulimit_freebsd.go': 2, 'cmd/ipfs/util/ulimit_unix.go': 2, 'core/coreapi/block.go': 15, 'core/coreapi/block_test.go': 2, 'core/coreapi/interface/coreapi.go': 8, 'core/coreapi/interface/dag.go': 8, 'core/coreapi/interface/object.go': 8, 'core/coreapi/interface/options/block.go': 3, 'core/coreapi/interface/path.go': 30, 'core/coreapi/interface/unixfs.go': 12, 'core/coreapi/object.go': 42, 'fuse/ipns/link_unix.go': 2, 'fuse/mount/fuse.go': 2, 'fuse/node/mount_darwin.go': 2, 'merkledag/errservice.go': 2, 'merkledag/readonly.go': 2, 'merkledag/readonly_test.go': 2, 'merkledag/rwservice.go': 2, 'merkledag/session.go': 2, 'path/resolver/resolver_test.go': 2, 'thirdparty/verifcid/validate.go': 2, 'thirdparty/verifcid/validate_test.go': 2, 'unixfs/hamt/hamt_stress_test.go': 2, 'unixfs/hamt/hamt_test.go': 2, 'namesys/ipns_resolver_validation_test.go': 39, 'test/sharness/t0170-dht.sh': 1, 'core/commands/urlstore.go': 55, 'unixfs/io/directory.go': 1, 'Rules.mk': 1, 'core/coreapi/name_test.go': 27, 'core/coreapi/path.go': 40, 'core/coreunix/cat.go': 14, 'core/pathresolver_test.go': 35, 'dagutils/diff.go': 36, 'dagutils/diffenum.go': 35, 'dagutils/diffenum_test.go': 35, 'dagutils/utils.go': 35, 'dagutils/utils_test.go': 35, 'mfs/fd.go': 7, 'namesys/base.go': 36, 'namesys/cache.go': 35, 'core/coreapi/interface/key.go': 7, 'filestore/pb/dataobj.pb.go': 3, 'pin/internal/pb/header.pb.go': 3, 'thirdparty/cidv0v1/blockstore.go': 16, 'repo/fsrepo/config_test.go': 13, 'repo/fsrepo/misc.go': 13, 'test/bench/bench_cli_ipfs_add/main.go': 14, 'test/bench/offline_add/main.go': 14, 'core/commands/cmdenv/env.go': 32, 'core/commands/name/ipns.go': 46, 'core/commands/name/ipnsps.go': 29, 'core/commands/name/name.go': 22, 'core/commands/name/publish.go': 33, 'misc/completion/ipfs-completion.bash': 1, 'core/coreapi/dht.go': 29, 'core/coreapi/dht_test.go': 5, 'test/sharness/t0275-cid-security.sh': 1, 'test/sharness/lib/test-lib.sh': 1, 'core/coreapi/interface/dht.go': 10, 'p2p/listener.go': 14, 'p2p/local.go': 14, 'p2p/remote.go': 14, 'p2p/stream.go': 14, 'core/coreapi/interface/swarm.go': 9, 'core/coreapi/swarm.go': 21, 'core/commands/cid.go': 20, 'core/coreapi/interface/options/unixfs.go': 12, 'core/coreapi/pubsub.go': 19, 'core/coreapi/unixfile.go': 13, 'cmd/ipfs/dnsresolve_test.go': 5, 'core/coreapi/interface/pubsub.go': 4, 'test/dependencies/iptb/iptb.go': 12, 'plugin/plugins/badgerds/badgerds.go': 4, 'plugin/plugins/flatfs/flatfs.go': 4, 'plugin/plugins/levelds/levelds.go': 3, 'commands/context.go': 18, 'core/corehttp/proxy.go': 10, 'core/coreapi/interface/tests/name.go': 4, 'core/coreapi/interface/tests/unixfs.go': 4, 'core/coreapi/test/api_test.go': 11, 'core/commands/cmdenv/cidbase.go': 11, 'core/commands/cmdenv/cidbase_test.go': 3, 'test/sharness/t0045-ls.sh': 1, 'test/sharness/t0051-object-data/mixed.json': 1, 'test/sharness/t0051-object.sh': 1, 'test/sharness/t0053-dag.sh': 1, 'test/sharness/t0085-pins.sh': 1, 'test/sharness/t0095-refs.sh': 1, 'test/sharness/t0160-resolve.sh': 1, 'test/sharness/t0210-tar.sh': 1, 'test/sharness/t0250-files-api.sh': 1, 'test/sharness/t0271-filestore-utils.sh': 1, 'test/sharness/t0272-urlstore.sh': 1, 'plugin/loader/loader.go': 9, 'core/commands/cmdenv/file.go': 3, 'core/corehttp/ipns_hostname.go': 8, 'namesys/dns_test.go': 8, 'plugin/daemon.go': 8, 'core/corerepo/stat.go': 2, 'core/corehttp/metrics.go': 1, 'core/corehttp/proxy_test.go': 2, 'plugin/tracer.go': 1, 'thirdparty/notifier/notifier.go': 1, 'test/sharness/t0220-bitswap.sh': 1, 'README.md': 1, 'go.mod': 3, 'go.sum': 3, 'package-list.json': 1, 'core/node/core.go': 2, 'core/node/groups.go': 3, 'core/node/provider.go': 2, 'provider/offline.go': 1, 'provider/provider.go': 1, 'provider/queue/queue.go': 1, 'provider/queue/queue_test.go': 1, 'provider/simple/provider.go': 2, 'provider/simple/provider_test.go': 2, 'provider/simple/reprovide.go': 2, 'provider/simple/reprovide_test.go': 2, 'provider/system.go': 1, 'test/sharness/lib/iptb-lib.sh': 1, 'test/sharness/t0175-provider.sh': 1, 'test/sharness/t0175-reprovider.sh': 1, 'test/sharness/t0175-strategic-provider.sh': 1, 'core/bootstrap/bootstrap.go': 1, 'core/bootstrap/bootstrap_test.go': 1, 'core/node/builder.go': 1, 'core/node/identity.go': 1, 'core/node/ipns.go': 1, 'core/node/libp2p/addrs.go': 1, 'core/node/libp2p/discovery.go': 1, 'core/node/libp2p/host.go': 1, 'core/node/libp2p/hostopt.go': 1, 'core/node/libp2p/libp2p.go': 1, 'core/node/libp2p/nat.go': 1, 'core/node/libp2p/pnet.go': 1, 'core/node/libp2p/pubsub.go': 1, 'core/node/libp2p/routing.go': 1, 'core/node/libp2p/routingopt.go': 1, 'core/node/libp2p/smux.go': 1, 'core/node/libp2p/transport.go': 1}","('core/commands/get.go', 0.8282828282828283, 0.6833333333333333)"
core/commands/block.go,254,1670,9,"[{'cyclomatic_complexity': 1, 'nloc': 3, 'token_count': 26, 'name': 'String', 'long_name': '(bs BlockStat)String', 'start_line': 24, 'end_line': 26, 'full_parameters': [], 'filename': '/home/dimi/Documents/Informatik_Studium/FSS/SoftEvo/DataCollection/FFS_SoftEvo/go-ipfs/core/commands/block.go', 'top_nesting_level': 0, 'length': 3, 'fan_in': 0, 'fan_out': 0, 'general_fan_out': 0}, {'cyclomatic_complexity': 2, 'nloc': 11, 'token_count': 80, 'name': '', 'long_name': '(req cmds.Request,res cmds.Response)', 'start_line': 62, 'end_line': 73, 'full_parameters': [], 'filename': '/home/dimi/Documents/Informatik_Studium/FSS/SoftEvo/DataCollection/FFS_SoftEvo/go-ipfs/core/commands/block.go', 'top_nesting_level': 0, 'length': 12, 'fan_in': 0, 'fan_out': 0, 'general_fan_out': 0}, {'cyclomatic_complexity': 1, 'nloc': 4, 'token_count': 41, 'name': '', 'long_name': '(res cmds.Response)(io.Reader,error)', 'start_line': 76, 'end_line': 79, 'full_parameters': [], 'filename': '/home/dimi/Documents/Informatik_Studium/FSS/SoftEvo/DataCollection/FFS_SoftEvo/go-ipfs/core/commands/block.go', 'top_nesting_level': 0, 'length': 4, 'fan_in': 0, 'fan_out': 0, 'general_fan_out': 0}, {'cyclomatic_complexity': 2, 'nloc': 8, 'token_count': 63, 'name': '', 'long_name': '(req cmds.Request,res cmds.Response)', 'start_line': 95, 'end_line': 103, 'full_parameters': [], 'filename': '/home/dimi/Documents/Informatik_Studium/FSS/SoftEvo/DataCollection/FFS_SoftEvo/go-ipfs/core/commands/block.go', 'top_nesting_level': 0, 'length': 9, 'fan_in': 0, 'fan_out': 0, 'general_fan_out': 0}, {'cyclomatic_complexity': 12, 'nloc': 67, 'token_count': 413, 'name': '', 'long_name': '(req cmds.Request,res cmds.Response)', 'start_line': 123, 'end_line': 200, 'full_parameters': [], 'filename': '/home/dimi/Documents/Informatik_Studium/FSS/SoftEvo/DataCollection/FFS_SoftEvo/go-ipfs/core/commands/block.go', 'top_nesting_level': 0, 'length': 78, 'fan_in': 0, 'fan_out': 0, 'general_fan_out': 0}, {'cyclomatic_complexity': 1, 'nloc': 4, 'token_count': 41, 'name': '', 'long_name': '(res cmds.Response)(io.Reader,error)', 'start_line': 202, 'end_line': 205, 'full_parameters': [], 'filename': '/home/dimi/Documents/Informatik_Studium/FSS/SoftEvo/DataCollection/FFS_SoftEvo/go-ipfs/core/commands/block.go', 'top_nesting_level': 0, 'length': 4, 'fan_in': 0, 'fan_out': 0, 'general_fan_out': 0}, {'cyclomatic_complexity': 5, 'nloc': 19, 'token_count': 125, 'name': 'getBlockForKey', 'long_name': 'getBlockForKey req cmds . Request , skey string', 'start_line': 210, 'end_line': 232, 'full_parameters': ['req cmds . Request', ' skey string'], 'filename': '/home/dimi/Documents/Informatik_Studium/FSS/SoftEvo/DataCollection/FFS_SoftEvo/go-ipfs/core/commands/block.go', 'top_nesting_level': 0, 'length': 23, 'fan_in': 0, 'fan_out': 0, 'general_fan_out': 0}, {'cyclomatic_complexity': 5, 'nloc': 28, 'token_count': 209, 'name': '', 'long_name': '(req cmds.Request,res cmds.Response)', 'start_line': 249, 'end_line': 277, 'full_parameters': [], 'filename': '/home/dimi/Documents/Informatik_Studium/FSS/SoftEvo/DataCollection/FFS_SoftEvo/go-ipfs/core/commands/block.go', 'top_nesting_level': 0, 'length': 29, 'fan_in': 0, 'fan_out': 0, 'general_fan_out': 0}, {'cyclomatic_complexity': 2, 'nloc': 8, 'token_count': 71, 'name': '', 'long_name': '(res cmds.Response)(io.Reader,error)', 'start_line': 279, 'end_line': 287, 'full_parameters': [], 'filename': '/home/dimi/Documents/Informatik_Studium/FSS/SoftEvo/DataCollection/FFS_SoftEvo/go-ipfs/core/commands/block.go', 'top_nesting_level': 0, 'length': 9, 'fan_in': 0, 'fan_out': 0, 'general_fan_out': 0}]",244,997,1,"[{'cyclomatic_complexity': 1, 'nloc': 3, 'token_count': 26, 'name': 'String', 'long_name': '(bs BlockStat)String', 'start_line': 25, 'end_line': 27, 'full_parameters': [], 'filename': '/home/dimi/Documents/Informatik_Studium/FSS/SoftEvo/DataCollection/FFS_SoftEvo/go-ipfs/core/commands/block.go', 'top_nesting_level': 0, 'length': 3, 'fan_in': 0, 'fan_out': 0, 'general_fan_out': 0}]",-10,-673,-8,93,93,"[{'timestamp': 1491058697.0, 'added_lines': 92, 'deleted_lines': 66, 'nloc': 276}, {'timestamp': 1508770239.0, 'added_lines': 3, 'deleted_lines': 3, 'nloc': 276}, {'timestamp': 1509016767.0, 'added_lines': 1, 'deleted_lines': 1, 'nloc': 276}, {'timestamp': 1499331469.0, 'added_lines': 2, 'deleted_lines': 2, 'nloc': 276}, {'timestamp': 1511223906.0, 'added_lines': 2, 'deleted_lines': 2, 'nloc': 276}, {'timestamp': 1511245249.0, 'added_lines': 3, 'deleted_lines': 3, 'nloc': 276}, {'timestamp': 1511373659.0, 'added_lines': 1, 'deleted_lines': 1, 'nloc': 276}, {'timestamp': 1512365669.0, 'added_lines': 5, 'deleted_lines': 5, 'nloc': 276}, {'timestamp': 1511187070.0, 'added_lines': 27, 'deleted_lines': 26, 'nloc': 277}, {'timestamp': 1512121226.0, 'added_lines': 1, 'deleted_lines': 1, 'nloc': 277}, {'timestamp': 1513436097.0, 'added_lines': 2, 'deleted_lines': 2, 'nloc': 277}, {'timestamp': 1513612261.0, 'added_lines': 2, 'deleted_lines': 2, 'nloc': 277}, {'timestamp': 1513764708.0, 'added_lines': 1, 'deleted_lines': 1, 'nloc': 277}, {'timestamp': 1513765470.0, 'added_lines': 1, 'deleted_lines': 1, 'nloc': 277}, {'timestamp': 1513766201.0, 'added_lines': 1, 'deleted_lines': 1, 'nloc': 277}, {'timestamp': 1513772654.0, 'added_lines': 1, 'deleted_lines': 1, 'nloc': 277}, {'timestamp': 1513773452.0, 'added_lines': 1, 'deleted_lines': 1, 'nloc': 277}, {'timestamp': 1515277696.0, 'added_lines': 2, 'deleted_lines': 2, 'nloc': 277}, {'timestamp': 1515465466.0, 'added_lines': 6, 'deleted_lines': 6, 'nloc': 277}, {'timestamp': 1515633079.0, 'added_lines': 1, 'deleted_lines': 1, 'nloc': 277}, {'timestamp': 1515713724.0, 'added_lines': 1, 'deleted_lines': 1, 'nloc': 277}, {'timestamp': 1516341168.0, 'added_lines': 1, 'deleted_lines': 1, 'nloc': 277}, {'timestamp': 1516838128.0, 'added_lines': 4, 'deleted_lines': 4, 'nloc': 277}, {'timestamp': 1516911711.0, 'added_lines': 2, 'deleted_lines': 2, 'nloc': 277}, {'timestamp': 1517105039.0, 'added_lines': 1, 'deleted_lines': 1, 'nloc': 277}, {'timestamp': 1517453697.0, 'added_lines': 1, 'deleted_lines': 1, 'nloc': 277}, {'timestamp': 1515417773.0, 'added_lines': 29, 'deleted_lines': 12, 'nloc': 291}, {'timestamp': 1518714221.0, 'added_lines': 1, 'deleted_lines': 1, 'nloc': 277}, {'timestamp': 1519173780.0, 'added_lines': 1, 'deleted_lines': 1, 'nloc': 277}, {'timestamp': 1520721874.0, 'added_lines': 4, 'deleted_lines': 4, 'nloc': 291}, {'timestamp': 1521314540.0, 'added_lines': 1, 'deleted_lines': 1, 'nloc': 277}, {'timestamp': 1521500314.0, 'added_lines': 1, 'deleted_lines': 1, 'nloc': 277}, {'timestamp': 1521427288.0, 'added_lines': 1, 'deleted_lines': 1, 'nloc': 291}, {'timestamp': 1524596476.0, 'added_lines': 1, 'deleted_lines': 1, 'nloc': 291}, {'timestamp': 1525408792.0, 'added_lines': 1, 'deleted_lines': 1, 'nloc': 291}, {'timestamp': 1528520460.0, 'added_lines': 5, 'deleted_lines': 5, 'nloc': 291}, {'timestamp': 1529984485.0, 'added_lines': 1, 'deleted_lines': 1, 'nloc': 291}, {'timestamp': 1531779409.0, 'added_lines': 2, 'deleted_lines': 2, 'nloc': 291}, {'timestamp': 1533779477.0, 'added_lines': 1, 'deleted_lines': 1, 'nloc': 291}, {'timestamp': 1533946888.0, 'added_lines': 2, 'deleted_lines': 2, 'nloc': 291}, {'timestamp': 1534115707.0, 'added_lines': 2, 'deleted_lines': 2, 'nloc': 291}, {'timestamp': 1534347022.0, 'added_lines': 2, 'deleted_lines': 2, 'nloc': 291}, {'timestamp': 1534896611.0, 'added_lines': 4, 'deleted_lines': 4, 'nloc': 291}, {'timestamp': 1534903410.0, 'added_lines': 4, 'deleted_lines': 3, 'nloc': 292}, {'timestamp': 1533196132.0, 'added_lines': 61, 'deleted_lines': 106, 'nloc': 252}, {'timestamp': 1534189181.0, 'added_lines': 9, 'deleted_lines': 7, 'nloc': 254}, {'timestamp': 1523628870.0, 'added_lines': 36, 'deleted_lines': 60, 'nloc': 232}, {'timestamp': 1535044155.0, 'added_lines': 1, 'deleted_lines': 1, 'nloc': 232}, {'timestamp': 1537193530.0, 'added_lines': 1, 'deleted_lines': 1, 'nloc': 232}, {'timestamp': 1537391809.0, 'added_lines': 1, 'deleted_lines': 1, 'nloc': 232}, {'timestamp': 1537792589.0, 'added_lines': 1, 'deleted_lines': 1, 'nloc': 232}, {'timestamp': 1538662493.0, 'added_lines': 21, 'deleted_lines': 10, 'nloc': 241}, {'timestamp': 1539850591.0, 'added_lines': 2, 'deleted_lines': 2, 'nloc': 241}, {'timestamp': 1540552487.0, 'added_lines': 1, 'deleted_lines': 1, 'nloc': 241}, {'timestamp': 1540597832.0, 'added_lines': 1, 'deleted_lines': 1, 'nloc': 241}, {'timestamp': 1541204121.0, 'added_lines': 2, 'deleted_lines': 2, 'nloc': 241}, {'timestamp': 1541822268.0, 'added_lines': 2, 'deleted_lines': 11, 'nloc': 232}, {'timestamp': 1541678851.0, 'added_lines': 3, 'deleted_lines': 3, 'nloc': 232}, {'timestamp': 1544661332.0, 'added_lines': 1, 'deleted_lines': 1, 'nloc': 232}, {'timestamp': 1540556089.0, 'added_lines': 1, 'deleted_lines': 1, 'nloc': 232}, {'timestamp': 1540562190.0, 'added_lines': 1, 'deleted_lines': 1, 'nloc': 232}, {'timestamp': 1542594282.0, 'added_lines': 7, 'deleted_lines': 4, 'nloc': 235}, {'timestamp': 1543031503.0, 'added_lines': 1, 'deleted_lines': 1, 'nloc': 235}, {'timestamp': 1543868676.0, 'added_lines': 3, 'deleted_lines': 2, 'nloc': 236}, {'timestamp': 1544737281.0, 'added_lines': 3, 'deleted_lines': 3, 'nloc': 236}, {'timestamp': 1544785510.0, 'added_lines': 4, 'deleted_lines': 8, 'nloc': 232}, {'timestamp': 1544451987.0, 'added_lines': 4, 'deleted_lines': 4, 'nloc': 232}, {'timestamp': 1547152271.0, 'added_lines': 1, 'deleted_lines': 1, 'nloc': 232}, {'timestamp': 1548866534.0, 'added_lines': 1, 'deleted_lines': 1, 'nloc': 232}, {'timestamp': 1549299905.0, 'added_lines': 7, 'deleted_lines': 1, 'nloc': 237}, {'timestamp': 1549672857.0, 'added_lines': 2, 'deleted_lines': 2, 'nloc': 237}, {'timestamp': 1549673846.0, 'added_lines': 2, 'deleted_lines': 2, 'nloc': 237}, {'timestamp': 1549903582.0, 'added_lines': 3, 'deleted_lines': 3, 'nloc': 237}, {'timestamp': 1550185115.0, 'added_lines': 2, 'deleted_lines': 2, 'nloc': 237}, {'timestamp': 1550507829.0, 'added_lines': 3, 'deleted_lines': 3, 'nloc': 237}, {'timestamp': 1550576884.0, 'added_lines': 2, 'deleted_lines': 2, 'nloc': 237}, {'timestamp': 1550610741.0, 'added_lines': 1, 'deleted_lines': 1, 'nloc': 237}, {'timestamp': 1550711994.0, 'added_lines': 2, 'deleted_lines': 2, 'nloc': 237}, {'timestamp': 1550723346.0, 'added_lines': 2, 'deleted_lines': 2, 'nloc': 237}, {'timestamp': 1551138343.0, 'added_lines': 1, 'deleted_lines': 1, 'nloc': 237}, {'timestamp': 1551229859.0, 'added_lines': 2, 'deleted_lines': 2, 'nloc': 237}, {'timestamp': 1551299964.0, 'added_lines': 3, 'deleted_lines': 3, 'nloc': 237}, {'timestamp': 1551471469.0, 'added_lines': 1, 'deleted_lines': 1, 'nloc': 237}, {'timestamp': 1551551196.0, 'added_lines': 5, 'deleted_lines': 5, 'nloc': 237}, {'timestamp': 1553529899.0, 'added_lines': 3, 'deleted_lines': 21, 'nloc': 222}, {'timestamp': 1553608614.0, 'added_lines': 4, 'deleted_lines': 4, 'nloc': 222}, {'timestamp': 1553609463.0, 'added_lines': 3, 'deleted_lines': 3, 'nloc': 222}, {'timestamp': 1557554420.0, 'added_lines': 21, 'deleted_lines': 22, 'nloc': 221}, {'timestamp': 1557557624.0, 'added_lines': 3, 'deleted_lines': 0, 'nloc': 224}, {'timestamp': 1557869330.0, 'added_lines': 26, 'deleted_lines': 16, 'nloc': 232}, {'timestamp': 1560349434.0, 'added_lines': 3, 'deleted_lines': 3, 'nloc': 232}, {'timestamp': 1560357841.0, 'added_lines': 2, 'deleted_lines': 2, 'nloc': 244}, {'timestamp': 1560358247.0, 'added_lines': 3, 'deleted_lines': 3, 'nloc': 235}]","{'blocks/blockstore/caching.go': 1, 'blocks/blockstore/util/remove.go': 3, 'cmd/ipfs/daemon.go': 56, 'cmd/ipfs/init.go': 44, 'cmd/ipfs/ipfs.go': 51, 'cmd/ipfs/main.go': 54, 'cmd/ipfs/main_test.go': 4, 'cmd/ipfswatch/main.go': 16, 'cmd/seccat/seccat.go': 16, None: 22, 'commands/channelmarshaler.go': 1, 'commands/cli/cmd_suggestion.go': 1, 'commands/cli/helptext.go': 3, 'commands/cli/helptext_test.go': 2, 'commands/cli/parse.go': 2, 'commands/cli/parse_test.go': 2, 'commands/command.go': 29, 'commands/command_test.go': 20, 'commands/http/client.go': 2, 'commands/http/handler.go': 2, 'commands/http/multifilereader.go': 2, 'commands/http/multifilereader_test.go': 2, 'commands/http/parse.go': 2, 'commands/reqlog.go': 1, 'commands/request.go': 39, 'commands/response.go': 24, 'commands/response_test.go': 20, 'core/bootstrap.go': 16, 'core/commands/active.go': 25, 'core/commands/add.go': 70, 'core/commands/bitswap.go': 63, 'core/commands/bootstrap.go': 27, 'core/commands/cat.go': 67, 'core/commands/commands.go': 54, 'core/commands/config.go': 34, 'core/commands/dag/dag.go': 52, 'core/commands/dht.go': 43, 'core/commands/diag.go': 23, 'core/commands/dns.go': 34, 'core/commands/e/error.go': 1, 'core/commands/external.go': 23, 'core/commands/files/files.go': 13, 'core/commands/filestore.go': 59, 'core/commands/get.go': 70, 'core/commands/helptext_test.go': 51, 'core/commands/id.go': 37, 'core/commands/ipns.go': 17, 'core/commands/keystore.go': 47, 'core/commands/log.go': 29, 'core/commands/ls.go': 47, 'core/commands/mount_nofuse.go': 23, 'core/commands/mount_unix.go': 28, 'core/commands/mount_windows.go': 22, 'core/commands/name.go': 10, 'core/commands/object/diff.go': 35, 'core/commands/object/object.go': 61, 'core/commands/object/patch.go': 58, 'core/commands/p2p.go': 31, 'core/commands/pin.go': 47, 'core/commands/ping.go': 36, 'core/commands/publish.go': 18, 'core/commands/pubsub.go': 68, 'core/commands/refs.go': 39, 'core/commands/repo.go': 63, 'core/commands/resolve.go': 45, 'core/commands/root.go': 55, 'core/commands/shutdown.go': 33, 'core/commands/stat.go': 58, 'core/commands/swarm.go': 39, 'core/commands/sysdiag.go': 27, 'core/commands/tar.go': 40, 'core/commands/unixfs/ls.go': 39, 'core/commands/unixfs/unixfs.go': 23, 'core/commands/version.go': 27, 'core/core_test.go': 8, 'core/corehttp/commands.go': 59, 'core/corehttp/gateway.go': 24, 'core/coreunix/add.go': 42, 'core/coreunix/add_test.go': 40, 'core/coreunix/metadata_test.go': 27, 'exchange/bitswap/bitswap_test.go': 12, 'exchange/bitswap/decision/engine_test.go': 10, 'exchange/bitswap/message/message_test.go': 5, 'exchange/bitswap/message/pb/Makefile': 1, 'exchange/bitswap/testnet/network_test.go': 9, 'exchange/bitswap/testnet/peernet.go': 10, 'exchange/reprovide/reprovide_test.go': 20, 'fuse/ipns/common.go': 20, 'fuse/node/mount_test.go': 18, 'importer/balanced/balanced_test.go': 8, 'importer/chunk/rabin_test.go': 3, 'importer/helpers/dagbuilder.go': 14, 'importer/importer.go': 13, 'merkledag/utils/utils_test.go': 6, 'mfs/repub_test.go': 12, 'namesys/dns.go': 18, 'namesys/interface.go': 19, 'namesys/ipns_select_test.go': 5, 'namesys/proquint.go': 18, 'namesys/republisher/repub_test.go': 23, 'package.json': 60, 'repo/config/identity.go': 3, 'routing/offline/offline_test.go': 6, 'test/integration/addcat_test.go': 23, 'test/integration/bench_cat_test.go': 22, 'test/integration/bitswap_wo_routing_test.go': 22, 'test/integration/three_legged_cat_test.go': 22, 'test/sharness/t0600-issues-and-regressions-online.sh': 1, 'core/bootstrap_test.go': 14, 'core/commands/dht_test.go': 14, 'core/commands/get_test.go': 50, 'core/core.go': 29, 'core/corehttp/gateway_test.go': 28, 'core/corehttp/metrics_test.go': 18, 'core/mock/mock.go': 18, 'exchange/bitswap/decision/bench_test.go': 8, 'exchange/bitswap/decision/peer_request_queue_test.go': 8, 'exchange/bitswap/message/message.go': 8, 'exchange/bitswap/network/interface.go': 8, 'exchange/bitswap/network/ipfs_impl.go': 8, 'exchange/bitswap/testnet/interface.go': 7, 'exchange/bitswap/testnet/virtual.go': 8, 'exchange/bitswap/testutils.go': 10, 'fuse/ipns/ipns_test.go': 17, 'fuse/readonly/ipfs_test.go': 34, 'namesys/publisher_test.go': 18, 'namesys/resolve_test.go': 22, 'p2p/p2p.go': 14, 'p2p/registry.go': 9, 'repo/config/bootstrap_peers.go': 9, 'routing/mock/centralized_client.go': 4, 'routing/mock/centralized_server.go': 4, 'routing/mock/centralized_test.go': 4, 'routing/mock/interface.go': 4, 'routing/none/none_client.go': 4, 'test/integration/bench_test.go': 14, 'assets/assets.go': 26, 'blocks/blockstore/arc_cache.go': 2, 'blocks/blockstore/arc_cache_test.go': 2, 'blocks/blockstore/blockstore.go': 3, 'blocks/blockstore/blockstore_test.go': 2, 'blocks/blockstore/bloom_cache.go': 2, 'blocks/blockstore/bloom_cache_test.go': 2, 'blocks/blocksutil/block_generator.go': 2, 'blockservice/blockservice.go': 9, 'blockservice/blockservice_test.go': 7, 'blockservice/test/blocks_test.go': 8, 'core/builder.go': 28, 'core/commands/ipnsps.go': 9, 'core/coreapi/coreapi.go': 18, 'core/coreapi/interface/interface.go': 2, 'core/coreapi/unixfs.go': 31, 'core/coreapi/unixfs_test.go': 23, 'core/coredag/cbor.go': 12, 'core/coredag/dagpb.go': 17, 'core/coredag/dagtransl.go': 11, 'core/coredag/raw.go': 17, 'core/corehttp/corehttp.go': 12, 'core/corehttp/gateway_handler.go': 36, 'core/corerepo/gc.go': 26, 'core/corerepo/pinning.go': 12, 'core/coreunix/metadata.go': 23, 'core/pathresolver.go': 21, 'exchange/bitswap/bitswap.go': 9, 'exchange/bitswap/decision/engine.go': 8, 'exchange/bitswap/decision/ledger.go': 8, 'exchange/bitswap/decision/peer_request_queue.go': 7, 'exchange/bitswap/get.go': 7, 'exchange/bitswap/notifications/notifications.go': 4, 'exchange/bitswap/notifications/notifications_test.go': 4, 'exchange/bitswap/session.go': 8, 'exchange/bitswap/session_test.go': 6, 'exchange/bitswap/stat.go': 4, 'exchange/bitswap/wantlist/wantlist.go': 4, 'exchange/bitswap/wantlist/wantlist_test.go': 4, 'exchange/bitswap/wantmanager.go': 7, 'exchange/bitswap/workers.go': 7, 'exchange/interface.go': 2, 'exchange/offline/offline.go': 3, 'exchange/offline/offline_test.go': 3, 'exchange/reprovide/providers.go': 21, 'exchange/reprovide/reprovide.go': 17, 'filestore/filestore.go': 17, 'filestore/filestore_test.go': 20, 'filestore/fsrefstore.go': 17, 'filestore/util.go': 16, 'fuse/ipns/ipns_unix.go': 25, 'fuse/readonly/readonly_unix.go': 27, 'importer/balanced/builder.go': 4, 'importer/chunk/splitting_test.go': 2, 'importer/helpers/helpers.go': 5, 'importer/importer_test.go': 7, 'importer/trickle/trickle_test.go': 7, 'importer/trickle/trickledag.go': 5, 'merkledag/batch.go': 2, 'merkledag/coding.go': 4, 'merkledag/merkledag.go': 5, 'merkledag/merkledag_test.go': 7, 'merkledag/node.go': 5, 'merkledag/node_test.go': 5, 'merkledag/raw.go': 5, 'merkledag/traverse/traverse.go': 4, 'merkledag/traverse/traverse_test.go': 5, 'merkledag/utils/diff.go': 5, 'merkledag/utils/diffenum.go': 4, 'merkledag/utils/diffenum_test.go': 5, 'merkledag/utils/utils.go': 8, 'mfs/dir.go': 9, 'mfs/file.go': 11, 'mfs/mfs_test.go': 12, 'mfs/ops.go': 7, 'mfs/system.go': 12, 'namesys/namesys.go': 25, 'namesys/publisher.go': 26, 'namesys/pubsub.go': 6, 'namesys/pubsub_test.go': 5, 'namesys/republisher/repub.go': 19, 'namesys/routing.go': 24, 'path/path.go': 4, 'path/resolver.go': 4, 'path/resolver_test.go': 3, 'pin/gc/gc.go': 22, 'pin/pin.go': 22, 'pin/pin_test.go': 21, 'pin/set.go': 19, 'pin/set_test.go': 20, 'plugin/ipld.go': 10, 'plugin/loader/initializer.go': 8, 'plugin/plugins/git/git.go': 10, 'repo/config/init.go': 7, 'repo/fsrepo/fsrepo.go': 14, 'repo/fsrepo/lock/lock.go': 3, 'repo/fsrepo/serialize/serialize.go': 3, 'repo/mock.go': 10, 'repo/repo.go': 11, 'routing/offline/offline.go': 3, 'tar/format.go': 26, 'test/dependencies/ma-pipe-unidir/main.go': 7, 'thirdparty/ds-help/key.go': 2, 'thirdparty/pollEndpoint/main.go': 12, 'thirdparty/posinfo/posinfo.go': 2, 'unixfs/archive/archive.go': 5, 'unixfs/archive/tar/writer.go': 5, 'unixfs/hamt/hamt.go': 5, 'unixfs/io/dagreader.go': 5, 'unixfs/io/dirbuilder.go': 4, 'unixfs/io/resolve.go': 5, 'unixfs/mod/dagmodifier.go': 8, 'unixfs/mod/dagmodifier_test.go': 3, 'unixfs/test/utils.go': 7, 'commands/legacy/command.go': 34, 'commands/legacy/legacy.go': 34, 'commands/legacy/legacy_test.go': 35, 'commands/legacy/request.go': 35, 'commands/legacy/response.go': 35, 'commands/legacy/responseemitter.go': 4, 'core/commands/env.go': 4, 'core/commands/commands_test.go': 44, 'test/sharness/t0040-add-and-cat.sh': 1, 'TODO.md': 2, 'test/sharness/t0110-gateway.sh': 1, 'test/sharness/t0410-api-add.sh': 1, 'core/coreapi/dag.go': 10, 'core/coreapi/dag_test.go': 3, 'core/coreapi/interface/options/dag.go': 7, 'core/coreapi/key.go': 25, 'core/coreapi/name.go': 26, 'merkledag/test/utils.go': 7, 'namesys/namesys_test.go': 26, 'repo/fsrepo/datastores.go': 10, 'repo/fsrepo/fsrepo_test.go': 8, 'thirdparty/datastore2/datastore_closer.go': 1, 'thirdparty/datastore2/delayed.go': 1, 'thirdparty/datastore2/threadsafe.go': 1, 'unixfs/io/pbdagreader.go': 4, 'mfs/fd.go': 5, 'unixfs/hamt/hamt_stress_test.go': 3, 'unixfs/hamt/hamt_test.go': 3, 'unixfs/io/dagreader_test.go': 1, 'unixfs/io/dirbuilder_test.go': 1, 'cmd/ipfs/util/ulimit.go': 9, 'cmd/seccat/util.go': 9, 'core/corehttp/logs.go': 9, 'fuse/mount/mount.go': 9, 'fuse/node/mount_unix.go': 9, 'importer/chunk/splitting.go': 1, 'namesys/ipns_validate_test.go': 3, 'plugin/loader/load.go': 7, 'test/sharness/t0050-block.sh': 2, 'blocks/blockstoreutil/remove.go': 14, 'core/coreapi/block.go': 25, 'core/commands/files.go': 53, 'core/commands/root_test.go': 1, 'test/sharness/t0090-get.sh': 1, 'CHANGELOG.md': 1, 'README.md': 2, 'bin/dist_get': 1, 'cmd/ipfs/util/ulimit_freebsd.go': 3, 'contribute.md': 1, 'core/coreapi/interface/options/pin.go': 1, 'docs/experimental-features.md': 1, 'docs/file-transfer.md': 1, 'docs/releases.md': 1, 'exchange/bitswap/README.md': 1, 'plugin/plugin.go': 1, 'repo/fsrepo/migrations/mfsr_test.go': 1, 'repo/fsrepo/migrations/migrations.go': 1, 'test/sharness/README.md': 1, 'thirdparty/dir/dir.go': 1, 'blockservice/test/mock.go': 4, 'core/coreapi/pin.go': 23, 'keystore/keystore.go': 8, 'keystore/keystore_test.go': 5, 'keystore/memkeystore.go': 5, 'namesys/validator.go': 2, 'path/resolver/resolver.go': 4, 'thirdparty/verifbs/verifbs.go': 13, 'cmd/ipfs/util/ulimit_unix.go': 2, 'core/coreapi/block_test.go': 4, 'core/coreapi/interface/coreapi.go': 6, 'core/coreapi/interface/dag.go': 6, 'core/coreapi/interface/object.go': 6, 'core/coreapi/interface/options/block.go': 4, 'core/coreapi/interface/path.go': 8, 'core/coreapi/interface/unixfs.go': 11, 'core/coreapi/object.go': 25, 'fuse/ipns/link_unix.go': 2, 'fuse/mount/fuse.go': 2, 'fuse/node/mount_darwin.go': 2, 'merkledag/errservice.go': 2, 'merkledag/readonly.go': 2, 'merkledag/readonly_test.go': 2, 'merkledag/rwservice.go': 2, 'merkledag/session.go': 2, 'path/resolver/resolver_test.go': 2, 'thirdparty/verifcid/validate.go': 2, 'thirdparty/verifcid/validate_test.go': 2, 'namesys/ipns_resolver_validation_test.go': 19, 'test/sharness/t0170-dht.sh': 1, 'core/commands/urlstore.go': 32, 'unixfs/io/directory.go': 1, 'core/coreapi/interface/key.go': 4, 'core/coreapi/name_test.go': 11, 'core/coreapi/path.go': 24, 'core/coreunix/cat.go': 6, 'core/pathresolver_test.go': 13, 'dagutils/diff.go': 17, 'dagutils/diffenum.go': 13, 'dagutils/diffenum_test.go': 13, 'dagutils/utils.go': 13, 'dagutils/utils_test.go': 13, 'filestore/pb/dataobj.pb.go': 3, 'namesys/base.go': 17, 'namesys/cache.go': 13, 'pin/internal/pb/header.pb.go': 3, 'thirdparty/cidv0v1/blockstore.go': 9, 'repo/fsrepo/config_test.go': 6, 'repo/fsrepo/misc.go': 6, 'test/bench/bench_cli_ipfs_add/main.go': 7, 'test/bench/offline_add/main.go': 7, 'core/commands/cmdenv/env.go': 29, 'core/commands/name/ipns.go': 31, 'core/commands/name/ipnsps.go': 24, 'core/commands/name/name.go': 22, 'core/commands/name/publish.go': 34, 'core/coreapi/interface/block.go': 1, 'core/coreapi/path_test.go': 1, 'test/sharness/lib/test-lib.sh': 1, 'core/coreapi/dht.go': 14, 'core/coreapi/dht_test.go': 2, 'core/coreapi/interface/dht.go': 2, 'p2p/listener.go': 5, 'p2p/local.go': 5, 'p2p/remote.go': 5, 'p2p/stream.go': 5, 'core/commands/cid.go': 19, 'core/coreapi/unixfile.go': 7, 'cmd/ipfs/dnsresolve_test.go': 3, 'core/coreapi/interface/options/unixfs.go': 2, 'core/coreapi/interface/pubsub.go': 1, 'core/coreapi/interface/swarm.go': 1, 'core/coreapi/pubsub.go': 12, 'core/coreapi/swarm.go': 12, 'test/dependencies/iptb/iptb.go': 8, 'commands/context.go': 18, 'core/commands/cmdenv/file.go': 4, 'core/commands/cmdenv/cidbase.go': 10, 'core/coreapi/interface/tests/name.go': 1, 'core/coreapi/interface/tests/unixfs.go': 1, 'core/coreapi/interface/tests/block.go': 1, 'core/coreapi/test/api_test.go': 11, 'core/corehttp/ipns_hostname.go': 11, 'namesys/dns_test.go': 10, 'plugin/daemon.go': 10, 'plugin/loader/loader.go': 11, 'core/corehttp/proxy.go': 6, 'plugin/plugins/badgerds/badgerds.go': 3, 'plugin/plugins/flatfs/flatfs.go': 3, 'plugin/plugins/levelds/levelds.go': 2, 'core/corerepo/stat.go': 2, 'core/commands/cmdenv/cidbase_test.go': 2, 'core/corehttp/metrics.go': 1, 'core/corehttp/proxy_test.go': 1, 'plugin/tracer.go': 1, 'thirdparty/notifier/notifier.go': 1, 'go.mod': 1, 'go.sum': 1, 'package-list.json': 1, 'cmd/ipfs/util/ulimit_test.go': 1, 'core/node/builder.go': 1, 'core/node/storage.go': 1}","('core/commands/add.go', 0.7526881720430108, 0.4827586206896552)"
core/commands/bootstrap.go,383,1855,12,"[{'cyclomatic_complexity': 5, 'nloc': 24, 'token_count': 149, 'name': '', 'long_name': '(req cmds.Request,res cmds.Response)', 'start_line': 136, 'end_line': 163, 'full_parameters': [], 'filename': '/home/dimi/Documents/Informatik_Studium/FSS/SoftEvo/DataCollection/FFS_SoftEvo/go-ipfs/core/commands/bootstrap.go', 'top_nesting_level': 0, 'length': 28, 'fan_in': 0, 'fan_out': 0, 'general_fan_out': 0}, {'cyclomatic_complexity': 3, 'nloc': 11, 'token_count': 78, 'name': '', 'long_name': '(res cmds.Response)(io.Reader,error)', 'start_line': 166, 'end_line': 178, 'full_parameters': [], 'filename': '/home/dimi/Documents/Informatik_Studium/FSS/SoftEvo/DataCollection/FFS_SoftEvo/go-ipfs/core/commands/bootstrap.go', 'top_nesting_level': 0, 'length': 13, 'fan_in': 0, 'fan_out': 0, 'general_fan_out': 0}, {'cyclomatic_complexity': 7, 'nloc': 34, 'token_count': 211, 'name': '', 'long_name': '(req cmds.Request,res cmds.Response)', 'start_line': 198, 'end_line': 235, 'full_parameters': [], 'filename': '/home/dimi/Documents/Informatik_Studium/FSS/SoftEvo/DataCollection/FFS_SoftEvo/go-ipfs/core/commands/bootstrap.go', 'top_nesting_level': 0, 'length': 38, 'fan_in': 0, 'fan_out': 0, 'general_fan_out': 0}, {'cyclomatic_complexity': 2, 'nloc': 9, 'token_count': 67, 'name': '', 'long_name': '(res cmds.Response)(io.Reader,error)', 'start_line': 238, 'end_line': 247, 'full_parameters': [], 'filename': '/home/dimi/Documents/Informatik_Studium/FSS/SoftEvo/DataCollection/FFS_SoftEvo/go-ipfs/core/commands/bootstrap.go', 'top_nesting_level': 0, 'length': 10, 'fan_in': 0, 'fan_out': 0, 'general_fan_out': 0}, {'cyclomatic_complexity': 4, 'nloc': 19, 'token_count': 121, 'name': '', 'long_name': '(req cmds.Request,res cmds.Response)', 'start_line': 257, 'end_line': 277, 'full_parameters': [], 'filename': '/home/dimi/Documents/Informatik_Studium/FSS/SoftEvo/DataCollection/FFS_SoftEvo/go-ipfs/core/commands/bootstrap.go', 'top_nesting_level': 0, 'length': 21, 'fan_in': 0, 'fan_out': 0, 'general_fan_out': 0}, {'cyclomatic_complexity': 2, 'nloc': 9, 'token_count': 67, 'name': '', 'long_name': '(res cmds.Response)(io.Reader,error)', 'start_line': 280, 'end_line': 289, 'full_parameters': [], 'filename': '/home/dimi/Documents/Informatik_Studium/FSS/SoftEvo/DataCollection/FFS_SoftEvo/go-ipfs/core/commands/bootstrap.go', 'top_nesting_level': 0, 'length': 10, 'fan_in': 0, 'fan_out': 0, 'general_fan_out': 0}, {'cyclomatic_complexity': 4, 'nloc': 19, 'token_count': 120, 'name': '', 'long_name': '(req cmds.Request,res cmds.Response)', 'start_line': 299, 'end_line': 318, 'full_parameters': [], 'filename': '/home/dimi/Documents/Informatik_Studium/FSS/SoftEvo/DataCollection/FFS_SoftEvo/go-ipfs/core/commands/bootstrap.go', 'top_nesting_level': 0, 'length': 20, 'fan_in': 0, 'fan_out': 0, 'general_fan_out': 0}, {'cyclomatic_complexity': 2, 'nloc': 9, 'token_count': 68, 'name': 'bootstrapMarshaler', 'long_name': 'bootstrapMarshaler res cmds . Response', 'start_line': 325, 'end_line': 334, 'full_parameters': ['res cmds . Response'], 'filename': '/home/dimi/Documents/Informatik_Studium/FSS/SoftEvo/DataCollection/FFS_SoftEvo/go-ipfs/core/commands/bootstrap.go', 'top_nesting_level': 0, 'length': 10, 'fan_in': 0, 'fan_out': 0, 'general_fan_out': 0}, {'cyclomatic_complexity': 3, 'nloc': 10, 'token_count': 66, 'name': 'bootstrapWritePeers', 'long_name': 'bootstrapWritePeers w io . Writer , prefix string , peers [ ] string', 'start_line': 336, 'end_line': 346, 'full_parameters': ['w io . Writer', ' prefix string', ' peers [ ] string'], 'filename': '/home/dimi/Documents/Informatik_Studium/FSS/SoftEvo/DataCollection/FFS_SoftEvo/go-ipfs/core/commands/bootstrap.go', 'top_nesting_level': 0, 'length': 11, 'fan_in': 0, 'fan_out': 0, 'general_fan_out': 0}, {'cyclomatic_complexity': 6, 'nloc': 26, 'token_count': 198, 'name': 'bootstrapAdd', 'long_name': 'bootstrapAdd r repo . Repo , cfg * config . Config , peers [ ] config . BootstrapPeer', 'start_line': 348, 'end_line': 383, 'full_parameters': ['r repo . Repo', ' cfg * config . Config', ' peers [ ] config . BootstrapPeer'], 'filename': '/home/dimi/Documents/Informatik_Studium/FSS/SoftEvo/DataCollection/FFS_SoftEvo/go-ipfs/core/commands/bootstrap.go', 'top_nesting_level': 0, 'length': 36, 'fan_in': 0, 'fan_out': 0, 'general_fan_out': 0}, {'cyclomatic_complexity': 7, 'nloc': 26, 'token_count': 171, 'name': 'bootstrapRemove', 'long_name': 'bootstrapRemove r repo . Repo , cfg * config . Config , toRemove [ ] config . BootstrapPeer', 'start_line': 385, 'end_line': 415, 'full_parameters': ['r repo . Repo', ' cfg * config . Config', ' toRemove [ ] config . BootstrapPeer'], 'filename': '/home/dimi/Documents/Informatik_Studium/FSS/SoftEvo/DataCollection/FFS_SoftEvo/go-ipfs/core/commands/bootstrap.go', 'top_nesting_level': 0, 'length': 31, 'fan_in': 0, 'fan_out': 0, 'general_fan_out': 0}, {'cyclomatic_complexity': 3, 'nloc': 11, 'token_count': 72, 'name': 'bootstrapRemoveAll', 'long_name': 'bootstrapRemoveAll r repo . Repo , cfg * config . Config', 'start_line': 417, 'end_line': 429, 'full_parameters': ['r repo . Repo', ' cfg * config . Config'], 'filename': '/home/dimi/Documents/Informatik_Studium/FSS/SoftEvo/DataCollection/FFS_SoftEvo/go-ipfs/core/commands/bootstrap.go', 'top_nesting_level': 0, 'length': 13, 'fan_in': 0, 'fan_out': 0, 'general_fan_out': 0}]",370,1896,4,"[{'cyclomatic_complexity': 3, 'nloc': 10, 'token_count': 68, 'name': 'bootstrapWritePeers', 'long_name': 'bootstrapWritePeers w io . Writer , prefix string , peers [ ] string', 'start_line': 286, 'end_line': 295, 'full_parameters': ['w io . Writer', ' prefix string', ' peers [ ] string'], 'filename': '/home/dimi/Documents/Informatik_Studium/FSS/SoftEvo/DataCollection/FFS_SoftEvo/go-ipfs/core/commands/bootstrap.go', 'top_nesting_level': 0, 'length': 10, 'fan_in': 0, 'fan_out': 0, 'general_fan_out': 0}, {'cyclomatic_complexity': 11, 'nloc': 38, 'token_count': 270, 'name': 'bootstrapAdd', 'long_name': 'bootstrapAdd r repo . Repo , cfg * config . Config , peers [ ] string', 'start_line': 297, 'end_line': 345, 'full_parameters': ['r repo . Repo', ' cfg * config . Config', ' peers [ ] string'], 'filename': '/home/dimi/Documents/Informatik_Studium/FSS/SoftEvo/DataCollection/FFS_SoftEvo/go-ipfs/core/commands/bootstrap.go', 'top_nesting_level': 0, 'length': 49, 'fan_in': 0, 'fan_out': 0, 'general_fan_out': 0}, {'cyclomatic_complexity': 13, 'nloc': 51, 'token_count': 348, 'name': 'bootstrapRemove', 'long_name': 'bootstrapRemove r repo . Repo , cfg * config . Config , toRemove [ ] string', 'start_line': 347, 'end_line': 406, 'full_parameters': ['r repo . Repo', ' cfg * config . Config', ' toRemove [ ] string'], 'filename': '/home/dimi/Documents/Informatik_Studium/FSS/SoftEvo/DataCollection/FFS_SoftEvo/go-ipfs/core/commands/bootstrap.go', 'top_nesting_level': 0, 'length': 60, 'fan_in': 0, 'fan_out': 0, 'general_fan_out': 0}, {'cyclomatic_complexity': 3, 'nloc': 11, 'token_count': 75, 'name': 'bootstrapRemoveAll', 'long_name': 'bootstrapRemoveAll r repo . Repo , cfg * config . Config', 'start_line': 408, 'end_line': 419, 'full_parameters': ['r repo . Repo', ' cfg * config . Config'], 'filename': '/home/dimi/Documents/Informatik_Studium/FSS/SoftEvo/DataCollection/FFS_SoftEvo/go-ipfs/core/commands/bootstrap.go', 'top_nesting_level': 0, 'length': 12, 'fan_in': 0, 'fan_out': 0, 'general_fan_out': 0}]",-13,41,-8,50,50,"[{'timestamp': 1491058697.0, 'added_lines': 79, 'deleted_lines': 52, 'nloc': 405}, {'timestamp': 1511223906.0, 'added_lines': 1, 'deleted_lines': 1, 'nloc': 405}, {'timestamp': 1512365669.0, 'added_lines': 1, 'deleted_lines': 1, 'nloc': 405}, {'timestamp': 1511187070.0, 'added_lines': 1, 'deleted_lines': 1, 'nloc': 405}, {'timestamp': 1513436097.0, 'added_lines': 1, 'deleted_lines': 1, 'nloc': 405}, {'timestamp': 1513612261.0, 'added_lines': 1, 'deleted_lines': 1, 'nloc': 405}, {'timestamp': 1515277696.0, 'added_lines': 1, 'deleted_lines': 1, 'nloc': 405}, {'timestamp': 1521417863.0, 'added_lines': 1, 'deleted_lines': 1, 'nloc': 405}, {'timestamp': 1528520460.0, 'added_lines': 1, 'deleted_lines': 1, 'nloc': 405}, {'timestamp': 1532357069.0, 'added_lines': 1, 'deleted_lines': 1, 'nloc': 405}, {'timestamp': 1532365899.0, 'added_lines': 1, 'deleted_lines': 1, 'nloc': 405}, {'timestamp': 1532388583.0, 'added_lines': 1, 'deleted_lines': 1, 'nloc': 405}, {'timestamp': 1533809170.0, 'added_lines': 1, 'deleted_lines': 1, 'nloc': 405}, {'timestamp': 1533946888.0, 'added_lines': 1, 'deleted_lines': 1, 'nloc': 405}, {'timestamp': 1534072974.0, 'added_lines': 1, 'deleted_lines': 1, 'nloc': 405}, {'timestamp': 1534896611.0, 'added_lines': 2, 'deleted_lines': 2, 'nloc': 405}, {'timestamp': 1535255498.0, 'added_lines': 1, 'deleted_lines': 1, 'nloc': 405}, {'timestamp': 1535601896.0, 'added_lines': 1, 'deleted_lines': 1, 'nloc': 405}, {'timestamp': 1536388808.0, 'added_lines': 1, 'deleted_lines': 1, 'nloc': 405}, {'timestamp': 1537792589.0, 'added_lines': 1, 'deleted_lines': 1, 'nloc': 405}, {'timestamp': 1538544957.0, 'added_lines': 1, 'deleted_lines': 1, 'nloc': 405}, {'timestamp': 1538547366.0, 'added_lines': 1, 'deleted_lines': 1, 'nloc': 405}, {'timestamp': 1538662493.0, 'added_lines': 12, 'deleted_lines': 4, 'nloc': 411}, {'timestamp': 1539850591.0, 'added_lines': 1, 'deleted_lines': 1, 'nloc': 411}, {'timestamp': 1540400358.0, 'added_lines': 1, 'deleted_lines': 1, 'nloc': 411}, {'timestamp': 1540489644.0, 'added_lines': 1, 'deleted_lines': 1, 'nloc': 411}, {'timestamp': 1541204121.0, 'added_lines': 1, 'deleted_lines': 1, 'nloc': 411}, {'timestamp': 1540621603.0, 'added_lines': 71, 'deleted_lines': 163, 'nloc': 329}, {'timestamp': 1541581893.0, 'added_lines': 46, 'deleted_lines': 18, 'nloc': 352}, {'timestamp': 1543282933.0, 'added_lines': 1, 'deleted_lines': 1, 'nloc': 352}, {'timestamp': 1544225843.0, 'added_lines': 1, 'deleted_lines': 1, 'nloc': 352}, {'timestamp': 1544661332.0, 'added_lines': 1, 'deleted_lines': 1, 'nloc': 352}, {'timestamp': 1540556089.0, 'added_lines': 1, 'deleted_lines': 1, 'nloc': 352}, {'timestamp': 1545323704.0, 'added_lines': 1, 'deleted_lines': 1, 'nloc': 352}, {'timestamp': 1546553605.0, 'added_lines': 1, 'deleted_lines': 1, 'nloc': 352}, {'timestamp': 1547003974.0, 'added_lines': 1, 'deleted_lines': 1, 'nloc': 352}, {'timestamp': 1547152271.0, 'added_lines': 1, 'deleted_lines': 1, 'nloc': 352}, {'timestamp': 1548866534.0, 'added_lines': 1, 'deleted_lines': 1, 'nloc': 352}, {'timestamp': 1549588289.0, 'added_lines': 1, 'deleted_lines': 1, 'nloc': 352}, {'timestamp': 1549903582.0, 'added_lines': 1, 'deleted_lines': 1, 'nloc': 352}, {'timestamp': 1550507829.0, 'added_lines': 2, 'deleted_lines': 2, 'nloc': 352}, {'timestamp': 1550546624.0, 'added_lines': 1, 'deleted_lines': 1, 'nloc': 352}, {'timestamp': 1550610741.0, 'added_lines': 1, 'deleted_lines': 1, 'nloc': 352}, {'timestamp': 1551138343.0, 'added_lines': 1, 'deleted_lines': 1, 'nloc': 352}, {'timestamp': 1551229859.0, 'added_lines': 1, 'deleted_lines': 1, 'nloc': 352}, {'timestamp': 1551299964.0, 'added_lines': 1, 'deleted_lines': 1, 'nloc': 352}, {'timestamp': 1551471469.0, 'added_lines': 1, 'deleted_lines': 1, 'nloc': 352}, {'timestamp': 1551551196.0, 'added_lines': 3, 'deleted_lines': 3, 'nloc': 352}, {'timestamp': 1557554420.0, 'added_lines': 14, 'deleted_lines': 15, 'nloc': 351}, {'timestamp': 1559347612.0, 'added_lines': 75, 'deleted_lines': 55, 'nloc': 370}]","{'blocks/blockstore/caching.go': 1, 'blocks/blockstore/util/remove.go': 2, 'cmd/ipfs/daemon.go': 28, 'cmd/ipfs/init.go': 44, 'cmd/ipfs/ipfs.go': 23, 'cmd/ipfs/main.go': 43, 'cmd/ipfs/main_test.go': 4, 'cmd/ipfswatch/main.go': 31, 'cmd/seccat/seccat.go': 17, None: 13, 'commands/channelmarshaler.go': 1, 'commands/cli/cmd_suggestion.go': 1, 'commands/cli/helptext.go': 2, 'commands/cli/helptext_test.go': 2, 'commands/cli/parse.go': 2, 'commands/cli/parse_test.go': 2, 'commands/command.go': 13, 'commands/command_test.go': 7, 'commands/http/client.go': 2, 'commands/http/handler.go': 2, 'commands/http/multifilereader.go': 2, 'commands/http/multifilereader_test.go': 2, 'commands/http/parse.go': 2, 'commands/reqlog.go': 1, 'commands/request.go': 26, 'commands/response.go': 11, 'commands/response_test.go': 7, 'core/bootstrap.go': 28, 'core/commands/active.go': 24, 'core/commands/add.go': 29, 'core/commands/bitswap.go': 34, 'core/commands/block.go': 27, 'core/commands/cat.go': 27, 'core/commands/commands.go': 25, 'core/commands/config.go': 45, 'core/commands/dag/dag.go': 33, 'core/commands/dht.go': 34, 'core/commands/diag.go': 23, 'core/commands/dns.go': 26, 'core/commands/e/error.go': 1, 'core/commands/external.go': 23, 'core/commands/files/files.go': 7, 'core/commands/filestore.go': 26, 'core/commands/get.go': 33, 'core/commands/helptext_test.go': 23, 'core/commands/id.go': 34, 'core/commands/ipns.go': 10, 'core/commands/keystore.go': 27, 'core/commands/log.go': 25, 'core/commands/ls.go': 33, 'core/commands/mount_nofuse.go': 23, 'core/commands/mount_unix.go': 44, 'core/commands/mount_windows.go': 22, 'core/commands/name.go': 10, 'core/commands/object/diff.go': 25, 'core/commands/object/object.go': 33, 'core/commands/object/patch.go': 26, 'core/commands/p2p.go': 33, 'core/commands/pin.go': 34, 'core/commands/ping.go': 34, 'core/commands/publish.go': 10, 'core/commands/pubsub.go': 30, 'core/commands/refs.go': 34, 'core/commands/repo.go': 45, 'core/commands/resolve.go': 34, 'core/commands/root.go': 26, 'core/commands/shutdown.go': 25, 'core/commands/stat.go': 30, 'core/commands/swarm.go': 46, 'core/commands/sysdiag.go': 29, 'core/commands/tar.go': 33, 'core/commands/unixfs/ls.go': 33, 'core/commands/unixfs/unixfs.go': 23, 'core/commands/version.go': 27, 'core/core_test.go': 24, 'core/corehttp/commands.go': 43, 'core/corehttp/gateway.go': 21, 'core/coreunix/add.go': 27, 'core/coreunix/add_test.go': 37, 'core/coreunix/metadata_test.go': 22, 'exchange/bitswap/bitswap_test.go': 4, 'exchange/bitswap/decision/engine_test.go': 4, 'exchange/bitswap/message/message_test.go': 3, 'exchange/bitswap/message/pb/Makefile': 1, 'exchange/bitswap/testnet/network_test.go': 4, 'exchange/bitswap/testnet/peernet.go': 4, 'exchange/reprovide/reprovide_test.go': 17, 'fuse/ipns/common.go': 20, 'fuse/node/mount_test.go': 17, 'importer/balanced/balanced_test.go': 3, 'importer/chunk/rabin_test.go': 2, 'importer/helpers/dagbuilder.go': 8, 'importer/importer.go': 8, 'merkledag/utils/utils_test.go': 3, 'mfs/repub_test.go': 4, 'namesys/dns.go': 16, 'namesys/interface.go': 16, 'namesys/ipns_select_test.go': 3, 'namesys/proquint.go': 16, 'namesys/republisher/repub_test.go': 18, 'package.json': 42, 'repo/config/identity.go': 1, 'routing/offline/offline_test.go': 3, 'test/integration/addcat_test.go': 21, 'test/integration/bench_cat_test.go': 20, 'test/integration/bitswap_wo_routing_test.go': 18, 'test/integration/three_legged_cat_test.go': 20, 'core/bootstrap_test.go': 26, 'core/commands/dht_test.go': 15, 'core/commands/get_test.go': 24, 'core/core.go': 34, 'core/corehttp/gateway_test.go': 29, 'core/corehttp/metrics_test.go': 17, 'core/mock/mock.go': 27, 'exchange/bitswap/decision/bench_test.go': 3, 'exchange/bitswap/decision/peer_request_queue_test.go': 3, 'exchange/bitswap/message/message.go': 3, 'exchange/bitswap/network/interface.go': 3, 'exchange/bitswap/network/ipfs_impl.go': 3, 'exchange/bitswap/testnet/interface.go': 3, 'exchange/bitswap/testnet/virtual.go': 3, 'exchange/bitswap/testutils.go': 3, 'fuse/ipns/ipns_test.go': 16, 'fuse/readonly/ipfs_test.go': 22, 'namesys/publisher_test.go': 16, 'namesys/resolve_test.go': 17, 'p2p/p2p.go': 16, 'p2p/registry.go': 6, 'repo/config/bootstrap_peers.go': 3, 'routing/mock/centralized_client.go': 2, 'routing/mock/centralized_server.go': 2, 'routing/mock/centralized_test.go': 2, 'routing/mock/interface.go': 2, 'routing/none/none_client.go': 2, 'test/integration/bench_test.go': 13, 'assets/assets.go': 20, 'blocks/blockstore/arc_cache.go': 1, 'blocks/blockstore/arc_cache_test.go': 1, 'blocks/blockstore/blockstore.go': 1, 'blocks/blockstore/blockstore_test.go': 1, 'blocks/blockstore/bloom_cache.go': 1, 'blocks/blockstore/bloom_cache_test.go': 1, 'blocks/blocksutil/block_generator.go': 1, 'blockservice/blockservice.go': 2, 'blockservice/blockservice_test.go': 2, 'blockservice/test/blocks_test.go': 2, 'core/builder.go': 32, 'core/commands/ipnsps.go': 7, 'core/coreapi/coreapi.go': 12, 'core/coreapi/interface/interface.go': 1, 'core/coreapi/unixfs.go': 22, 'core/coreapi/unixfs_test.go': 22, 'core/coredag/cbor.go': 6, 'core/coredag/dagpb.go': 16, 'core/coredag/dagtransl.go': 5, 'core/coredag/raw.go': 16, 'core/corehttp/corehttp.go': 9, 'core/corehttp/gateway_handler.go': 22, 'core/corerepo/gc.go': 21, 'core/corerepo/pinning.go': 8, 'core/coreunix/metadata.go': 21, 'core/pathresolver.go': 16, 'exchange/bitswap/bitswap.go': 2, 'exchange/bitswap/decision/engine.go': 2, 'exchange/bitswap/decision/ledger.go': 2, 'exchange/bitswap/decision/peer_request_queue.go': 2, 'exchange/bitswap/get.go': 2, 'exchange/bitswap/notifications/notifications.go': 2, 'exchange/bitswap/notifications/notifications_test.go': 2, 'exchange/bitswap/session.go': 2, 'exchange/bitswap/session_test.go': 2, 'exchange/bitswap/stat.go': 2, 'exchange/bitswap/wantlist/wantlist.go': 2, 'exchange/bitswap/wantlist/wantlist_test.go': 2, 'exchange/bitswap/wantmanager.go': 2, 'exchange/bitswap/workers.go': 2, 'exchange/interface.go': 1, 'exchange/offline/offline.go': 1, 'exchange/offline/offline_test.go': 1, 'exchange/reprovide/providers.go': 16, 'exchange/reprovide/reprovide.go': 14, 'filestore/filestore.go': 9, 'filestore/filestore_test.go': 16, 'filestore/fsrefstore.go': 9, 'filestore/util.go': 9, 'fuse/ipns/ipns_unix.go': 21, 'fuse/readonly/readonly_unix.go': 21, 'importer/balanced/builder.go': 2, 'importer/chunk/splitting_test.go': 1, 'importer/helpers/helpers.go': 2, 'importer/importer_test.go': 2, 'importer/trickle/trickle_test.go': 2, 'importer/trickle/trickledag.go': 2, 'merkledag/batch.go': 1, 'merkledag/coding.go': 2, 'merkledag/merkledag.go': 2, 'merkledag/merkledag_test.go': 2, 'merkledag/node.go': 2, 'merkledag/node_test.go': 2, 'merkledag/raw.go': 2, 'merkledag/traverse/traverse.go': 2, 'merkledag/traverse/traverse_test.go': 2, 'merkledag/utils/diff.go': 2, 'merkledag/utils/diffenum.go': 2, 'merkledag/utils/diffenum_test.go': 2, 'merkledag/utils/utils.go': 2, 'mfs/dir.go': 3, 'mfs/file.go': 3, 'mfs/mfs_test.go': 3, 'mfs/ops.go': 2, 'mfs/system.go': 3, 'namesys/namesys.go': 17, 'namesys/publisher.go': 21, 'namesys/pubsub.go': 1, 'namesys/pubsub_test.go': 1, 'namesys/republisher/repub.go': 16, 'namesys/routing.go': 17, 'path/path.go': 2, 'path/resolver.go': 1, 'path/resolver_test.go': 1, 'pin/gc/gc.go': 16, 'pin/pin.go': 16, 'pin/pin_test.go': 16, 'pin/set.go': 16, 'pin/set_test.go': 16, 'plugin/ipld.go': 5, 'plugin/loader/initializer.go': 4, 'plugin/plugins/git/git.go': 5, 'repo/config/init.go': 2, 'repo/fsrepo/fsrepo.go': 26, 'repo/fsrepo/lock/lock.go': 1, 'repo/fsrepo/serialize/serialize.go': 2, 'repo/mock.go': 26, 'repo/repo.go': 26, 'routing/offline/offline.go': 1, 'tar/format.go': 21, 'test/dependencies/ma-pipe-unidir/main.go': 7, 'thirdparty/ds-help/key.go': 1, 'thirdparty/pollEndpoint/main.go': 9, 'thirdparty/posinfo/posinfo.go': 1, 'unixfs/archive/archive.go': 2, 'unixfs/archive/tar/writer.go': 2, 'unixfs/hamt/hamt.go': 2, 'unixfs/io/dagreader.go': 2, 'unixfs/io/dirbuilder.go': 2, 'unixfs/io/resolve.go': 2, 'unixfs/mod/dagmodifier.go': 2, 'unixfs/mod/dagmodifier_test.go': 2, 'unixfs/test/utils.go': 2, 'commands/legacy/command.go': 9, 'commands/legacy/legacy.go': 9, 'commands/legacy/legacy_test.go': 10, 'commands/legacy/request.go': 10, 'commands/legacy/response.go': 10, 'commands/legacy/responseemitter.go': 4, 'core/commands/env.go': 8, 'TODO.md': 2, 'core/commands/commands_test.go': 19, 'test/sharness/t0110-gateway.sh': 1, 'test/sharness/t0410-api-add.sh': 1, 'test/sharness/t0120-bootstrap.sh': 2, 'blocks/blockstoreutil/remove.go': 8, 'blockservice/test/mock.go': 1, 'cmd/ipfs/util/ulimit.go': 5, 'cmd/ipfs/util/ulimit_freebsd.go': 2, 'cmd/ipfs/util/ulimit_unix.go': 2, 'cmd/seccat/util.go': 5, 'core/commands/files.go': 27, 'core/coreapi/block.go': 8, 'core/coreapi/block_test.go': 2, 'core/coreapi/dag.go': 4, 'core/coreapi/dag_test.go': 2, 'core/coreapi/interface/coreapi.go': 3, 'core/coreapi/interface/dag.go': 3, 'core/coreapi/interface/object.go': 3, 'core/coreapi/interface/options/block.go': 2, 'core/coreapi/interface/options/dag.go': 3, 'core/coreapi/interface/path.go': 11, 'core/coreapi/interface/unixfs.go': 7, 'core/coreapi/key.go': 16, 'core/coreapi/name.go': 16, 'core/coreapi/object.go': 20, 'core/coreapi/pin.go': 16, 'core/corehttp/logs.go': 5, 'fuse/ipns/link_unix.go': 2, 'fuse/mount/fuse.go': 2, 'fuse/mount/mount.go': 5, 'fuse/node/mount_darwin.go': 2, 'fuse/node/mount_unix.go': 5, 'keystore/keystore.go': 5, 'merkledag/errservice.go': 1, 'merkledag/readonly.go': 1, 'merkledag/readonly_test.go': 1, 'merkledag/rwservice.go': 1, 'merkledag/session.go': 1, 'merkledag/test/utils.go': 1, 'namesys/ipns_validate_test.go': 1, 'namesys/namesys_test.go': 20, 'namesys/validator.go': 1, 'path/resolver/resolver.go': 1, 'path/resolver/resolver_test.go': 1, 'plugin/loader/load.go': 3, 'repo/fsrepo/datastores.go': 7, 'thirdparty/verifbs/verifbs.go': 8, 'thirdparty/verifcid/validate.go': 1, 'thirdparty/verifcid/validate_test.go': 1, 'unixfs/hamt/hamt_stress_test.go': 1, 'unixfs/hamt/hamt_test.go': 1, 'unixfs/io/pbdagreader.go': 1, 'repo/fsrepo/misc.go': 24, 'cmd/ipfs/Rules.mk': 1, 'core/corehttp/option_test.go': 1, 'docs/releases.md': 1, 'docs/windows.md': 1, 'repo/fsrepo/config_test.go': 23, 'repo/fsrepo/fsrepo_test.go': 23, 'repo/version.go': 1, 'test/bench/bench_cli_ipfs_add/main.go': 24, 'test/bench/offline_add/main.go': 24, 'core/commands/urlstore.go': 25, 'core/coreapi/path.go': 19, 'core/coreunix/cat.go': 5, 'mfs/fd.go': 1, 'core/coreapi/interface/key.go': 6, 'core/coreapi/name_test.go': 10, 'core/pathresolver_test.go': 14, 'dagutils/diff.go': 15, 'dagutils/diffenum.go': 14, 'dagutils/diffenum_test.go': 14, 'dagutils/utils.go': 14, 'dagutils/utils_test.go': 14, 'namesys/base.go': 15, 'namesys/cache.go': 14, 'namesys/ipns_resolver_validation_test.go': 15, 'thirdparty/cidv0v1/blockstore.go': 7, 'core/commands/cmdenv/env.go': 28, 'core/commands/name/ipns.go': 23, 'core/commands/name/publish.go': 19, 'core/commands/name/ipnsps.go': 19, 'core/commands/name/name.go': 15, 'core/coreapi/dht.go': 12, 'core/coreapi/dht_test.go': 4, 'core/coreapi/interface/dht.go': 7, 'p2p/listener.go': 10, 'p2p/local.go': 10, 'p2p/remote.go': 10, 'p2p/stream.go': 10, 'core/coreapi/interface/swarm.go': 6, 'core/coreapi/swarm.go': 12, 'core/commands/cid.go': 15, 'core/coreapi/unixfile.go': 6, 'cmd/ipfs/dnsresolve_test.go': 5, 'core/coreapi/interface/options/unixfs.go': 5, 'core/coreapi/interface/pubsub.go': 4, 'core/coreapi/pubsub.go': 11, 'test/sharness/t0180-pubsub.sh': 1, 'keystore/keystore_test.go': 3, 'keystore/memkeystore.go': 3, 'test/dependencies/iptb/iptb.go': 11, 'commands/context.go': 17, 'core/corehttp/proxy.go': 7, 'core/coreapi/test/api_test.go': 8, 'core/coreapi/interface/tests/name.go': 3, 'core/coreapi/interface/tests/unixfs.go': 3, 'core/commands/cmdenv/cidbase.go': 9, 'core/commands/cmdenv/file.go': 3, 'core/corehttp/ipns_hostname.go': 5, 'namesys/dns_test.go': 5, 'plugin/daemon.go': 5, 'plugin/loader/loader.go': 5, 'filestore/pb/dataobj.pb.go': 2, 'pin/internal/pb/header.pb.go': 2, 'plugin/plugins/badgerds/badgerds.go': 3, 'plugin/plugins/flatfs/flatfs.go': 3, 'plugin/plugins/levelds/levelds.go': 2, 'core/corerepo/stat.go': 2, 'core/commands/cmdenv/cidbase_test.go': 1, 'core/corehttp/metrics.go': 1, 'core/corehttp/proxy_test.go': 1, 'plugin/tracer.go': 1, 'thirdparty/notifier/notifier.go': 1, 'README.md': 1, 'go.mod': 2, 'go.sum': 2, 'package-list.json': 1, 'core/bootstrap/bootstrap.go': 1, 'core/bootstrap/bootstrap_test.go': 1}","('core/commands/swarm.go', 0.92, 0.48936170212765956)"
core/commands/cat.go,60,401,3,"[{'cyclomatic_complexity': 5, 'nloc': 21, 'token_count': 138, 'name': '', 'long_name': '(req cmds.Request,res cmds.Response)', 'start_line': 24, 'end_line': 55, 'full_parameters': [], 'filename': '/home/dimi/Documents/Informatik_Studium/FSS/SoftEvo/DataCollection/FFS_SoftEvo/go-ipfs/core/commands/cat.go', 'top_nesting_level': 0, 'length': 32, 'fan_in': 0, 'fan_out': 0, 'general_fan_out': 0}, {'cyclomatic_complexity': 2, 'nloc': 8, 'token_count': 69, 'name': '', 'long_name': '(req cmds.Request,res cmds.Response)', 'start_line': 56, 'end_line': 65, 'full_parameters': [], 'filename': '/home/dimi/Documents/Informatik_Studium/FSS/SoftEvo/DataCollection/FFS_SoftEvo/go-ipfs/core/commands/cat.go', 'top_nesting_level': 0, 'length': 10, 'fan_in': 0, 'fan_out': 0, 'general_fan_out': 0}, {'cyclomatic_complexity': 3, 'nloc': 13, 'token_count': 114, 'name': 'cat', 'long_name': 'cat ctx context . Context , node * core . IpfsNode , paths [ ] string', 'start_line': 68, 'end_line': 80, 'full_parameters': ['ctx context . Context', ' node * core . IpfsNode', ' paths [ ] string'], 'filename': '/home/dimi/Documents/Informatik_Studium/FSS/SoftEvo/DataCollection/FFS_SoftEvo/go-ipfs/core/commands/cat.go', 'top_nesting_level': 0, 'length': 13, 'fan_in': 0, 'fan_out': 0, 'general_fan_out': 0}]",137,782,1,"[{'cyclomatic_complexity': 13, 'nloc': 52, 'token_count': 336, 'name': 'cat', 'long_name': 'cat ctx context . Context , api iface . CoreAPI , paths [ ] string , offset int64 , max int64', 'start_line': 114, 'end_line': 171, 'full_parameters': ['ctx context . Context', ' api iface . CoreAPI', ' paths [ ] string', ' offset int64', ' max int64'], 'filename': '/home/dimi/Documents/Informatik_Studium/FSS/SoftEvo/DataCollection/FFS_SoftEvo/go-ipfs/core/commands/cat.go', 'top_nesting_level': 0, 'length': 58, 'fan_in': 0, 'fan_out': 0, 'general_fan_out': 0}]",77,381,-2,83,83,"[{'timestamp': 1491058697.0, 'added_lines': 57, 'deleted_lines': 19, 'nloc': 89}, {'timestamp': 1508770239.0, 'added_lines': 1, 'deleted_lines': 1, 'nloc': 89}, {'timestamp': 1509016767.0, 'added_lines': 1, 'deleted_lines': 1, 'nloc': 89}, {'timestamp': 1511223906.0, 'added_lines': 2, 'deleted_lines': 2, 'nloc': 89}, {'timestamp': 1511373659.0, 'added_lines': 1, 'deleted_lines': 1, 'nloc': 89}, {'timestamp': 1512365669.0, 'added_lines': 2, 'deleted_lines': 2, 'nloc': 89}, {'timestamp': 1514915535.0, 'added_lines': 26, 'deleted_lines': 3, 'nloc': 111}, {'timestamp': 1515205255.0, 'added_lines': 30, 'deleted_lines': 3, 'nloc': 137}, {'timestamp': 1511187070.0, 'added_lines': 15, 'deleted_lines': 12, 'nloc': 138}, {'timestamp': 1512121226.0, 'added_lines': 1, 'deleted_lines': 1, 'nloc': 138}, {'timestamp': 1513436097.0, 'added_lines': 2, 'deleted_lines': 2, 'nloc': 138}, {'timestamp': 1513612261.0, 'added_lines': 2, 'deleted_lines': 2, 'nloc': 138}, {'timestamp': 1513764708.0, 'added_lines': 1, 'deleted_lines': 1, 'nloc': 138}, {'timestamp': 1513765470.0, 'added_lines': 1, 'deleted_lines': 1, 'nloc': 138}, {'timestamp': 1513766201.0, 'added_lines': 1, 'deleted_lines': 1, 'nloc': 138}, {'timestamp': 1513772371.0, 'added_lines': 1, 'deleted_lines': 1, 'nloc': 138}, {'timestamp': 1513772654.0, 'added_lines': 1, 'deleted_lines': 1, 'nloc': 138}, {'timestamp': 1513773452.0, 'added_lines': 1, 'deleted_lines': 1, 'nloc': 138}, {'timestamp': 1515277696.0, 'added_lines': 2, 'deleted_lines': 2, 'nloc': 138}, {'timestamp': 1515465466.0, 'added_lines': 2, 'deleted_lines': 2, 'nloc': 138}, {'timestamp': 1515633079.0, 'added_lines': 1, 'deleted_lines': 1, 'nloc': 138}, {'timestamp': 1515713724.0, 'added_lines': 1, 'deleted_lines': 1, 'nloc': 138}, {'timestamp': 1516341168.0, 'added_lines': 1, 'deleted_lines': 1, 'nloc': 138}, {'timestamp': 1516562066.0, 'added_lines': 2, 'deleted_lines': 2, 'nloc': 138}, {'timestamp': 1516838128.0, 'added_lines': 1, 'deleted_lines': 1, 'nloc': 138}, {'timestamp': 1517105039.0, 'added_lines': 1, 'deleted_lines': 1, 'nloc': 138}, {'timestamp': 1517453697.0, 'added_lines': 1, 'deleted_lines': 1, 'nloc': 138}, {'timestamp': 1519173780.0, 'added_lines': 1, 'deleted_lines': 1, 'nloc': 138}, {'timestamp': 1521314540.0, 'added_lines': 2, 'deleted_lines': 2, 'nloc': 138}, {'timestamp': 1521500314.0, 'added_lines': 1, 'deleted_lines': 1, 'nloc': 138}, {'timestamp': 1521399286.0, 'added_lines': 2, 'deleted_lines': 2, 'nloc': 138}, {'timestamp': 1524596476.0, 'added_lines': 1, 'deleted_lines': 1, 'nloc': 138}, {'timestamp': 1525408792.0, 'added_lines': 1, 'deleted_lines': 1, 'nloc': 138}, {'timestamp': 1528520460.0, 'added_lines': 2, 'deleted_lines': 2, 'nloc': 138}, {'timestamp': 1529984485.0, 'added_lines': 1, 'deleted_lines': 1, 'nloc': 138}, {'timestamp': 1533779477.0, 'added_lines': 1, 'deleted_lines': 1, 'nloc': 138}, {'timestamp': 1533946888.0, 'added_lines': 2, 'deleted_lines': 2, 'nloc': 138}, {'timestamp': 1534896611.0, 'added_lines': 2, 'deleted_lines': 2, 'nloc': 138}, {'timestamp': 1534903410.0, 'added_lines': 2, 'deleted_lines': 1, 'nloc': 139}, {'timestamp': 1523628870.0, 'added_lines': 30, 'deleted_lines': 49, 'nloc': 124}, {'timestamp': 1535044155.0, 'added_lines': 1, 'deleted_lines': 1, 'nloc': 124}, {'timestamp': 1537193530.0, 'added_lines': 1, 'deleted_lines': 1, 'nloc': 124}, {'timestamp': 1537391809.0, 'added_lines': 1, 'deleted_lines': 1, 'nloc': 124}, {'timestamp': 1537792589.0, 'added_lines': 1, 'deleted_lines': 1, 'nloc': 124}, {'timestamp': 1537393245.0, 'added_lines': 15, 'deleted_lines': 6, 'nloc': 131}, {'timestamp': 1538662493.0, 'added_lines': 9, 'deleted_lines': 5, 'nloc': 135}, {'timestamp': 1539850591.0, 'added_lines': 2, 'deleted_lines': 2, 'nloc': 135}, {'timestamp': 1539876785.0, 'added_lines': 4, 'deleted_lines': 4, 'nloc': 135}, {'timestamp': 1539104245.0, 'added_lines': 29, 'deleted_lines': 8, 'nloc': 149}, {'timestamp': 1539172054.0, 'added_lines': 4, 'deleted_lines': 0, 'nloc': 152}, {'timestamp': 1539600349.0, 'added_lines': 3, 'deleted_lines': 12, 'nloc': 146}, {'timestamp': 1540552487.0, 'added_lines': 1, 'deleted_lines': 1, 'nloc': 146}, {'timestamp': 1540597832.0, 'added_lines': 1, 'deleted_lines': 1, 'nloc': 146}, {'timestamp': 1541204121.0, 'added_lines': 1, 'deleted_lines': 1, 'nloc': 146}, {'timestamp': 1544440342.0, 'added_lines': 1, 'deleted_lines': 3, 'nloc': 143}, {'timestamp': 1544661332.0, 'added_lines': 1, 'deleted_lines': 1, 'nloc': 143}, {'timestamp': 1544667474.0, 'added_lines': 0, 'deleted_lines': 11, 'nloc': 134}, {'timestamp': 1540556089.0, 'added_lines': 1, 'deleted_lines': 1, 'nloc': 134}, {'timestamp': 1542594282.0, 'added_lines': 4, 'deleted_lines': 2, 'nloc': 136}, {'timestamp': 1545095383.0, 'added_lines': 1, 'deleted_lines': 1, 'nloc': 136}, {'timestamp': 1545034475.0, 'added_lines': 1, 'deleted_lines': 1, 'nloc': 136}, {'timestamp': 1547152271.0, 'added_lines': 1, 'deleted_lines': 1, 'nloc': 136}, {'timestamp': 1548866534.0, 'added_lines': 2, 'deleted_lines': 2, 'nloc': 136}, {'timestamp': 1549672857.0, 'added_lines': 1, 'deleted_lines': 1, 'nloc': 136}, {'timestamp': 1549673846.0, 'added_lines': 1, 'deleted_lines': 1, 'nloc': 136}, {'timestamp': 1549903582.0, 'added_lines': 3, 'deleted_lines': 3, 'nloc': 136}, {'timestamp': 1550185115.0, 'added_lines': 1, 'deleted_lines': 1, 'nloc': 136}, {'timestamp': 1550507829.0, 'added_lines': 2, 'deleted_lines': 2, 'nloc': 136}, {'timestamp': 1550547515.0, 'added_lines': 8, 'deleted_lines': 2, 'nloc': 141}, {'timestamp': 1550576884.0, 'added_lines': 2, 'deleted_lines': 3, 'nloc': 141}, {'timestamp': 1550610741.0, 'added_lines': 1, 'deleted_lines': 1, 'nloc': 141}, {'timestamp': 1550711994.0, 'added_lines': 1, 'deleted_lines': 1, 'nloc': 141}, {'timestamp': 1550723346.0, 'added_lines': 1, 'deleted_lines': 1, 'nloc': 141}, {'timestamp': 1551138343.0, 'added_lines': 1, 'deleted_lines': 1, 'nloc': 141}, {'timestamp': 1551229859.0, 'added_lines': 1, 'deleted_lines': 1, 'nloc': 141}, {'timestamp': 1551299964.0, 'added_lines': 2, 'deleted_lines': 2, 'nloc': 141}, {'timestamp': 1551471469.0, 'added_lines': 1, 'deleted_lines': 1, 'nloc': 141}, {'timestamp': 1551551196.0, 'added_lines': 4, 'deleted_lines': 4, 'nloc': 141}, {'timestamp': 1553529899.0, 'added_lines': 1, 'deleted_lines': 6, 'nloc': 137}, {'timestamp': 1553608614.0, 'added_lines': 2, 'deleted_lines': 1, 'nloc': 138}, {'timestamp': 1553609463.0, 'added_lines': 1, 'deleted_lines': 1, 'nloc': 138}, {'timestamp': 1557554420.0, 'added_lines': 8, 'deleted_lines': 9, 'nloc': 137}, {'timestamp': 1579218500.0, 'added_lines': 1, 'deleted_lines': 1, 'nloc': 137}]","{'blocks/blockstore/caching.go': 1, 'blocks/blockstore/util/remove.go': 3, 'cmd/ipfs/daemon.go': 56, 'cmd/ipfs/init.go': 40, 'cmd/ipfs/ipfs.go': 51, 'cmd/ipfs/main.go': 54, 'cmd/ipfs/main_test.go': 4, 'cmd/ipfswatch/main.go': 16, 'cmd/seccat/seccat.go': 16, None: 14, 'commands/channelmarshaler.go': 1, 'commands/cli/cmd_suggestion.go': 1, 'commands/cli/helptext.go': 2, 'commands/cli/helptext_test.go': 2, 'commands/cli/parse.go': 2, 'commands/cli/parse_test.go': 2, 'commands/command.go': 29, 'commands/command_test.go': 20, 'commands/http/client.go': 2, 'commands/http/handler.go': 2, 'commands/http/multifilereader.go': 2, 'commands/http/multifilereader_test.go': 2, 'commands/http/parse.go': 2, 'commands/reqlog.go': 1, 'commands/request.go': 38, 'commands/response.go': 24, 'commands/response_test.go': 20, 'core/bootstrap.go': 16, 'core/commands/active.go': 24, 'core/commands/add.go': 64, 'core/commands/bitswap.go': 59, 'core/commands/block.go': 67, 'core/commands/bootstrap.go': 27, 'core/commands/commands.go': 54, 'core/commands/config.go': 30, 'core/commands/dag/dag.go': 40, 'core/commands/dht.go': 38, 'core/commands/diag.go': 23, 'core/commands/dns.go': 33, 'core/commands/e/error.go': 1, 'core/commands/external.go': 23, 'core/commands/files/files.go': 10, 'core/commands/filestore.go': 56, 'core/commands/get.go': 67, 'core/commands/helptext_test.go': 51, 'core/commands/id.go': 39, 'core/commands/ipns.go': 13, 'core/commands/keystore.go': 45, 'core/commands/log.go': 29, 'core/commands/ls.go': 41, 'core/commands/mount_nofuse.go': 23, 'core/commands/mount_unix.go': 27, 'core/commands/mount_windows.go': 22, 'core/commands/name.go': 10, 'core/commands/object/diff.go': 34, 'core/commands/object/object.go': 50, 'core/commands/object/patch.go': 50, 'core/commands/p2p.go': 30, 'core/commands/pin.go': 42, 'core/commands/ping.go': 35, 'core/commands/publish.go': 16, 'core/commands/pubsub.go': 63, 'core/commands/refs.go': 32, 'core/commands/repo.go': 57, 'core/commands/resolve.go': 43, 'core/commands/root.go': 54, 'core/commands/shutdown.go': 33, 'core/commands/stat.go': 56, 'core/commands/swarm.go': 36, 'core/commands/sysdiag.go': 27, 'core/commands/tar.go': 32, 'core/commands/unixfs/ls.go': 37, 'core/commands/unixfs/unixfs.go': 23, 'core/commands/version.go': 26, 'core/core_test.go': 8, 'core/corehttp/commands.go': 57, 'core/corehttp/gateway.go': 24, 'core/coreunix/add.go': 33, 'core/coreunix/add_test.go': 31, 'core/coreunix/metadata_test.go': 22, 'exchange/bitswap/bitswap_test.go': 10, 'exchange/bitswap/decision/engine_test.go': 8, 'exchange/bitswap/message/message_test.go': 4, 'exchange/bitswap/message/pb/Makefile': 1, 'exchange/bitswap/testnet/network_test.go': 8, 'exchange/bitswap/testnet/peernet.go': 9, 'exchange/reprovide/reprovide_test.go': 16, 'fuse/ipns/common.go': 18, 'fuse/node/mount_test.go': 16, 'importer/balanced/balanced_test.go': 7, 'importer/chunk/rabin_test.go': 3, 'importer/helpers/dagbuilder.go': 11, 'importer/importer.go': 11, 'merkledag/utils/utils_test.go': 4, 'mfs/repub_test.go': 9, 'namesys/dns.go': 16, 'namesys/interface.go': 18, 'namesys/ipns_select_test.go': 5, 'namesys/proquint.go': 16, 'namesys/republisher/repub_test.go': 21, 'package.json': 56, 'repo/config/identity.go': 3, 'routing/offline/offline_test.go': 6, 'test/integration/addcat_test.go': 25, 'test/integration/bench_cat_test.go': 24, 'test/integration/bitswap_wo_routing_test.go': 19, 'test/integration/three_legged_cat_test.go': 24, 'test/sharness/t0600-issues-and-regressions-online.sh': 1, 'core/bootstrap_test.go': 14, 'core/commands/dht_test.go': 14, 'core/commands/get_test.go': 51, 'core/core.go': 27, 'core/corehttp/gateway_test.go': 25, 'core/corehttp/metrics_test.go': 18, 'core/mock/mock.go': 18, 'exchange/bitswap/decision/bench_test.go': 7, 'exchange/bitswap/decision/peer_request_queue_test.go': 7, 'exchange/bitswap/message/message.go': 7, 'exchange/bitswap/network/interface.go': 7, 'exchange/bitswap/network/ipfs_impl.go': 7, 'exchange/bitswap/testnet/interface.go': 7, 'exchange/bitswap/testnet/virtual.go': 8, 'exchange/bitswap/testutils.go': 8, 'fuse/ipns/ipns_test.go': 15, 'fuse/readonly/ipfs_test.go': 33, 'namesys/publisher_test.go': 15, 'namesys/resolve_test.go': 20, 'p2p/p2p.go': 14, 'p2p/registry.go': 9, 'repo/config/bootstrap_peers.go': 9, 'routing/mock/centralized_client.go': 4, 'routing/mock/centralized_server.go': 4, 'routing/mock/centralized_test.go': 4, 'routing/mock/interface.go': 4, 'routing/none/none_client.go': 4, 'test/integration/bench_test.go': 14, 'assets/assets.go': 23, 'blocks/blockstore/arc_cache.go': 2, 'blocks/blockstore/arc_cache_test.go': 2, 'blocks/blockstore/blockstore.go': 3, 'blocks/blockstore/blockstore_test.go': 2, 'blocks/blockstore/bloom_cache.go': 2, 'blocks/blockstore/bloom_cache_test.go': 2, 'blocks/blocksutil/block_generator.go': 2, 'blockservice/blockservice.go': 6, 'blockservice/blockservice_test.go': 5, 'blockservice/test/blocks_test.go': 5, 'core/builder.go': 23, 'core/commands/ipnsps.go': 9, 'core/coreapi/coreapi.go': 16, 'core/coreapi/interface/interface.go': 2, 'core/coreapi/unixfs.go': 28, 'core/coreapi/unixfs_test.go': 16, 'core/coredag/cbor.go': 9, 'core/coredag/dagpb.go': 14, 'core/coredag/dagtransl.go': 7, 'core/coredag/raw.go': 14, 'core/corehttp/corehttp.go': 12, 'core/corehttp/gateway_handler.go': 34, 'core/corerepo/gc.go': 24, 'core/corerepo/pinning.go': 9, 'core/coreunix/metadata.go': 19, 'core/pathresolver.go': 18, 'exchange/bitswap/bitswap.go': 6, 'exchange/bitswap/decision/engine.go': 6, 'exchange/bitswap/decision/ledger.go': 6, 'exchange/bitswap/decision/peer_request_queue.go': 6, 'exchange/bitswap/get.go': 5, 'exchange/bitswap/notifications/notifications.go': 3, 'exchange/bitswap/notifications/notifications_test.go': 3, 'exchange/bitswap/session.go': 7, 'exchange/bitswap/session_test.go': 5, 'exchange/bitswap/stat.go': 3, 'exchange/bitswap/wantlist/wantlist.go': 3, 'exchange/bitswap/wantlist/wantlist_test.go': 3, 'exchange/bitswap/wantmanager.go': 6, 'exchange/bitswap/workers.go': 6, 'exchange/interface.go': 2, 'exchange/offline/offline.go': 2, 'exchange/offline/offline_test.go': 2, 'exchange/reprovide/providers.go': 16, 'exchange/reprovide/reprovide.go': 15, 'filestore/filestore.go': 13, 'filestore/filestore_test.go': 16, 'filestore/fsrefstore.go': 12, 'filestore/util.go': 12, 'fuse/ipns/ipns_unix.go': 24, 'fuse/readonly/readonly_unix.go': 25, 'importer/balanced/builder.go': 3, 'importer/chunk/splitting_test.go': 2, 'importer/helpers/helpers.go': 3, 'importer/importer_test.go': 5, 'importer/trickle/trickle_test.go': 6, 'importer/trickle/trickledag.go': 4, 'merkledag/batch.go': 2, 'merkledag/coding.go': 4, 'merkledag/merkledag.go': 4, 'merkledag/merkledag_test.go': 6, 'merkledag/node.go': 3, 'merkledag/node_test.go': 3, 'merkledag/raw.go': 3, 'merkledag/traverse/traverse.go': 3, 'merkledag/traverse/traverse_test.go': 3, 'merkledag/utils/diff.go': 3, 'merkledag/utils/diffenum.go': 3, 'merkledag/utils/diffenum_test.go': 3, 'merkledag/utils/utils.go': 5, 'mfs/dir.go': 5, 'mfs/file.go': 7, 'mfs/mfs_test.go': 8, 'mfs/ops.go': 4, 'mfs/system.go': 8, 'namesys/namesys.go': 22, 'namesys/publisher.go': 23, 'namesys/pubsub.go': 6, 'namesys/pubsub_test.go': 5, 'namesys/republisher/repub.go': 17, 'namesys/routing.go': 21, 'path/path.go': 3, 'path/resolver.go': 3, 'path/resolver_test.go': 2, 'pin/gc/gc.go': 17, 'pin/pin.go': 18, 'pin/pin_test.go': 16, 'pin/set.go': 14, 'pin/set_test.go': 16, 'plugin/ipld.go': 7, 'plugin/loader/initializer.go': 5, 'plugin/plugins/git/git.go': 7, 'repo/config/init.go': 8, 'repo/fsrepo/fsrepo.go': 15, 'repo/fsrepo/lock/lock.go': 3, 'repo/fsrepo/serialize/serialize.go': 4, 'repo/mock.go': 10, 'repo/repo.go': 11, 'routing/offline/offline.go': 3, 'tar/format.go': 22, 'test/dependencies/ma-pipe-unidir/main.go': 7, 'thirdparty/ds-help/key.go': 2, 'thirdparty/pollEndpoint/main.go': 13, 'thirdparty/posinfo/posinfo.go': 2, 'unixfs/archive/archive.go': 3, 'unixfs/archive/tar/writer.go': 3, 'unixfs/hamt/hamt.go': 3, 'unixfs/io/dagreader.go': 3, 'unixfs/io/dirbuilder.go': 3, 'unixfs/io/resolve.go': 3, 'unixfs/mod/dagmodifier.go': 5, 'unixfs/mod/dagmodifier_test.go': 3, 'unixfs/test/utils.go': 6, 'commands/legacy/command.go': 34, 'commands/legacy/legacy.go': 35, 'commands/legacy/legacy_test.go': 36, 'commands/legacy/request.go': 36, 'commands/legacy/response.go': 35, 'commands/legacy/responseemitter.go': 4, 'core/commands/env.go': 4, 'core/commands/commands_test.go': 44, 'test/sharness/t0040-add-and-cat.sh': 1, 'TODO.md': 2, 'test/sharness/t0110-gateway.sh': 2, 'test/sharness/t0410-api-add.sh': 1, 'core/coreapi/dag.go': 6, 'core/coreapi/dag_test.go': 3, 'core/coreapi/interface/options/dag.go': 4, 'core/coreapi/key.go': 23, 'core/coreapi/name.go': 25, 'merkledag/test/utils.go': 4, 'namesys/namesys_test.go': 24, 'repo/fsrepo/datastores.go': 10, 'repo/fsrepo/fsrepo_test.go': 8, 'thirdparty/datastore2/datastore_closer.go': 1, 'thirdparty/datastore2/delayed.go': 1, 'thirdparty/datastore2/threadsafe.go': 1, 'unixfs/io/pbdagreader.go': 3, 'cmd/ipfs/util/ulimit.go': 9, 'cmd/seccat/util.go': 9, 'core/corehttp/logs.go': 9, 'fuse/mount/mount.go': 11, 'fuse/node/mount_unix.go': 9, 'importer/chunk/splitting.go': 1, 'namesys/ipns_validate_test.go': 3, 'plugin/loader/load.go': 7, 'core/commands/files.go': 46, 'core/commands/root_test.go': 1, 'test/sharness/t0090-get.sh': 1, 'core/coreapi/object.go': 23, 'fuse/mount/fuse.go': 4, 'keystore/keystore_test.go': 6, 'namesys/dns_test.go': 11, 'repo/config/config.go': 1, 'unixfs/unixfs.go': 1, 'blocks/blockstoreutil/remove.go': 10, 'blockservice/test/mock.go': 3, 'core/coreapi/pin.go': 21, 'keystore/keystore.go': 9, 'keystore/memkeystore.go': 5, 'namesys/validator.go': 2, 'path/resolver/resolver.go': 3, 'thirdparty/verifbs/verifbs.go': 10, 'cmd/ipfs/util/ulimit_freebsd.go': 2, 'cmd/ipfs/util/ulimit_unix.go': 2, 'core/coreapi/block.go': 16, 'core/coreapi/block_test.go': 2, 'core/coreapi/interface/coreapi.go': 3, 'core/coreapi/interface/dag.go': 3, 'core/coreapi/interface/object.go': 3, 'core/coreapi/interface/options/block.go': 2, 'core/coreapi/interface/path.go': 5, 'core/coreapi/interface/unixfs.go': 9, 'fuse/ipns/link_unix.go': 2, 'fuse/node/mount_darwin.go': 2, 'merkledag/errservice.go': 1, 'merkledag/readonly.go': 1, 'merkledag/readonly_test.go': 1, 'merkledag/rwservice.go': 1, 'merkledag/session.go': 1, 'path/resolver/resolver_test.go': 1, 'thirdparty/verifcid/validate.go': 1, 'thirdparty/verifcid/validate_test.go': 1, 'unixfs/hamt/hamt_stress_test.go': 1, 'unixfs/hamt/hamt_test.go': 1, 'namesys/ipns_resolver_validation_test.go': 16, 'test/sharness/t0170-dht.sh': 1, 'core/commands/urlstore.go': 29, 'core/coreapi/interface/key.go': 4, 'core/coreapi/name_test.go': 6, 'core/coreapi/path.go': 22, 'core/coreunix/cat.go': 4, 'core/pathresolver_test.go': 11, 'dagutils/diff.go': 15, 'dagutils/diffenum.go': 11, 'dagutils/diffenum_test.go': 11, 'dagutils/utils.go': 11, 'dagutils/utils_test.go': 11, 'filestore/pb/dataobj.pb.go': 3, 'mfs/fd.go': 2, 'namesys/base.go': 15, 'namesys/cache.go': 11, 'pin/internal/pb/header.pb.go': 3, 'thirdparty/cidv0v1/blockstore.go': 7, 'repo/fsrepo/config_test.go': 6, 'repo/fsrepo/misc.go': 6, 'test/bench/bench_cli_ipfs_add/main.go': 7, 'test/bench/offline_add/main.go': 7, 'core/commands/cmdenv/env.go': 28, 'core/commands/name/ipns.go': 29, 'core/commands/name/ipnsps.go': 23, 'core/commands/name/name.go': 22, 'core/commands/name/publish.go': 32, 'test/sharness/lib/test-lib.sh': 1, 'core/coreapi/dht.go': 15, 'core/coreapi/dht_test.go': 2, 'core/coreapi/interface/dht.go': 2, 'p2p/listener.go': 5, 'p2p/local.go': 6, 'p2p/remote.go': 5, 'p2p/stream.go': 5, 'core/coreapi/interface/util.go': 1, 'core/commands/cid.go': 18, 'core/coreapi/unixfile.go': 5, 'cmd/ipfs/dnsresolve_test.go': 3, 'core/coreapi/interface/options/unixfs.go': 1, 'core/coreapi/interface/pubsub.go': 1, 'core/coreapi/interface/swarm.go': 1, 'core/coreapi/pubsub.go': 13, 'core/coreapi/swarm.go': 12, 'test/dependencies/iptb/iptb.go': 8, 'commands/context.go': 18, 'core/commands/cmdenv/file.go': 4, 'core/coreapi/interface/errors.go': 1, 'core/commands/cmdenv/cidbase.go': 10, 'core/coreapi/interface/tests/name.go': 1, 'core/coreapi/interface/tests/unixfs.go': 1, 'core/coreapi/test/api_test.go': 11, 'core/corehttp/ipns_hostname.go': 11, 'plugin/daemon.go': 10, 'plugin/loader/loader.go': 11, 'core/corehttp/proxy.go': 6, 'plugin/plugins/badgerds/badgerds.go': 3, 'plugin/plugins/flatfs/flatfs.go': 3, 'plugin/plugins/levelds/levelds.go': 2, 'core/corerepo/stat.go': 2, 'core/commands/cmdenv/cidbase_test.go': 2, 'core/corehttp/metrics.go': 1, 'core/corehttp/proxy_test.go': 1, 'plugin/tracer.go': 1, 'thirdparty/notifier/notifier.go': 1, 'README.md': 1, 'go.mod': 1, 'go.sum': 1, 'package-list.json': 1, 'core/bootstrap/bootstrap.go': 1, 'core/node/libp2p/discovery.go': 1, 'core/node/libp2p/pnet.go': 1, 'core/node/libp2p/smux.go': 1, 'core/node/libp2p/transport.go': 1, 'plugin/loader/load_unix.go': 1}","('core/commands/block.go', 0.8072289156626506, 0.7204301075268817)"
core/commands/commands.go,91,551,6,"[{'cyclomatic_complexity': 1, 'nloc': 4, 'token_count': 29, 'name': '', 'long_name': '(req cmds.Request,res cmds.Response)', 'start_line': 42, 'end_line': 45, 'full_parameters': [], 'filename': '/home/dimi/Documents/Informatik_Studium/FSS/SoftEvo/DataCollection/FFS_SoftEvo/go-ipfs/core/commands/commands.go', 'top_nesting_level': 0, 'length': 4, 'fan_in': 0, 'fan_out': 0, 'general_fan_out': 0}, {'cyclomatic_complexity': 2, 'nloc': 9, 'token_count': 87, 'name': '', 'long_name': '(res cmds.Response)(io.Reader,error)', 'start_line': 47, 'end_line': 55, 'full_parameters': [], 'filename': '/home/dimi/Documents/Informatik_Studium/FSS/SoftEvo/DataCollection/FFS_SoftEvo/go-ipfs/core/commands/commands.go', 'top_nesting_level': 0, 'length': 9, 'fan_in': 0, 'fan_out': 0, 'general_fan_out': 0}, {'cyclomatic_complexity': 1, 'nloc': 16, 'token_count': 100, 'name': 'CommandsCmd', 'long_name': 'CommandsCmd root * cmds . Command', 'start_line': 33, 'end_line': 59, 'full_parameters': ['root * cmds . Command'], 'filename': '/home/dimi/Documents/Informatik_Studium/FSS/SoftEvo/DataCollection/FFS_SoftEvo/go-ipfs/core/commands/commands.go', 'top_nesting_level': 0, 'length': 27, 'fan_in': 0, 'fan_out': 0, 'general_fan_out': 0}, {'cyclomatic_complexity': 3, 'nloc': 17, 'token_count': 114, 'name': 'cmd2outputCmd', 'long_name': 'cmd2outputCmd name string , cmd * cmds . Command', 'start_line': 61, 'end_line': 80, 'full_parameters': ['name string', ' cmd * cmds . Command'], 'filename': '/home/dimi/Documents/Informatik_Studium/FSS/SoftEvo/DataCollection/FFS_SoftEvo/go-ipfs/core/commands/commands.go', 'top_nesting_level': 0, 'length': 20, 'fan_in': 0, 'fan_out': 0, 'general_fan_out': 0}, {'cyclomatic_complexity': 7, 'nloc': 21, 'token_count': 130, 'name': '', 'long_name': '(prefix string,cmd*Command)', 'start_line': 86, 'end_line': 106, 'full_parameters': [], 'filename': '/home/dimi/Documents/Informatik_Studium/FSS/SoftEvo/DataCollection/FFS_SoftEvo/go-ipfs/core/commands/commands.go', 'top_nesting_level': 0, 'length': 21, 'fan_in': 0, 'fan_out': 0, 'general_fan_out': 0}, {'cyclomatic_complexity': 1, 'nloc': 6, 'token_count': 32, 'name': 'recurse', 'long_name': '(prefix string,cmd*Command)recurse', 'start_line': 85, 'end_line': 111, 'full_parameters': [], 'filename': '/home/dimi/Documents/Informatik_Studium/FSS/SoftEvo/DataCollection/FFS_SoftEvo/go-ipfs/core/commands/commands.go', 'top_nesting_level': 0, 'length': 27, 'fan_in': 0, 'fan_out': 0, 'general_fan_out': 0}]",174,1055,10,"[{'cyclomatic_complexity': 4, 'nloc': 16, 'token_count': 109, 'name': 'Encode', 'long_name': '(e*commandEncoder)Encode v interface { }', 'start_line': 23, 'end_line': 41, 'full_parameters': ['v interface { }'], 'filename': '/home/dimi/Documents/Informatik_Studium/FSS/SoftEvo/DataCollection/FFS_SoftEvo/go-ipfs/core/commands/commands.go', 'top_nesting_level': 0, 'length': 19, 'fan_in': 0, 'fan_out': 0, 'general_fan_out': 0}, {'cyclomatic_complexity': 1, 'nloc': 2, 'token_count': 19, 'name': 'cmds', 'long_name': '(w io.Writer)cmds', 'start_line': 81, 'end_line': 82, 'full_parameters': [], 'filename': '/home/dimi/Documents/Informatik_Studium/FSS/SoftEvo/DataCollection/FFS_SoftEvo/go-ipfs/core/commands/commands.go', 'top_nesting_level': 0, 'length': 2, 'fan_in': 0, 'fan_out': 0, 'general_fan_out': 0}, {'cyclomatic_complexity': 1, 'nloc': 5, 'token_count': 30, 'name': 'func', 'long_name': '(req*cmds.Request)func io . Writer', 'start_line': 80, 'end_line': 85, 'full_parameters': ['io . Writer'], 'filename': '/home/dimi/Documents/Informatik_Studium/FSS/SoftEvo/DataCollection/FFS_SoftEvo/go-ipfs/core/commands/commands.go', 'top_nesting_level': 0, 'length': 6, 'fan_in': 0, 'fan_out': 0, 'general_fan_out': 0}, {'cyclomatic_complexity': 3, 'nloc': 15, 'token_count': 115, 'name': 'cmd2outputCmd', 'long_name': 'cmd2outputCmd name string , cmd * cmds . Command', 'start_line': 88, 'end_line': 105, 'full_parameters': ['name string', ' cmd * cmds . Command'], 'filename': '/home/dimi/Documents/Informatik_Studium/FSS/SoftEvo/DataCollection/FFS_SoftEvo/go-ipfs/core/commands/commands.go', 'top_nesting_level': 0, 'length': 18, 'fan_in': 0, 'fan_out': 0, 'general_fan_out': 0}, {'cyclomatic_complexity': 7, 'nloc': 21, 'token_count': 130, 'name': '', 'long_name': '(prefix string,cmd*Command)', 'start_line': 111, 'end_line': 131, 'full_parameters': [], 'filename': '/home/dimi/Documents/Informatik_Studium/FSS/SoftEvo/DataCollection/FFS_SoftEvo/go-ipfs/core/commands/commands.go', 'top_nesting_level': 0, 'length': 21, 'fan_in': 0, 'fan_out': 0, 'general_fan_out': 0}, {'cyclomatic_complexity': 1, 'nloc': 6, 'token_count': 27, 'name': 'recurse', 'long_name': '(prefix string,cmd*Command)recurse', 'start_line': 110, 'end_line': 136, 'full_parameters': [], 'filename': '/home/dimi/Documents/Informatik_Studium/FSS/SoftEvo/DataCollection/FFS_SoftEvo/go-ipfs/core/commands/commands.go', 'top_nesting_level': 0, 'length': 27, 'fan_in': 0, 'fan_out': 0, 'general_fan_out': 0}, {'cyclomatic_complexity': 2, 'nloc': 11, 'token_count': 71, 'name': 'error', 'long_name': '(req*cmds.Request,res cmds.ResponseEmitter,env cmds.Environment)error', 'start_line': 163, 'end_line': 173, 'full_parameters': [], 'filename': '/home/dimi/Documents/Informatik_Studium/FSS/SoftEvo/DataCollection/FFS_SoftEvo/go-ipfs/core/commands/commands.go', 'top_nesting_level': 0, 'length': 11, 'fan_in': 0, 'fan_out': 0, 'general_fan_out': 0}, {'cyclomatic_complexity': 2, 'nloc': 6, 'token_count': 32, 'name': '', 'long_name': '()', 'start_line': 183, 'end_line': 188, 'full_parameters': [], 'filename': '/home/dimi/Documents/Informatik_Studium/FSS/SoftEvo/DataCollection/FFS_SoftEvo/go-ipfs/core/commands/commands.go', 'top_nesting_level': 0, 'length': 6, 'fan_in': 0, 'fan_out': 0, 'general_fan_out': 0}, {'cyclomatic_complexity': 6, 'nloc': 22, 'token_count': 98, 'name': '', 'long_name': '(res cmds.Response,re cmds.ResponseEmitter)(err error)', 'start_line': 182, 'end_line': 212, 'full_parameters': [], 'filename': '/home/dimi/Documents/Informatik_Studium/FSS/SoftEvo/DataCollection/FFS_SoftEvo/go-ipfs/core/commands/commands.go', 'top_nesting_level': 0, 'length': 31, 'fan_in': 0, 'fan_out': 0, 'general_fan_out': 0}, {'cyclomatic_complexity': 1, 'nloc': 3, 'token_count': 31, 'name': 'streamResult', 'long_name': 'streamResult procVal func interface { } , io . Writer nonFatalError', 'start_line': 181, 'end_line': 213, 'full_parameters': ['procVal func interface { }', ' io . Writer nonFatalError'], 'filename': '/home/dimi/Documents/Informatik_Studium/FSS/SoftEvo/DataCollection/FFS_SoftEvo/go-ipfs/core/commands/commands.go', 'top_nesting_level': 0, 'length': 33, 'fan_in': 0, 'fan_out': 0, 'general_fan_out': 0}]",83,504,4,63,63,"[{'timestamp': 1491058697.0, 'added_lines': 100, 'deleted_lines': 17, 'nloc': 150}, {'timestamp': 1508770239.0, 'added_lines': 1, 'deleted_lines': 1, 'nloc': 150}, {'timestamp': 1509016767.0, 'added_lines': 1, 'deleted_lines': 1, 'nloc': 150}, {'timestamp': 1499331469.0, 'added_lines': 1, 'deleted_lines': 1, 'nloc': 150}, {'timestamp': 1511223906.0, 'added_lines': 2, 'deleted_lines': 2, 'nloc': 150}, {'timestamp': 1511373659.0, 'added_lines': 1, 'deleted_lines': 1, 'nloc': 150}, {'timestamp': 1512365669.0, 'added_lines': 2, 'deleted_lines': 2, 'nloc': 150}, {'timestamp': 1511187070.0, 'added_lines': 8, 'deleted_lines': 47, 'nloc': 119}, {'timestamp': 1512121226.0, 'added_lines': 1, 'deleted_lines': 1, 'nloc': 119}, {'timestamp': 1513436097.0, 'added_lines': 2, 'deleted_lines': 2, 'nloc': 119}, {'timestamp': 1513612261.0, 'added_lines': 2, 'deleted_lines': 2, 'nloc': 119}, {'timestamp': 1513764708.0, 'added_lines': 1, 'deleted_lines': 1, 'nloc': 119}, {'timestamp': 1513765470.0, 'added_lines': 1, 'deleted_lines': 1, 'nloc': 119}, {'timestamp': 1513766201.0, 'added_lines': 1, 'deleted_lines': 1, 'nloc': 119}, {'timestamp': 1513772371.0, 'added_lines': 0, 'deleted_lines': 1, 'nloc': 119}, {'timestamp': 1513772654.0, 'added_lines': 1, 'deleted_lines': 1, 'nloc': 119}, {'timestamp': 1513773452.0, 'added_lines': 1, 'deleted_lines': 1, 'nloc': 119}, {'timestamp': 1515277696.0, 'added_lines': 1, 'deleted_lines': 1, 'nloc': 119}, {'timestamp': 1515465466.0, 'added_lines': 2, 'deleted_lines': 2, 'nloc': 119}, {'timestamp': 1515713724.0, 'added_lines': 1, 'deleted_lines': 1, 'nloc': 119}, {'timestamp': 1516341168.0, 'added_lines': 1, 'deleted_lines': 1, 'nloc': 119}, {'timestamp': 1516838128.0, 'added_lines': 1, 'deleted_lines': 1, 'nloc': 119}, {'timestamp': 1517105039.0, 'added_lines': 1, 'deleted_lines': 1, 'nloc': 119}, {'timestamp': 1517453697.0, 'added_lines': 1, 'deleted_lines': 1, 'nloc': 119}, {'timestamp': 1519173780.0, 'added_lines': 1, 'deleted_lines': 1, 'nloc': 119}, {'timestamp': 1521191854.0, 'added_lines': 1, 'deleted_lines': 1, 'nloc': 119}, {'timestamp': 1521314540.0, 'added_lines': 1, 'deleted_lines': 1, 'nloc': 119}, {'timestamp': 1521500314.0, 'added_lines': 1, 'deleted_lines': 1, 'nloc': 119}, {'timestamp': 1524596476.0, 'added_lines': 1, 'deleted_lines': 1, 'nloc': 119}, {'timestamp': 1525408792.0, 'added_lines': 1, 'deleted_lines': 1, 'nloc': 119}, {'timestamp': 1528520460.0, 'added_lines': 2, 'deleted_lines': 2, 'nloc': 119}, {'timestamp': 1529984485.0, 'added_lines': 1, 'deleted_lines': 1, 'nloc': 119}, {'timestamp': 1533779477.0, 'added_lines': 1, 'deleted_lines': 1, 'nloc': 119}, {'timestamp': 1533946888.0, 'added_lines': 2, 'deleted_lines': 2, 'nloc': 119}, {'timestamp': 1534896611.0, 'added_lines': 2, 'deleted_lines': 2, 'nloc': 119}, {'timestamp': 1523628870.0, 'added_lines': 3, 'deleted_lines': 6, 'nloc': 116}, {'timestamp': 1535044155.0, 'added_lines': 1, 'deleted_lines': 1, 'nloc': 116}, {'timestamp': 1537193530.0, 'added_lines': 1, 'deleted_lines': 1, 'nloc': 116}, {'timestamp': 1537391809.0, 'added_lines': 1, 'deleted_lines': 1, 'nloc': 116}, {'timestamp': 1537792589.0, 'added_lines': 1, 'deleted_lines': 1, 'nloc': 116}, {'timestamp': 1535328619.0, 'added_lines': 40, 'deleted_lines': 0, 'nloc': 147}, {'timestamp': 1535600345.0, 'added_lines': 4, 'deleted_lines': 4, 'nloc': 147}, {'timestamp': 1537428017.0, 'added_lines': 2, 'deleted_lines': 2, 'nloc': 147}, {'timestamp': 1539850591.0, 'added_lines': 2, 'deleted_lines': 2, 'nloc': 147}, {'timestamp': 1540552487.0, 'added_lines': 1, 'deleted_lines': 1, 'nloc': 147}, {'timestamp': 1540597832.0, 'added_lines': 1, 'deleted_lines': 1, 'nloc': 147}, {'timestamp': 1541204121.0, 'added_lines': 1, 'deleted_lines': 1, 'nloc': 147}, {'timestamp': 1544661332.0, 'added_lines': 1, 'deleted_lines': 1, 'nloc': 147}, {'timestamp': 1540556089.0, 'added_lines': 1, 'deleted_lines': 1, 'nloc': 147}, {'timestamp': 1547152271.0, 'added_lines': 1, 'deleted_lines': 1, 'nloc': 147}, {'timestamp': 1548866534.0, 'added_lines': 1, 'deleted_lines': 1, 'nloc': 147}, {'timestamp': 1549903582.0, 'added_lines': 1, 'deleted_lines': 1, 'nloc': 147}, {'timestamp': 1550507829.0, 'added_lines': 1, 'deleted_lines': 1, 'nloc': 147}, {'timestamp': 1550610741.0, 'added_lines': 1, 'deleted_lines': 1, 'nloc': 147}, {'timestamp': 1551138343.0, 'added_lines': 1, 'deleted_lines': 1, 'nloc': 147}, {'timestamp': 1551299964.0, 'added_lines': 1, 'deleted_lines': 1, 'nloc': 147}, {'timestamp': 1551471469.0, 'added_lines': 1, 'deleted_lines': 1, 'nloc': 147}, {'timestamp': 1551551196.0, 'added_lines': 2, 'deleted_lines': 2, 'nloc': 147}, {'timestamp': 1553697989.0, 'added_lines': 1, 'deleted_lines': 21, 'nloc': 136}, {'timestamp': 1557554420.0, 'added_lines': 4, 'deleted_lines': 5, 'nloc': 135}, {'timestamp': 1587221101.0, 'added_lines': 1, 'deleted_lines': 1, 'nloc': 135}, {'timestamp': 1595277534.0, 'added_lines': 1, 'deleted_lines': 0, 'nloc': 136}, {'timestamp': 1617263267.0, 'added_lines': 42, 'deleted_lines': 0, 'nloc': 174}]","{'blocks/blockstore/caching.go': 1, 'blocks/blockstore/util/remove.go': 3, 'cmd/ipfs/daemon.go': 58, 'cmd/ipfs/init.go': 37, 'cmd/ipfs/ipfs.go': 52, 'cmd/ipfs/main.go': 55, 'cmd/ipfs/main_test.go': 4, 'cmd/ipfswatch/main.go': 16, 'cmd/seccat/seccat.go': 15, None: 14, 'commands/channelmarshaler.go': 1, 'commands/cli/cmd_suggestion.go': 1, 'commands/cli/helptext.go': 2, 'commands/cli/helptext_test.go': 2, 'commands/cli/parse.go': 2, 'commands/cli/parse_test.go': 2, 'commands/command.go': 29, 'commands/command_test.go': 20, 'commands/http/client.go': 2, 'commands/http/handler.go': 2, 'commands/http/multifilereader.go': 2, 'commands/http/multifilereader_test.go': 2, 'commands/http/parse.go': 2, 'commands/reqlog.go': 2, 'commands/request.go': 38, 'commands/response.go': 24, 'commands/response_test.go': 20, 'core/bootstrap.go': 15, 'core/commands/active.go': 25, 'core/commands/add.go': 55, 'core/commands/bitswap.go': 53, 'core/commands/block.go': 54, 'core/commands/bootstrap.go': 25, 'core/commands/cat.go': 54, 'core/commands/config.go': 29, 'core/commands/dag/dag.go': 31, 'core/commands/dht.go': 32, 'core/commands/diag.go': 23, 'core/commands/dns.go': 26, 'core/commands/e/error.go': 1, 'core/commands/external.go': 24, 'core/commands/files/files.go': 11, 'core/commands/filestore.go': 56, 'core/commands/get.go': 56, 'core/commands/helptext_test.go': 51, 'core/commands/id.go': 33, 'core/commands/ipns.go': 14, 'core/commands/keystore.go': 37, 'core/commands/log.go': 30, 'core/commands/ls.go': 30, 'core/commands/mount_nofuse.go': 23, 'core/commands/mount_unix.go': 25, 'core/commands/mount_windows.go': 22, 'core/commands/name.go': 10, 'core/commands/object/diff.go': 24, 'core/commands/object/object.go': 39, 'core/commands/object/patch.go': 39, 'core/commands/p2p.go': 29, 'core/commands/pin.go': 31, 'core/commands/ping.go': 30, 'core/commands/publish.go': 15, 'core/commands/pubsub.go': 53, 'core/commands/refs.go': 28, 'core/commands/repo.go': 56, 'core/commands/resolve.go': 30, 'core/commands/root.go': 54, 'core/commands/shutdown.go': 32, 'core/commands/stat.go': 54, 'core/commands/swarm.go': 35, 'core/commands/sysdiag.go': 26, 'core/commands/tar.go': 27, 'core/commands/unixfs/ls.go': 26, 'core/commands/unixfs/unixfs.go': 23, 'core/commands/version.go': 27, 'core/core_test.go': 7, 'core/corehttp/commands.go': 52, 'core/corehttp/gateway.go': 17, 'core/coreunix/add.go': 24, 'core/coreunix/add_test.go': 25, 'core/coreunix/metadata_test.go': 19, 'exchange/bitswap/bitswap_test.go': 10, 'exchange/bitswap/decision/engine_test.go': 8, 'exchange/bitswap/message/message_test.go': 4, 'exchange/bitswap/message/pb/Makefile': 1, 'exchange/bitswap/testnet/network_test.go': 8, 'exchange/bitswap/testnet/peernet.go': 9, 'exchange/reprovide/reprovide_test.go': 15, 'fuse/ipns/common.go': 14, 'fuse/node/mount_test.go': 14, 'importer/balanced/balanced_test.go': 6, 'importer/chunk/rabin_test.go': 3, 'importer/helpers/dagbuilder.go': 11, 'importer/importer.go': 11, 'merkledag/utils/utils_test.go': 4, 'mfs/repub_test.go': 9, 'namesys/dns.go': 9, 'namesys/interface.go': 10, 'namesys/ipns_select_test.go': 5, 'namesys/proquint.go': 9, 'namesys/republisher/repub_test.go': 19, 'package.json': 51, 'repo/config/identity.go': 3, 'routing/offline/offline_test.go': 6, 'test/integration/addcat_test.go': 20, 'test/integration/bench_cat_test.go': 19, 'test/integration/bitswap_wo_routing_test.go': 17, 'test/integration/three_legged_cat_test.go': 19, 'test/sharness/t0600-issues-and-regressions-online.sh': 2, 'core/bootstrap_test.go': 13, 'core/commands/dht_test.go': 13, 'core/commands/get_test.go': 51, 'core/core.go': 21, 'core/corehttp/gateway_test.go': 18, 'core/corehttp/metrics_test.go': 15, 'core/mock/mock.go': 15, 'exchange/bitswap/decision/bench_test.go': 7, 'exchange/bitswap/decision/peer_request_queue_test.go': 7, 'exchange/bitswap/message/message.go': 7, 'exchange/bitswap/network/interface.go': 7, 'exchange/bitswap/network/ipfs_impl.go': 7, 'exchange/bitswap/testnet/interface.go': 7, 'exchange/bitswap/testnet/virtual.go': 7, 'exchange/bitswap/testutils.go': 8, 'fuse/ipns/ipns_test.go': 15, 'fuse/readonly/ipfs_test.go': 20, 'namesys/publisher_test.go': 13, 'namesys/resolve_test.go': 14, 'p2p/p2p.go': 13, 'p2p/registry.go': 9, 'repo/config/bootstrap_peers.go': 9, 'routing/mock/centralized_client.go': 4, 'routing/mock/centralized_server.go': 4, 'routing/mock/centralized_test.go': 4, 'routing/mock/interface.go': 4, 'routing/none/none_client.go': 4, 'test/integration/bench_test.go': 13, 'assets/assets.go': 15, 'blocks/blockstore/arc_cache.go': 2, 'blocks/blockstore/arc_cache_test.go': 2, 'blocks/blockstore/blockstore.go': 3, 'blocks/blockstore/blockstore_test.go': 2, 'blocks/blockstore/bloom_cache.go': 2, 'blocks/blockstore/bloom_cache_test.go': 2, 'blocks/blocksutil/block_generator.go': 2, 'blockservice/blockservice.go': 6, 'blockservice/blockservice_test.go': 5, 'blockservice/test/blocks_test.go': 5, 'core/builder.go': 19, 'core/commands/ipnsps.go': 9, 'core/coreapi/coreapi.go': 8, 'core/coreapi/interface/interface.go': 2, 'core/coreapi/unixfs.go': 16, 'core/coreapi/unixfs_test.go': 13, 'core/coredag/cbor.go': 7, 'core/coredag/dagpb.go': 10, 'core/coredag/dagtransl.go': 6, 'core/coredag/raw.go': 10, 'core/corehttp/corehttp.go': 12, 'core/corehttp/gateway_handler.go': 20, 'core/corerepo/gc.go': 19, 'core/corerepo/pinning.go': 8, 'core/coreunix/metadata.go': 15, 'core/pathresolver.go': 13, 'exchange/bitswap/bitswap.go': 6, 'exchange/bitswap/decision/engine.go': 6, 'exchange/bitswap/decision/ledger.go': 6, 'exchange/bitswap/decision/peer_request_queue.go': 6, 'exchange/bitswap/get.go': 5, 'exchange/bitswap/notifications/notifications.go': 3, 'exchange/bitswap/notifications/notifications_test.go': 3, 'exchange/bitswap/session.go': 7, 'exchange/bitswap/session_test.go': 5, 'exchange/bitswap/stat.go': 3, 'exchange/bitswap/wantlist/wantlist.go': 3, 'exchange/bitswap/wantlist/wantlist_test.go': 3, 'exchange/bitswap/wantmanager.go': 6, 'exchange/bitswap/workers.go': 6, 'exchange/interface.go': 2, 'exchange/offline/offline.go': 2, 'exchange/offline/offline_test.go': 2, 'exchange/reprovide/providers.go': 12, 'exchange/reprovide/reprovide.go': 12, 'filestore/filestore.go': 12, 'filestore/filestore_test.go': 12, 'filestore/fsrefstore.go': 11, 'filestore/util.go': 11, 'fuse/ipns/ipns_unix.go': 18, 'fuse/readonly/readonly_unix.go': 20, 'importer/balanced/builder.go': 3, 'importer/chunk/splitting_test.go': 2, 'importer/helpers/helpers.go': 3, 'importer/importer_test.go': 5, 'importer/trickle/trickle_test.go': 5, 'importer/trickle/trickledag.go': 3, 'merkledag/batch.go': 2, 'merkledag/coding.go': 3, 'merkledag/merkledag.go': 3, 'merkledag/merkledag_test.go': 5, 'merkledag/node.go': 3, 'merkledag/node_test.go': 3, 'merkledag/raw.go': 3, 'merkledag/traverse/traverse.go': 3, 'merkledag/traverse/traverse_test.go': 3, 'merkledag/utils/diff.go': 3, 'merkledag/utils/diffenum.go': 3, 'merkledag/utils/diffenum_test.go': 3, 'merkledag/utils/utils.go': 5, 'mfs/dir.go': 5, 'mfs/file.go': 7, 'mfs/mfs_test.go': 7, 'mfs/ops.go': 4, 'mfs/system.go': 8, 'namesys/namesys.go': 17, 'namesys/publisher.go': 18, 'namesys/pubsub.go': 5, 'namesys/pubsub_test.go': 5, 'namesys/republisher/repub.go': 13, 'namesys/routing.go': 15, 'path/path.go': 3, 'path/resolver.go': 3, 'path/resolver_test.go': 2, 'pin/gc/gc.go': 13, 'pin/pin.go': 13, 'pin/pin_test.go': 13, 'pin/set.go': 10, 'pin/set_test.go': 12, 'plugin/ipld.go': 6, 'plugin/loader/initializer.go': 5, 'plugin/plugins/git/git.go': 6, 'repo/config/init.go': 7, 'repo/fsrepo/fsrepo.go': 12, 'repo/fsrepo/lock/lock.go': 3, 'repo/fsrepo/serialize/serialize.go': 3, 'repo/mock.go': 9, 'repo/repo.go': 10, 'routing/offline/offline.go': 3, 'tar/format.go': 18, 'test/dependencies/ma-pipe-unidir/main.go': 7, 'thirdparty/ds-help/key.go': 2, 'thirdparty/pollEndpoint/main.go': 11, 'thirdparty/posinfo/posinfo.go': 2, 'unixfs/archive/archive.go': 3, 'unixfs/archive/tar/writer.go': 3, 'unixfs/hamt/hamt.go': 3, 'unixfs/io/dagreader.go': 3, 'unixfs/io/dirbuilder.go': 3, 'unixfs/io/resolve.go': 3, 'unixfs/mod/dagmodifier.go': 5, 'unixfs/mod/dagmodifier_test.go': 3, 'unixfs/test/utils.go': 5, 'commands/legacy/command.go': 34, 'commands/legacy/legacy.go': 35, 'commands/legacy/legacy_test.go': 36, 'commands/legacy/request.go': 35, 'commands/legacy/response.go': 35, 'commands/legacy/responseemitter.go': 4, 'core/commands/env.go': 4, 'core/commands/commands_test.go': 45, 'test/sharness/t0040-add-and-cat.sh': 2, 'TODO.md': 2, 'test/sharness/t0110-gateway.sh': 3, 'test/sharness/t0410-api-add.sh': 2, 'core/coreapi/dag.go': 5, 'core/coreapi/dag_test.go': 3, 'core/coreapi/interface/options/dag.go': 4, 'core/coreapi/key.go': 13, 'core/coreapi/name.go': 13, 'merkledag/test/utils.go': 4, 'namesys/namesys_test.go': 17, 'repo/fsrepo/datastores.go': 10, 'repo/fsrepo/fsrepo_test.go': 7, 'thirdparty/datastore2/datastore_closer.go': 1, 'thirdparty/datastore2/delayed.go': 1, 'thirdparty/datastore2/threadsafe.go': 1, 'unixfs/io/pbdagreader.go': 2, 'cmd/ipfs/util/ulimit.go': 10, 'cmd/seccat/util.go': 9, 'core/corehttp/logs.go': 9, 'fuse/mount/mount.go': 9, 'fuse/node/mount_unix.go': 10, 'importer/chunk/splitting.go': 1, 'namesys/ipns_validate_test.go': 3, 'plugin/loader/load.go': 7, 'core/commands/files.go': 34, 'core/commands/root_test.go': 1, 'test/sharness/t0090-get.sh': 2, 'blocks/blockstoreutil/remove.go': 10, 'blockservice/test/mock.go': 3, 'core/coreapi/pin.go': 11, 'keystore/keystore.go': 9, 'keystore/keystore_test.go': 7, 'keystore/memkeystore.go': 6, 'namesys/validator.go': 2, 'path/resolver/resolver.go': 3, 'thirdparty/verifbs/verifbs.go': 9, 'cmd/ipfs/util/ulimit_freebsd.go': 2, 'cmd/ipfs/util/ulimit_unix.go': 2, 'core/coreapi/block.go': 7, 'core/coreapi/block_test.go': 2, 'core/coreapi/interface/coreapi.go': 3, 'core/coreapi/interface/dag.go': 3, 'core/coreapi/interface/object.go': 3, 'core/coreapi/interface/options/block.go': 2, 'core/coreapi/interface/path.go': 5, 'core/coreapi/interface/unixfs.go': 6, 'core/coreapi/object.go': 13, 'fuse/ipns/link_unix.go': 2, 'fuse/mount/fuse.go': 3, 'fuse/node/mount_darwin.go': 3, 'merkledag/errservice.go': 1, 'merkledag/readonly.go': 1, 'merkledag/readonly_test.go': 1, 'merkledag/rwservice.go': 1, 'merkledag/session.go': 1, 'path/resolver/resolver_test.go': 1, 'thirdparty/verifcid/validate.go': 1, 'thirdparty/verifcid/validate_test.go': 1, 'unixfs/hamt/hamt_stress_test.go': 1, 'unixfs/hamt/hamt_test.go': 1, 'namesys/ipns_resolver_validation_test.go': 9, 'test/sharness/t0170-dht.sh': 1, 'core/commands/urlstore.go': 24, 'core/coreapi/interface/key.go': 4, 'core/coreapi/name_test.go': 6, 'core/coreapi/path.go': 12, 'core/coreunix/cat.go': 4, 'core/pathresolver_test.go': 7, 'dagutils/diff.go': 9, 'dagutils/diffenum.go': 7, 'dagutils/diffenum_test.go': 7, 'dagutils/utils.go': 8, 'dagutils/utils_test.go': 7, 'filestore/pb/dataobj.pb.go': 3, 'mfs/fd.go': 2, 'namesys/base.go': 8, 'namesys/cache.go': 7, 'pin/internal/pb/header.pb.go': 3, 'thirdparty/cidv0v1/blockstore.go': 6, 'repo/fsrepo/config_test.go': 5, 'repo/fsrepo/misc.go': 5, 'test/bench/bench_cli_ipfs_add/main.go': 7, 'test/bench/offline_add/main.go': 7, 'core/commands/cmdenv/env.go': 20, 'core/commands/name/ipns.go': 21, 'core/commands/name/ipnsps.go': 21, 'core/commands/name/name.go': 21, 'core/commands/name/publish.go': 21, 'test/sharness/lib/test-lib.sh': 1, 'core/coreapi/dht.go': 6, 'core/coreapi/dht_test.go': 2, 'core/coreapi/interface/dht.go': 2, 'p2p/listener.go': 4, 'p2p/local.go': 4, 'p2p/remote.go': 5, 'p2p/stream.go': 5, 'core/commands/cid.go': 21, 'core/coreapi/unixfile.go': 3, 'cmd/ipfs/dnsresolve_test.go': 2, 'core/coreapi/interface/options/unixfs.go': 1, 'core/coreapi/interface/pubsub.go': 1, 'core/coreapi/interface/swarm.go': 1, 'core/coreapi/pubsub.go': 6, 'core/coreapi/swarm.go': 6, 'test/dependencies/iptb/iptb.go': 4, 'commands/context.go': 11, 'core/commands/cmdenv/cidbase.go': 9, 'core/commands/cmdenv/file.go': 3, 'core/coreapi/interface/tests/name.go': 1, 'core/coreapi/interface/tests/unixfs.go': 1, 'core/coreapi/test/api_test.go': 4, 'core/corehttp/ipns_hostname.go': 4, 'namesys/dns_test.go': 4, 'plugin/daemon.go': 4, 'plugin/loader/loader.go': 5, 'core/corehttp/proxy.go': 3, 'plugin/plugins/badgerds/badgerds.go': 3, 'plugin/plugins/flatfs/flatfs.go': 3, 'plugin/plugins/levelds/levelds.go': 2, 'core/corerepo/stat.go': 2, 'core/commands/cmdenv/cidbase_test.go': 1, 'core/corehttp/metrics.go': 1, 'core/corehttp/proxy_test.go': 1, 'plugin/tracer.go': 1, 'thirdparty/notifier/notifier.go': 2, 'core/corehttp/mutex_profile.go': 1, 'core/corehttp/option_test.go': 1, 'provider/queue.go': 1, 'provider/queue_test.go': 1, 'README.md': 3, 'go.mod': 2, 'go.sum': 2, 'package-list.json': 1, 'CHANGELOG.md': 1, 'Dockerfile': 1, 'bin/check_go_version': 1, 'coverage/Rules.mk': 1, 'docs/config.md': 1, 'docs/debug-guide.md': 1, 'docs/environment-variables.md': 1, 'gc/gc.go': 1, 'keystore/memkeystore_test.go': 1, 'misc/completion/ipfs-completion.bash': 1, 'plugin/plugins/gen_main.sh': 1, 'repo/fsrepo/migrations/migrations.go': 1, 'repo/onlyone.go': 1, 'test/3nodetest/run-test-on-img.sh': 1, 'test/ipfs-test-lib.sh': 1, 'test/sharness/README.md': 1, 'test/sharness/lib/iptb-lib.sh': 1, 'test/sharness/t0010-basic-commands.sh': 1, 'test/sharness/t0020-init.sh': 1, 'test/sharness/t0030-mount.sh': 1, 'test/sharness/t0031-mount-publish.sh': 1, 'test/sharness/t0050-block.sh': 1, 'test/sharness/t0051-object.sh': 1, 'test/sharness/t0053-dag.sh': 1, 'test/sharness/t0060-daemon.sh': 1, 'test/sharness/t0062-daemon-api.sh': 1, 'test/sharness/t0080-repo.sh': 1, 'test/sharness/t0087-repo-robust-gc.sh': 1, 'test/sharness/t0114-gateway-subdomains.sh': 1, 'test/sharness/t0131-multinode-client-routing.sh': 1, 'test/sharness/t0140-swarm.sh': 1, 'test/sharness/t0183-namesys-pubsub.sh': 1, 'test/sharness/t0250-files-api.sh': 1, 'test/sharness/t0270-filestore.sh': 1, 'test/sharness/t0272-urlstore.sh': 1, 'test/sharness_test_coverage_helper.sh': 1, 'thirdparty/README.md': 1, 'cmd/ipfs/rotate.go': 1, 'core/commands/extra.go': 1, 'core/commands/completion.go': 1, 'docs/command-completion.md': 1, 'test/sharness/t0011-completion.sh': 1}","('cmd/ipfs/daemon.go', 0.9206349206349206, 0.3790849673202614)"
core/commands/config.go,283,1799,11,"[{'cyclomatic_complexity': 8, 'nloc': 40, 'token_count': 286, 'name': '', 'long_name': '(req cmds.Request,res cmds.Response)', 'start_line': 59, 'end_line': 104, 'full_parameters': [], 'filename': '/home/dimi/Documents/Informatik_Studium/FSS/SoftEvo/DataCollection/FFS_SoftEvo/go-ipfs/core/commands/config.go', 'top_nesting_level': 0, 'length': 46, 'fan_in': 0, 'fan_out': 0, 'general_fan_out': 0}, {'cyclomatic_complexity': 5, 'nloc': 20, 'token_count': 140, 'name': '', 'long_name': '(res cmds.Response)(io.Reader,error)', 'start_line': 106, 'end_line': 127, 'full_parameters': [], 'filename': '/home/dimi/Documents/Informatik_Studium/FSS/SoftEvo/DataCollection/FFS_SoftEvo/go-ipfs/core/commands/config.go', 'top_nesting_level': 0, 'length': 22, 'fan_in': 0, 'fan_out': 0, 'general_fan_out': 0}, {'cyclomatic_complexity': 6, 'nloc': 29, 'token_count': 185, 'name': '', 'long_name': '(req cmds.Request,res cmds.Response)', 'start_line': 146, 'end_line': 179, 'full_parameters': [], 'filename': '/home/dimi/Documents/Informatik_Studium/FSS/SoftEvo/DataCollection/FFS_SoftEvo/go-ipfs/core/commands/config.go', 'top_nesting_level': 0, 'length': 34, 'fan_in': 0, 'fan_out': 0, 'general_fan_out': 0}, {'cyclomatic_complexity': 3, 'nloc': 10, 'token_count': 68, 'name': '', 'long_name': '(m map[string]interface{},k string)(string,interface{},bool)', 'start_line': 183, 'end_line': 192, 'full_parameters': [], 'filename': '/home/dimi/Documents/Informatik_Studium/FSS/SoftEvo/DataCollection/FFS_SoftEvo/go-ipfs/core/commands/config.go', 'top_nesting_level': 0, 'length': 10, 'fan_in': 0, 'fan_out': 0, 'general_fan_out': 0}, {'cyclomatic_complexity': 6, 'nloc': 24, 'token_count': 166, 'name': 'scrubValue', 'long_name': 'scrubValue m map [ string ] interface { } , key [ ] string', 'start_line': 182, 'end_line': 221, 'full_parameters': ['m map [ string ] interface { }', ' key [ ] string'], 'filename': '/home/dimi/Documents/Informatik_Studium/FSS/SoftEvo/DataCollection/FFS_SoftEvo/go-ipfs/core/commands/config.go', 'top_nesting_level': 0, 'length': 40, 'fan_in': 0, 'fan_out': 0, 'general_fan_out': 0}, {'cyclomatic_complexity': 3, 'nloc': 11, 'token_count': 69, 'name': '', 'long_name': '(req cmds.Request,res cmds.Response)', 'start_line': 232, 'end_line': 243, 'full_parameters': [], 'filename': '/home/dimi/Documents/Informatik_Studium/FSS/SoftEvo/DataCollection/FFS_SoftEvo/go-ipfs/core/commands/config.go', 'top_nesting_level': 0, 'length': 12, 'fan_in': 0, 'fan_out': 0, 'general_fan_out': 0}, {'cyclomatic_complexity': 4, 'nloc': 19, 'token_count': 114, 'name': '', 'long_name': '(req cmds.Request,res cmds.Response)', 'start_line': 258, 'end_line': 278, 'full_parameters': [], 'filename': '/home/dimi/Documents/Informatik_Studium/FSS/SoftEvo/DataCollection/FFS_SoftEvo/go-ipfs/core/commands/config.go', 'top_nesting_level': 0, 'length': 21, 'fan_in': 0, 'fan_out': 0, 'general_fan_out': 0}, {'cyclomatic_complexity': 2, 'nloc': 10, 'token_count': 61, 'name': 'getConfig', 'long_name': 'getConfig r repo . Repo , key string', 'start_line': 281, 'end_line': 290, 'full_parameters': ['r repo . Repo', ' key string'], 'filename': '/home/dimi/Documents/Informatik_Studium/FSS/SoftEvo/DataCollection/FFS_SoftEvo/go-ipfs/core/commands/config.go', 'top_nesting_level': 0, 'length': 10, 'fan_in': 0, 'fan_out': 0, 'general_fan_out': 0}, {'cyclomatic_complexity': 2, 'nloc': 7, 'token_count': 58, 'name': 'setConfig', 'long_name': 'setConfig r repo . Repo , key string , value interface { }', 'start_line': 292, 'end_line': 298, 'full_parameters': ['r repo . Repo', ' key string', ' value interface { }'], 'filename': '/home/dimi/Documents/Informatik_Studium/FSS/SoftEvo/DataCollection/FFS_SoftEvo/go-ipfs/core/commands/config.go', 'top_nesting_level': 0, 'length': 7, 'fan_in': 0, 'fan_out': 0, 'general_fan_out': 0}, {'cyclomatic_complexity': 2, 'nloc': 9, 'token_count': 75, 'name': 'editConfig', 'long_name': 'editConfig filename string', 'start_line': 300, 'end_line': 309, 'full_parameters': ['filename string'], 'filename': '/home/dimi/Documents/Informatik_Studium/FSS/SoftEvo/DataCollection/FFS_SoftEvo/go-ipfs/core/commands/config.go', 'top_nesting_level': 0, 'length': 10, 'fan_in': 0, 'fan_out': 0, 'general_fan_out': 0}, {'cyclomatic_complexity': 5, 'nloc': 19, 'token_count': 132, 'name': 'replaceConfig', 'long_name': 'replaceConfig r repo . Repo , file io . Reader', 'start_line': 311, 'end_line': 333, 'full_parameters': ['r repo . Repo', ' file io . Reader'], 'filename': '/home/dimi/Documents/Informatik_Studium/FSS/SoftEvo/DataCollection/FFS_SoftEvo/go-ipfs/core/commands/config.go', 'top_nesting_level': 0, 'length': 23, 'fan_in': 0, 'fan_out': 0, 'general_fan_out': 0}]",489,2339,12,"[{'cyclomatic_complexity': 5, 'nloc': 15, 'token_count': 69, 'name': 'matchesGlobPrefix', 'long_name': 'matchesGlobPrefix key string , glob [ ] string', 'start_line': 159, 'end_line': 173, 'full_parameters': ['key string', ' glob [ ] string'], 'filename': '/home/dimi/Documents/Informatik_Studium/FSS/SoftEvo/DataCollection/FFS_SoftEvo/go-ipfs/core/commands/config.go', 'top_nesting_level': 0, 'length': 15, 'fan_in': 0, 'fan_out': 0, 'general_fan_out': 0}, {'cyclomatic_complexity': 1, 'nloc': 1, 'token_count': 25, 'name': 'scrubValue', 'long_name': 'scrubValue m map [ string ] interface { } , key [ ] string', 'start_line': 231, 'end_line': 231, 'full_parameters': ['m map [ string ] interface { }', ' key [ ] string'], 'filename': '/home/dimi/Documents/Informatik_Studium/FSS/SoftEvo/DataCollection/FFS_SoftEvo/go-ipfs/core/commands/config.go', 'top_nesting_level': 0, 'length': 1, 'fan_in': 0, 'fan_out': 0, 'general_fan_out': 0}, {'cyclomatic_complexity': 1, 'nloc': 1, 'token_count': 25, 'name': 'scrubOptionalValue', 'long_name': 'scrubOptionalValue m map [ string ] interface { } , key [ ] string', 'start_line': 236, 'end_line': 236, 'full_parameters': ['m map [ string ] interface { }', ' key [ ] string'], 'filename': '/home/dimi/Documents/Informatik_Studium/FSS/SoftEvo/DataCollection/FFS_SoftEvo/go-ipfs/core/commands/config.go', 'top_nesting_level': 0, 'length': 1, 'fan_in': 0, 'fan_out': 0, 'general_fan_out': 0}, {'cyclomatic_complexity': 1, 'nloc': 1, 'token_count': 20, 'name': 'scrubEither', 'long_name': 'scrubEither u interface { } , key [ ] string , okIfMissing bool', 'start_line': 240, 'end_line': 240, 'full_parameters': ['u interface { }', ' key [ ] string', ' okIfMissing bool'], 'filename': '/home/dimi/Documents/Informatik_Studium/FSS/SoftEvo/DataCollection/FFS_SoftEvo/go-ipfs/core/commands/config.go', 'top_nesting_level': 0, 'length': 1, 'fan_in': 0, 'fan_out': 0, 'general_fan_out': 0}, {'cyclomatic_complexity': 1, 'nloc': 1, 'token_count': 20, 'name': 'scrubValueInternal', 'long_name': 'scrubValueInternal v interface { } , key [ ] string , okIfMissing bool', 'start_line': 248, 'end_line': 248, 'full_parameters': ['v interface { }', ' key [ ] string', ' okIfMissing bool'], 'filename': '/home/dimi/Documents/Informatik_Studium/FSS/SoftEvo/DataCollection/FFS_SoftEvo/go-ipfs/core/commands/config.go', 'top_nesting_level': 0, 'length': 1, 'fan_in': 0, 'fan_out': 0, 'general_fan_out': 0}, {'cyclomatic_complexity': 1, 'nloc': 1, 'token_count': 28, 'name': 'scrubMapInternal', 'long_name': 'scrubMapInternal m map [ string ] interface { } , key [ ] string , okIfMissing bool', 'start_line': 255, 'end_line': 255, 'full_parameters': ['m map [ string ] interface { }', ' key [ ] string', ' okIfMissing bool'], 'filename': '/home/dimi/Documents/Informatik_Studium/FSS/SoftEvo/DataCollection/FFS_SoftEvo/go-ipfs/core/commands/config.go', 'top_nesting_level': 0, 'length': 1, 'fan_in': 0, 'fan_out': 0, 'general_fan_out': 0}, {'cyclomatic_complexity': 8, 'nloc': 30, 'token_count': 177, 'name': 'transformConfig', 'long_name': 'transformConfig configRoot string , configName string , transformer config . Transformer , dryRun bool', 'start_line': 438, 'end_line': 474, 'full_parameters': ['configRoot string', ' configName string', ' transformer config . Transformer', ' dryRun bool'], 'filename': '/home/dimi/Documents/Informatik_Studium/FSS/SoftEvo/DataCollection/FFS_SoftEvo/go-ipfs/core/commands/config.go', 'top_nesting_level': 0, 'length': 37, 'fan_in': 0, 'fan_out': 0, 'general_fan_out': 0}, {'cyclomatic_complexity': 2, 'nloc': 10, 'token_count': 61, 'name': 'getConfig', 'long_name': 'getConfig r repo . Repo , key string', 'start_line': 476, 'end_line': 485, 'full_parameters': ['r repo . Repo', ' key string'], 'filename': '/home/dimi/Documents/Informatik_Studium/FSS/SoftEvo/DataCollection/FFS_SoftEvo/go-ipfs/core/commands/config.go', 'top_nesting_level': 0, 'length': 10, 'fan_in': 0, 'fan_out': 0, 'general_fan_out': 0}, {'cyclomatic_complexity': 2, 'nloc': 7, 'token_count': 58, 'name': 'setConfig', 'long_name': 'setConfig r repo . Repo , key string , value interface { }', 'start_line': 487, 'end_line': 493, 'full_parameters': ['r repo . Repo', ' key string', ' value interface { }'], 'filename': '/home/dimi/Documents/Informatik_Studium/FSS/SoftEvo/DataCollection/FFS_SoftEvo/go-ipfs/core/commands/config.go', 'top_nesting_level': 0, 'length': 7, 'fan_in': 0, 'fan_out': 0, 'general_fan_out': 0}, {'cyclomatic_complexity': 2, 'nloc': 9, 'token_count': 75, 'name': 'editConfig', 'long_name': 'editConfig filename string', 'start_line': 495, 'end_line': 504, 'full_parameters': ['filename string'], 'filename': '/home/dimi/Documents/Informatik_Studium/FSS/SoftEvo/DataCollection/FFS_SoftEvo/go-ipfs/core/commands/config.go', 'top_nesting_level': 0, 'length': 10, 'fan_in': 0, 'fan_out': 0, 'general_fan_out': 0}, {'cyclomatic_complexity': 12, 'nloc': 38, 'token_count': 275, 'name': 'replaceConfig', 'long_name': 'replaceConfig r repo . Repo , file io . Reader', 'start_line': 506, 'end_line': 561, 'full_parameters': ['r repo . Repo', ' file io . Reader'], 'filename': '/home/dimi/Documents/Informatik_Studium/FSS/SoftEvo/DataCollection/FFS_SoftEvo/go-ipfs/core/commands/config.go', 'top_nesting_level': 0, 'length': 56, 'fan_in': 0, 'fan_out': 0, 'general_fan_out': 0}, {'cyclomatic_complexity': 5, 'nloc': 16, 'token_count': 116, 'name': 'getRemotePinningServices', 'long_name': 'getRemotePinningServices r repo . Repo', 'start_line': 563, 'end_line': 581, 'full_parameters': ['r repo . Repo'], 'filename': '/home/dimi/Documents/Informatik_Studium/FSS/SoftEvo/DataCollection/FFS_SoftEvo/go-ipfs/core/commands/config.go', 'top_nesting_level': 0, 'length': 19, 'fan_in': 0, 'fan_out': 0, 'general_fan_out': 0}]",206,540,1,81,81,"[{'timestamp': 1491058697.0, 'added_lines': 49, 'deleted_lines': 35, 'nloc': 293}, {'timestamp': 1508770239.0, 'added_lines': 2, 'deleted_lines': 1, 'nloc': 294}, {'timestamp': 1499331469.0, 'added_lines': 2, 'deleted_lines': 2, 'nloc': 294}, {'timestamp': 1511223906.0, 'added_lines': 1, 'deleted_lines': 1, 'nloc': 294}, {'timestamp': 1512365669.0, 'added_lines': 1, 'deleted_lines': 1, 'nloc': 294}, {'timestamp': 1504229011.0, 'added_lines': 54, 'deleted_lines': 0, 'nloc': 340}, {'timestamp': 1504647877.0, 'added_lines': 43, 'deleted_lines': 13, 'nloc': 365}, {'timestamp': 1506032038.0, 'added_lines': 4, 'deleted_lines': 8, 'nloc': 363}, {'timestamp': 1509888074.0, 'added_lines': 1, 'deleted_lines': 1, 'nloc': 363}, {'timestamp': 1511575295.0, 'added_lines': 11, 'deleted_lines': 11, 'nloc': 363}, {'timestamp': 1511576190.0, 'added_lines': 3, 'deleted_lines': 1, 'nloc': 365}, {'timestamp': 1513367731.0, 'added_lines': 5, 'deleted_lines': 0, 'nloc': 369}, {'timestamp': 1513444603.0, 'added_lines': 4, 'deleted_lines': 4, 'nloc': 369}, {'timestamp': 1513447186.0, 'added_lines': 4, 'deleted_lines': 32, 'nloc': 344}, {'timestamp': 1515554640.0, 'added_lines': 1, 'deleted_lines': 2, 'nloc': 343}, {'timestamp': 1511187070.0, 'added_lines': 1, 'deleted_lines': 1, 'nloc': 343}, {'timestamp': 1513436097.0, 'added_lines': 1, 'deleted_lines': 1, 'nloc': 343}, {'timestamp': 1513612261.0, 'added_lines': 1, 'deleted_lines': 1, 'nloc': 343}, {'timestamp': 1515277696.0, 'added_lines': 1, 'deleted_lines': 1, 'nloc': 343}, {'timestamp': 1521564637.0, 'added_lines': 20, 'deleted_lines': 1, 'nloc': 383}, {'timestamp': 1521399286.0, 'added_lines': 2, 'deleted_lines': 2, 'nloc': 343}, {'timestamp': 1528520460.0, 'added_lines': 1, 'deleted_lines': 1, 'nloc': 383}, {'timestamp': 1533587404.0, 'added_lines': 24, 'deleted_lines': 7, 'nloc': 400}, {'timestamp': 1532357069.0, 'added_lines': 1, 'deleted_lines': 1, 'nloc': 383}, {'timestamp': 1532365899.0, 'added_lines': 1, 'deleted_lines': 1, 'nloc': 383}, {'timestamp': 1532388583.0, 'added_lines': 1, 'deleted_lines': 1, 'nloc': 383}, {'timestamp': 1533809170.0, 'added_lines': 1, 'deleted_lines': 1, 'nloc': 383}, {'timestamp': 1533946888.0, 'added_lines': 1, 'deleted_lines': 1, 'nloc': 383}, {'timestamp': 1534072974.0, 'added_lines': 1, 'deleted_lines': 1, 'nloc': 383}, {'timestamp': 1534896611.0, 'added_lines': 2, 'deleted_lines': 2, 'nloc': 400}, {'timestamp': 1535255498.0, 'added_lines': 1, 'deleted_lines': 1, 'nloc': 400}, {'timestamp': 1535601896.0, 'added_lines': 1, 'deleted_lines': 1, 'nloc': 400}, {'timestamp': 1536388808.0, 'added_lines': 1, 'deleted_lines': 1, 'nloc': 400}, {'timestamp': 1537792589.0, 'added_lines': 1, 'deleted_lines': 1, 'nloc': 400}, {'timestamp': 1538544957.0, 'added_lines': 1, 'deleted_lines': 1, 'nloc': 400}, {'timestamp': 1538547366.0, 'added_lines': 1, 'deleted_lines': 1, 'nloc': 400}, {'timestamp': 1538662493.0, 'added_lines': 9, 'deleted_lines': 4, 'nloc': 404}, {'timestamp': 1538708341.0, 'added_lines': 3, 'deleted_lines': 3, 'nloc': 404}, {'timestamp': 1539850591.0, 'added_lines': 1, 'deleted_lines': 1, 'nloc': 404}, {'timestamp': 1536827968.0, 'added_lines': 63, 'deleted_lines': 11, 'nloc': 439}, {'timestamp': 1539141380.0, 'added_lines': 33, 'deleted_lines': 5, 'nloc': 467}, {'timestamp': 1540400358.0, 'added_lines': 1, 'deleted_lines': 1, 'nloc': 467}, {'timestamp': 1540489644.0, 'added_lines': 1, 'deleted_lines': 1, 'nloc': 467}, {'timestamp': 1541204121.0, 'added_lines': 1, 'deleted_lines': 1, 'nloc': 467}, {'timestamp': 1540565575.0, 'added_lines': 74, 'deleted_lines': 140, 'nloc': 405}, {'timestamp': 1540951823.0, 'added_lines': 3, 'deleted_lines': 3, 'nloc': 405}, {'timestamp': 1541470705.0, 'added_lines': 39, 'deleted_lines': 16, 'nloc': 424}, {'timestamp': 1543282933.0, 'added_lines': 1, 'deleted_lines': 1, 'nloc': 424}, {'timestamp': 1544225843.0, 'added_lines': 1, 'deleted_lines': 1, 'nloc': 424}, {'timestamp': 1544661332.0, 'added_lines': 1, 'deleted_lines': 1, 'nloc': 424}, {'timestamp': 1540556089.0, 'added_lines': 1, 'deleted_lines': 1, 'nloc': 424}, {'timestamp': 1542594282.0, 'added_lines': 7, 'deleted_lines': 3, 'nloc': 428}, {'timestamp': 1543031503.0, 'added_lines': 1, 'deleted_lines': 1, 'nloc': 428}, {'timestamp': 1543868676.0, 'added_lines': 3, 'deleted_lines': 2, 'nloc': 429}, {'timestamp': 1544737281.0, 'added_lines': 3, 'deleted_lines': 3, 'nloc': 429}, {'timestamp': 1544785510.0, 'added_lines': 9, 'deleted_lines': 14, 'nloc': 424}, {'timestamp': 1545323704.0, 'added_lines': 1, 'deleted_lines': 1, 'nloc': 424}, {'timestamp': 1540314216.0, 'added_lines': 9, 'deleted_lines': 6, 'nloc': 426}, {'timestamp': 1546553605.0, 'added_lines': 1, 'deleted_lines': 1, 'nloc': 426}, {'timestamp': 1547003974.0, 'added_lines': 1, 'deleted_lines': 1, 'nloc': 426}, {'timestamp': 1547152271.0, 'added_lines': 1, 'deleted_lines': 1, 'nloc': 426}, {'timestamp': 1548570418.0, 'added_lines': 9, 'deleted_lines': 8, 'nloc': 427}, {'timestamp': 1548866534.0, 'added_lines': 1, 'deleted_lines': 1, 'nloc': 427}, {'timestamp': 1549588289.0, 'added_lines': 1, 'deleted_lines': 1, 'nloc': 427}, {'timestamp': 1549903582.0, 'added_lines': 1, 'deleted_lines': 1, 'nloc': 427}, {'timestamp': 1550507829.0, 'added_lines': 2, 'deleted_lines': 2, 'nloc': 427}, {'timestamp': 1550546844.0, 'added_lines': 1, 'deleted_lines': 1, 'nloc': 427}, {'timestamp': 1550610741.0, 'added_lines': 1, 'deleted_lines': 1, 'nloc': 427}, {'timestamp': 1551138343.0, 'added_lines': 1, 'deleted_lines': 1, 'nloc': 427}, {'timestamp': 1551229859.0, 'added_lines': 1, 'deleted_lines': 1, 'nloc': 427}, {'timestamp': 1551299964.0, 'added_lines': 1, 'deleted_lines': 1, 'nloc': 427}, {'timestamp': 1551471469.0, 'added_lines': 1, 'deleted_lines': 1, 'nloc': 427}, {'timestamp': 1551551196.0, 'added_lines': 4, 'deleted_lines': 4, 'nloc': 427}, {'timestamp': 1553697989.0, 'added_lines': 6, 'deleted_lines': 8, 'nloc': 426}, {'timestamp': 1557554420.0, 'added_lines': 18, 'deleted_lines': 19, 'nloc': 425}, {'timestamp': 1595277534.0, 'added_lines': 2, 'deleted_lines': 1, 'nloc': 427}, {'timestamp': 1607477553.0, 'added_lines': 75, 'deleted_lines': 5, 'nloc': 471}, {'timestamp': 1611878324.0, 'added_lines': 103, 'deleted_lines': 77, 'nloc': 490}, {'timestamp': 1616604074.0, 'added_lines': 2, 'deleted_lines': 2, 'nloc': 490}, {'timestamp': 1617132175.0, 'added_lines': 2, 'deleted_lines': 3, 'nloc': 489}, {'timestamp': 1619116241.0, 'added_lines': 1, 'deleted_lines': 1, 'nloc': 489}]","{'blocks/blockstore/caching.go': 1, 'blocks/blockstore/util/remove.go': 2, 'cmd/ipfs/daemon.go': 33, 'cmd/ipfs/init.go': 54, 'cmd/ipfs/ipfs.go': 25, 'cmd/ipfs/main.go': 46, 'cmd/ipfs/main_test.go': 4, 'cmd/ipfswatch/main.go': 33, 'cmd/seccat/seccat.go': 19, None: 13, 'commands/channelmarshaler.go': 1, 'commands/cli/cmd_suggestion.go': 1, 'commands/cli/helptext.go': 2, 'commands/cli/helptext_test.go': 2, 'commands/cli/parse.go': 2, 'commands/cli/parse_test.go': 2, 'commands/command.go': 13, 'commands/command_test.go': 7, 'commands/http/client.go': 2, 'commands/http/handler.go': 2, 'commands/http/multifilereader.go': 2, 'commands/http/multifilereader_test.go': 2, 'commands/http/parse.go': 2, 'commands/reqlog.go': 2, 'commands/request.go': 26, 'commands/response.go': 11, 'commands/response_test.go': 7, 'core/bootstrap.go': 28, 'core/commands/active.go': 28, 'core/commands/add.go': 34, 'core/commands/bitswap.go': 35, 'core/commands/block.go': 34, 'core/commands/bootstrap.go': 45, 'core/commands/cat.go': 30, 'core/commands/commands.go': 29, 'core/commands/dag/dag.go': 40, 'core/commands/dht.go': 36, 'core/commands/diag.go': 24, 'core/commands/dns.go': 27, 'core/commands/e/error.go': 1, 'core/commands/external.go': 24, 'core/commands/files/files.go': 9, 'core/commands/filestore.go': 27, 'core/commands/get.go': 37, 'core/commands/helptext_test.go': 24, 'core/commands/id.go': 36, 'core/commands/ipns.go': 11, 'core/commands/keystore.go': 29, 'core/commands/log.go': 27, 'core/commands/ls.go': 34, 'core/commands/mount_nofuse.go': 24, 'core/commands/mount_unix.go': 46, 'core/commands/mount_windows.go': 23, 'core/commands/name.go': 10, 'core/commands/object/diff.go': 26, 'core/commands/object/object.go': 41, 'core/commands/object/patch.go': 33, 'core/commands/p2p.go': 35, 'core/commands/pin.go': 36, 'core/commands/ping.go': 33, 'core/commands/publish.go': 11, 'core/commands/pubsub.go': 32, 'core/commands/refs.go': 35, 'core/commands/repo.go': 49, 'core/commands/resolve.go': 35, 'core/commands/root.go': 30, 'core/commands/shutdown.go': 26, 'core/commands/stat.go': 33, 'core/commands/swarm.go': 47, 'core/commands/sysdiag.go': 31, 'core/commands/tar.go': 39, 'core/commands/unixfs/ls.go': 33, 'core/commands/unixfs/unixfs.go': 23, 'core/commands/version.go': 30, 'core/core_test.go': 24, 'core/corehttp/commands.go': 44, 'core/corehttp/gateway.go': 21, 'core/coreunix/add.go': 31, 'core/coreunix/add_test.go': 41, 'core/coreunix/metadata_test.go': 23, 'exchange/bitswap/bitswap_test.go': 5, 'exchange/bitswap/decision/engine_test.go': 4, 'exchange/bitswap/message/message_test.go': 3, 'exchange/bitswap/message/pb/Makefile': 1, 'exchange/bitswap/testnet/network_test.go': 4, 'exchange/bitswap/testnet/peernet.go': 4, 'exchange/reprovide/reprovide_test.go': 18, 'fuse/ipns/common.go': 20, 'fuse/node/mount_test.go': 17, 'importer/balanced/balanced_test.go': 4, 'importer/chunk/rabin_test.go': 2, 'importer/helpers/dagbuilder.go': 8, 'importer/importer.go': 8, 'merkledag/utils/utils_test.go': 3, 'mfs/repub_test.go': 4, 'namesys/dns.go': 16, 'namesys/interface.go': 17, 'namesys/ipns_select_test.go': 3, 'namesys/proquint.go': 16, 'namesys/republisher/repub_test.go': 20, 'package.json': 44, 'repo/config/identity.go': 1, 'routing/offline/offline_test.go': 4, 'test/integration/addcat_test.go': 23, 'test/integration/bench_cat_test.go': 22, 'test/integration/bitswap_wo_routing_test.go': 19, 'test/integration/three_legged_cat_test.go': 22, 'test/sharness/t0600-issues-and-regressions-online.sh': 1, 'core/bootstrap_test.go': 26, 'core/commands/dht_test.go': 15, 'core/commands/get_test.go': 24, 'core/core.go': 35, 'core/corehttp/gateway_test.go': 30, 'core/corehttp/metrics_test.go': 17, 'core/mock/mock.go': 27, 'exchange/bitswap/decision/bench_test.go': 3, 'exchange/bitswap/decision/peer_request_queue_test.go': 3, 'exchange/bitswap/message/message.go': 3, 'exchange/bitswap/network/interface.go': 3, 'exchange/bitswap/network/ipfs_impl.go': 3, 'exchange/bitswap/testnet/interface.go': 3, 'exchange/bitswap/testnet/virtual.go': 4, 'exchange/bitswap/testutils.go': 3, 'fuse/ipns/ipns_test.go': 17, 'fuse/readonly/ipfs_test.go': 25, 'namesys/publisher_test.go': 16, 'namesys/resolve_test.go': 18, 'p2p/p2p.go': 16, 'p2p/registry.go': 6, 'repo/config/bootstrap_peers.go': 3, 'routing/mock/centralized_client.go': 2, 'routing/mock/centralized_server.go': 2, 'routing/mock/centralized_test.go': 2, 'routing/mock/interface.go': 2, 'routing/none/none_client.go': 2, 'test/integration/bench_test.go': 13, 'assets/assets.go': 20, 'blocks/blockstore/arc_cache.go': 1, 'blocks/blockstore/arc_cache_test.go': 1, 'blocks/blockstore/blockstore.go': 1, 'blocks/blockstore/blockstore_test.go': 1, 'blocks/blockstore/bloom_cache.go': 1, 'blocks/blockstore/bloom_cache_test.go': 1, 'blocks/blocksutil/block_generator.go': 1, 'blockservice/blockservice.go': 2, 'blockservice/blockservice_test.go': 2, 'blockservice/test/blocks_test.go': 2, 'core/builder.go': 33, 'core/commands/ipnsps.go': 7, 'core/coreapi/coreapi.go': 12, 'core/coreapi/interface/interface.go': 1, 'core/coreapi/unixfs.go': 23, 'core/coreapi/unixfs_test.go': 26, 'core/coredag/cbor.go': 6, 'core/coredag/dagpb.go': 16, 'core/coredag/dagtransl.go': 5, 'core/coredag/raw.go': 16, 'core/corehttp/corehttp.go': 9, 'core/corehttp/gateway_handler.go': 24, 'core/corerepo/gc.go': 23, 'core/corerepo/pinning.go': 8, 'core/coreunix/metadata.go': 21, 'core/pathresolver.go': 16, 'exchange/bitswap/bitswap.go': 2, 'exchange/bitswap/decision/engine.go': 2, 'exchange/bitswap/decision/ledger.go': 2, 'exchange/bitswap/decision/peer_request_queue.go': 2, 'exchange/bitswap/get.go': 2, 'exchange/bitswap/notifications/notifications.go': 2, 'exchange/bitswap/notifications/notifications_test.go': 2, 'exchange/bitswap/session.go': 2, 'exchange/bitswap/session_test.go': 2, 'exchange/bitswap/stat.go': 2, 'exchange/bitswap/wantlist/wantlist.go': 2, 'exchange/bitswap/wantlist/wantlist_test.go': 2, 'exchange/bitswap/wantmanager.go': 2, 'exchange/bitswap/workers.go': 2, 'exchange/interface.go': 1, 'exchange/offline/offline.go': 1, 'exchange/offline/offline_test.go': 1, 'exchange/reprovide/providers.go': 16, 'exchange/reprovide/reprovide.go': 15, 'filestore/filestore.go': 9, 'filestore/filestore_test.go': 16, 'filestore/fsrefstore.go': 9, 'filestore/util.go': 9, 'fuse/ipns/ipns_unix.go': 22, 'fuse/readonly/readonly_unix.go': 22, 'importer/balanced/builder.go': 2, 'importer/chunk/splitting_test.go': 1, 'importer/helpers/helpers.go': 2, 'importer/importer_test.go': 2, 'importer/trickle/trickle_test.go': 3, 'importer/trickle/trickledag.go': 3, 'merkledag/batch.go': 1, 'merkledag/coding.go': 3, 'merkledag/merkledag.go': 3, 'merkledag/merkledag_test.go': 3, 'merkledag/node.go': 2, 'merkledag/node_test.go': 2, 'merkledag/raw.go': 2, 'merkledag/traverse/traverse.go': 2, 'merkledag/traverse/traverse_test.go': 2, 'merkledag/utils/diff.go': 2, 'merkledag/utils/diffenum.go': 2, 'merkledag/utils/diffenum_test.go': 2, 'merkledag/utils/utils.go': 2, 'mfs/dir.go': 3, 'mfs/file.go': 3, 'mfs/mfs_test.go': 4, 'mfs/ops.go': 2, 'mfs/system.go': 3, 'namesys/namesys.go': 18, 'namesys/publisher.go': 21, 'namesys/pubsub.go': 2, 'namesys/pubsub_test.go': 1, 'namesys/republisher/repub.go': 16, 'namesys/routing.go': 18, 'path/path.go': 2, 'path/resolver.go': 1, 'path/resolver_test.go': 1, 'pin/gc/gc.go': 16, 'pin/pin.go': 17, 'pin/pin_test.go': 17, 'pin/set.go': 16, 'pin/set_test.go': 16, 'plugin/ipld.go': 5, 'plugin/loader/initializer.go': 4, 'plugin/plugins/git/git.go': 5, 'repo/config/init.go': 4, 'repo/fsrepo/fsrepo.go': 29, 'repo/fsrepo/lock/lock.go': 1, 'repo/fsrepo/serialize/serialize.go': 3, 'repo/mock.go': 27, 'repo/repo.go': 27, 'routing/offline/offline.go': 1, 'tar/format.go': 21, 'test/dependencies/ma-pipe-unidir/main.go': 8, 'thirdparty/ds-help/key.go': 1, 'thirdparty/pollEndpoint/main.go': 10, 'thirdparty/posinfo/posinfo.go': 1, 'unixfs/archive/archive.go': 2, 'unixfs/archive/tar/writer.go': 2, 'unixfs/hamt/hamt.go': 2, 'unixfs/io/dagreader.go': 2, 'unixfs/io/dirbuilder.go': 2, 'unixfs/io/resolve.go': 2, 'unixfs/mod/dagmodifier.go': 2, 'unixfs/mod/dagmodifier_test.go': 2, 'unixfs/test/utils.go': 3, 'repo/config/profile.go': 7, 'docs/config.md': 4, 'test/sharness/t0021-config.sh': 5, 'commands/legacy/command.go': 9, 'commands/legacy/legacy.go': 9, 'commands/legacy/legacy_test.go': 10, 'commands/legacy/request.go': 11, 'commands/legacy/response.go': 10, 'commands/legacy/responseemitter.go': 4, 'core/commands/env.go': 8, 'TODO.md': 2, 'core/commands/commands_test.go': 20, 'test/sharness/t0110-gateway.sh': 1, 'test/sharness/t0410-api-add.sh': 1, 'core/coreapi/object.go': 21, 'fuse/mount/fuse.go': 4, 'fuse/mount/mount.go': 6, 'keystore/keystore_test.go': 5, 'namesys/dns_test.go': 6, 'namesys/namesys_test.go': 22, 'repo/config/config.go': 1, 'unixfs/io/pbdagreader.go': 2, 'unixfs/unixfs.go': 1, 'blocks/blockstoreutil/remove.go': 8, 'blockservice/test/mock.go': 1, 'cmd/ipfs/util/ulimit.go': 5, 'cmd/ipfs/util/ulimit_freebsd.go': 2, 'cmd/ipfs/util/ulimit_unix.go': 2, 'cmd/seccat/util.go': 5, 'core/commands/files.go': 34, 'core/coreapi/block.go': 8, 'core/coreapi/block_test.go': 2, 'core/coreapi/dag.go': 4, 'core/coreapi/dag_test.go': 2, 'core/coreapi/interface/coreapi.go': 3, 'core/coreapi/interface/dag.go': 3, 'core/coreapi/interface/object.go': 3, 'core/coreapi/interface/options/block.go': 2, 'core/coreapi/interface/options/dag.go': 3, 'core/coreapi/interface/path.go': 11, 'core/coreapi/interface/unixfs.go': 8, 'core/coreapi/key.go': 16, 'core/coreapi/name.go': 16, 'core/coreapi/pin.go': 16, 'core/corehttp/logs.go': 5, 'fuse/ipns/link_unix.go': 2, 'fuse/node/mount_darwin.go': 2, 'fuse/node/mount_unix.go': 6, 'keystore/keystore.go': 5, 'merkledag/errservice.go': 1, 'merkledag/readonly.go': 1, 'merkledag/readonly_test.go': 1, 'merkledag/rwservice.go': 1, 'merkledag/session.go': 1, 'merkledag/test/utils.go': 1, 'namesys/ipns_validate_test.go': 1, 'namesys/validator.go': 1, 'path/resolver/resolver.go': 1, 'path/resolver/resolver_test.go': 1, 'plugin/loader/load.go': 3, 'repo/fsrepo/datastores.go': 7, 'thirdparty/verifbs/verifbs.go': 8, 'thirdparty/verifcid/validate.go': 1, 'thirdparty/verifcid/validate_test.go': 1, 'unixfs/hamt/hamt_stress_test.go': 1, 'unixfs/hamt/hamt_test.go': 1, 'repo/fsrepo/misc.go': 24, 'cmd/ipfs/Rules.mk': 1, 'core/corehttp/option_test.go': 2, 'docs/releases.md': 1, 'docs/windows.md': 1, 'repo/fsrepo/config_test.go': 23, 'repo/fsrepo/fsrepo_test.go': 23, 'repo/version.go': 1, 'test/bench/bench_cli_ipfs_add/main.go': 25, 'test/bench/offline_add/main.go': 25, 'core/commands/urlstore.go': 25, 'core/coreapi/path.go': 19, 'core/coreunix/cat.go': 5, 'mfs/fd.go': 1, 'core/coreapi/interface/key.go': 6, 'core/coreapi/name_test.go': 12, 'core/pathresolver_test.go': 14, 'dagutils/diff.go': 16, 'dagutils/diffenum.go': 14, 'dagutils/diffenum_test.go': 14, 'dagutils/utils.go': 15, 'dagutils/utils_test.go': 14, 'namesys/base.go': 15, 'namesys/cache.go': 14, 'namesys/ipns_resolver_validation_test.go': 15, 'thirdparty/cidv0v1/blockstore.go': 7, 'core/commands/cmdenv/env.go': 28, 'core/commands/name/ipns.go': 23, 'core/commands/name/publish.go': 19, 'core/commands/name/ipnsps.go': 20, 'core/commands/name/name.go': 15, 'core/coreapi/dht.go': 12, 'core/coreapi/dht_test.go': 4, 'core/coreapi/interface/dht.go': 7, 'p2p/listener.go': 10, 'p2p/local.go': 10, 'p2p/remote.go': 11, 'p2p/stream.go': 11, 'core/coreapi/interface/swarm.go': 6, 'core/coreapi/swarm.go': 12, 'core/commands/cid.go': 17, 'core/coreapi/unixfile.go': 9, 'cmd/ipfs/dnsresolve_test.go': 5, 'core/coreapi/interface/options/unixfs.go': 5, 'core/coreapi/interface/pubsub.go': 4, 'core/coreapi/pubsub.go': 12, 'test/sharness/t0180-pubsub.sh': 1, 'keystore/memkeystore.go': 3, 'test/dependencies/iptb/iptb.go': 11, 'commands/context.go': 18, 'core/corehttp/proxy.go': 7, 'core/commands/cmdenv/file.go': 4, 'core/coreapi/test/api_test.go': 8, 'core/coreapi/interface/tests/name.go': 3, 'core/coreapi/interface/tests/unixfs.go': 3, 'core/commands/cmdenv/cidbase.go': 9, 'core/corehttp/ipns_hostname.go': 5, 'plugin/daemon.go': 5, 'plugin/loader/loader.go': 6, 'filestore/pb/dataobj.pb.go': 2, 'pin/internal/pb/header.pb.go': 2, 'plugin/plugins/badgerds/badgerds.go': 3, 'plugin/plugins/flatfs/flatfs.go': 3, 'plugin/plugins/levelds/levelds.go': 2, 'core/corerepo/stat.go': 2, 'core/commands/cmdenv/cidbase_test.go': 1, 'core/corehttp/metrics.go': 1, 'core/corehttp/proxy_test.go': 1, 'plugin/tracer.go': 1, 'thirdparty/notifier/notifier.go': 1, 'core/corehttp/mutex_profile.go': 1, 'provider/queue.go': 1, 'provider/queue_test.go': 1, 'README.md': 2, 'go.mod': 4, 'go.sum': 4, 'package-list.json': 1, 'cmd/ipfs/rotate.go': 1, 'core/commands/extra.go': 1, '.circleci/config.yml': 1, 'core/commands/pin/pin.go': 2, 'core/commands/pin/remotepin.go': 2, 'test/sharness/t0700-remotepin.sh': 2, 'cmd/ipfs/pinmfs.go': 1, 'cmd/ipfs/pinmfs_test.go': 1, 'core/commands/config_test.go': 1, 'core/commands/stat_dht.go': 1}","('cmd/ipfs/init.go', 0.6666666666666666, 0.6506024096385542)"
core/commands/dht.go,685,4566,42,"[{'cyclomatic_complexity': 2, 'nloc': 9, 'token_count': 40, 'name': '', 'long_name': '()', 'start_line': 79, 'end_line': 87, 'full_parameters': [], 'filename': '/home/dimi/Documents/Informatik_Studium/FSS/SoftEvo/DataCollection/FFS_SoftEvo/go-ipfs/core/commands/dht.go', 'top_nesting_level': 0, 'length': 9, 'fan_in': 0, 'fan_out': 0, 'general_fan_out': 0}, {'cyclomatic_complexity': 2, 'nloc': 6, 'token_count': 21, 'name': '', 'long_name': '()', 'start_line': 92, 'end_line': 97, 'full_parameters': [], 'filename': '/home/dimi/Documents/Informatik_Studium/FSS/SoftEvo/DataCollection/FFS_SoftEvo/go-ipfs/core/commands/dht.go', 'top_nesting_level': 0, 'length': 6, 'fan_in': 0, 'fan_out': 0, 'general_fan_out': 0}, {'cyclomatic_complexity': 4, 'nloc': 24, 'token_count': 178, 'name': '', 'long_name': '(req cmds.Request,res cmds.Response)', 'start_line': 55, 'end_line': 98, 'full_parameters': [], 'filename': '/home/dimi/Documents/Informatik_Studium/FSS/SoftEvo/DataCollection/FFS_SoftEvo/go-ipfs/core/commands/dht.go', 'top_nesting_level': 0, 'length': 44, 'fan_in': 0, 'fan_out': 0, 'general_fan_out': 0}, {'cyclomatic_complexity': 2, 'nloc': 5, 'token_count': 45, 'name': '', 'long_name': '(obj*notif.QueryEvent,out io.Writer,verbose bool)', 'start_line': 107, 'end_line': 111, 'full_parameters': [], 'filename': '/home/dimi/Documents/Informatik_Studium/FSS/SoftEvo/DataCollection/FFS_SoftEvo/go-ipfs/core/commands/dht.go', 'top_nesting_level': 0, 'length': 5, 'fan_in': 0, 'fan_out': 0, 'general_fan_out': 0}, {'cyclomatic_complexity': 2, 'nloc': 10, 'token_count': 83, 'name': '', 'long_name': '(v interface{})(io.Reader,error)', 'start_line': 114, 'end_line': 125, 'full_parameters': [], 'filename': '/home/dimi/Documents/Informatik_Studium/FSS/SoftEvo/DataCollection/FFS_SoftEvo/go-ipfs/core/commands/dht.go', 'top_nesting_level': 0, 'length': 12, 'fan_in': 0, 'fan_out': 0, 'general_fan_out': 0}, {'cyclomatic_complexity': 2, 'nloc': 15, 'token_count': 82, 'name': '', 'long_name': '(res cmds.Response)(io.Reader,error)', 'start_line': 100, 'end_line': 132, 'full_parameters': [], 'filename': '/home/dimi/Documents/Informatik_Studium/FSS/SoftEvo/DataCollection/FFS_SoftEvo/go-ipfs/core/commands/dht.go', 'top_nesting_level': 0, 'length': 33, 'fan_in': 0, 'fan_out': 0, 'general_fan_out': 0}, {'cyclomatic_complexity': 2, 'nloc': 6, 'token_count': 21, 'name': '', 'long_name': '()', 'start_line': 186, 'end_line': 191, 'full_parameters': [], 'filename': '/home/dimi/Documents/Informatik_Studium/FSS/SoftEvo/DataCollection/FFS_SoftEvo/go-ipfs/core/commands/dht.go', 'top_nesting_level': 0, 'length': 6, 'fan_in': 0, 'fan_out': 0, 'general_fan_out': 0}, {'cyclomatic_complexity': 2, 'nloc': 10, 'token_count': 52, 'name': '', 'long_name': '()', 'start_line': 193, 'end_line': 202, 'full_parameters': [], 'filename': '/home/dimi/Documents/Informatik_Studium/FSS/SoftEvo/DataCollection/FFS_SoftEvo/go-ipfs/core/commands/dht.go', 'top_nesting_level': 0, 'length': 10, 'fan_in': 0, 'fan_out': 0, 'general_fan_out': 0}, {'cyclomatic_complexity': 6, 'nloc': 33, 'token_count': 236, 'name': '', 'long_name': '(req cmds.Request,res cmds.Response)', 'start_line': 150, 'end_line': 203, 'full_parameters': [], 'filename': '/home/dimi/Documents/Informatik_Studium/FSS/SoftEvo/DataCollection/FFS_SoftEvo/go-ipfs/core/commands/dht.go', 'top_nesting_level': 0, 'length': 54, 'fan_in': 0, 'fan_out': 0, 'general_fan_out': 0}, {'cyclomatic_complexity': 2, 'nloc': 5, 'token_count': 34, 'name': '', 'long_name': '(obj*notif.QueryEvent,out io.Writer,verbose bool)', 'start_line': 213, 'end_line': 217, 'full_parameters': [], 'filename': '/home/dimi/Documents/Informatik_Studium/FSS/SoftEvo/DataCollection/FFS_SoftEvo/go-ipfs/core/commands/dht.go', 'top_nesting_level': 0, 'length': 5, 'fan_in': 0, 'fan_out': 0, 'general_fan_out': 0}, {'cyclomatic_complexity': 4, 'nloc': 12, 'token_count': 79, 'name': '', 'long_name': '(obj*notif.QueryEvent,out io.Writer,verbose bool)', 'start_line': 218, 'end_line': 229, 'full_parameters': [], 'filename': '/home/dimi/Documents/Informatik_Studium/FSS/SoftEvo/DataCollection/FFS_SoftEvo/go-ipfs/core/commands/dht.go', 'top_nesting_level': 0, 'length': 12, 'fan_in': 0, 'fan_out': 0, 'general_fan_out': 0}, {'cyclomatic_complexity': 2, 'nloc': 9, 'token_count': 63, 'name': '', 'long_name': '(v interface{})(io.Reader,error)', 'start_line': 232, 'end_line': 241, 'full_parameters': [], 'filename': '/home/dimi/Documents/Informatik_Studium/FSS/SoftEvo/DataCollection/FFS_SoftEvo/go-ipfs/core/commands/dht.go', 'top_nesting_level': 0, 'length': 10, 'fan_in': 0, 'fan_out': 0, 'general_fan_out': 0}, {'cyclomatic_complexity': 2, 'nloc': 17, 'token_count': 108, 'name': '', 'long_name': '(res cmds.Response)(io.Reader,error)', 'start_line': 205, 'end_line': 248, 'full_parameters': [], 'filename': '/home/dimi/Documents/Informatik_Studium/FSS/SoftEvo/DataCollection/FFS_SoftEvo/go-ipfs/core/commands/dht.go', 'top_nesting_level': 0, 'length': 44, 'fan_in': 0, 'fan_out': 0, 'general_fan_out': 0}, {'cyclomatic_complexity': 2, 'nloc': 6, 'token_count': 21, 'name': '', 'long_name': '()', 'start_line': 307, 'end_line': 312, 'full_parameters': [], 'filename': '/home/dimi/Documents/Informatik_Studium/FSS/SoftEvo/DataCollection/FFS_SoftEvo/go-ipfs/core/commands/dht.go', 'top_nesting_level': 0, 'length': 6, 'fan_in': 0, 'fan_out': 0, 'general_fan_out': 0}, {'cyclomatic_complexity': 3, 'nloc': 15, 'token_count': 81, 'name': '', 'long_name': '()', 'start_line': 314, 'end_line': 328, 'full_parameters': [], 'filename': '/home/dimi/Documents/Informatik_Studium/FSS/SoftEvo/DataCollection/FFS_SoftEvo/go-ipfs/core/commands/dht.go', 'top_nesting_level': 0, 'length': 15, 'fan_in': 0, 'fan_out': 0, 'general_fan_out': 0}, {'cyclomatic_complexity': 7, 'nloc': 36, 'token_count': 244, 'name': '', 'long_name': '(req cmds.Request,res cmds.Response)', 'start_line': 265, 'end_line': 329, 'full_parameters': [], 'filename': '/home/dimi/Documents/Informatik_Studium/FSS/SoftEvo/DataCollection/FFS_SoftEvo/go-ipfs/core/commands/dht.go', 'top_nesting_level': 0, 'length': 65, 'fan_in': 0, 'fan_out': 0, 'general_fan_out': 0}, {'cyclomatic_complexity': 2, 'nloc': 5, 'token_count': 34, 'name': '', 'long_name': '(obj*notif.QueryEvent,out io.Writer,verbose bool)', 'start_line': 339, 'end_line': 343, 'full_parameters': [], 'filename': '/home/dimi/Documents/Informatik_Studium/FSS/SoftEvo/DataCollection/FFS_SoftEvo/go-ipfs/core/commands/dht.go', 'top_nesting_level': 0, 'length': 5, 'fan_in': 0, 'fan_out': 0, 'general_fan_out': 0}, {'cyclomatic_complexity': 2, 'nloc': 9, 'token_count': 63, 'name': '', 'long_name': '(v interface{})(io.Reader,error)', 'start_line': 346, 'end_line': 355, 'full_parameters': [], 'filename': '/home/dimi/Documents/Informatik_Studium/FSS/SoftEvo/DataCollection/FFS_SoftEvo/go-ipfs/core/commands/dht.go', 'top_nesting_level': 0, 'length': 10, 'fan_in': 0, 'fan_out': 0, 'general_fan_out': 0}, {'cyclomatic_complexity': 2, 'nloc': 16, 'token_count': 102, 'name': '', 'long_name': '(res cmds.Response)(io.Reader,error)', 'start_line': 331, 'end_line': 362, 'full_parameters': [], 'filename': '/home/dimi/Documents/Informatik_Studium/FSS/SoftEvo/DataCollection/FFS_SoftEvo/go-ipfs/core/commands/dht.go', 'top_nesting_level': 0, 'length': 32, 'fan_in': 0, 'fan_out': 0, 'general_fan_out': 0}, {'cyclomatic_complexity': 3, 'nloc': 9, 'token_count': 55, 'name': 'provideKeys', 'long_name': 'provideKeys ctx context . Context , r routing . IpfsRouting , cids [ ] * cid . Cid', 'start_line': 367, 'end_line': 375, 'full_parameters': ['ctx context . Context', ' r routing . IpfsRouting', ' cids [ ] * cid . Cid'], 'filename': '/home/dimi/Documents/Informatik_Studium/FSS/SoftEvo/DataCollection/FFS_SoftEvo/go-ipfs/core/commands/dht.go', 'top_nesting_level': 0, 'length': 9, 'fan_in': 0, 'fan_out': 0, 'general_fan_out': 0}, {'cyclomatic_complexity': 6, 'nloc': 21, 'token_count': 132, 'name': 'provideKeysRec', 'long_name': 'provideKeysRec ctx context . Context , r routing . IpfsRouting , dserv dag . DAGService , cids [ ] * cid . Cid', 'start_line': 377, 'end_line': 401, 'full_parameters': ['ctx context . Context', ' r routing . IpfsRouting', ' dserv dag . DAGService', ' cids [ ] * cid . Cid'], 'filename': '/home/dimi/Documents/Informatik_Studium/FSS/SoftEvo/DataCollection/FFS_SoftEvo/go-ipfs/core/commands/dht.go', 'top_nesting_level': 0, 'length': 25, 'fan_in': 0, 'fan_out': 0, 'general_fan_out': 0}, {'cyclomatic_complexity': 2, 'nloc': 6, 'token_count': 21, 'name': '', 'long_name': '()', 'start_line': 440, 'end_line': 445, 'full_parameters': [], 'filename': '/home/dimi/Documents/Informatik_Studium/FSS/SoftEvo/DataCollection/FFS_SoftEvo/go-ipfs/core/commands/dht.go', 'top_nesting_level': 0, 'length': 6, 'fan_in': 0, 'fan_out': 0, 'general_fan_out': 0}, {'cyclomatic_complexity': 2, 'nloc': 15, 'token_count': 88, 'name': '', 'long_name': '()', 'start_line': 447, 'end_line': 462, 'full_parameters': [], 'filename': '/home/dimi/Documents/Informatik_Studium/FSS/SoftEvo/DataCollection/FFS_SoftEvo/go-ipfs/core/commands/dht.go', 'top_nesting_level': 0, 'length': 16, 'fan_in': 0, 'fan_out': 0, 'general_fan_out': 0}, {'cyclomatic_complexity': 4, 'nloc': 23, 'token_count': 165, 'name': '', 'long_name': '(req cmds.Request,res cmds.Response)', 'start_line': 415, 'end_line': 463, 'full_parameters': [], 'filename': '/home/dimi/Documents/Informatik_Studium/FSS/SoftEvo/DataCollection/FFS_SoftEvo/go-ipfs/core/commands/dht.go', 'top_nesting_level': 0, 'length': 49, 'fan_in': 0, 'fan_out': 0, 'general_fan_out': 0}, {'cyclomatic_complexity': 2, 'nloc': 6, 'token_count': 47, 'name': '', 'long_name': '(obj*notif.QueryEvent,out io.Writer,verbose bool)', 'start_line': 474, 'end_line': 479, 'full_parameters': [], 'filename': '/home/dimi/Documents/Informatik_Studium/FSS/SoftEvo/DataCollection/FFS_SoftEvo/go-ipfs/core/commands/dht.go', 'top_nesting_level': 0, 'length': 6, 'fan_in': 0, 'fan_out': 0, 'general_fan_out': 0}, {'cyclomatic_complexity': 2, 'nloc': 9, 'token_count': 63, 'name': '', 'long_name': '(v interface{})(io.Reader,error)', 'start_line': 481, 'end_line': 490, 'full_parameters': [], 'filename': '/home/dimi/Documents/Informatik_Studium/FSS/SoftEvo/DataCollection/FFS_SoftEvo/go-ipfs/core/commands/dht.go', 'top_nesting_level': 0, 'length': 10, 'fan_in': 0, 'fan_out': 0, 'general_fan_out': 0}, {'cyclomatic_complexity': 2, 'nloc': 16, 'token_count': 102, 'name': '', 'long_name': '(res cmds.Response)(io.Reader,error)', 'start_line': 465, 'end_line': 497, 'full_parameters': [], 'filename': '/home/dimi/Documents/Informatik_Studium/FSS/SoftEvo/DataCollection/FFS_SoftEvo/go-ipfs/core/commands/dht.go', 'top_nesting_level': 0, 'length': 33, 'fan_in': 0, 'fan_out': 0, 'general_fan_out': 0}, {'cyclomatic_complexity': 2, 'nloc': 6, 'token_count': 21, 'name': '', 'long_name': '()', 'start_line': 547, 'end_line': 552, 'full_parameters': [], 'filename': '/home/dimi/Documents/Informatik_Studium/FSS/SoftEvo/DataCollection/FFS_SoftEvo/go-ipfs/core/commands/dht.go', 'top_nesting_level': 0, 'length': 6, 'fan_in': 0, 'fan_out': 0, 'general_fan_out': 0}, {'cyclomatic_complexity': 2, 'nloc': 15, 'token_count': 84, 'name': '', 'long_name': '()', 'start_line': 554, 'end_line': 568, 'full_parameters': [], 'filename': '/home/dimi/Documents/Informatik_Studium/FSS/SoftEvo/DataCollection/FFS_SoftEvo/go-ipfs/core/commands/dht.go', 'top_nesting_level': 0, 'length': 15, 'fan_in': 0, 'fan_out': 0, 'general_fan_out': 0}, {'cyclomatic_complexity': 4, 'nloc': 23, 'token_count': 163, 'name': '', 'long_name': '(req cmds.Request,res cmds.Response)', 'start_line': 522, 'end_line': 569, 'full_parameters': [], 'filename': '/home/dimi/Documents/Informatik_Studium/FSS/SoftEvo/DataCollection/FFS_SoftEvo/go-ipfs/core/commands/dht.go', 'top_nesting_level': 0, 'length': 48, 'fan_in': 0, 'fan_out': 0, 'general_fan_out': 0}, {'cyclomatic_complexity': 2, 'nloc': 7, 'token_count': 47, 'name': '', 'long_name': '(obj*notif.QueryEvent,out io.Writer,verbose bool)', 'start_line': 580, 'end_line': 586, 'full_parameters': [], 'filename': '/home/dimi/Documents/Informatik_Studium/FSS/SoftEvo/DataCollection/FFS_SoftEvo/go-ipfs/core/commands/dht.go', 'top_nesting_level': 0, 'length': 7, 'fan_in': 0, 'fan_out': 0, 'general_fan_out': 0}, {'cyclomatic_complexity': 2, 'nloc': 9, 'token_count': 63, 'name': '', 'long_name': '(v interface{})(io.Reader,error)', 'start_line': 588, 'end_line': 599, 'full_parameters': [], 'filename': '/home/dimi/Documents/Informatik_Studium/FSS/SoftEvo/DataCollection/FFS_SoftEvo/go-ipfs/core/commands/dht.go', 'top_nesting_level': 0, 'length': 12, 'fan_in': 0, 'fan_out': 0, 'general_fan_out': 0}, {'cyclomatic_complexity': 2, 'nloc': 16, 'token_count': 102, 'name': '', 'long_name': '(res cmds.Response)(io.Reader,error)', 'start_line': 571, 'end_line': 606, 'full_parameters': [], 'filename': '/home/dimi/Documents/Informatik_Studium/FSS/SoftEvo/DataCollection/FFS_SoftEvo/go-ipfs/core/commands/dht.go', 'top_nesting_level': 0, 'length': 36, 'fan_in': 0, 'fan_out': 0, 'general_fan_out': 0}, {'cyclomatic_complexity': 2, 'nloc': 6, 'token_count': 21, 'name': '', 'long_name': '()', 'start_line': 667, 'end_line': 672, 'full_parameters': [], 'filename': '/home/dimi/Documents/Informatik_Studium/FSS/SoftEvo/DataCollection/FFS_SoftEvo/go-ipfs/core/commands/dht.go', 'top_nesting_level': 0, 'length': 6, 'fan_in': 0, 'fan_out': 0, 'general_fan_out': 0}, {'cyclomatic_complexity': 2, 'nloc': 10, 'token_count': 60, 'name': '', 'long_name': '()', 'start_line': 674, 'end_line': 683, 'full_parameters': [], 'filename': '/home/dimi/Documents/Informatik_Studium/FSS/SoftEvo/DataCollection/FFS_SoftEvo/go-ipfs/core/commands/dht.go', 'top_nesting_level': 0, 'length': 10, 'fan_in': 0, 'fan_out': 0, 'general_fan_out': 0}, {'cyclomatic_complexity': 4, 'nloc': 24, 'token_count': 173, 'name': '', 'long_name': '(req cmds.Request,res cmds.Response)', 'start_line': 640, 'end_line': 684, 'full_parameters': [], 'filename': '/home/dimi/Documents/Informatik_Studium/FSS/SoftEvo/DataCollection/FFS_SoftEvo/go-ipfs/core/commands/dht.go', 'top_nesting_level': 0, 'length': 45, 'fan_in': 0, 'fan_out': 0, 'general_fan_out': 0}, {'cyclomatic_complexity': 2, 'nloc': 5, 'token_count': 34, 'name': '', 'long_name': '(obj*notif.QueryEvent,out io.Writer,verbose bool)', 'start_line': 694, 'end_line': 698, 'full_parameters': [], 'filename': '/home/dimi/Documents/Informatik_Studium/FSS/SoftEvo/DataCollection/FFS_SoftEvo/go-ipfs/core/commands/dht.go', 'top_nesting_level': 0, 'length': 5, 'fan_in': 0, 'fan_out': 0, 'general_fan_out': 0}, {'cyclomatic_complexity': 1, 'nloc': 3, 'token_count': 34, 'name': '', 'long_name': '(obj*notif.QueryEvent,out io.Writer,verbose bool)', 'start_line': 699, 'end_line': 701, 'full_parameters': [], 'filename': '/home/dimi/Documents/Informatik_Studium/FSS/SoftEvo/DataCollection/FFS_SoftEvo/go-ipfs/core/commands/dht.go', 'top_nesting_level': 0, 'length': 3, 'fan_in': 0, 'fan_out': 0, 'general_fan_out': 0}, {'cyclomatic_complexity': 2, 'nloc': 9, 'token_count': 63, 'name': '', 'long_name': '(v interface{})(io.Reader,error)', 'start_line': 704, 'end_line': 714, 'full_parameters': [], 'filename': '/home/dimi/Documents/Informatik_Studium/FSS/SoftEvo/DataCollection/FFS_SoftEvo/go-ipfs/core/commands/dht.go', 'top_nesting_level': 0, 'length': 11, 'fan_in': 0, 'fan_out': 0, 'general_fan_out': 0}, {'cyclomatic_complexity': 2, 'nloc': 17, 'token_count': 108, 'name': '', 'long_name': '(res cmds.Response)(io.Reader,error)', 'start_line': 686, 'end_line': 721, 'full_parameters': [], 'filename': '/home/dimi/Documents/Informatik_Studium/FSS/SoftEvo/DataCollection/FFS_SoftEvo/go-ipfs/core/commands/dht.go', 'top_nesting_level': 0, 'length': 36, 'fan_in': 0, 'fan_out': 0, 'general_fan_out': 0}, {'cyclomatic_complexity': 19, 'nloc': 48, 'token_count': 272, 'name': 'printEvent', 'long_name': 'printEvent obj * notif . QueryEvent , out io . Writer , verbose bool , override pfuncMap', 'start_line': 729, 'end_line': 778, 'full_parameters': ['obj * notif . QueryEvent', ' out io . Writer', ' verbose bool', ' override pfuncMap'], 'filename': '/home/dimi/Documents/Informatik_Studium/FSS/SoftEvo/DataCollection/FFS_SoftEvo/go-ipfs/core/commands/dht.go', 'top_nesting_level': 0, 'length': 50, 'fan_in': 0, 'fan_out': 0, 'general_fan_out': 0}, {'cyclomatic_complexity': 3, 'nloc': 12, 'token_count': 89, 'name': 'escapeDhtKey', 'long_name': 'escapeDhtKey s string', 'start_line': 780, 'end_line': 791, 'full_parameters': ['s string'], 'filename': '/home/dimi/Documents/Informatik_Studium/FSS/SoftEvo/DataCollection/FFS_SoftEvo/go-ipfs/core/commands/dht.go', 'top_nesting_level': 0, 'length': 12, 'fan_in': 0, 'fan_out': 0, 'general_fan_out': 0}]",602,3834,8,"[{'cyclomatic_complexity': 3, 'nloc': 15, 'token_count': 72, 'name': '', 'long_name': '()', 'start_line': 97, 'end_line': 112, 'full_parameters': [], 'filename': '/home/dimi/Documents/Informatik_Studium/FSS/SoftEvo/DataCollection/FFS_SoftEvo/go-ipfs/core/commands/dht.go', 'top_nesting_level': 0, 'length': 16, 'fan_in': 0, 'fan_out': 0, 'general_fan_out': 0}, {'cyclomatic_complexity': 2, 'nloc': 10, 'token_count': 51, 'name': '', 'long_name': '()', 'start_line': 181, 'end_line': 190, 'full_parameters': [], 'filename': '/home/dimi/Documents/Informatik_Studium/FSS/SoftEvo/DataCollection/FFS_SoftEvo/go-ipfs/core/commands/dht.go', 'top_nesting_level': 0, 'length': 10, 'fan_in': 0, 'fan_out': 0, 'general_fan_out': 0}, {'cyclomatic_complexity': 3, 'nloc': 14, 'token_count': 77, 'name': '', 'long_name': '()', 'start_line': 292, 'end_line': 305, 'full_parameters': [], 'filename': '/home/dimi/Documents/Informatik_Studium/FSS/SoftEvo/DataCollection/FFS_SoftEvo/go-ipfs/core/commands/dht.go', 'top_nesting_level': 0, 'length': 14, 'fan_in': 0, 'fan_out': 0, 'general_fan_out': 0}, {'cyclomatic_complexity': 3, 'nloc': 9, 'token_count': 54, 'name': 'provideKeys', 'long_name': 'provideKeys ctx context . Context , r routing . Routing , cids [ ] cid . Cid', 'start_line': 333, 'end_line': 341, 'full_parameters': ['ctx context . Context', ' r routing . Routing', ' cids [ ] cid . Cid'], 'filename': '/home/dimi/Documents/Informatik_Studium/FSS/SoftEvo/DataCollection/FFS_SoftEvo/go-ipfs/core/commands/dht.go', 'top_nesting_level': 0, 'length': 9, 'fan_in': 0, 'fan_out': 0, 'general_fan_out': 0}, {'cyclomatic_complexity': 6, 'nloc': 21, 'token_count': 131, 'name': 'provideKeysRec', 'long_name': 'provideKeysRec ctx context . Context , r routing . Routing , dserv ipld . DAGService , cids [ ] cid . Cid', 'start_line': 343, 'end_line': 367, 'full_parameters': ['ctx context . Context', ' r routing . Routing', ' dserv ipld . DAGService', ' cids [ ] cid . Cid'], 'filename': '/home/dimi/Documents/Informatik_Studium/FSS/SoftEvo/DataCollection/FFS_SoftEvo/go-ipfs/core/commands/dht.go', 'top_nesting_level': 0, 'length': 25, 'fan_in': 0, 'fan_out': 0, 'general_fan_out': 0}, {'cyclomatic_complexity': 2, 'nloc': 16, 'token_count': 94, 'name': '', 'long_name': '()', 'start_line': 400, 'end_line': 416, 'full_parameters': [], 'filename': '/home/dimi/Documents/Informatik_Studium/FSS/SoftEvo/DataCollection/FFS_SoftEvo/go-ipfs/core/commands/dht.go', 'top_nesting_level': 0, 'length': 17, 'fan_in': 0, 'fan_out': 0, 'general_fan_out': 0}, {'cyclomatic_complexity': 2, 'nloc': 16, 'token_count': 94, 'name': '', 'long_name': '()', 'start_line': 484, 'end_line': 499, 'full_parameters': [], 'filename': '/home/dimi/Documents/Informatik_Studium/FSS/SoftEvo/DataCollection/FFS_SoftEvo/go-ipfs/core/commands/dht.go', 'top_nesting_level': 0, 'length': 16, 'fan_in': 0, 'fan_out': 0, 'general_fan_out': 0}, {'cyclomatic_complexity': 2, 'nloc': 10, 'token_count': 61, 'name': '', 'long_name': '()', 'start_line': 592, 'end_line': 601, 'full_parameters': [], 'filename': '/home/dimi/Documents/Informatik_Studium/FSS/SoftEvo/DataCollection/FFS_SoftEvo/go-ipfs/core/commands/dht.go', 'top_nesting_level': 0, 'length': 10, 'fan_in': 0, 'fan_out': 0, 'general_fan_out': 0}]",-83,-732,-34,111,111,"[{'timestamp': 1507304579.0, 'added_lines': 1, 'deleted_lines': 1, 'nloc': 685}, {'timestamp': 1508243375.0, 'added_lines': 5, 'deleted_lines': 0, 'nloc': 689}, {'timestamp': 1508424715.0, 'added_lines': 1, 'deleted_lines': 1, 'nloc': 689}, {'timestamp': 1509224406.0, 'added_lines': 1, 'deleted_lines': 1, 'nloc': 689}, {'timestamp': 1491058697.0, 'added_lines': 119, 'deleted_lines': 155, 'nloc': 660}, {'timestamp': 1499331469.0, 'added_lines': 7, 'deleted_lines': 7, 'nloc': 660}, {'timestamp': 1511223906.0, 'added_lines': 2, 'deleted_lines': 2, 'nloc': 660}, {'timestamp': 1511245249.0, 'added_lines': 1, 'deleted_lines': 1, 'nloc': 660}, {'timestamp': 1511307577.0, 'added_lines': 29, 'deleted_lines': 6, 'nloc': 682}, {'timestamp': 1511062375.0, 'added_lines': 1, 'deleted_lines': 1, 'nloc': 682}, {'timestamp': 1512365669.0, 'added_lines': 7, 'deleted_lines': 7, 'nloc': 682}, {'timestamp': 1511187070.0, 'added_lines': 1, 'deleted_lines': 1, 'nloc': 682}, {'timestamp': 1513436097.0, 'added_lines': 1, 'deleted_lines': 1, 'nloc': 682}, {'timestamp': 1513612261.0, 'added_lines': 1, 'deleted_lines': 1, 'nloc': 682}, {'timestamp': 1515277696.0, 'added_lines': 1, 'deleted_lines': 1, 'nloc': 682}, {'timestamp': 1516838128.0, 'added_lines': 6, 'deleted_lines': 6, 'nloc': 682}, {'timestamp': 1516838710.0, 'added_lines': 16, 'deleted_lines': 5, 'nloc': 693}, {'timestamp': 1516911711.0, 'added_lines': 2, 'deleted_lines': 1, 'nloc': 694}, {'timestamp': 1516932179.0, 'added_lines': 12, 'deleted_lines': 12, 'nloc': 694}, {'timestamp': 1517105039.0, 'added_lines': 1, 'deleted_lines': 1, 'nloc': 694}, {'timestamp': 1517255734.0, 'added_lines': 2, 'deleted_lines': 2, 'nloc': 694}, {'timestamp': 1517453697.0, 'added_lines': 5, 'deleted_lines': 5, 'nloc': 694}, {'timestamp': 1519761835.0, 'added_lines': 1, 'deleted_lines': 1, 'nloc': 694}, {'timestamp': 1519999272.0, 'added_lines': 1, 'deleted_lines': 1, 'nloc': 694}, {'timestamp': 1521399286.0, 'added_lines': 1, 'deleted_lines': 1, 'nloc': 694}, {'timestamp': 1525408792.0, 'added_lines': 5, 'deleted_lines': 5, 'nloc': 694}, {'timestamp': 1528131220.0, 'added_lines': 1, 'deleted_lines': 1, 'nloc': 694}, {'timestamp': 1528268108.0, 'added_lines': 4, 'deleted_lines': 4, 'nloc': 694}, {'timestamp': 1528520460.0, 'added_lines': 8, 'deleted_lines': 8, 'nloc': 694}, {'timestamp': 1529984485.0, 'added_lines': 5, 'deleted_lines': 5, 'nloc': 694}, {'timestamp': 1530945222.0, 'added_lines': 27, 'deleted_lines': 30, 'nloc': 688}, {'timestamp': 1531779409.0, 'added_lines': 4, 'deleted_lines': 4, 'nloc': 688}, {'timestamp': 1532764253.0, 'added_lines': 1, 'deleted_lines': 1, 'nloc': 688}, {'timestamp': 1532847462.0, 'added_lines': 1, 'deleted_lines': 1, 'nloc': 688}, {'timestamp': 1533180255.0, 'added_lines': 1, 'deleted_lines': 1, 'nloc': 688}, {'timestamp': 1533500571.0, 'added_lines': 2, 'deleted_lines': 2, 'nloc': 688}, {'timestamp': 1533618653.0, 'added_lines': 2, 'deleted_lines': 2, 'nloc': 688}, {'timestamp': 1533779477.0, 'added_lines': 6, 'deleted_lines': 6, 'nloc': 688}, {'timestamp': 1533946888.0, 'added_lines': 1, 'deleted_lines': 1, 'nloc': 688}, {'timestamp': 1534115707.0, 'added_lines': 6, 'deleted_lines': 6, 'nloc': 688}, {'timestamp': 1534195762.0, 'added_lines': 2, 'deleted_lines': 2, 'nloc': 688}, {'timestamp': 1534347022.0, 'added_lines': 6, 'deleted_lines': 6, 'nloc': 688}, {'timestamp': 1534896611.0, 'added_lines': 9, 'deleted_lines': 9, 'nloc': 688}, {'timestamp': 1534903410.0, 'added_lines': 5, 'deleted_lines': 5, 'nloc': 688}, {'timestamp': 1535601896.0, 'added_lines': 2, 'deleted_lines': 2, 'nloc': 688}, {'timestamp': 1536388808.0, 'added_lines': 5, 'deleted_lines': 5, 'nloc': 688}, {'timestamp': 1536718784.0, 'added_lines': 9, 'deleted_lines': 9, 'nloc': 688}, {'timestamp': 1536723292.0, 'added_lines': 2, 'deleted_lines': 2, 'nloc': 688}, {'timestamp': 1537790637.0, 'added_lines': 4, 'deleted_lines': 4, 'nloc': 688}, {'timestamp': 1537792589.0, 'added_lines': 6, 'deleted_lines': 6, 'nloc': 688}, {'timestamp': 1538544957.0, 'added_lines': 5, 'deleted_lines': 5, 'nloc': 688}, {'timestamp': 1538694687.0, 'added_lines': 2, 'deleted_lines': 2, 'nloc': 688}, {'timestamp': 1538695953.0, 'added_lines': 2, 'deleted_lines': 2, 'nloc': 688}, {'timestamp': 1538662493.0, 'added_lines': 28, 'deleted_lines': 16, 'nloc': 697}, {'timestamp': 1538773916.0, 'added_lines': 5, 'deleted_lines': 5, 'nloc': 697}, {'timestamp': 1539176817.0, 'added_lines': 5, 'deleted_lines': 5, 'nloc': 697}, {'timestamp': 1539357340.0, 'added_lines': 2, 'deleted_lines': 2, 'nloc': 697}, {'timestamp': 1539850591.0, 'added_lines': 1, 'deleted_lines': 1, 'nloc': 697}, {'timestamp': 1540400358.0, 'added_lines': 6, 'deleted_lines': 6, 'nloc': 697}, {'timestamp': 1539965302.0, 'added_lines': 22, 'deleted_lines': 20, 'nloc': 698}, {'timestamp': 1540410565.0, 'added_lines': 2, 'deleted_lines': 2, 'nloc': 698}, {'timestamp': 1540418491.0, 'added_lines': 2, 'deleted_lines': 2, 'nloc': 698}, {'timestamp': 1540603818.0, 'added_lines': 3, 'deleted_lines': 3, 'nloc': 698}, {'timestamp': 1540916861.0, 'added_lines': 1, 'deleted_lines': 1, 'nloc': 698}, {'timestamp': 1540609052.0, 'added_lines': 121, 'deleted_lines': 216, 'nloc': 607}, {'timestamp': 1540701691.0, 'added_lines': 43, 'deleted_lines': 85, 'nloc': 573}, {'timestamp': 1541189794.0, 'added_lines': 2, 'deleted_lines': 2, 'nloc': 573}, {'timestamp': 1541204121.0, 'added_lines': 9, 'deleted_lines': 9, 'nloc': 573}, {'timestamp': 1541903826.0, 'added_lines': 5, 'deleted_lines': 5, 'nloc': 573}, {'timestamp': 1543443696.0, 'added_lines': 2, 'deleted_lines': 2, 'nloc': 573}, {'timestamp': 1544225843.0, 'added_lines': 6, 'deleted_lines': 6, 'nloc': 573}, {'timestamp': 1544661332.0, 'added_lines': 1, 'deleted_lines': 1, 'nloc': 573}, {'timestamp': 1545096286.0, 'added_lines': 5, 'deleted_lines': 5, 'nloc': 573}, {'timestamp': 1540556089.0, 'added_lines': 1, 'deleted_lines': 1, 'nloc': 573}, {'timestamp': 1547003974.0, 'added_lines': 5, 'deleted_lines': 5, 'nloc': 573}, {'timestamp': 1547152271.0, 'added_lines': 1, 'deleted_lines': 1, 'nloc': 573}, {'timestamp': 1547499910.0, 'added_lines': 3, 'deleted_lines': 3, 'nloc': 573}, {'timestamp': 1548271418.0, 'added_lines': 7, 'deleted_lines': 7, 'nloc': 573}, {'timestamp': 1548866534.0, 'added_lines': 1, 'deleted_lines': 1, 'nloc': 573}, {'timestamp': 1549588289.0, 'added_lines': 6, 'deleted_lines': 6, 'nloc': 573}, {'timestamp': 1549903582.0, 'added_lines': 1, 'deleted_lines': 1, 'nloc': 573}, {'timestamp': 1550185115.0, 'added_lines': 2, 'deleted_lines': 2, 'nloc': 573}, {'timestamp': 1550507829.0, 'added_lines': 7, 'deleted_lines': 7, 'nloc': 573}, {'timestamp': 1550610741.0, 'added_lines': 1, 'deleted_lines': 1, 'nloc': 573}, {'timestamp': 1550711994.0, 'added_lines': 2, 'deleted_lines': 2, 'nloc': 573}, {'timestamp': 1550723346.0, 'added_lines': 6, 'deleted_lines': 6, 'nloc': 573}, {'timestamp': 1551138343.0, 'added_lines': 1, 'deleted_lines': 1, 'nloc': 573}, {'timestamp': 1551229859.0, 'added_lines': 6, 'deleted_lines': 6, 'nloc': 573}, {'timestamp': 1551299964.0, 'added_lines': 3, 'deleted_lines': 3, 'nloc': 573}, {'timestamp': 1551471469.0, 'added_lines': 1, 'deleted_lines': 1, 'nloc': 573}, {'timestamp': 1551466490.0, 'added_lines': 23, 'deleted_lines': 18, 'nloc': 578}, {'timestamp': 1551644494.0, 'added_lines': 0, 'deleted_lines': 3, 'nloc': 570}, {'timestamp': 1551754781.0, 'added_lines': 5, 'deleted_lines': 5, 'nloc': 575}, {'timestamp': 1551551196.0, 'added_lines': 11, 'deleted_lines': 11, 'nloc': 575}, {'timestamp': 1556610991.0, 'added_lines': 26, 'deleted_lines': 28, 'nloc': 577}, {'timestamp': 1556611140.0, 'added_lines': 7, 'deleted_lines': 2, 'nloc': 582}, {'timestamp': 1556611570.0, 'added_lines': 13, 'deleted_lines': 0, 'nloc': 590}, {'timestamp': 1557554420.0, 'added_lines': 34, 'deleted_lines': 35, 'nloc': 574}, {'timestamp': 1558459378.0, 'added_lines': 8, 'deleted_lines': 8, 'nloc': 589}, {'timestamp': 1559060517.0, 'added_lines': 59, 'deleted_lines': 61, 'nloc': 587}, {'timestamp': 1562894485.0, 'added_lines': 1, 'deleted_lines': 1, 'nloc': 587}, {'timestamp': 1564107966.0, 'added_lines': 1, 'deleted_lines': 1, 'nloc': 587}, {'timestamp': 1572976217.0, 'added_lines': 3, 'deleted_lines': 3, 'nloc': 588}, {'timestamp': 1572976453.0, 'added_lines': 14, 'deleted_lines': 10, 'nloc': 593}, {'timestamp': 1576349311.0, 'added_lines': 2, 'deleted_lines': 2, 'nloc': 593}, {'timestamp': 1583531397.0, 'added_lines': 1, 'deleted_lines': 1, 'nloc': 593}, {'timestamp': 1586818692.0, 'added_lines': 6, 'deleted_lines': 1, 'nloc': 597}, {'timestamp': 1586824923.0, 'added_lines': 18, 'deleted_lines': 16, 'nloc': 599}, {'timestamp': 1598768175.0, 'added_lines': 9, 'deleted_lines': 15, 'nloc': 592}, {'timestamp': 1598768175.0, 'added_lines': 9, 'deleted_lines': 15, 'nloc': 592}, {'timestamp': 1617641312.0, 'added_lines': 34, 'deleted_lines': 22, 'nloc': 602}]","{'core/bootstrap.go': 29, 'core/bootstrap_test.go': 26, 'core/commands/dht_test.go': 25, 'core/commands/id.go': 58, 'core/commands/pubsub.go': 52, 'core/core.go': 72, 'core/corehttp/gateway.go': 39, 'core/corehttp/gateway_test.go': 57, 'core/corehttp/metrics_test.go': 37, 'core/mock/mock.go': 38, 'exchange/bitswap/bitswap_test.go': 16, 'exchange/bitswap/decision/bench_test.go': 9, 'exchange/bitswap/decision/engine_test.go': 12, 'exchange/bitswap/decision/peer_request_queue_test.go': 9, 'exchange/bitswap/network/ipfs_impl.go': 11, 'exchange/bitswap/testnet/interface.go': 8, 'exchange/bitswap/testnet/network_test.go': 14, 'exchange/bitswap/testnet/peernet.go': 17, 'exchange/bitswap/testnet/virtual.go': 14, 'exchange/bitswap/testutils.go': 15, 'exchange/reprovide/reprovide_test.go': 40, 'fuse/ipns/ipns_test.go': 37, 'fuse/node/mount_test.go': 38, 'fuse/readonly/ipfs_test.go': 57, 'mfs/repub_test.go': 13, 'namesys/publisher_test.go': 39, 'namesys/republisher/repub_test.go': 54, 'namesys/resolve_test.go': 56, 'p2p/p2p.go': 28, 'package.json': 73, 'routing/mock/centralized_client.go': 6, 'routing/mock/centralized_server.go': 6, 'routing/mock/centralized_test.go': 5, 'routing/mock/interface.go': 6, 'routing/none/none_client.go': 5, 'routing/offline/offline_test.go': 7, 'test/integration/addcat_test.go': 41, 'test/integration/bench_cat_test.go': 40, 'test/integration/bench_test.go': 20, 'test/integration/bitswap_wo_routing_test.go': 41, 'test/integration/three_legged_cat_test.go': 40, 'thirdparty/ipfsaddr/ipfsaddr.go': 2, 'core/commands/swarm.go': 53, 'blocks/blockstore/caching.go': 1, 'blocks/blockstore/util/remove.go': 4, 'cmd/ipfs/daemon.go': 38, 'cmd/ipfs/init.go': 39, 'cmd/ipfs/ipfs.go': 29, 'cmd/ipfs/main.go': 40, 'cmd/ipfs/main_test.go': 4, 'cmd/ipfswatch/main.go': 20, 'cmd/seccat/seccat.go': 29, None: 36, 'commands/channelmarshaler.go': 1, 'commands/cli/cmd_suggestion.go': 1, 'commands/cli/helptext.go': 3, 'commands/cli/helptext_test.go': 2, 'commands/cli/parse.go': 2, 'commands/cli/parse_test.go': 2, 'commands/command.go': 19, 'commands/command_test.go': 10, 'commands/http/client.go': 2, 'commands/http/handler.go': 2, 'commands/http/multifilereader.go': 2, 'commands/http/multifilereader_test.go': 2, 'commands/http/parse.go': 2, 'commands/reqlog.go': 1, 'commands/request.go': 24, 'commands/response.go': 14, 'commands/response_test.go': 10, 'core/commands/active.go': 25, 'core/commands/add.go': 53, 'core/commands/bitswap.go': 65, 'core/commands/block.go': 43, 'core/commands/bootstrap.go': 34, 'core/commands/cat.go': 38, 'core/commands/commands.go': 32, 'core/commands/config.go': 36, 'core/commands/dag/dag.go': 66, 'core/commands/diag.go': 23, 'core/commands/dns.go': 32, 'core/commands/e/error.go': 1, 'core/commands/external.go': 23, 'core/commands/files/files.go': 13, 'core/commands/filestore.go': 38, 'core/commands/get.go': 69, 'core/commands/helptext_test.go': 29, 'core/commands/ipns.go': 22, 'core/commands/keystore.go': 36, 'core/commands/log.go': 29, 'core/commands/ls.go': 67, 'core/commands/mount_nofuse.go': 23, 'core/commands/mount_unix.go': 35, 'core/commands/mount_windows.go': 22, 'core/commands/name.go': 10, 'core/commands/object/diff.go': 29, 'core/commands/object/object.go': 68, 'core/commands/object/patch.go': 38, 'core/commands/p2p.go': 41, 'core/commands/pin.go': 70, 'core/commands/ping.go': 49, 'core/commands/publish.go': 23, 'core/commands/refs.go': 66, 'core/commands/repo.go': 53, 'core/commands/resolve.go': 62, 'core/commands/root.go': 34, 'core/commands/shutdown.go': 28, 'core/commands/stat.go': 43, 'core/commands/sysdiag.go': 31, 'core/commands/tar.go': 61, 'core/commands/unixfs/ls.go': 59, 'core/commands/unixfs/unixfs.go': 23, 'core/commands/version.go': 26, 'core/core_test.go': 18, 'core/corehttp/commands.go': 63, 'core/coreunix/add.go': 62, 'core/coreunix/add_test.go': 59, 'core/coreunix/metadata_test.go': 55, 'exchange/bitswap/message/message_test.go': 5, 'exchange/bitswap/message/pb/Makefile': 1, 'fuse/ipns/common.go': 48, 'importer/balanced/balanced_test.go': 11, 'importer/chunk/rabin_test.go': 3, 'importer/helpers/dagbuilder.go': 15, 'importer/importer.go': 14, 'merkledag/utils/utils_test.go': 7, 'namesys/dns.go': 42, 'namesys/interface.go': 45, 'namesys/ipns_select_test.go': 5, 'namesys/proquint.go': 42, 'repo/config/identity.go': 3, 'core/commands/get_test.go': 30, 'exchange/bitswap/message/message.go': 9, 'exchange/bitswap/network/interface.go': 9, 'p2p/registry.go': 12, 'repo/config/bootstrap_peers.go': 11, 'blocks/blockstore/arc_cache.go': 3, 'blocks/blockstore/arc_cache_test.go': 3, 'blocks/blockstore/blockstore.go': 4, 'blocks/blockstore/blockstore_test.go': 3, 'blocks/blockstore/bloom_cache_test.go': 3, 'blockservice/blockservice_test.go': 8, 'blockservice/test/blocks_test.go': 9, 'core/builder.go': 57, 'exchange/offline/offline_test.go': 4, 'filestore/filestore.go': 28, 'filestore/filestore_test.go': 47, 'filestore/fsrefstore.go': 27, 'filestore/util.go': 25, 'merkledag/test/utils.go': 9, 'merkledag/utils/utils.go': 10, 'mfs/mfs_test.go': 20, 'namesys/namesys.go': 54, 'namesys/namesys_test.go': 57, 'namesys/publisher.go': 57, 'namesys/pubsub.go': 9, 'namesys/pubsub_test.go': 8, 'namesys/republisher/repub.go': 50, 'pin/pin.go': 51, 'pin/pin_test.go': 48, 'pin/set_test.go': 47, 'repo/fsrepo/datastores.go': 17, 'repo/fsrepo/fsrepo.go': 26, 'repo/fsrepo/fsrepo_test.go': 20, 'repo/repo.go': 23, 'routing/offline/offline.go': 4, 'thirdparty/datastore2/datastore_closer.go': 3, 'thirdparty/datastore2/delayed.go': 3, 'thirdparty/datastore2/threadsafe.go': 3, 'thirdparty/ds-help/key.go': 3, 'assets/assets.go': 46, 'blocks/blockstore/bloom_cache.go': 2, 'blocks/blocksutil/block_generator.go': 2, 'blockservice/blockservice.go': 9, 'core/commands/ipnsps.go': 9, 'core/coreapi/coreapi.go': 26, 'core/coreapi/interface/interface.go': 2, 'core/coreapi/unixfs.go': 50, 'core/coreapi/unixfs_test.go': 40, 'core/coredag/cbor.go': 18, 'core/coredag/dagpb.go': 44, 'core/coredag/dagtransl.go': 14, 'core/coredag/raw.go': 44, 'core/corehttp/corehttp.go': 15, 'core/corehttp/gateway_handler.go': 59, 'core/corerepo/gc.go': 50, 'core/corerepo/pinning.go': 20, 'core/coreunix/metadata.go': 49, 'core/pathresolver.go': 48, 'exchange/bitswap/bitswap.go': 8, 'exchange/bitswap/decision/engine.go': 8, 'exchange/bitswap/decision/ledger.go': 7, 'exchange/bitswap/decision/peer_request_queue.go': 7, 'exchange/bitswap/get.go': 7, 'exchange/bitswap/notifications/notifications.go': 4, 'exchange/bitswap/notifications/notifications_test.go': 4, 'exchange/bitswap/session.go': 8, 'exchange/bitswap/session_test.go': 6, 'exchange/bitswap/stat.go': 4, 'exchange/bitswap/wantlist/wantlist.go': 4, 'exchange/bitswap/wantlist/wantlist_test.go': 4, 'exchange/bitswap/wantmanager.go': 7, 'exchange/bitswap/workers.go': 7, 'exchange/interface.go': 2, 'exchange/offline/offline.go': 3, 'exchange/reprovide/providers.go': 48, 'exchange/reprovide/reprovide.go': 30, 'fuse/ipns/ipns_unix.go': 55, 'fuse/readonly/readonly_unix.go': 57, 'importer/balanced/builder.go': 5, 'importer/chunk/splitting_test.go': 2, 'importer/helpers/helpers.go': 7, 'importer/importer_test.go': 9, 'importer/trickle/trickle_test.go': 10, 'importer/trickle/trickledag.go': 7, 'merkledag/batch.go': 2, 'merkledag/coding.go': 6, 'merkledag/merkledag.go': 7, 'merkledag/merkledag_test.go': 9, 'merkledag/node.go': 6, 'merkledag/node_test.go': 6, 'merkledag/raw.go': 5, 'merkledag/traverse/traverse.go': 5, 'merkledag/traverse/traverse_test.go': 6, 'merkledag/utils/diff.go': 6, 'merkledag/utils/diffenum.go': 5, 'merkledag/utils/diffenum_test.go': 6, 'mfs/dir.go': 14, 'mfs/file.go': 16, 'mfs/ops.go': 12, 'mfs/system.go': 17, 'namesys/routing.go': 52, 'path/path.go': 4, 'path/resolver.go': 5, 'path/resolver_test.go': 4, 'pin/gc/gc.go': 51, 'pin/set.go': 45, 'plugin/ipld.go': 14, 'plugin/loader/initializer.go': 11, 'plugin/plugins/git/git.go': 13, 'repo/config/init.go': 8, 'repo/fsrepo/lock/lock.go': 3, 'repo/fsrepo/serialize/serialize.go': 4, 'repo/mock.go': 17, 'tar/format.go': 55, 'test/dependencies/ma-pipe-unidir/main.go': 10, 'thirdparty/pollEndpoint/main.go': 16, 'thirdparty/posinfo/posinfo.go': 3, 'unixfs/archive/archive.go': 6, 'unixfs/archive/tar/writer.go': 7, 'unixfs/hamt/hamt.go': 7, 'unixfs/io/dagreader.go': 7, 'unixfs/io/dirbuilder.go': 5, 'unixfs/io/resolve.go': 7, 'unixfs/mod/dagmodifier.go': 9, 'unixfs/mod/dagmodifier_test.go': 3, 'unixfs/test/utils.go': 10, 'commands/legacy/command.go': 15, 'commands/legacy/legacy.go': 15, 'commands/legacy/legacy_test.go': 16, 'commands/legacy/request.go': 17, 'commands/legacy/response.go': 16, 'commands/legacy/responseemitter.go': 4, 'core/commands/env.go': 4, 'TODO.md': 2, 'core/commands/commands_test.go': 25, 'test/sharness/t0110-gateway.sh': 1, 'test/sharness/t0410-api-add.sh': 1, 'core/coreapi/dag.go': 13, 'core/coreapi/dag_test.go': 3, 'core/coreapi/interface/options/dag.go': 8, 'core/coreapi/key.go': 47, 'core/coreapi/name.go': 52, 'unixfs/io/pbdagreader.go': 7, 'mfs/fd.go': 8, 'unixfs/hamt/hamt_stress_test.go': 5, 'unixfs/hamt/hamt_test.go': 5, 'unixfs/io/dagreader_test.go': 2, 'unixfs/io/dirbuilder_test.go': 1, 'cmd/ipfs/util/ulimit.go': 9, 'cmd/seccat/util.go': 9, 'core/corehttp/logs.go': 9, 'fuse/mount/mount.go': 10, 'fuse/node/mount_unix.go': 10, 'importer/chunk/splitting.go': 1, 'namesys/ipns_validate_test.go': 7, 'plugin/loader/load.go': 7, 'blocks/blockstoreutil/remove.go': 22, 'blockservice/test/mock.go': 8, 'namesys/validator.go': 5, 'core/coreapi/object.go': 47, 'fuse/mount/fuse.go': 3, 'keystore/keystore_test.go': 7, 'namesys/dns_test.go': 9, 'repo/config/config.go': 1, 'unixfs/unixfs.go': 2, 'core/commands/files.go': 58, 'core/coreapi/pin.go': 46, 'keystore/keystore.go': 9, 'keystore/memkeystore.go': 6, 'path/resolver/resolver.go': 5, 'thirdparty/verifbs/verifbs.go': 21, 'cmd/ipfs/util/ulimit_freebsd.go': 2, 'cmd/ipfs/util/ulimit_unix.go': 2, 'core/coreapi/block.go': 15, 'core/coreapi/block_test.go': 2, 'core/coreapi/interface/coreapi.go': 9, 'core/coreapi/interface/dag.go': 9, 'core/coreapi/interface/object.go': 9, 'core/coreapi/interface/options/block.go': 3, 'core/coreapi/interface/path.go': 35, 'core/coreapi/interface/unixfs.go': 13, 'fuse/ipns/link_unix.go': 2, 'fuse/node/mount_darwin.go': 2, 'merkledag/errservice.go': 2, 'merkledag/readonly.go': 2, 'merkledag/readonly_test.go': 2, 'merkledag/rwservice.go': 2, 'merkledag/session.go': 2, 'path/resolver/resolver_test.go': 3, 'thirdparty/verifcid/validate.go': 2, 'thirdparty/verifcid/validate_test.go': 2, 'namesys/ipns_resolver_validation_test.go': 44, 'test/sharness/t0170-dht.sh': 5, 'core/commands/urlstore.go': 51, 'unixfs/io/directory.go': 2, 'Rules.mk': 1, 'dagutils/diff.go': 40, 'dagutils/diffenum.go': 41, 'dagutils/diffenum_test.go': 39, 'dagutils/utils.go': 41, 'dagutils/utils_test.go': 41, 'unixfs/io/directory_test.go': 1, 'core/coreapi/name_test.go': 32, 'core/coreapi/path.go': 45, 'core/coreunix/cat.go': 15, 'core/pathresolver_test.go': 40, 'namesys/base.go': 41, 'namesys/cache.go': 40, 'test/sharness/t0175-reprovider.sh': 1, 'core/coreapi/interface/key.go': 7, 'filestore/pb/dataobj.pb.go': 3, 'pin/internal/pb/header.pb.go': 3, 'thirdparty/cidv0v1/blockstore.go': 16, 'repo/fsrepo/config_test.go': 13, 'repo/fsrepo/misc.go': 13, 'test/bench/bench_cli_ipfs_add/main.go': 14, 'test/bench/offline_add/main.go': 14, 'core/commands/cmdenv/env.go': 26, 'core/commands/name/ipns.go': 43, 'core/commands/name/ipnsps.go': 22, 'core/commands/name/name.go': 16, 'core/commands/name/publish.go': 26, 'core/coreapi/dht.go': 33, 'core/coreapi/dht_test.go': 5, 'test/sharness/t0275-cid-security.sh': 1, 'core/coreapi/interface/dht.go': 10, 'p2p/listener.go': 14, 'p2p/local.go': 14, 'p2p/remote.go': 14, 'p2p/stream.go': 14, 'core/coreapi/interface/swarm.go': 9, 'core/coreapi/swarm.go': 21, 'core/commands/cid.go': 16, 'core/coreapi/interface/options/unixfs.go': 15, 'core/coreapi/pubsub.go': 19, 'core/coreapi/unixfile.go': 16, 'cmd/ipfs/dnsresolve_test.go': 5, 'core/coreapi/interface/pubsub.go': 4, 'test/dependencies/iptb/iptb.go': 12, 'plugin/plugins/badgerds/badgerds.go': 4, 'plugin/plugins/flatfs/flatfs.go': 4, 'plugin/plugins/levelds/levelds.go': 3, 'commands/context.go': 18, 'core/corehttp/proxy.go': 10, 'core/coreapi/interface/tests/name.go': 4, 'core/coreapi/interface/tests/unixfs.go': 4, 'core/coreapi/test/api_test.go': 11, 'plugin/loader/loader.go': 9, 'core/commands/cmdenv/cidbase.go': 10, 'core/commands/cmdenv/file.go': 3, 'core/corehttp/ipns_hostname.go': 8, 'plugin/daemon.go': 8, 'core/corerepo/stat.go': 2, 'core/commands/cmdenv/cidbase_test.go': 2, 'core/corehttp/metrics.go': 1, 'core/corehttp/proxy_test.go': 2, 'plugin/tracer.go': 1, 'thirdparty/notifier/notifier.go': 1, 'README.md': 1, 'go.mod': 6, 'go.sum': 4, 'package-list.json': 1, 'core/node/libp2p/addrs.go': 2, 'namesys/resolve/pathresolver_test.go': 1, 'plugin/plugins/gen_main.sh': 1, 'core/bootstrap/bootstrap.go': 1, 'core/bootstrap/bootstrap_test.go': 1, 'core/node/builder.go': 1, 'core/node/core.go': 1, 'core/node/groups.go': 3, 'core/node/identity.go': 1, 'core/node/ipns.go': 1, 'core/node/libp2p/discovery.go': 1, 'core/node/libp2p/host.go': 2, 'core/node/libp2p/hostopt.go': 1, 'core/node/libp2p/libp2p.go': 1, 'core/node/libp2p/nat.go': 1, 'core/node/libp2p/pnet.go': 1, 'core/node/libp2p/pubsub.go': 1, 'core/node/libp2p/routing.go': 3, 'core/node/libp2p/routingopt.go': 2, 'core/node/libp2p/smux.go': 1, 'core/node/libp2p/transport.go': 1, 'core/node/provider.go': 1, 'provider/simple/provider.go': 1, 'provider/simple/provider_test.go': 1, 'provider/simple/reprovide.go': 1, 'provider/simple/reprovide_test.go': 1, 'core/commands/stat_dht.go': 1}","('core/core.go', 0.6486486486486487, 0.4022346368715084)"
core/commands/dht_test.go,24,114,1,"[{'cyclomatic_complexity': 5, 'nloc': 18, 'token_count': 105, 'name': 'TestKeyTranslation', 'long_name': 'TestKeyTranslation t * testing . T', 'start_line': 10, 'end_line': 31, 'full_parameters': ['t * testing . T'], 'filename': '/home/dimi/Documents/Informatik_Studium/FSS/SoftEvo/DataCollection/FFS_SoftEvo/go-ipfs/core/commands/dht_test.go', 'top_nesting_level': 0, 'length': 22, 'fan_in': 0, 'fan_out': 0, 'general_fan_out': 0}]",26,121,1,"[{'cyclomatic_complexity': 5, 'nloc': 19, 'token_count': 111, 'name': 'TestKeyTranslation', 'long_name': 'TestKeyTranslation t * testing . T', 'start_line': 12, 'end_line': 34, 'full_parameters': ['t * testing . T'], 'filename': '/home/dimi/Documents/Informatik_Studium/FSS/SoftEvo/DataCollection/FFS_SoftEvo/go-ipfs/core/commands/dht_test.go', 'top_nesting_level': 0, 'length': 23, 'fan_in': 0, 'fan_out': 0, 'general_fan_out': 0}]",2,7,0,29,29,"[{'timestamp': 1507212616.0, 'added_lines': 1, 'deleted_lines': 1, 'nloc': 24}, {'timestamp': 1507304579.0, 'added_lines': 1, 'deleted_lines': 1, 'nloc': 24}, {'timestamp': 1511223906.0, 'added_lines': 1, 'deleted_lines': 1, 'nloc': 24}, {'timestamp': 1512365669.0, 'added_lines': 1, 'deleted_lines': 1, 'nloc': 24}, {'timestamp': 1516838128.0, 'added_lines': 1, 'deleted_lines': 1, 'nloc': 24}, {'timestamp': 1517453697.0, 'added_lines': 1, 'deleted_lines': 1, 'nloc': 24}, {'timestamp': 1525408792.0, 'added_lines': 1, 'deleted_lines': 1, 'nloc': 24}, {'timestamp': 1528520460.0, 'added_lines': 1, 'deleted_lines': 1, 'nloc': 24}, {'timestamp': 1529106827.0, 'added_lines': 6, 'deleted_lines': 3, 'nloc': 26}, {'timestamp': 1528945488.0, 'added_lines': 1, 'deleted_lines': 1, 'nloc': 26}, {'timestamp': 1529984485.0, 'added_lines': 2, 'deleted_lines': 2, 'nloc': 26}, {'timestamp': 1533779477.0, 'added_lines': 2, 'deleted_lines': 2, 'nloc': 26}, {'timestamp': 1534896611.0, 'added_lines': 2, 'deleted_lines': 2, 'nloc': 26}, {'timestamp': 1536388808.0, 'added_lines': 1, 'deleted_lines': 1, 'nloc': 26}, {'timestamp': 1537792589.0, 'added_lines': 2, 'deleted_lines': 2, 'nloc': 26}, {'timestamp': 1538544957.0, 'added_lines': 1, 'deleted_lines': 1, 'nloc': 26}, {'timestamp': 1538773916.0, 'added_lines': 1, 'deleted_lines': 1, 'nloc': 26}, {'timestamp': 1539176817.0, 'added_lines': 1, 'deleted_lines': 1, 'nloc': 26}, {'timestamp': 1540400358.0, 'added_lines': 2, 'deleted_lines': 2, 'nloc': 26}, {'timestamp': 1541204121.0, 'added_lines': 2, 'deleted_lines': 2, 'nloc': 26}, {'timestamp': 1541903826.0, 'added_lines': 1, 'deleted_lines': 1, 'nloc': 26}, {'timestamp': 1544225843.0, 'added_lines': 2, 'deleted_lines': 2, 'nloc': 26}, {'timestamp': 1547003974.0, 'added_lines': 2, 'deleted_lines': 2, 'nloc': 26}, {'timestamp': 1549588289.0, 'added_lines': 2, 'deleted_lines': 2, 'nloc': 26}, {'timestamp': 1550507829.0, 'added_lines': 2, 'deleted_lines': 2, 'nloc': 26}, {'timestamp': 1551229859.0, 'added_lines': 2, 'deleted_lines': 2, 'nloc': 26}, {'timestamp': 1551551196.0, 'added_lines': 2, 'deleted_lines': 2, 'nloc': 26}, {'timestamp': 1559060517.0, 'added_lines': 2, 'deleted_lines': 2, 'nloc': 26}, {'timestamp': 1613691223.0, 'added_lines': 1, 'deleted_lines': 1, 'nloc': 26}]","{'core/bootstrap_test.go': 25, 'core/mock/mock.go': 26, 'exchange/bitswap/bitswap_test.go': 10, 'exchange/bitswap/decision/bench_test.go': 9, 'exchange/bitswap/decision/engine_test.go': 9, 'exchange/bitswap/decision/peer_request_queue_test.go': 9, 'exchange/bitswap/testnet/interface.go': 9, 'exchange/bitswap/testnet/network_test.go': 10, 'exchange/bitswap/testnet/peernet.go': 10, 'exchange/bitswap/testnet/virtual.go': 10, 'exchange/bitswap/testutils.go': 9, 'exchange/reprovide/reprovide_test.go': 26, 'fuse/ipns/ipns_test.go': 27, 'fuse/node/mount_test.go': 27, 'fuse/readonly/ipfs_test.go': 26, 'mfs/repub_test.go': 10, 'namesys/publisher_test.go': 28, 'namesys/resolve_test.go': 28, 'package.json': 26, 'routing/mock/centralized_client.go': 6, 'routing/mock/centralized_server.go': 6, 'routing/mock/centralized_test.go': 6, 'routing/mock/interface.go': 6, 'routing/offline/offline_test.go': 6, 'test/integration/addcat_test.go': 26, 'test/integration/bench_cat_test.go': 26, 'test/integration/bench_test.go': 21, 'test/integration/grandcentral_test.go': 1, 'test/integration/three_legged_cat_test.go': 26, 'core/bootstrap.go': 24, 'core/commands/dht.go': 25, 'core/commands/id.go': 25, 'core/commands/pubsub.go': 17, 'core/core.go': 28, 'core/corehttp/gateway.go': 24, 'core/corehttp/gateway_test.go': 26, 'core/corehttp/metrics_test.go': 25, 'exchange/bitswap/network/ipfs_impl.go': 8, 'namesys/republisher/repub_test.go': 25, 'p2p/p2p.go': 25, 'routing/none/none_client.go': 5, 'test/integration/bitswap_wo_routing_test.go': 24, 'thirdparty/ipfsaddr/ipfsaddr.go': 1, 'cmd/ipfs/daemon.go': 16, 'cmd/ipfs/init.go': 19, 'cmd/ipfs/ipfs.go': 13, 'cmd/ipfs/main.go': 20, 'cmd/ipfs/main_test.go': 2, 'cmd/ipfswatch/main.go': 15, 'cmd/seccat/seccat.go': 24, 'commands/cli/helptext.go': 1, 'commands/cli/helptext_test.go': 1, 'commands/cli/parse.go': 1, 'commands/cli/parse_test.go': 1, 'commands/command.go': 11, 'commands/command_test.go': 4, 'commands/http/client.go': 1, 'commands/http/handler.go': 1, 'commands/http/multifilereader.go': 1, 'commands/http/multifilereader_test.go': 1, 'commands/http/parse.go': 1, 'commands/request.go': 14, 'commands/response.go': 6, 'commands/response_test.go': 4, 'core/commands/active.go': 6, 'core/commands/add.go': 16, 'core/commands/bitswap.go': 24, 'core/commands/block.go': 14, 'core/commands/bootstrap.go': 15, 'core/commands/cat.go': 14, 'core/commands/commands.go': 13, 'core/commands/config.go': 15, 'core/commands/dag/dag.go': 21, 'core/commands/diag.go': 6, 'core/commands/dns.go': 10, 'core/commands/external.go': 6, 'core/commands/files/files.go': 4, 'core/commands/filestore.go': 13, 'core/commands/get.go': 22, 'core/commands/get_test.go': 13, 'core/commands/helptext_test.go': 13, 'core/commands/ipns.go': 8, 'core/commands/keystore.go': 14, 'core/commands/log.go': 12, 'core/commands/ls.go': 21, 'core/commands/mount_nofuse.go': 6, 'core/commands/mount_unix.go': 15, 'core/commands/name.go': 4, 'core/commands/object/diff.go': 8, 'core/commands/object/object.go': 22, 'core/commands/object/patch.go': 13, 'core/commands/p2p.go': 20, 'core/commands/pin.go': 22, 'core/commands/ping.go': 24, 'core/commands/publish.go': 9, 'core/commands/refs.go': 20, 'core/commands/repo.go': 22, 'core/commands/resolve.go': 20, 'core/commands/root.go': 13, 'core/commands/shutdown.go': 9, 'core/commands/stat.go': 18, 'core/commands/swarm.go': 24, 'core/commands/sysdiag.go': 12, 'core/commands/tar.go': 19, 'core/commands/unixfs/ls.go': 19, 'core/commands/unixfs/unixfs.go': 6, 'core/commands/version.go': 7, 'core/corehttp/commands.go': 23, 'core/coreunix/add.go': 23, 'core/coreunix/add_test.go': 22, 'exchange/bitswap/message/message.go': 7, 'exchange/bitswap/network/interface.go': 7, 'importer/helpers/dagbuilder.go': 6, 'importer/importer.go': 6, 'p2p/registry.go': 10, 'repo/config/bootstrap_peers.go': 8, 'assets/assets.go': 18, 'blocks/blockstore/arc_cache.go': 2, 'blocks/blockstore/arc_cache_test.go': 2, 'blocks/blockstore/blockstore.go': 3, 'blocks/blockstore/blockstore_test.go': 2, 'blocks/blockstore/bloom_cache.go': 2, 'blocks/blockstore/bloom_cache_test.go': 2, 'blocks/blockstore/util/remove.go': 2, 'blocks/blocksutil/block_generator.go': 2, 'blockservice/blockservice.go': 6, 'blockservice/blockservice_test.go': 5, 'blockservice/test/blocks_test.go': 5, 'core/builder.go': 23, 'core/commands/ipnsps.go': 5, 'core/commands/mount_windows.go': 5, 'core/coreapi/coreapi.go': 14, 'core/coreapi/interface/interface.go': 2, 'core/coreapi/unixfs.go': 19, 'core/coreapi/unixfs_test.go': 17, 'core/coredag/cbor.go': 7, 'core/coredag/dagpb.go': 19, 'core/coredag/dagtransl.go': 6, 'core/coredag/raw.go': 19, 'core/corehttp/corehttp.go': 14, 'core/corehttp/gateway_handler.go': 23, 'core/corerepo/gc.go': 22, 'core/corerepo/pinning.go': 8, 'core/coreunix/metadata.go': 19, 'core/coreunix/metadata_test.go': 21, 'core/pathresolver.go': 22, 'exchange/bitswap/bitswap.go': 6, 'exchange/bitswap/decision/engine.go': 6, 'exchange/bitswap/decision/ledger.go': 6, 'exchange/bitswap/decision/peer_request_queue.go': 6, 'exchange/bitswap/get.go': 5, 'exchange/bitswap/message/message_test.go': 3, 'exchange/bitswap/notifications/notifications.go': 3, 'exchange/bitswap/notifications/notifications_test.go': 3, 'exchange/bitswap/session.go': 6, 'exchange/bitswap/session_test.go': 5, 'exchange/bitswap/stat.go': 3, 'exchange/bitswap/wantlist/wantlist.go': 3, 'exchange/bitswap/wantlist/wantlist_test.go': 3, 'exchange/bitswap/wantmanager.go': 6, 'exchange/bitswap/workers.go': 6, 'exchange/interface.go': 2, 'exchange/offline/offline.go': 2, 'exchange/offline/offline_test.go': 2, 'exchange/reprovide/providers.go': 21, 'exchange/reprovide/reprovide.go': 22, 'filestore/filestore.go': 16, 'filestore/filestore_test.go': 21, 'filestore/fsrefstore.go': 15, 'filestore/util.go': 15, 'fuse/ipns/ipns_unix.go': 23, 'fuse/readonly/readonly_unix.go': 22, 'importer/balanced/balanced_test.go': 5, 'importer/balanced/builder.go': 3, 'importer/chunk/rabin_test.go': 2, 'importer/chunk/splitting_test.go': 2, 'importer/helpers/helpers.go': 3, 'importer/importer_test.go': 5, 'importer/trickle/trickle_test.go': 5, 'importer/trickle/trickledag.go': 3, 'merkledag/batch.go': 2, 'merkledag/coding.go': 3, 'merkledag/merkledag.go': 3, 'merkledag/merkledag_test.go': 5, 'merkledag/node.go': 3, 'merkledag/node_test.go': 3, 'merkledag/raw.go': 3, 'merkledag/traverse/traverse.go': 3, 'merkledag/traverse/traverse_test.go': 3, 'merkledag/utils/diff.go': 3, 'merkledag/utils/diffenum.go': 3, 'merkledag/utils/diffenum_test.go': 3, 'merkledag/utils/utils.go': 5, 'merkledag/utils/utils_test.go': 3, 'mfs/dir.go': 4, 'mfs/file.go': 6, 'mfs/mfs_test.go': 6, 'mfs/ops.go': 4, 'mfs/system.go': 7, 'namesys/ipns_select_test.go': 4, 'namesys/namesys.go': 23, 'namesys/publisher.go': 25, 'namesys/pubsub.go': 4, 'namesys/pubsub_test.go': 4, 'namesys/republisher/repub.go': 25, 'namesys/routing.go': 25, 'path/path.go': 3, 'path/resolver.go': 3, 'path/resolver_test.go': 2, 'pin/gc/gc.go': 22, 'pin/pin.go': 22, 'pin/pin_test.go': 21, 'pin/set.go': 19, 'pin/set_test.go': 21, 'plugin/ipld.go': 6, 'plugin/loader/initializer.go': 5, 'plugin/plugins/git/git.go': 6, 'repo/config/init.go': 7, 'repo/fsrepo/fsrepo.go': 22, 'repo/fsrepo/lock/lock.go': 3, 'repo/fsrepo/serialize/serialize.go': 3, 'repo/mock.go': 17, 'repo/repo.go': 20, 'routing/offline/offline.go': 3, 'tar/format.go': 22, 'test/dependencies/ma-pipe-unidir/main.go': 9, 'thirdparty/ds-help/key.go': 2, 'thirdparty/pollEndpoint/main.go': 14, 'thirdparty/posinfo/posinfo.go': 2, 'unixfs/archive/archive.go': 3, 'unixfs/archive/tar/writer.go': 3, 'unixfs/hamt/hamt.go': 3, 'unixfs/io/dagreader.go': 3, 'unixfs/io/dirbuilder.go': 3, 'unixfs/io/resolve.go': 3, 'unixfs/mod/dagmodifier.go': 5, 'unixfs/mod/dagmodifier_test.go': 3, 'unixfs/test/utils.go': 5, 'commands/legacy/command.go': 9, 'commands/legacy/legacy.go': 9, 'commands/legacy/legacy_test.go': 9, 'commands/legacy/request.go': 9, 'commands/legacy/response.go': 9, 'core/commands/commands_test.go': 11, 'core/coreapi/dag.go': 5, 'core/coreapi/dag_test.go': 3, 'core/coreapi/interface/options/dag.go': 4, 'core/coreapi/key.go': 22, 'core/coreapi/name.go': 24, 'merkledag/test/utils.go': 4, 'namesys/namesys_test.go': 22, 'repo/fsrepo/datastores.go': 14, 'repo/fsrepo/fsrepo_test.go': 16, 'thirdparty/datastore2/datastore_closer.go': 1, 'thirdparty/datastore2/delayed.go': 1, 'thirdparty/datastore2/threadsafe.go': 1, 'unixfs/io/pbdagreader.go': 2, 'cmd/ipfs/util/ulimit.go': 9, 'cmd/seccat/util.go': 9, 'core/corehttp/logs.go': 9, 'fuse/mount/mount.go': 9, 'fuse/node/mount_unix.go': 9, 'importer/chunk/splitting.go': 1, 'namesys/ipns_validate_test.go': 3, 'plugin/loader/load.go': 7, 'blocks/blockstoreutil/remove.go': 13, 'blockservice/test/mock.go': 4, 'core/commands/files.go': 19, 'core/core_test.go': 15, 'core/coreapi/pin.go': 19, 'fuse/ipns/common.go': 19, 'keystore/keystore.go': 9, 'keystore/keystore_test.go': 6, 'keystore/memkeystore.go': 6, 'namesys/interface.go': 18, 'namesys/validator.go': 2, 'path/resolver/resolver.go': 3, 'repo/config/identity.go': 2, 'thirdparty/verifbs/verifbs.go': 13, 'cmd/ipfs/util/ulimit_freebsd.go': 2, 'cmd/ipfs/util/ulimit_unix.go': 2, 'core/coreapi/block.go': 6, 'core/coreapi/block_test.go': 2, 'core/coreapi/interface/coreapi.go': 3, 'core/coreapi/interface/dag.go': 3, 'core/coreapi/interface/object.go': 3, 'core/coreapi/interface/options/block.go': 2, 'core/coreapi/interface/path.go': 14, 'core/coreapi/interface/unixfs.go': 4, 'core/coreapi/object.go': 17, 'fuse/ipns/link_unix.go': 2, 'fuse/mount/fuse.go': 2, 'fuse/node/mount_darwin.go': 2, 'merkledag/errservice.go': 1, 'merkledag/readonly.go': 1, 'merkledag/readonly_test.go': 1, 'merkledag/rwservice.go': 1, 'merkledag/session.go': 1, 'path/resolver/resolver_test.go': 1, 'thirdparty/verifcid/validate.go': 1, 'thirdparty/verifcid/validate_test.go': 1, 'unixfs/hamt/hamt_stress_test.go': 1, 'unixfs/hamt/hamt_test.go': 1, 'Rules.mk': 1, 'namesys/ipns_resolver_validation_test.go': 20, None: 25, 'test/sharness/t0170-dht.sh': 1, 'core/commands/env.go': 2, 'core/commands/urlstore.go': 16, 'core/coreapi/interface/key.go': 7, 'core/coreapi/name_test.go': 11, 'core/coreapi/path.go': 17, 'core/coreunix/cat.go': 4, 'core/pathresolver_test.go': 16, 'dagutils/diff.go': 16, 'dagutils/diffenum.go': 16, 'dagutils/diffenum_test.go': 16, 'dagutils/utils.go': 16, 'dagutils/utils_test.go': 16, 'filestore/pb/dataobj.pb.go': 3, 'mfs/fd.go': 1, 'namesys/base.go': 16, 'namesys/cache.go': 16, 'namesys/dns.go': 16, 'namesys/proquint.go': 16, 'pin/internal/pb/header.pb.go': 3, 'thirdparty/cidv0v1/blockstore.go': 10, 'repo/fsrepo/config_test.go': 12, 'repo/fsrepo/misc.go': 12, 'test/bench/bench_cli_ipfs_add/main.go': 12, 'test/bench/offline_add/main.go': 12, 'core/commands/cmdenv/env.go': 11, 'core/commands/name/ipns.go': 15, 'core/commands/name/publish.go': 7, 'core/commands/name/ipnsps.go': 9, 'core/commands/name/name.go': 4, 'core/coreapi/dht.go': 14, 'core/coreapi/dht_test.go': 4, 'core/coreapi/interface/dht.go': 10, 'p2p/listener.go': 14, 'p2p/local.go': 14, 'p2p/remote.go': 14, 'p2p/stream.go': 14, 'core/coreapi/interface/swarm.go': 9, 'core/coreapi/swarm.go': 13, 'core/coreapi/interface/options/unixfs.go': 8, 'core/coreapi/pubsub.go': 12, 'core/coreapi/unixfile.go': 7, 'cmd/ipfs/dnsresolve_test.go': 5, 'core/coreapi/interface/pubsub.go': 4, 'core/commands/cid.go': 3, 'test/dependencies/iptb/iptb.go': 8, 'plugin/plugins/badgerds/badgerds.go': 3, 'plugin/plugins/flatfs/flatfs.go': 3, 'plugin/plugins/levelds/levelds.go': 3, 'commands/context.go': 6, 'core/corehttp/proxy.go': 7, 'core/coreapi/interface/tests/name.go': 2, 'core/coreapi/interface/tests/unixfs.go': 2, 'core/coreapi/test/api_test.go': 7, 'core/commands/cmdenv/cidbase.go': 2, 'core/corehttp/ipns_hostname.go': 3, 'namesys/dns_test.go': 3, 'plugin/daemon.go': 3, 'plugin/loader/loader.go': 3, 'core/commands/cmdenv/cidbase_test.go': 1, 'core/commands/cmdenv/file.go': 1, 'core/corehttp/metrics.go': 1, 'core/corehttp/proxy_test.go': 2, 'core/corerepo/stat.go': 1, 'plugin/tracer.go': 1, 'thirdparty/notifier/notifier.go': 1, 'core/bootstrap/bootstrap.go': 1, 'core/bootstrap/bootstrap_test.go': 1, 'core/node/builder.go': 1, 'core/node/core.go': 1, 'core/node/groups.go': 1, 'core/node/identity.go': 1, 'core/node/ipns.go': 2, 'core/node/libp2p/addrs.go': 1, 'core/node/libp2p/discovery.go': 1, 'core/node/libp2p/host.go': 1, 'core/node/libp2p/hostopt.go': 1, 'core/node/libp2p/libp2p.go': 1, 'core/node/libp2p/nat.go': 1, 'core/node/libp2p/pnet.go': 1, 'core/node/libp2p/pubsub.go': 1, 'core/node/libp2p/routing.go': 1, 'core/node/libp2p/routingopt.go': 1, 'core/node/libp2p/smux.go': 1, 'core/node/libp2p/transport.go': 1, 'core/node/provider.go': 1, 'go.mod': 2, 'go.sum': 2, 'provider/simple/provider.go': 1, 'provider/simple/provider_test.go': 1, 'provider/simple/reprovide.go': 1, 'provider/simple/reprovide_test.go': 1, 'core/corehttp/hostname.go': 1}","('core/core.go', 0.9655172413793104, 0.1564245810055866)"
core/commands/diag.go,11,47,0,[],14,53,0,[],3,6,0,28,28,"[{'timestamp': 1491058697.0, 'added_lines': 6, 'deleted_lines': 2, 'nloc': 14}, {'timestamp': 1511223906.0, 'added_lines': 1, 'deleted_lines': 1, 'nloc': 14}, {'timestamp': 1512365669.0, 'added_lines': 1, 'deleted_lines': 1, 'nloc': 14}, {'timestamp': 1511187070.0, 'added_lines': 1, 'deleted_lines': 1, 'nloc': 14}, {'timestamp': 1513436097.0, 'added_lines': 1, 'deleted_lines': 1, 'nloc': 14}, {'timestamp': 1513612261.0, 'added_lines': 1, 'deleted_lines': 1, 'nloc': 14}, {'timestamp': 1515277696.0, 'added_lines': 1, 'deleted_lines': 1, 'nloc': 14}, {'timestamp': 1528520460.0, 'added_lines': 1, 'deleted_lines': 1, 'nloc': 14}, {'timestamp': 1533946888.0, 'added_lines': 1, 'deleted_lines': 1, 'nloc': 14}, {'timestamp': 1534896611.0, 'added_lines': 1, 'deleted_lines': 1, 'nloc': 14}, {'timestamp': 1539850591.0, 'added_lines': 1, 'deleted_lines': 1, 'nloc': 14}, {'timestamp': 1540564653.0, 'added_lines': 2, 'deleted_lines': 3, 'nloc': 14}, {'timestamp': 1540572903.0, 'added_lines': 1, 'deleted_lines': 1, 'nloc': 14}, {'timestamp': 1540619689.0, 'added_lines': 1, 'deleted_lines': 1, 'nloc': 14}, {'timestamp': 1540951823.0, 'added_lines': 1, 'deleted_lines': 1, 'nloc': 14}, {'timestamp': 1544661332.0, 'added_lines': 1, 'deleted_lines': 1, 'nloc': 14}, {'timestamp': 1540556089.0, 'added_lines': 1, 'deleted_lines': 1, 'nloc': 14}, {'timestamp': 1547152271.0, 'added_lines': 1, 'deleted_lines': 1, 'nloc': 14}, {'timestamp': 1548866534.0, 'added_lines': 1, 'deleted_lines': 1, 'nloc': 14}, {'timestamp': 1549903582.0, 'added_lines': 1, 'deleted_lines': 1, 'nloc': 14}, {'timestamp': 1550507829.0, 'added_lines': 1, 'deleted_lines': 1, 'nloc': 14}, {'timestamp': 1550610741.0, 'added_lines': 1, 'deleted_lines': 1, 'nloc': 14}, {'timestamp': 1551138343.0, 'added_lines': 1, 'deleted_lines': 1, 'nloc': 14}, {'timestamp': 1551299964.0, 'added_lines': 1, 'deleted_lines': 1, 'nloc': 14}, {'timestamp': 1551471469.0, 'added_lines': 1, 'deleted_lines': 1, 'nloc': 14}, {'timestamp': 1551551196.0, 'added_lines': 2, 'deleted_lines': 2, 'nloc': 14}, {'timestamp': 1557554420.0, 'added_lines': 1, 'deleted_lines': 2, 'nloc': 13}, {'timestamp': 1626901942.0, 'added_lines': 3, 'deleted_lines': 2, 'nloc': 14}]","{'blocks/blockstore/caching.go': 1, 'blocks/blockstore/util/remove.go': 2, 'cmd/ipfs/daemon.go': 23, 'cmd/ipfs/init.go': 23, 'cmd/ipfs/ipfs.go': 21, 'cmd/ipfs/main.go': 22, 'cmd/ipfs/main_test.go': 4, 'cmd/ipfswatch/main.go': 10, 'cmd/seccat/seccat.go': 7, None: 13, 'commands/channelmarshaler.go': 1, 'commands/cli/cmd_suggestion.go': 1, 'commands/cli/helptext.go': 2, 'commands/cli/helptext_test.go': 2, 'commands/cli/parse.go': 2, 'commands/cli/parse_test.go': 2, 'commands/command.go': 11, 'commands/command_test.go': 7, 'commands/http/client.go': 2, 'commands/http/handler.go': 2, 'commands/http/multifilereader.go': 2, 'commands/http/multifilereader_test.go': 2, 'commands/http/parse.go': 2, 'commands/reqlog.go': 1, 'commands/request.go': 11, 'commands/response.go': 11, 'commands/response_test.go': 7, 'core/bootstrap.go': 7, 'core/commands/active.go': 27, 'core/commands/add.go': 23, 'core/commands/bitswap.go': 23, 'core/commands/block.go': 23, 'core/commands/bootstrap.go': 23, 'core/commands/cat.go': 23, 'core/commands/commands.go': 23, 'core/commands/config.go': 24, 'core/commands/dag/dag.go': 23, 'core/commands/dht.go': 23, 'core/commands/dns.go': 23, 'core/commands/e/error.go': 1, 'core/commands/external.go': 23, 'core/commands/files/files.go': 7, 'core/commands/filestore.go': 23, 'core/commands/get.go': 23, 'core/commands/helptext_test.go': 21, 'core/commands/id.go': 23, 'core/commands/ipns.go': 10, 'core/commands/keystore.go': 23, 'core/commands/log.go': 24, 'core/commands/ls.go': 23, 'core/commands/mount_nofuse.go': 26, 'core/commands/mount_unix.go': 24, 'core/commands/mount_windows.go': 25, 'core/commands/name.go': 10, 'core/commands/object/diff.go': 23, 'core/commands/object/object.go': 23, 'core/commands/object/patch.go': 23, 'core/commands/p2p.go': 23, 'core/commands/pin.go': 23, 'core/commands/ping.go': 23, 'core/commands/publish.go': 10, 'core/commands/pubsub.go': 23, 'core/commands/refs.go': 23, 'core/commands/repo.go': 23, 'core/commands/resolve.go': 23, 'core/commands/root.go': 24, 'core/commands/shutdown.go': 23, 'core/commands/stat.go': 23, 'core/commands/swarm.go': 23, 'core/commands/sysdiag.go': 26, 'core/commands/tar.go': 23, 'core/commands/unixfs/ls.go': 23, 'core/commands/unixfs/unixfs.go': 23, 'core/commands/version.go': 23, 'core/core_test.go': 4, 'core/corehttp/commands.go': 22, 'core/corehttp/gateway.go': 9, 'core/coreunix/add.go': 17, 'core/coreunix/add_test.go': 17, 'core/coreunix/metadata_test.go': 12, 'exchange/bitswap/bitswap_test.go': 4, 'exchange/bitswap/decision/engine_test.go': 4, 'exchange/bitswap/message/message_test.go': 3, 'exchange/bitswap/message/pb/Makefile': 1, 'exchange/bitswap/testnet/network_test.go': 4, 'exchange/bitswap/testnet/peernet.go': 4, 'exchange/reprovide/reprovide_test.go': 7, 'fuse/ipns/common.go': 10, 'fuse/node/mount_test.go': 7, 'importer/balanced/balanced_test.go': 3, 'importer/chunk/rabin_test.go': 2, 'importer/helpers/dagbuilder.go': 8, 'importer/importer.go': 8, 'merkledag/utils/utils_test.go': 3, 'mfs/repub_test.go': 4, 'namesys/dns.go': 6, 'namesys/interface.go': 6, 'namesys/ipns_select_test.go': 3, 'namesys/proquint.go': 6, 'namesys/republisher/repub_test.go': 8, 'package.json': 21, 'repo/config/identity.go': 1, 'routing/offline/offline_test.go': 3, 'test/integration/addcat_test.go': 11, 'test/integration/bench_cat_test.go': 10, 'test/integration/bitswap_wo_routing_test.go': 8, 'test/integration/three_legged_cat_test.go': 10, 'core/bootstrap_test.go': 6, 'core/commands/dht_test.go': 6, 'core/commands/get_test.go': 22, 'core/core.go': 12, 'core/corehttp/gateway_test.go': 9, 'core/corehttp/metrics_test.go': 7, 'core/mock/mock.go': 7, 'exchange/bitswap/decision/bench_test.go': 3, 'exchange/bitswap/decision/peer_request_queue_test.go': 3, 'exchange/bitswap/message/message.go': 3, 'exchange/bitswap/network/interface.go': 3, 'exchange/bitswap/network/ipfs_impl.go': 3, 'exchange/bitswap/testnet/interface.go': 3, 'exchange/bitswap/testnet/virtual.go': 3, 'exchange/bitswap/testutils.go': 3, 'fuse/ipns/ipns_test.go': 6, 'fuse/readonly/ipfs_test.go': 12, 'namesys/publisher_test.go': 6, 'namesys/resolve_test.go': 7, 'p2p/p2p.go': 6, 'p2p/registry.go': 4, 'repo/config/bootstrap_peers.go': 3, 'routing/mock/centralized_client.go': 2, 'routing/mock/centralized_server.go': 2, 'routing/mock/centralized_test.go': 2, 'routing/mock/interface.go': 2, 'routing/none/none_client.go': 2, 'test/integration/bench_test.go': 6, 'assets/assets.go': 11, 'blocks/blockstore/arc_cache.go': 1, 'blocks/blockstore/arc_cache_test.go': 1, 'blocks/blockstore/blockstore.go': 1, 'blocks/blockstore/blockstore_test.go': 1, 'blocks/blockstore/bloom_cache.go': 1, 'blocks/blockstore/bloom_cache_test.go': 1, 'blocks/blocksutil/block_generator.go': 1, 'blockservice/blockservice.go': 2, 'blockservice/blockservice_test.go': 2, 'blockservice/test/blocks_test.go': 2, 'core/builder.go': 11, 'core/commands/ipnsps.go': 7, 'core/coreapi/coreapi.go': 6, 'core/coreapi/interface/interface.go': 1, 'core/coreapi/unixfs.go': 12, 'core/coreapi/unixfs_test.go': 6, 'core/coredag/cbor.go': 4, 'core/coredag/dagpb.go': 6, 'core/coredag/dagtransl.go': 4, 'core/coredag/raw.go': 6, 'core/corehttp/corehttp.go': 4, 'core/corehttp/gateway_handler.go': 12, 'core/corerepo/gc.go': 11, 'core/corerepo/pinning.go': 4, 'core/coreunix/metadata.go': 11, 'core/pathresolver.go': 6, 'exchange/bitswap/bitswap.go': 2, 'exchange/bitswap/decision/engine.go': 2, 'exchange/bitswap/decision/ledger.go': 2, 'exchange/bitswap/decision/peer_request_queue.go': 2, 'exchange/bitswap/get.go': 2, 'exchange/bitswap/notifications/notifications.go': 2, 'exchange/bitswap/notifications/notifications_test.go': 2, 'exchange/bitswap/session.go': 2, 'exchange/bitswap/session_test.go': 2, 'exchange/bitswap/stat.go': 2, 'exchange/bitswap/wantlist/wantlist.go': 2, 'exchange/bitswap/wantlist/wantlist_test.go': 2, 'exchange/bitswap/wantmanager.go': 2, 'exchange/bitswap/workers.go': 2, 'exchange/interface.go': 1, 'exchange/offline/offline.go': 1, 'exchange/offline/offline_test.go': 1, 'exchange/reprovide/providers.go': 6, 'exchange/reprovide/reprovide.go': 5, 'filestore/filestore.go': 5, 'filestore/filestore_test.go': 6, 'filestore/fsrefstore.go': 5, 'filestore/util.go': 5, 'fuse/ipns/ipns_unix.go': 11, 'fuse/readonly/readonly_unix.go': 11, 'importer/balanced/builder.go': 2, 'importer/chunk/splitting_test.go': 1, 'importer/helpers/helpers.go': 2, 'importer/importer_test.go': 2, 'importer/trickle/trickle_test.go': 2, 'importer/trickle/trickledag.go': 2, 'merkledag/batch.go': 1, 'merkledag/coding.go': 2, 'merkledag/merkledag.go': 2, 'merkledag/merkledag_test.go': 2, 'merkledag/node.go': 2, 'merkledag/node_test.go': 2, 'merkledag/raw.go': 2, 'merkledag/traverse/traverse.go': 2, 'merkledag/traverse/traverse_test.go': 2, 'merkledag/utils/diff.go': 2, 'merkledag/utils/diffenum.go': 2, 'merkledag/utils/diffenum_test.go': 2, 'merkledag/utils/utils.go': 2, 'mfs/dir.go': 3, 'mfs/file.go': 3, 'mfs/mfs_test.go': 3, 'mfs/ops.go': 2, 'mfs/system.go': 3, 'namesys/namesys.go': 7, 'namesys/publisher.go': 11, 'namesys/pubsub.go': 1, 'namesys/pubsub_test.go': 1, 'namesys/republisher/repub.go': 6, 'namesys/routing.go': 7, 'path/path.go': 2, 'path/resolver.go': 1, 'path/resolver_test.go': 1, 'pin/gc/gc.go': 6, 'pin/pin.go': 6, 'pin/pin_test.go': 6, 'pin/set.go': 6, 'pin/set_test.go': 6, 'plugin/ipld.go': 4, 'plugin/loader/initializer.go': 3, 'plugin/plugins/git/git.go': 4, 'repo/config/init.go': 2, 'repo/fsrepo/fsrepo.go': 5, 'repo/fsrepo/lock/lock.go': 1, 'repo/fsrepo/serialize/serialize.go': 2, 'repo/mock.go': 5, 'repo/repo.go': 5, 'routing/offline/offline.go': 1, 'tar/format.go': 11, 'test/dependencies/ma-pipe-unidir/main.go': 3, 'thirdparty/ds-help/key.go': 1, 'thirdparty/pollEndpoint/main.go': 4, 'thirdparty/posinfo/posinfo.go': 1, 'unixfs/archive/archive.go': 2, 'unixfs/archive/tar/writer.go': 2, 'unixfs/hamt/hamt.go': 2, 'unixfs/io/dagreader.go': 2, 'unixfs/io/dirbuilder.go': 2, 'unixfs/io/resolve.go': 2, 'unixfs/mod/dagmodifier.go': 2, 'unixfs/mod/dagmodifier_test.go': 2, 'unixfs/test/utils.go': 2, 'commands/legacy/command.go': 7, 'commands/legacy/legacy.go': 7, 'commands/legacy/legacy_test.go': 8, 'commands/legacy/request.go': 8, 'commands/legacy/response.go': 8, 'commands/legacy/responseemitter.go': 4, 'core/commands/env.go': 3, 'TODO.md': 2, 'core/commands/commands_test.go': 17, 'test/sharness/t0110-gateway.sh': 1, 'test/sharness/t0410-api-add.sh': 1, 'blocks/blockstoreutil/remove.go': 4, 'blockservice/test/mock.go': 1, 'cmd/ipfs/util/ulimit.go': 3, 'cmd/ipfs/util/ulimit_freebsd.go': 2, 'cmd/ipfs/util/ulimit_unix.go': 2, 'cmd/seccat/util.go': 3, 'core/commands/files.go': 16, 'core/coreapi/block.go': 6, 'core/coreapi/block_test.go': 1, 'core/coreapi/dag.go': 3, 'core/coreapi/dag_test.go': 1, 'core/coreapi/interface/coreapi.go': 2, 'core/coreapi/interface/dag.go': 2, 'core/coreapi/interface/object.go': 2, 'core/coreapi/interface/options/block.go': 1, 'core/coreapi/interface/options/dag.go': 2, 'core/coreapi/interface/path.go': 2, 'core/coreapi/interface/unixfs.go': 5, 'core/coreapi/key.go': 6, 'core/coreapi/name.go': 6, 'core/coreapi/object.go': 10, 'core/coreapi/pin.go': 6, 'core/corehttp/logs.go': 3, 'fuse/ipns/link_unix.go': 2, 'fuse/mount/fuse.go': 2, 'fuse/mount/mount.go': 3, 'fuse/node/mount_darwin.go': 2, 'fuse/node/mount_unix.go': 3, 'keystore/keystore.go': 3, 'merkledag/errservice.go': 1, 'merkledag/readonly.go': 1, 'merkledag/readonly_test.go': 1, 'merkledag/rwservice.go': 1, 'merkledag/session.go': 1, 'merkledag/test/utils.go': 1, 'namesys/ipns_validate_test.go': 1, 'namesys/namesys_test.go': 10, 'namesys/validator.go': 1, 'path/resolver/resolver.go': 1, 'path/resolver/resolver_test.go': 1, 'plugin/loader/load.go': 1, 'repo/fsrepo/datastores.go': 3, 'thirdparty/verifbs/verifbs.go': 4, 'thirdparty/verifcid/validate.go': 1, 'thirdparty/verifcid/validate_test.go': 1, 'unixfs/hamt/hamt_stress_test.go': 1, 'unixfs/hamt/hamt_test.go': 1, 'unixfs/io/pbdagreader.go': 1, 'core/commands/urlstore.go': 15, 'core/coreapi/path.go': 9, 'core/coreunix/cat.go': 2, 'mfs/fd.go': 1, 'core/coreapi/interface/key.go': 1, 'core/coreapi/name_test.go': 3, 'core/pathresolver_test.go': 4, 'dagutils/diff.go': 5, 'dagutils/diffenum.go': 4, 'dagutils/diffenum_test.go': 4, 'dagutils/utils.go': 4, 'dagutils/utils_test.go': 4, 'namesys/base.go': 5, 'namesys/cache.go': 4, 'namesys/ipns_resolver_validation_test.go': 5, 'repo/fsrepo/config_test.go': 3, 'repo/fsrepo/fsrepo_test.go': 3, 'repo/fsrepo/misc.go': 3, 'test/bench/bench_cli_ipfs_add/main.go': 4, 'test/bench/offline_add/main.go': 4, 'thirdparty/cidv0v1/blockstore.go': 3, 'core/commands/cid.go': 13, 'core/commands/cmdenv/env.go': 12, 'core/commands/name/ipns.go': 13, 'core/commands/name/ipnsps.go': 13, 'core/commands/name/name.go': 13, 'core/commands/name/publish.go': 13, 'core/coreapi/unixfile.go': 2, 'commands/context.go': 11, 'core/commands/cmdenv/cidbase.go': 9, 'core/commands/cmdenv/file.go': 3, 'core/coreapi/interface/tests/name.go': 1, 'core/coreapi/interface/tests/unixfs.go': 1, 'core/coreapi/dht.go': 4, 'core/coreapi/pubsub.go': 4, 'core/coreapi/swarm.go': 4, 'core/coreapi/test/api_test.go': 4, 'core/corehttp/ipns_hostname.go': 4, 'namesys/dns_test.go': 4, 'plugin/daemon.go': 4, 'plugin/loader/loader.go': 4, 'core/corehttp/proxy.go': 3, 'filestore/pb/dataobj.pb.go': 2, 'keystore/keystore_test.go': 2, 'keystore/memkeystore.go': 2, 'p2p/listener.go': 2, 'p2p/local.go': 2, 'p2p/remote.go': 2, 'p2p/stream.go': 2, 'pin/internal/pb/header.pb.go': 2, 'plugin/plugins/badgerds/badgerds.go': 3, 'plugin/plugins/flatfs/flatfs.go': 3, 'plugin/plugins/levelds/levelds.go': 2, 'test/dependencies/iptb/iptb.go': 3, 'core/corerepo/stat.go': 2, 'cmd/ipfs/dnsresolve_test.go': 1, 'core/commands/cmdenv/cidbase_test.go': 1, 'core/corehttp/metrics.go': 1, 'core/corehttp/proxy_test.go': 1, 'plugin/tracer.go': 1, 'thirdparty/notifier/notifier.go': 1, 'README.md': 1, 'go.mod': 1, 'go.sum': 1, 'package-list.json': 1, 'core/commands/profile.go': 1, 'docs/debug-guide.md': 1, 'test/sharness/t0152-profile.sh': 1}","('core/commands/active.go', 0.9642857142857143, 0.84375)"
core/commands/dns.go,71,480,2,"[{'cyclomatic_complexity': 4, 'nloc': 19, 'token_count': 123, 'name': '', 'long_name': '(req cmds.Request,res cmds.Response)', 'start_line': 52, 'end_line': 72, 'full_parameters': [], 'filename': '/home/dimi/Documents/Informatik_Studium/FSS/SoftEvo/DataCollection/FFS_SoftEvo/go-ipfs/core/commands/dns.go', 'top_nesting_level': 0, 'length': 21, 'fan_in': 0, 'fan_out': 0, 'general_fan_out': 0}, {'cyclomatic_complexity': 2, 'nloc': 7, 'token_count': 60, 'name': '', 'long_name': '(res cmds.Response)(io.Reader,error)', 'start_line': 74, 'end_line': 80, 'full_parameters': [], 'filename': '/home/dimi/Documents/Informatik_Studium/FSS/SoftEvo/DataCollection/FFS_SoftEvo/go-ipfs/core/commands/dns.go', 'top_nesting_level': 0, 'length': 7, 'fan_in': 0, 'fan_out': 0, 'general_fan_out': 0}]",75,543,0,[],4,63,-2,47,47,"[{'timestamp': 1491058697.0, 'added_lines': 17, 'deleted_lines': 10, 'nloc': 76}, {'timestamp': 1499331469.0, 'added_lines': 1, 'deleted_lines': 1, 'nloc': 76}, {'timestamp': 1511223906.0, 'added_lines': 1, 'deleted_lines': 1, 'nloc': 76}, {'timestamp': 1512365669.0, 'added_lines': 1, 'deleted_lines': 1, 'nloc': 76}, {'timestamp': 1511187070.0, 'added_lines': 1, 'deleted_lines': 1, 'nloc': 76}, {'timestamp': 1513436097.0, 'added_lines': 1, 'deleted_lines': 1, 'nloc': 76}, {'timestamp': 1513612261.0, 'added_lines': 1, 'deleted_lines': 1, 'nloc': 76}, {'timestamp': 1515277696.0, 'added_lines': 1, 'deleted_lines': 1, 'nloc': 76}, {'timestamp': 1519404450.0, 'added_lines': 4, 'deleted_lines': 4, 'nloc': 76}, {'timestamp': 1519855044.0, 'added_lines': 5, 'deleted_lines': 3, 'nloc': 77}, {'timestamp': 1519934965.0, 'added_lines': 1, 'deleted_lines': 1, 'nloc': 77}, {'timestamp': 1528520460.0, 'added_lines': 1, 'deleted_lines': 1, 'nloc': 77}, {'timestamp': 1533946888.0, 'added_lines': 1, 'deleted_lines': 1, 'nloc': 77}, {'timestamp': 1534896611.0, 'added_lines': 1, 'deleted_lines': 1, 'nloc': 77}, {'timestamp': 1534903410.0, 'added_lines': 4, 'deleted_lines': 3, 'nloc': 78}, {'timestamp': 1538662493.0, 'added_lines': 6, 'deleted_lines': 2, 'nloc': 81}, {'timestamp': 1539850591.0, 'added_lines': 1, 'deleted_lines': 1, 'nloc': 81}, {'timestamp': 1540271226.0, 'added_lines': 4, 'deleted_lines': 0, 'nloc': 84}, {'timestamp': 1540558290.0, 'added_lines': 15, 'deleted_lines': 27, 'nloc': 74}, {'timestamp': 1540597832.0, 'added_lines': 1, 'deleted_lines': 1, 'nloc': 74}, {'timestamp': 1540906996.0, 'added_lines': 1, 'deleted_lines': 1, 'nloc': 74}, {'timestamp': 1541204121.0, 'added_lines': 1, 'deleted_lines': 1, 'nloc': 74}, {'timestamp': 1544661332.0, 'added_lines': 1, 'deleted_lines': 1, 'nloc': 74}, {'timestamp': 1540556089.0, 'added_lines': 1, 'deleted_lines': 1, 'nloc': 74}, {'timestamp': 1547152271.0, 'added_lines': 1, 'deleted_lines': 1, 'nloc': 74}, {'timestamp': 1548866534.0, 'added_lines': 1, 'deleted_lines': 1, 'nloc': 74}, {'timestamp': 1549650181.0, 'added_lines': 1, 'deleted_lines': 1, 'nloc': 74}, {'timestamp': 1549672857.0, 'added_lines': 1, 'deleted_lines': 1, 'nloc': 74}, {'timestamp': 1549903582.0, 'added_lines': 2, 'deleted_lines': 2, 'nloc': 74}, {'timestamp': 1550185115.0, 'added_lines': 1, 'deleted_lines': 1, 'nloc': 74}, {'timestamp': 1550507829.0, 'added_lines': 2, 'deleted_lines': 2, 'nloc': 74}, {'timestamp': 1550576884.0, 'added_lines': 1, 'deleted_lines': 1, 'nloc': 74}, {'timestamp': 1550610741.0, 'added_lines': 1, 'deleted_lines': 1, 'nloc': 74}, {'timestamp': 1550711994.0, 'added_lines': 1, 'deleted_lines': 1, 'nloc': 74}, {'timestamp': 1550723346.0, 'added_lines': 1, 'deleted_lines': 1, 'nloc': 74}, {'timestamp': 1551138343.0, 'added_lines': 1, 'deleted_lines': 1, 'nloc': 74}, {'timestamp': 1551229859.0, 'added_lines': 1, 'deleted_lines': 1, 'nloc': 74}, {'timestamp': 1551299964.0, 'added_lines': 2, 'deleted_lines': 2, 'nloc': 74}, {'timestamp': 1551471469.0, 'added_lines': 1, 'deleted_lines': 1, 'nloc': 74}, {'timestamp': 1551551196.0, 'added_lines': 3, 'deleted_lines': 3, 'nloc': 74}, {'timestamp': 1552702853.0, 'added_lines': 1, 'deleted_lines': 1, 'nloc': 74}, {'timestamp': 1552702977.0, 'added_lines': 1, 'deleted_lines': 4, 'nloc': 71}, {'timestamp': 1557554420.0, 'added_lines': 5, 'deleted_lines': 6, 'nloc': 70}, {'timestamp': 1559060517.0, 'added_lines': 3, 'deleted_lines': 3, 'nloc': 70}, {'timestamp': 1608253728.0, 'added_lines': 2, 'deleted_lines': 1, 'nloc': 71}, {'timestamp': 1613691223.0, 'added_lines': 1, 'deleted_lines': 1, 'nloc': 71}, {'timestamp': 1618224384.0, 'added_lines': 6, 'deleted_lines': 1, 'nloc': 75}]","{'blocks/blockstore/caching.go': 1, 'blocks/blockstore/util/remove.go': 2, 'cmd/ipfs/daemon.go': 27, 'cmd/ipfs/init.go': 28, 'cmd/ipfs/ipfs.go': 23, 'cmd/ipfs/main.go': 25, 'cmd/ipfs/main_test.go': 4, 'cmd/ipfswatch/main.go': 12, 'cmd/seccat/seccat.go': 10, None: 34, 'commands/channelmarshaler.go': 1, 'commands/cli/cmd_suggestion.go': 1, 'commands/cli/helptext.go': 2, 'commands/cli/helptext_test.go': 2, 'commands/cli/parse.go': 2, 'commands/cli/parse_test.go': 2, 'commands/command.go': 12, 'commands/command_test.go': 7, 'commands/http/client.go': 2, 'commands/http/handler.go': 2, 'commands/http/multifilereader.go': 2, 'commands/http/multifilereader_test.go': 2, 'commands/http/parse.go': 2, 'commands/reqlog.go': 1, 'commands/request.go': 13, 'commands/response.go': 11, 'commands/response_test.go': 7, 'core/bootstrap.go': 9, 'core/commands/active.go': 25, 'core/commands/add.go': 33, 'core/commands/bitswap.go': 32, 'core/commands/block.go': 34, 'core/commands/bootstrap.go': 26, 'core/commands/cat.go': 33, 'core/commands/commands.go': 26, 'core/commands/config.go': 27, 'core/commands/dag/dag.go': 33, 'core/commands/dht.go': 32, 'core/commands/diag.go': 23, 'core/commands/e/error.go': 1, 'core/commands/external.go': 23, 'core/commands/files/files.go': 8, 'core/commands/filestore.go': 28, 'core/commands/get.go': 34, 'core/commands/helptext_test.go': 23, 'core/commands/id.go': 30, 'core/commands/ipns.go': 14, 'core/commands/keystore.go': 34, 'core/commands/log.go': 24, 'core/commands/ls.go': 33, 'core/commands/mount_nofuse.go': 23, 'core/commands/mount_unix.go': 27, 'core/commands/mount_windows.go': 22, 'core/commands/name.go': 10, 'core/commands/object/diff.go': 30, 'core/commands/object/object.go': 33, 'core/commands/object/patch.go': 33, 'core/commands/p2p.go': 29, 'core/commands/pin.go': 32, 'core/commands/ping.go': 30, 'core/commands/publish.go': 10, 'core/commands/pubsub.go': 35, 'core/commands/refs.go': 30, 'core/commands/repo.go': 30, 'core/commands/resolve.go': 39, 'core/commands/root.go': 28, 'core/commands/shutdown.go': 26, 'core/commands/stat.go': 31, 'core/commands/swarm.go': 31, 'core/commands/sysdiag.go': 25, 'core/commands/tar.go': 31, 'core/commands/unixfs/ls.go': 31, 'core/commands/unixfs/unixfs.go': 23, 'core/commands/version.go': 29, 'core/core_test.go': 6, 'core/corehttp/commands.go': 28, 'core/corehttp/gateway.go': 16, 'core/coreunix/add.go': 24, 'core/coreunix/add_test.go': 24, 'core/coreunix/metadata_test.go': 17, 'exchange/bitswap/bitswap_test.go': 4, 'exchange/bitswap/decision/engine_test.go': 4, 'exchange/bitswap/message/message_test.go': 3, 'exchange/bitswap/message/pb/Makefile': 1, 'exchange/bitswap/testnet/network_test.go': 4, 'exchange/bitswap/testnet/peernet.go': 4, 'exchange/reprovide/reprovide_test.go': 10, 'fuse/ipns/common.go': 17, 'fuse/node/mount_test.go': 10, 'importer/balanced/balanced_test.go': 3, 'importer/chunk/rabin_test.go': 2, 'importer/helpers/dagbuilder.go': 8, 'importer/importer.go': 8, 'merkledag/utils/utils_test.go': 3, 'mfs/repub_test.go': 4, 'namesys/dns.go': 16, 'namesys/interface.go': 17, 'namesys/ipns_select_test.go': 3, 'namesys/proquint.go': 16, 'namesys/republisher/repub_test.go': 16, 'package.json': 28, 'repo/config/identity.go': 1, 'routing/offline/offline_test.go': 3, 'test/integration/addcat_test.go': 16, 'test/integration/bench_cat_test.go': 15, 'test/integration/bitswap_wo_routing_test.go': 12, 'test/integration/three_legged_cat_test.go': 15, 'core/bootstrap_test.go': 8, 'core/commands/dht_test.go': 10, 'core/commands/get_test.go': 24, 'core/core.go': 20, 'core/corehttp/gateway_test.go': 20, 'core/corehttp/metrics_test.go': 12, 'core/mock/mock.go': 12, 'exchange/bitswap/decision/bench_test.go': 3, 'exchange/bitswap/decision/peer_request_queue_test.go': 3, 'exchange/bitswap/message/message.go': 3, 'exchange/bitswap/network/interface.go': 3, 'exchange/bitswap/network/ipfs_impl.go': 3, 'exchange/bitswap/testnet/interface.go': 3, 'exchange/bitswap/testnet/virtual.go': 3, 'exchange/bitswap/testutils.go': 3, 'fuse/ipns/ipns_test.go': 9, 'fuse/readonly/ipfs_test.go': 20, 'namesys/publisher_test.go': 10, 'namesys/resolve_test.go': 15, 'p2p/p2p.go': 9, 'p2p/registry.go': 4, 'repo/config/bootstrap_peers.go': 3, 'routing/mock/centralized_client.go': 2, 'routing/mock/centralized_server.go': 2, 'routing/mock/centralized_test.go': 2, 'routing/mock/interface.go': 2, 'routing/none/none_client.go': 2, 'test/integration/bench_test.go': 9, 'assets/assets.go': 18, 'blocks/blockstore/arc_cache.go': 1, 'blocks/blockstore/arc_cache_test.go': 1, 'blocks/blockstore/blockstore.go': 1, 'blocks/blockstore/blockstore_test.go': 1, 'blocks/blockstore/bloom_cache.go': 1, 'blocks/blockstore/bloom_cache_test.go': 1, 'blocks/blocksutil/block_generator.go': 1, 'blockservice/blockservice.go': 2, 'blockservice/blockservice_test.go': 2, 'blockservice/test/blocks_test.go': 2, 'core/builder.go': 16, 'core/commands/ipnsps.go': 7, 'core/coreapi/coreapi.go': 16, 'core/coreapi/interface/interface.go': 1, 'core/coreapi/unixfs.go': 19, 'core/coreapi/unixfs_test.go': 7, 'core/coredag/cbor.go': 7, 'core/coredag/dagpb.go': 11, 'core/coredag/dagtransl.go': 6, 'core/coredag/raw.go': 11, 'core/corehttp/corehttp.go': 6, 'core/corehttp/gateway_handler.go': 20, 'core/corerepo/gc.go': 16, 'core/corerepo/pinning.go': 5, 'core/coreunix/metadata.go': 16, 'core/pathresolver.go': 13, 'exchange/bitswap/bitswap.go': 2, 'exchange/bitswap/decision/engine.go': 2, 'exchange/bitswap/decision/ledger.go': 2, 'exchange/bitswap/decision/peer_request_queue.go': 2, 'exchange/bitswap/get.go': 2, 'exchange/bitswap/notifications/notifications.go': 2, 'exchange/bitswap/notifications/notifications_test.go': 2, 'exchange/bitswap/session.go': 2, 'exchange/bitswap/session_test.go': 2, 'exchange/bitswap/stat.go': 2, 'exchange/bitswap/wantlist/wantlist.go': 2, 'exchange/bitswap/wantlist/wantlist_test.go': 2, 'exchange/bitswap/wantmanager.go': 2, 'exchange/bitswap/workers.go': 2, 'exchange/interface.go': 1, 'exchange/offline/offline.go': 1, 'exchange/offline/offline_test.go': 1, 'exchange/reprovide/providers.go': 11, 'exchange/reprovide/reprovide.go': 8, 'filestore/filestore.go': 7, 'filestore/filestore_test.go': 11, 'filestore/fsrefstore.go': 7, 'filestore/util.go': 7, 'fuse/ipns/ipns_unix.go': 19, 'fuse/readonly/readonly_unix.go': 16, 'importer/balanced/builder.go': 2, 'importer/chunk/splitting_test.go': 1, 'importer/helpers/helpers.go': 2, 'importer/importer_test.go': 2, 'importer/trickle/trickle_test.go': 2, 'importer/trickle/trickledag.go': 2, 'merkledag/batch.go': 1, 'merkledag/coding.go': 2, 'merkledag/merkledag.go': 2, 'merkledag/merkledag_test.go': 2, 'merkledag/node.go': 2, 'merkledag/node_test.go': 2, 'merkledag/raw.go': 2, 'merkledag/traverse/traverse.go': 2, 'merkledag/traverse/traverse_test.go': 2, 'merkledag/utils/diff.go': 2, 'merkledag/utils/diffenum.go': 2, 'merkledag/utils/diffenum_test.go': 2, 'merkledag/utils/utils.go': 2, 'mfs/dir.go': 3, 'mfs/file.go': 3, 'mfs/mfs_test.go': 3, 'mfs/ops.go': 2, 'mfs/system.go': 3, 'namesys/namesys.go': 18, 'namesys/publisher.go': 17, 'namesys/pubsub.go': 3, 'namesys/pubsub_test.go': 3, 'namesys/republisher/repub.go': 12, 'namesys/routing.go': 18, 'path/path.go': 2, 'path/resolver.go': 1, 'path/resolver_test.go': 1, 'pin/gc/gc.go': 11, 'pin/pin.go': 11, 'pin/pin_test.go': 11, 'pin/set.go': 11, 'pin/set_test.go': 11, 'plugin/ipld.go': 6, 'plugin/loader/initializer.go': 4, 'plugin/plugins/git/git.go': 6, 'repo/config/init.go': 2, 'repo/fsrepo/fsrepo.go': 8, 'repo/fsrepo/lock/lock.go': 1, 'repo/fsrepo/serialize/serialize.go': 2, 'repo/mock.go': 8, 'repo/repo.go': 8, 'routing/offline/offline.go': 1, 'tar/format.go': 16, 'test/dependencies/ma-pipe-unidir/main.go': 5, 'thirdparty/ds-help/key.go': 1, 'thirdparty/pollEndpoint/main.go': 6, 'thirdparty/posinfo/posinfo.go': 1, 'unixfs/archive/archive.go': 2, 'unixfs/archive/tar/writer.go': 2, 'unixfs/hamt/hamt.go': 2, 'unixfs/io/dagreader.go': 2, 'unixfs/io/dirbuilder.go': 2, 'unixfs/io/resolve.go': 2, 'unixfs/mod/dagmodifier.go': 2, 'unixfs/mod/dagmodifier_test.go': 2, 'unixfs/test/utils.go': 2, 'commands/legacy/command.go': 9, 'commands/legacy/legacy.go': 9, 'commands/legacy/legacy_test.go': 10, 'commands/legacy/request.go': 10, 'commands/legacy/response.go': 10, 'commands/legacy/responseemitter.go': 4, 'core/commands/env.go': 3, 'TODO.md': 2, 'core/commands/commands_test.go': 19, 'test/sharness/t0110-gateway.sh': 1, 'test/sharness/t0410-api-add.sh': 1, 'core/coreapi/name.go': 19, 'core/corehttp/ipns_hostname.go': 13, 'namesys/base.go': 15, 'namesys/ipns_validate_test.go': 3, 'namesys/namesys_test.go': 21, 'namesys/opts.go': 1, 'namesys/dns_test.go': 12, 'namesys/opts/opts.go': 1, 'blocks/blockstoreutil/remove.go': 6, 'blockservice/test/mock.go': 1, 'cmd/ipfs/util/ulimit.go': 4, 'cmd/ipfs/util/ulimit_freebsd.go': 2, 'cmd/ipfs/util/ulimit_unix.go': 2, 'cmd/seccat/util.go': 4, 'core/commands/files.go': 26, 'core/coreapi/block.go': 13, 'core/coreapi/block_test.go': 2, 'core/coreapi/dag.go': 5, 'core/coreapi/dag_test.go': 2, 'core/coreapi/interface/coreapi.go': 3, 'core/coreapi/interface/dag.go': 3, 'core/coreapi/interface/object.go': 3, 'core/coreapi/interface/options/block.go': 2, 'core/coreapi/interface/options/dag.go': 3, 'core/coreapi/interface/path.go': 3, 'core/coreapi/interface/unixfs.go': 6, 'core/coreapi/key.go': 14, 'core/coreapi/object.go': 17, 'core/coreapi/pin.go': 13, 'core/corehttp/logs.go': 4, 'fuse/ipns/link_unix.go': 2, 'fuse/mount/fuse.go': 2, 'fuse/mount/mount.go': 4, 'fuse/node/mount_darwin.go': 2, 'fuse/node/mount_unix.go': 4, 'keystore/keystore.go': 5, 'merkledag/errservice.go': 1, 'merkledag/readonly.go': 1, 'merkledag/readonly_test.go': 1, 'merkledag/rwservice.go': 1, 'merkledag/session.go': 1, 'merkledag/test/utils.go': 1, 'namesys/validator.go': 1, 'path/resolver/resolver.go': 1, 'path/resolver/resolver_test.go': 1, 'plugin/loader/load.go': 2, 'repo/fsrepo/datastores.go': 4, 'thirdparty/verifbs/verifbs.go': 6, 'thirdparty/verifcid/validate.go': 1, 'thirdparty/verifcid/validate_test.go': 1, 'unixfs/hamt/hamt_stress_test.go': 1, 'unixfs/hamt/hamt_test.go': 1, 'unixfs/io/pbdagreader.go': 1, 'core/commands/urlstore.go': 22, 'core/coreapi/path.go': 17, 'core/coreunix/cat.go': 2, 'mfs/fd.go': 1, 'core/coreapi/interface/key.go': 2, 'core/coreapi/name_test.go': 4, 'core/pathresolver_test.go': 9, 'dagutils/diff.go': 12, 'dagutils/diffenum.go': 9, 'dagutils/diffenum_test.go': 9, 'dagutils/utils.go': 9, 'dagutils/utils_test.go': 9, 'namesys/cache.go': 9, 'namesys/ipns_resolver_validation_test.go': 14, 'repo/fsrepo/config_test.go': 5, 'repo/fsrepo/fsrepo_test.go': 5, 'repo/fsrepo/misc.go': 5, 'test/bench/bench_cli_ipfs_add/main.go': 6, 'test/bench/offline_add/main.go': 6, 'thirdparty/cidv0v1/blockstore.go': 5, 'core/commands/cmdenv/env.go': 22, 'core/commands/name/ipns.go': 26, 'core/commands/name/ipnsps.go': 18, 'core/commands/name/name.go': 16, 'core/commands/name/publish.go': 23, 'core/commands/cid.go': 17, 'core/coreapi/unixfile.go': 3, 'cmd/ipfs/dnsresolve_test.go': 3, 'core/coreapi/dht.go': 12, 'core/coreapi/dht_test.go': 1, 'core/coreapi/interface/dht.go': 1, 'core/coreapi/interface/options/unixfs.go': 1, 'core/coreapi/interface/pubsub.go': 1, 'core/coreapi/interface/swarm.go': 1, 'core/coreapi/pubsub.go': 12, 'core/coreapi/swarm.go': 12, 'keystore/keystore_test.go': 4, 'keystore/memkeystore.go': 4, 'p2p/listener.go': 5, 'p2p/local.go': 5, 'p2p/remote.go': 5, 'p2p/stream.go': 5, 'test/dependencies/iptb/iptb.go': 8, 'commands/context.go': 17, 'core/commands/cmdenv/cidbase.go': 10, 'core/commands/cmdenv/file.go': 3, 'core/coreapi/interface/tests/name.go': 1, 'core/coreapi/interface/tests/unixfs.go': 1, 'core/coreapi/interface/options/name.go': 1, 'core/coreapi/interface/options/namesys/opts.go': 1, 'core/coreapi/test/api_test.go': 12, 'plugin/daemon.go': 10, 'plugin/loader/loader.go': 10, 'core/corehttp/proxy.go': 7, 'filestore/pb/dataobj.pb.go': 2, 'pin/internal/pb/header.pb.go': 2, 'plugin/plugins/badgerds/badgerds.go': 3, 'plugin/plugins/flatfs/flatfs.go': 3, 'plugin/plugins/levelds/levelds.go': 2, 'core/corerepo/stat.go': 2, 'core/commands/cmdenv/cidbase_test.go': 2, 'core/corehttp/metrics.go': 1, 'core/corehttp/proxy_test.go': 2, 'plugin/tracer.go': 1, 'thirdparty/notifier/notifier.go': 1, 'README.md': 1, 'go.mod': 3, 'go.sum': 3, 'package-list.json': 1, 'core/bootstrap/bootstrap.go': 1, 'core/bootstrap/bootstrap_test.go': 1, 'core/node/builder.go': 1, 'core/node/core.go': 1, 'core/node/groups.go': 2, 'core/node/identity.go': 1, 'core/node/ipns.go': 3, 'core/node/libp2p/addrs.go': 1, 'core/node/libp2p/discovery.go': 1, 'core/node/libp2p/host.go': 1, 'core/node/libp2p/hostopt.go': 1, 'core/node/libp2p/libp2p.go': 1, 'core/node/libp2p/nat.go': 1, 'core/node/libp2p/pnet.go': 1, 'core/node/libp2p/pubsub.go': 1, 'core/node/libp2p/routing.go': 1, 'core/node/libp2p/routingopt.go': 1, 'core/node/libp2p/smux.go': 1, 'core/node/libp2p/transport.go': 1, 'core/node/provider.go': 1, 'provider/simple/provider.go': 1, 'provider/simple/provider_test.go': 1, 'provider/simple/reprovide.go': 1, 'provider/simple/reprovide_test.go': 1, 'core/commands/pin/remotepin.go': 1, 'core/corehttp/hostname.go': 1, 'core/node/dns.go': 1, 'core/node/libp2p/dns.go': 1}","('core/commands/resolve.go', 0.8297872340425532, 0.42857142857142855)"
core/commands/external.go,60,366,3,"[{'cyclomatic_complexity': 2, 'nloc': 7, 'token_count': 33, 'name': '', 'long_name': '()', 'start_line': 68, 'end_line': 75, 'full_parameters': [], 'filename': '/home/dimi/Documents/Informatik_Studium/FSS/SoftEvo/DataCollection/FFS_SoftEvo/go-ipfs/core/commands/external.go', 'top_nesting_level': 0, 'length': 8, 'fan_in': 0, 'fan_out': 0, 'general_fan_out': 0}, {'cyclomatic_complexity': 7, 'nloc': 36, 'token_count': 274, 'name': '', 'long_name': '(req cmds.Request,res cmds.Response)', 'start_line': 20, 'end_line': 76, 'full_parameters': [], 'filename': '/home/dimi/Documents/Informatik_Studium/FSS/SoftEvo/DataCollection/FFS_SoftEvo/go-ipfs/core/commands/external.go', 'top_nesting_level': 0, 'length': 57, 'fan_in': 0, 'fan_out': 0, 'general_fan_out': 0}, {'cyclomatic_complexity': 1, 'nloc': 9, 'token_count': 48, 'name': 'ExternalBinary', 'long_name': 'ExternalBinary', 'start_line': 14, 'end_line': 78, 'full_parameters': [], 'filename': '/home/dimi/Documents/Informatik_Studium/FSS/SoftEvo/DataCollection/FFS_SoftEvo/go-ipfs/core/commands/external.go', 'top_nesting_level': 0, 'length': 65, 'fan_in': 0, 'fan_out': 0, 'general_fan_out': 0}]",58,339,3,"[{'cyclomatic_complexity': 1, 'nloc': 1, 'token_count': 9, 'name': '', 'long_name': '()', 'start_line': 63, 'end_line': 63, 'full_parameters': [], 'filename': '/home/dimi/Documents/Informatik_Studium/FSS/SoftEvo/DataCollection/FFS_SoftEvo/go-ipfs/core/commands/external.go', 'top_nesting_level': 0, 'length': 1, 'fan_in': 0, 'fan_out': 0, 'general_fan_out': 0}, {'cyclomatic_complexity': 1, 'nloc': 6, 'token_count': 24, 'name': '', 'long_name': '()', 'start_line': 61, 'end_line': 66, 'full_parameters': [], 'filename': '/home/dimi/Documents/Informatik_Studium/FSS/SoftEvo/DataCollection/FFS_SoftEvo/go-ipfs/core/commands/external.go', 'top_nesting_level': 0, 'length': 6, 'fan_in': 0, 'fan_out': 0, 'general_fan_out': 0}, {'cyclomatic_complexity': 7, 'nloc': 35, 'token_count': 244, 'name': 'error', 'long_name': '(req*cmds.Request,res cmds.ResponseEmitter,env cmds.Environment)error', 'start_line': 21, 'end_line': 75, 'full_parameters': [], 'filename': '/home/dimi/Documents/Informatik_Studium/FSS/SoftEvo/DataCollection/FFS_SoftEvo/go-ipfs/core/commands/external.go', 'top_nesting_level': 0, 'length': 55, 'fan_in': 0, 'fan_out': 0, 'general_fan_out': 0}]",-2,-27,0,28,28,"[{'timestamp': 1491058697.0, 'added_lines': 7, 'deleted_lines': 5, 'nloc': 61}, {'timestamp': 1511223906.0, 'added_lines': 1, 'deleted_lines': 1, 'nloc': 61}, {'timestamp': 1512365669.0, 'added_lines': 1, 'deleted_lines': 1, 'nloc': 61}, {'timestamp': 1511187070.0, 'added_lines': 1, 'deleted_lines': 1, 'nloc': 61}, {'timestamp': 1513436097.0, 'added_lines': 1, 'deleted_lines': 1, 'nloc': 61}, {'timestamp': 1513612261.0, 'added_lines': 1, 'deleted_lines': 1, 'nloc': 61}, {'timestamp': 1515277696.0, 'added_lines': 1, 'deleted_lines': 1, 'nloc': 61}, {'timestamp': 1528520460.0, 'added_lines': 1, 'deleted_lines': 1, 'nloc': 61}, {'timestamp': 1530824936.0, 'added_lines': 10, 'deleted_lines': 2, 'nloc': 68}, {'timestamp': 1533946888.0, 'added_lines': 1, 'deleted_lines': 1, 'nloc': 68}, {'timestamp': 1534896611.0, 'added_lines': 1, 'deleted_lines': 1, 'nloc': 68}, {'timestamp': 1539850591.0, 'added_lines': 1, 'deleted_lines': 1, 'nloc': 68}, {'timestamp': 1541259636.0, 'added_lines': 26, 'deleted_lines': 27, 'nloc': 66}, {'timestamp': 1544661332.0, 'added_lines': 1, 'deleted_lines': 1, 'nloc': 66}, {'timestamp': 1540556089.0, 'added_lines': 1, 'deleted_lines': 1, 'nloc': 66}, {'timestamp': 1547152271.0, 'added_lines': 1, 'deleted_lines': 1, 'nloc': 66}, {'timestamp': 1548866534.0, 'added_lines': 1, 'deleted_lines': 1, 'nloc': 66}, {'timestamp': 1549903582.0, 'added_lines': 1, 'deleted_lines': 1, 'nloc': 66}, {'timestamp': 1550507829.0, 'added_lines': 1, 'deleted_lines': 1, 'nloc': 66}, {'timestamp': 1550610741.0, 'added_lines': 1, 'deleted_lines': 1, 'nloc': 66}, {'timestamp': 1551138343.0, 'added_lines': 1, 'deleted_lines': 1, 'nloc': 66}, {'timestamp': 1551299964.0, 'added_lines': 1, 'deleted_lines': 1, 'nloc': 66}, {'timestamp': 1551471469.0, 'added_lines': 1, 'deleted_lines': 1, 'nloc': 66}, {'timestamp': 1551754061.0, 'added_lines': 0, 'deleted_lines': 11, 'nloc': 58}, {'timestamp': 1551551196.0, 'added_lines': 2, 'deleted_lines': 2, 'nloc': 58}, {'timestamp': 1557554420.0, 'added_lines': 2, 'deleted_lines': 3, 'nloc': 57}, {'timestamp': 1564169853.0, 'added_lines': 2, 'deleted_lines': 2, 'nloc': 57}, {'timestamp': 1595277534.0, 'added_lines': 1, 'deleted_lines': 0, 'nloc': 58}]","{'blocks/blockstore/caching.go': 1, 'blocks/blockstore/util/remove.go': 2, 'cmd/ipfs/daemon.go': 24, 'cmd/ipfs/init.go': 25, 'cmd/ipfs/ipfs.go': 22, 'cmd/ipfs/main.go': 23, 'cmd/ipfs/main_test.go': 4, 'cmd/ipfswatch/main.go': 11, 'cmd/seccat/seccat.go': 7, None: 13, 'commands/channelmarshaler.go': 1, 'commands/cli/cmd_suggestion.go': 1, 'commands/cli/helptext.go': 2, 'commands/cli/helptext_test.go': 2, 'commands/cli/parse.go': 2, 'commands/cli/parse_test.go': 2, 'commands/command.go': 11, 'commands/command_test.go': 7, 'commands/http/client.go': 2, 'commands/http/handler.go': 2, 'commands/http/multifilereader.go': 2, 'commands/http/multifilereader_test.go': 2, 'commands/http/parse.go': 2, 'commands/reqlog.go': 1, 'commands/request.go': 11, 'commands/response.go': 11, 'commands/response_test.go': 7, 'core/bootstrap.go': 7, 'core/commands/active.go': 24, 'core/commands/add.go': 23, 'core/commands/bitswap.go': 23, 'core/commands/block.go': 23, 'core/commands/bootstrap.go': 23, 'core/commands/cat.go': 23, 'core/commands/commands.go': 24, 'core/commands/config.go': 24, 'core/commands/dag/dag.go': 23, 'core/commands/dht.go': 23, 'core/commands/diag.go': 23, 'core/commands/dns.go': 23, 'core/commands/e/error.go': 1, 'core/commands/files/files.go': 7, 'core/commands/filestore.go': 23, 'core/commands/get.go': 23, 'core/commands/helptext_test.go': 21, 'core/commands/id.go': 23, 'core/commands/ipns.go': 10, 'core/commands/keystore.go': 24, 'core/commands/log.go': 24, 'core/commands/ls.go': 23, 'core/commands/mount_nofuse.go': 23, 'core/commands/mount_unix.go': 23, 'core/commands/mount_windows.go': 22, 'core/commands/name.go': 10, 'core/commands/object/diff.go': 23, 'core/commands/object/object.go': 23, 'core/commands/object/patch.go': 23, 'core/commands/p2p.go': 23, 'core/commands/pin.go': 23, 'core/commands/ping.go': 23, 'core/commands/publish.go': 10, 'core/commands/pubsub.go': 23, 'core/commands/refs.go': 23, 'core/commands/repo.go': 24, 'core/commands/resolve.go': 23, 'core/commands/root.go': 25, 'core/commands/shutdown.go': 23, 'core/commands/stat.go': 23, 'core/commands/swarm.go': 23, 'core/commands/sysdiag.go': 23, 'core/commands/tar.go': 23, 'core/commands/unixfs/ls.go': 23, 'core/commands/unixfs/unixfs.go': 23, 'core/commands/version.go': 24, 'core/core_test.go': 4, 'core/corehttp/commands.go': 22, 'core/corehttp/gateway.go': 9, 'core/coreunix/add.go': 17, 'core/coreunix/add_test.go': 17, 'core/coreunix/metadata_test.go': 12, 'exchange/bitswap/bitswap_test.go': 4, 'exchange/bitswap/decision/engine_test.go': 4, 'exchange/bitswap/message/message_test.go': 3, 'exchange/bitswap/message/pb/Makefile': 1, 'exchange/bitswap/testnet/network_test.go': 4, 'exchange/bitswap/testnet/peernet.go': 4, 'exchange/reprovide/reprovide_test.go': 7, 'fuse/ipns/common.go': 10, 'fuse/node/mount_test.go': 7, 'importer/balanced/balanced_test.go': 3, 'importer/chunk/rabin_test.go': 2, 'importer/helpers/dagbuilder.go': 8, 'importer/importer.go': 8, 'merkledag/utils/utils_test.go': 3, 'mfs/repub_test.go': 4, 'namesys/dns.go': 6, 'namesys/interface.go': 6, 'namesys/ipns_select_test.go': 3, 'namesys/proquint.go': 6, 'namesys/republisher/repub_test.go': 8, 'package.json': 21, 'repo/config/identity.go': 1, 'routing/offline/offline_test.go': 3, 'test/integration/addcat_test.go': 11, 'test/integration/bench_cat_test.go': 10, 'test/integration/bitswap_wo_routing_test.go': 8, 'test/integration/three_legged_cat_test.go': 10, 'core/bootstrap_test.go': 6, 'core/commands/dht_test.go': 6, 'core/commands/get_test.go': 22, 'core/core.go': 12, 'core/corehttp/gateway_test.go': 9, 'core/corehttp/metrics_test.go': 7, 'core/mock/mock.go': 8, 'exchange/bitswap/decision/bench_test.go': 3, 'exchange/bitswap/decision/peer_request_queue_test.go': 3, 'exchange/bitswap/message/message.go': 3, 'exchange/bitswap/network/interface.go': 3, 'exchange/bitswap/network/ipfs_impl.go': 3, 'exchange/bitswap/testnet/interface.go': 3, 'exchange/bitswap/testnet/virtual.go': 3, 'exchange/bitswap/testutils.go': 3, 'fuse/ipns/ipns_test.go': 6, 'fuse/readonly/ipfs_test.go': 12, 'namesys/publisher_test.go': 6, 'namesys/resolve_test.go': 7, 'p2p/p2p.go': 6, 'p2p/registry.go': 4, 'repo/config/bootstrap_peers.go': 3, 'routing/mock/centralized_client.go': 2, 'routing/mock/centralized_server.go': 2, 'routing/mock/centralized_test.go': 2, 'routing/mock/interface.go': 2, 'routing/none/none_client.go': 2, 'test/integration/bench_test.go': 6, 'assets/assets.go': 11, 'blocks/blockstore/arc_cache.go': 1, 'blocks/blockstore/arc_cache_test.go': 1, 'blocks/blockstore/blockstore.go': 1, 'blocks/blockstore/blockstore_test.go': 1, 'blocks/blockstore/bloom_cache.go': 1, 'blocks/blockstore/bloom_cache_test.go': 1, 'blocks/blocksutil/block_generator.go': 1, 'blockservice/blockservice.go': 2, 'blockservice/blockservice_test.go': 2, 'blockservice/test/blocks_test.go': 2, 'core/builder.go': 11, 'core/commands/ipnsps.go': 7, 'core/coreapi/coreapi.go': 6, 'core/coreapi/interface/interface.go': 1, 'core/coreapi/unixfs.go': 12, 'core/coreapi/unixfs_test.go': 6, 'core/coredag/cbor.go': 4, 'core/coredag/dagpb.go': 6, 'core/coredag/dagtransl.go': 4, 'core/coredag/raw.go': 6, 'core/corehttp/corehttp.go': 4, 'core/corehttp/gateway_handler.go': 12, 'core/corerepo/gc.go': 11, 'core/corerepo/pinning.go': 4, 'core/coreunix/metadata.go': 11, 'core/pathresolver.go': 6, 'exchange/bitswap/bitswap.go': 2, 'exchange/bitswap/decision/engine.go': 2, 'exchange/bitswap/decision/ledger.go': 2, 'exchange/bitswap/decision/peer_request_queue.go': 2, 'exchange/bitswap/get.go': 2, 'exchange/bitswap/notifications/notifications.go': 2, 'exchange/bitswap/notifications/notifications_test.go': 2, 'exchange/bitswap/session.go': 2, 'exchange/bitswap/session_test.go': 2, 'exchange/bitswap/stat.go': 2, 'exchange/bitswap/wantlist/wantlist.go': 2, 'exchange/bitswap/wantlist/wantlist_test.go': 2, 'exchange/bitswap/wantmanager.go': 2, 'exchange/bitswap/workers.go': 2, 'exchange/interface.go': 1, 'exchange/offline/offline.go': 1, 'exchange/offline/offline_test.go': 1, 'exchange/reprovide/providers.go': 6, 'exchange/reprovide/reprovide.go': 5, 'filestore/filestore.go': 5, 'filestore/filestore_test.go': 6, 'filestore/fsrefstore.go': 5, 'filestore/util.go': 5, 'fuse/ipns/ipns_unix.go': 11, 'fuse/readonly/readonly_unix.go': 11, 'importer/balanced/builder.go': 2, 'importer/chunk/splitting_test.go': 1, 'importer/helpers/helpers.go': 2, 'importer/importer_test.go': 2, 'importer/trickle/trickle_test.go': 2, 'importer/trickle/trickledag.go': 2, 'merkledag/batch.go': 1, 'merkledag/coding.go': 2, 'merkledag/merkledag.go': 2, 'merkledag/merkledag_test.go': 2, 'merkledag/node.go': 2, 'merkledag/node_test.go': 2, 'merkledag/raw.go': 2, 'merkledag/traverse/traverse.go': 2, 'merkledag/traverse/traverse_test.go': 2, 'merkledag/utils/diff.go': 2, 'merkledag/utils/diffenum.go': 2, 'merkledag/utils/diffenum_test.go': 2, 'merkledag/utils/utils.go': 2, 'mfs/dir.go': 3, 'mfs/file.go': 3, 'mfs/mfs_test.go': 3, 'mfs/ops.go': 2, 'mfs/system.go': 3, 'namesys/namesys.go': 7, 'namesys/publisher.go': 11, 'namesys/pubsub.go': 1, 'namesys/pubsub_test.go': 1, 'namesys/republisher/repub.go': 6, 'namesys/routing.go': 7, 'path/path.go': 2, 'path/resolver.go': 1, 'path/resolver_test.go': 1, 'pin/gc/gc.go': 6, 'pin/pin.go': 6, 'pin/pin_test.go': 6, 'pin/set.go': 6, 'pin/set_test.go': 6, 'plugin/ipld.go': 4, 'plugin/loader/initializer.go': 3, 'plugin/plugins/git/git.go': 4, 'repo/config/init.go': 2, 'repo/fsrepo/fsrepo.go': 5, 'repo/fsrepo/lock/lock.go': 1, 'repo/fsrepo/serialize/serialize.go': 2, 'repo/mock.go': 5, 'repo/repo.go': 5, 'routing/offline/offline.go': 1, 'tar/format.go': 11, 'test/dependencies/ma-pipe-unidir/main.go': 3, 'thirdparty/ds-help/key.go': 1, 'thirdparty/pollEndpoint/main.go': 4, 'thirdparty/posinfo/posinfo.go': 1, 'unixfs/archive/archive.go': 2, 'unixfs/archive/tar/writer.go': 2, 'unixfs/hamt/hamt.go': 2, 'unixfs/io/dagreader.go': 2, 'unixfs/io/dirbuilder.go': 2, 'unixfs/io/resolve.go': 2, 'unixfs/mod/dagmodifier.go': 2, 'unixfs/mod/dagmodifier_test.go': 2, 'unixfs/test/utils.go': 2, 'commands/legacy/command.go': 7, 'commands/legacy/legacy.go': 7, 'commands/legacy/legacy_test.go': 8, 'commands/legacy/request.go': 8, 'commands/legacy/response.go': 8, 'commands/legacy/responseemitter.go': 4, 'core/commands/env.go': 3, 'TODO.md': 2, 'core/commands/commands_test.go': 17, 'test/sharness/t0110-gateway.sh': 1, 'test/sharness/t0410-api-add.sh': 1, 'blocks/blockstoreutil/remove.go': 4, 'blockservice/test/mock.go': 1, 'cmd/ipfs/util/ulimit.go': 3, 'cmd/ipfs/util/ulimit_freebsd.go': 2, 'cmd/ipfs/util/ulimit_unix.go': 2, 'cmd/seccat/util.go': 3, 'core/commands/files.go': 16, 'core/coreapi/block.go': 6, 'core/coreapi/block_test.go': 1, 'core/coreapi/dag.go': 3, 'core/coreapi/dag_test.go': 1, 'core/coreapi/interface/coreapi.go': 2, 'core/coreapi/interface/dag.go': 2, 'core/coreapi/interface/object.go': 2, 'core/coreapi/interface/options/block.go': 1, 'core/coreapi/interface/options/dag.go': 2, 'core/coreapi/interface/path.go': 2, 'core/coreapi/interface/unixfs.go': 5, 'core/coreapi/key.go': 6, 'core/coreapi/name.go': 6, 'core/coreapi/object.go': 10, 'core/coreapi/pin.go': 6, 'core/corehttp/logs.go': 3, 'fuse/ipns/link_unix.go': 2, 'fuse/mount/fuse.go': 2, 'fuse/mount/mount.go': 3, 'fuse/node/mount_darwin.go': 2, 'fuse/node/mount_unix.go': 3, 'keystore/keystore.go': 3, 'merkledag/errservice.go': 1, 'merkledag/readonly.go': 1, 'merkledag/readonly_test.go': 1, 'merkledag/rwservice.go': 1, 'merkledag/session.go': 1, 'merkledag/test/utils.go': 1, 'namesys/ipns_validate_test.go': 1, 'namesys/namesys_test.go': 10, 'namesys/validator.go': 1, 'path/resolver/resolver.go': 1, 'path/resolver/resolver_test.go': 1, 'plugin/loader/load.go': 1, 'repo/fsrepo/datastores.go': 3, 'thirdparty/verifbs/verifbs.go': 4, 'thirdparty/verifcid/validate.go': 1, 'thirdparty/verifcid/validate_test.go': 1, 'unixfs/hamt/hamt_stress_test.go': 1, 'unixfs/hamt/hamt_test.go': 1, 'unixfs/io/pbdagreader.go': 1, 'core/commands/urlstore.go': 15, 'core/coreapi/path.go': 9, 'core/coreunix/cat.go': 2, 'mfs/fd.go': 1, 'core/coreapi/interface/key.go': 1, 'core/coreapi/name_test.go': 3, 'core/pathresolver_test.go': 4, 'dagutils/diff.go': 5, 'dagutils/diffenum.go': 4, 'dagutils/diffenum_test.go': 4, 'dagutils/utils.go': 4, 'dagutils/utils_test.go': 4, 'namesys/base.go': 5, 'namesys/cache.go': 4, 'namesys/ipns_resolver_validation_test.go': 5, 'repo/fsrepo/config_test.go': 3, 'repo/fsrepo/fsrepo_test.go': 3, 'repo/fsrepo/misc.go': 3, 'test/bench/bench_cli_ipfs_add/main.go': 4, 'test/bench/offline_add/main.go': 4, 'thirdparty/cidv0v1/blockstore.go': 3, 'core/commands/cid.go': 14, 'core/commands/cmdenv/env.go': 12, 'core/commands/name/ipns.go': 13, 'core/commands/name/ipnsps.go': 13, 'core/commands/name/name.go': 13, 'core/commands/name/publish.go': 13, 'core/coreapi/unixfile.go': 2, 'commands/context.go': 12, 'core/commands/cmdenv/cidbase.go': 9, 'core/commands/cmdenv/file.go': 3, 'core/coreapi/interface/tests/name.go': 1, 'core/coreapi/interface/tests/unixfs.go': 1, 'core/coreapi/dht.go': 4, 'core/coreapi/pubsub.go': 4, 'core/coreapi/swarm.go': 4, 'core/coreapi/test/api_test.go': 4, 'core/corehttp/ipns_hostname.go': 4, 'namesys/dns_test.go': 4, 'plugin/daemon.go': 4, 'plugin/loader/loader.go': 4, 'core/corehttp/proxy.go': 3, 'filestore/pb/dataobj.pb.go': 2, 'keystore/keystore_test.go': 2, 'keystore/memkeystore.go': 2, 'p2p/listener.go': 2, 'p2p/local.go': 2, 'p2p/remote.go': 2, 'p2p/stream.go': 2, 'pin/internal/pb/header.pb.go': 2, 'plugin/plugins/badgerds/badgerds.go': 3, 'plugin/plugins/flatfs/flatfs.go': 3, 'plugin/plugins/levelds/levelds.go': 2, 'test/dependencies/iptb/iptb.go': 3, 'core/corerepo/stat.go': 2, 'cmd/ipfs/dnsresolve_test.go': 1, 'core/commands/cmdenv/cidbase_test.go': 1, 'core/corehttp/metrics.go': 1, 'core/corehttp/proxy_test.go': 1, 'plugin/tracer.go': 1, 'thirdparty/notifier/notifier.go': 1, 'README.md': 1, 'go.mod': 2, 'go.sum': 2, 'package-list.json': 1, 'cmd/ipfs/rotate.go': 1, 'core/commands/extra.go': 1}","('cmd/ipfs/init.go', 0.8928571428571429, 0.30120481927710846)"
core/commands/filestore.go,238,1513,11,"[{'cyclomatic_complexity': 2, 'nloc': 15, 'token_count': 104, 'name': '*', 'long_name': '(c*cid.Cid)*', 'start_line': 54, 'end_line': 68, 'full_parameters': [], 'filename': '/home/dimi/Documents/Informatik_Studium/FSS/SoftEvo/DataCollection/FFS_SoftEvo/go-ipfs/core/commands/filestore.go', 'top_nesting_level': 0, 'length': 15, 'fan_in': 0, 'fan_out': 0, 'general_fan_out': 0}, {'cyclomatic_complexity': 5, 'nloc': 20, 'token_count': 132, 'name': '', 'long_name': '(res cmds.Response)(io.Reader,error)', 'start_line': 70, 'end_line': 89, 'full_parameters': [], 'filename': '/home/dimi/Documents/Informatik_Studium/FSS/SoftEvo/DataCollection/FFS_SoftEvo/go-ipfs/core/commands/filestore.go', 'top_nesting_level': 0, 'length': 20, 'fan_in': 0, 'fan_out': 0, 'general_fan_out': 0}, {'cyclomatic_complexity': 2, 'nloc': 15, 'token_count': 104, 'name': '*', 'long_name': '(c*cid.Cid)*', 'start_line': 132, 'end_line': 146, 'full_parameters': [], 'filename': '/home/dimi/Documents/Informatik_Studium/FSS/SoftEvo/DataCollection/FFS_SoftEvo/go-ipfs/core/commands/filestore.go', 'top_nesting_level': 0, 'length': 15, 'fan_in': 0, 'fan_out': 0, 'general_fan_out': 0}, {'cyclomatic_complexity': 4, 'nloc': 15, 'token_count': 126, 'name': '', 'long_name': '(res cmds.Response)(io.Reader,error)', 'start_line': 148, 'end_line': 162, 'full_parameters': [], 'filename': '/home/dimi/Documents/Informatik_Studium/FSS/SoftEvo/DataCollection/FFS_SoftEvo/go-ipfs/core/commands/filestore.go', 'top_nesting_level': 0, 'length': 15, 'fan_in': 0, 'fan_out': 0, 'general_fan_out': 0}, {'cyclomatic_complexity': 4, 'nloc': 13, 'token_count': 70, 'name': '', 'long_name': '()', 'start_line': 186, 'end_line': 198, 'full_parameters': [], 'filename': '/home/dimi/Documents/Informatik_Studium/FSS/SoftEvo/DataCollection/FFS_SoftEvo/go-ipfs/core/commands/filestore.go', 'top_nesting_level': 0, 'length': 13, 'fan_in': 0, 'fan_out': 0, 'general_fan_out': 0}, {'cyclomatic_complexity': 3, 'nloc': 15, 'token_count': 107, 'name': '', 'long_name': '(req cmds.Request,res cmds.Response)', 'start_line': 171, 'end_line': 199, 'full_parameters': [], 'filename': '/home/dimi/Documents/Informatik_Studium/FSS/SoftEvo/DataCollection/FFS_SoftEvo/go-ipfs/core/commands/filestore.go', 'top_nesting_level': 0, 'length': 29, 'fan_in': 0, 'fan_out': 0, 'general_fan_out': 0}, {'cyclomatic_complexity': 3, 'nloc': 11, 'token_count': 76, 'name': 'getFilestore', 'long_name': 'getFilestore req cmds . Request', 'start_line': 204, 'end_line': 214, 'full_parameters': ['req cmds . Request'], 'filename': '/home/dimi/Documents/Informatik_Studium/FSS/SoftEvo/DataCollection/FFS_SoftEvo/go-ipfs/core/commands/filestore.go', 'top_nesting_level': 0, 'length': 11, 'fan_in': 0, 'fan_out': 0, 'general_fan_out': 0}, {'cyclomatic_complexity': 1, 'nloc': 1, 'token_count': 23, 'name': 'listResToChan', 'long_name': 'listResToChan next func * filestore . ListRes , ctx context . Context', 'start_line': 216, 'end_line': 216, 'full_parameters': ['next func * filestore . ListRes', ' ctx context . Context'], 'filename': '/home/dimi/Documents/Informatik_Studium/FSS/SoftEvo/DataCollection/FFS_SoftEvo/go-ipfs/core/commands/filestore.go', 'top_nesting_level': 0, 'length': 1, 'fan_in': 0, 'fan_out': 0, 'general_fan_out': 0}, {'cyclomatic_complexity': 5, 'nloc': 14, 'token_count': 44, 'name': '', 'long_name': '()', 'start_line': 218, 'end_line': 231, 'full_parameters': [], 'filename': '/home/dimi/Documents/Informatik_Studium/FSS/SoftEvo/DataCollection/FFS_SoftEvo/go-ipfs/core/commands/filestore.go', 'top_nesting_level': 0, 'length': 14, 'fan_in': 0, 'fan_out': 0, 'general_fan_out': 0}, {'cyclomatic_complexity': 1, 'nloc': 1, 'token_count': 32, 'name': 'perKeyActionToChan', 'long_name': 'perKeyActionToChan args [ ] string , action func * cid . Cid * filestore . ListRes , ctx context . Context', 'start_line': 235, 'end_line': 235, 'full_parameters': ['args [ ] string', ' action func * cid . Cid * filestore . ListRes', ' ctx context . Context'], 'filename': '/home/dimi/Documents/Informatik_Studium/FSS/SoftEvo/DataCollection/FFS_SoftEvo/go-ipfs/core/commands/filestore.go', 'top_nesting_level': 0, 'length': 1, 'fan_in': 0, 'fan_out': 0, 'general_fan_out': 0}, {'cyclomatic_complexity': 5, 'nloc': 19, 'token_count': 89, 'name': '', 'long_name': '()', 'start_line': 237, 'end_line': 255, 'full_parameters': [], 'filename': '/home/dimi/Documents/Informatik_Studium/FSS/SoftEvo/DataCollection/FFS_SoftEvo/go-ipfs/core/commands/filestore.go', 'top_nesting_level': 0, 'length': 19, 'fan_in': 0, 'fan_out': 0, 'general_fan_out': 0}]",226,1316,2,"[{'cyclomatic_complexity': 3, 'nloc': 11, 'token_count': 70, 'name': 'getFilestore', 'long_name': 'getFilestore env cmds . Environment', 'start_line': 226, 'end_line': 236, 'full_parameters': ['env cmds . Environment'], 'filename': '/home/dimi/Documents/Informatik_Studium/FSS/SoftEvo/DataCollection/FFS_SoftEvo/go-ipfs/core/commands/filestore.go', 'top_nesting_level': 0, 'length': 11, 'fan_in': 0, 'fan_out': 0, 'general_fan_out': 0}, {'cyclomatic_complexity': 5, 'nloc': 20, 'token_count': 121, 'name': 'listByArgs', 'long_name': 'listByArgs res cmds . ResponseEmitter , fs * filestore . Filestore , args [ ] string', 'start_line': 238, 'end_line': 258, 'full_parameters': ['res cmds . ResponseEmitter', ' fs * filestore . Filestore', ' args [ ] string'], 'filename': '/home/dimi/Documents/Informatik_Studium/FSS/SoftEvo/DataCollection/FFS_SoftEvo/go-ipfs/core/commands/filestore.go', 'top_nesting_level': 0, 'length': 21, 'fan_in': 0, 'fan_out': 0, 'general_fan_out': 0}]",-12,-197,-9,77,77,"[{'timestamp': 1491058697.0, 'added_lines': 110, 'deleted_lines': 71, 'nloc': 264}, {'timestamp': 1508770239.0, 'added_lines': 1, 'deleted_lines': 1, 'nloc': 264}, {'timestamp': 1509016767.0, 'added_lines': 1, 'deleted_lines': 1, 'nloc': 264}, {'timestamp': 1511223906.0, 'added_lines': 2, 'deleted_lines': 2, 'nloc': 264}, {'timestamp': 1511373659.0, 'added_lines': 1, 'deleted_lines': 1, 'nloc': 264}, {'timestamp': 1512365669.0, 'added_lines': 3, 'deleted_lines': 3, 'nloc': 264}, {'timestamp': 1511187070.0, 'added_lines': 15, 'deleted_lines': 20, 'nloc': 260}, {'timestamp': 1512121226.0, 'added_lines': 1, 'deleted_lines': 1, 'nloc': 260}, {'timestamp': 1513436097.0, 'added_lines': 2, 'deleted_lines': 2, 'nloc': 260}, {'timestamp': 1513612261.0, 'added_lines': 2, 'deleted_lines': 2, 'nloc': 260}, {'timestamp': 1513764708.0, 'added_lines': 1, 'deleted_lines': 1, 'nloc': 260}, {'timestamp': 1513765470.0, 'added_lines': 1, 'deleted_lines': 1, 'nloc': 260}, {'timestamp': 1513766201.0, 'added_lines': 1, 'deleted_lines': 1, 'nloc': 260}, {'timestamp': 1513772654.0, 'added_lines': 1, 'deleted_lines': 1, 'nloc': 260}, {'timestamp': 1513773452.0, 'added_lines': 1, 'deleted_lines': 1, 'nloc': 260}, {'timestamp': 1515277696.0, 'added_lines': 1, 'deleted_lines': 1, 'nloc': 260}, {'timestamp': 1515465466.0, 'added_lines': 2, 'deleted_lines': 2, 'nloc': 260}, {'timestamp': 1515713724.0, 'added_lines': 1, 'deleted_lines': 1, 'nloc': 260}, {'timestamp': 1516341168.0, 'added_lines': 1, 'deleted_lines': 1, 'nloc': 260}, {'timestamp': 1516438273.0, 'added_lines': 1, 'deleted_lines': 1, 'nloc': 260}, {'timestamp': 1516838128.0, 'added_lines': 2, 'deleted_lines': 2, 'nloc': 260}, {'timestamp': 1517105039.0, 'added_lines': 1, 'deleted_lines': 1, 'nloc': 260}, {'timestamp': 1517453697.0, 'added_lines': 1, 'deleted_lines': 1, 'nloc': 260}, {'timestamp': 1519173780.0, 'added_lines': 1, 'deleted_lines': 1, 'nloc': 260}, {'timestamp': 1521314540.0, 'added_lines': 1, 'deleted_lines': 1, 'nloc': 260}, {'timestamp': 1521500314.0, 'added_lines': 1, 'deleted_lines': 1, 'nloc': 260}, {'timestamp': 1521421769.0, 'added_lines': 1, 'deleted_lines': 6, 'nloc': 256}, {'timestamp': 1524596476.0, 'added_lines': 1, 'deleted_lines': 1, 'nloc': 256}, {'timestamp': 1525408792.0, 'added_lines': 1, 'deleted_lines': 1, 'nloc': 256}, {'timestamp': 1528520460.0, 'added_lines': 3, 'deleted_lines': 3, 'nloc': 256}, {'timestamp': 1529984485.0, 'added_lines': 1, 'deleted_lines': 1, 'nloc': 256}, {'timestamp': 1530066615.0, 'added_lines': 1, 'deleted_lines': 1, 'nloc': 256}, {'timestamp': 1531779409.0, 'added_lines': 1, 'deleted_lines': 1, 'nloc': 256}, {'timestamp': 1533779477.0, 'added_lines': 1, 'deleted_lines': 1, 'nloc': 256}, {'timestamp': 1533946888.0, 'added_lines': 2, 'deleted_lines': 2, 'nloc': 256}, {'timestamp': 1534115707.0, 'added_lines': 1, 'deleted_lines': 1, 'nloc': 256}, {'timestamp': 1534347022.0, 'added_lines': 1, 'deleted_lines': 1, 'nloc': 256}, {'timestamp': 1534896611.0, 'added_lines': 3, 'deleted_lines': 3, 'nloc': 256}, {'timestamp': 1534903410.0, 'added_lines': 2, 'deleted_lines': 1, 'nloc': 257}, {'timestamp': 1536152234.0, 'added_lines': 5, 'deleted_lines': 1, 'nloc': 260}, {'timestamp': 1536333170.0, 'added_lines': 9, 'deleted_lines': 2, 'nloc': 267}, {'timestamp': 1536718784.0, 'added_lines': 4, 'deleted_lines': 4, 'nloc': 267}, {'timestamp': 1523628870.0, 'added_lines': 36, 'deleted_lines': 46, 'nloc': 257}, {'timestamp': 1535044155.0, 'added_lines': 1, 'deleted_lines': 1, 'nloc': 257}, {'timestamp': 1537193530.0, 'added_lines': 1, 'deleted_lines': 1, 'nloc': 257}, {'timestamp': 1537354376.0, 'added_lines': 1, 'deleted_lines': 3, 'nloc': 256}, {'timestamp': 1537391809.0, 'added_lines': 1, 'deleted_lines': 1, 'nloc': 256}, {'timestamp': 1537792589.0, 'added_lines': 1, 'deleted_lines': 1, 'nloc': 256}, {'timestamp': 1535328619.0, 'added_lines': 7, 'deleted_lines': 30, 'nloc': 237}, {'timestamp': 1535600345.0, 'added_lines': 1, 'deleted_lines': 1, 'nloc': 237}, {'timestamp': 1537428017.0, 'added_lines': 1, 'deleted_lines': 1, 'nloc': 237}, {'timestamp': 1538662493.0, 'added_lines': 8, 'deleted_lines': 4, 'nloc': 240}, {'timestamp': 1539850591.0, 'added_lines': 2, 'deleted_lines': 2, 'nloc': 240}, {'timestamp': 1540552487.0, 'added_lines': 1, 'deleted_lines': 1, 'nloc': 240}, {'timestamp': 1540597832.0, 'added_lines': 1, 'deleted_lines': 1, 'nloc': 240}, {'timestamp': 1541204121.0, 'added_lines': 2, 'deleted_lines': 2, 'nloc': 240}, {'timestamp': 1540612646.0, 'added_lines': 44, 'deleted_lines': 51, 'nloc': 233}, {'timestamp': 1540615984.0, 'added_lines': 8, 'deleted_lines': 8, 'nloc': 232}, {'timestamp': 1540697401.0, 'added_lines': 52, 'deleted_lines': 76, 'nloc': 207}, {'timestamp': 1540880761.0, 'added_lines': 2, 'deleted_lines': 1, 'nloc': 208}, {'timestamp': 1541257002.0, 'added_lines': 22, 'deleted_lines': 7, 'nloc': 221}, {'timestamp': 1541472719.0, 'added_lines': 2, 'deleted_lines': 12, 'nloc': 213}, {'timestamp': 1544661332.0, 'added_lines': 1, 'deleted_lines': 1, 'nloc': 213}, {'timestamp': 1540556089.0, 'added_lines': 1, 'deleted_lines': 1, 'nloc': 213}, {'timestamp': 1547152271.0, 'added_lines': 1, 'deleted_lines': 1, 'nloc': 213}, {'timestamp': 1542878205.0, 'added_lines': 26, 'deleted_lines': 9, 'nloc': 227}, {'timestamp': 1548866534.0, 'added_lines': 1, 'deleted_lines': 1, 'nloc': 227}, {'timestamp': 1549903582.0, 'added_lines': 1, 'deleted_lines': 1, 'nloc': 227}, {'timestamp': 1550507829.0, 'added_lines': 1, 'deleted_lines': 1, 'nloc': 227}, {'timestamp': 1550610741.0, 'added_lines': 1, 'deleted_lines': 1, 'nloc': 227}, {'timestamp': 1550723346.0, 'added_lines': 1, 'deleted_lines': 1, 'nloc': 227}, {'timestamp': 1551138343.0, 'added_lines': 1, 'deleted_lines': 1, 'nloc': 227}, {'timestamp': 1551299964.0, 'added_lines': 1, 'deleted_lines': 1, 'nloc': 227}, {'timestamp': 1551471469.0, 'added_lines': 1, 'deleted_lines': 1, 'nloc': 227}, {'timestamp': 1551551196.0, 'added_lines': 3, 'deleted_lines': 3, 'nloc': 227}, {'timestamp': 1557554420.0, 'added_lines': 14, 'deleted_lines': 15, 'nloc': 226}, {'timestamp': 1563198626.0, 'added_lines': 1, 'deleted_lines': 1, 'nloc': 226}]","{'blocks/blockstore/caching.go': 1, 'blocks/blockstore/util/remove.go': 3, 'cmd/ipfs/daemon.go': 53, 'cmd/ipfs/init.go': 35, 'cmd/ipfs/ipfs.go': 51, 'cmd/ipfs/main.go': 53, 'cmd/ipfs/main_test.go': 4, 'cmd/ipfswatch/main.go': 15, 'cmd/seccat/seccat.go': 14, None: 15, 'commands/channelmarshaler.go': 1, 'commands/cli/cmd_suggestion.go': 1, 'commands/cli/helptext.go': 2, 'commands/cli/helptext_test.go': 2, 'commands/cli/parse.go': 2, 'commands/cli/parse_test.go': 2, 'commands/command.go': 29, 'commands/command_test.go': 20, 'commands/http/client.go': 2, 'commands/http/handler.go': 2, 'commands/http/multifilereader.go': 2, 'commands/http/multifilereader_test.go': 2, 'commands/http/parse.go': 2, 'commands/reqlog.go': 1, 'commands/request.go': 37, 'commands/response.go': 24, 'commands/response_test.go': 20, 'core/bootstrap.go': 15, 'core/commands/active.go': 24, 'core/commands/add.go': 61, 'core/commands/bitswap.go': 61, 'core/commands/block.go': 59, 'core/commands/bootstrap.go': 26, 'core/commands/cat.go': 56, 'core/commands/commands.go': 56, 'core/commands/config.go': 27, 'core/commands/dag/dag.go': 36, 'core/commands/dht.go': 38, 'core/commands/diag.go': 23, 'core/commands/dns.go': 28, 'core/commands/e/error.go': 1, 'core/commands/external.go': 23, 'core/commands/files/files.go': 10, 'core/commands/get.go': 59, 'core/commands/helptext_test.go': 51, 'core/commands/id.go': 35, 'core/commands/ipns.go': 16, 'core/commands/keystore.go': 39, 'core/commands/log.go': 29, 'core/commands/ls.go': 36, 'core/commands/mount_nofuse.go': 23, 'core/commands/mount_unix.go': 26, 'core/commands/mount_windows.go': 22, 'core/commands/name.go': 10, 'core/commands/object/diff.go': 25, 'core/commands/object/object.go': 45, 'core/commands/object/patch.go': 40, 'core/commands/p2p.go': 29, 'core/commands/pin.go': 37, 'core/commands/ping.go': 33, 'core/commands/publish.go': 17, 'core/commands/pubsub.go': 60, 'core/commands/refs.go': 35, 'core/commands/repo.go': 61, 'core/commands/resolve.go': 36, 'core/commands/root.go': 56, 'core/commands/shutdown.go': 33, 'core/commands/stat.go': 55, 'core/commands/swarm.go': 35, 'core/commands/sysdiag.go': 26, 'core/commands/tar.go': 32, 'core/commands/unixfs/ls.go': 30, 'core/commands/unixfs/unixfs.go': 23, 'core/commands/version.go': 26, 'core/core_test.go': 7, 'core/corehttp/commands.go': 56, 'core/corehttp/gateway.go': 18, 'core/coreunix/add.go': 30, 'core/coreunix/add_test.go': 28, 'core/coreunix/metadata_test.go': 23, 'exchange/bitswap/bitswap_test.go': 11, 'exchange/bitswap/decision/engine_test.go': 9, 'exchange/bitswap/message/message_test.go': 5, 'exchange/bitswap/message/pb/Makefile': 1, 'exchange/bitswap/testnet/network_test.go': 9, 'exchange/bitswap/testnet/peernet.go': 10, 'exchange/reprovide/reprovide_test.go': 19, 'fuse/ipns/common.go': 18, 'fuse/node/mount_test.go': 18, 'importer/balanced/balanced_test.go': 7, 'importer/chunk/rabin_test.go': 3, 'importer/helpers/dagbuilder.go': 12, 'importer/importer.go': 13, 'merkledag/utils/utils_test.go': 5, 'mfs/repub_test.go': 12, 'namesys/dns.go': 13, 'namesys/interface.go': 14, 'namesys/ipns_select_test.go': 5, 'namesys/proquint.go': 13, 'namesys/republisher/repub_test.go': 21, 'package.json': 56, 'repo/config/identity.go': 3, 'routing/offline/offline_test.go': 6, 'test/integration/addcat_test.go': 20, 'test/integration/bench_cat_test.go': 19, 'test/integration/bitswap_wo_routing_test.go': 21, 'test/integration/three_legged_cat_test.go': 19, 'test/sharness/t0600-issues-and-regressions-online.sh': 1, 'core/bootstrap_test.go': 13, 'core/commands/dht_test.go': 13, 'core/commands/get_test.go': 50, 'core/core.go': 27, 'core/corehttp/gateway_test.go': 21, 'core/corehttp/metrics_test.go': 16, 'core/mock/mock.go': 16, 'exchange/bitswap/decision/bench_test.go': 8, 'exchange/bitswap/decision/peer_request_queue_test.go': 8, 'exchange/bitswap/message/message.go': 8, 'exchange/bitswap/network/interface.go': 8, 'exchange/bitswap/network/ipfs_impl.go': 8, 'exchange/bitswap/testnet/interface.go': 7, 'exchange/bitswap/testnet/virtual.go': 8, 'exchange/bitswap/testutils.go': 10, 'fuse/ipns/ipns_test.go': 17, 'fuse/readonly/ipfs_test.go': 24, 'namesys/publisher_test.go': 18, 'namesys/resolve_test.go': 19, 'p2p/p2p.go': 13, 'p2p/registry.go': 9, 'repo/config/bootstrap_peers.go': 9, 'routing/mock/centralized_client.go': 4, 'routing/mock/centralized_server.go': 4, 'routing/mock/centralized_test.go': 4, 'routing/mock/interface.go': 4, 'routing/none/none_client.go': 4, 'test/integration/bench_test.go': 13, 'assets/assets.go': 20, 'blocks/blockstore/arc_cache.go': 2, 'blocks/blockstore/arc_cache_test.go': 2, 'blocks/blockstore/blockstore.go': 3, 'blocks/blockstore/blockstore_test.go': 2, 'blocks/blockstore/bloom_cache.go': 2, 'blocks/blockstore/bloom_cache_test.go': 2, 'blocks/blocksutil/block_generator.go': 2, 'blockservice/blockservice.go': 7, 'blockservice/blockservice_test.go': 6, 'blockservice/test/blocks_test.go': 6, 'core/builder.go': 23, 'core/commands/ipnsps.go': 9, 'core/coreapi/coreapi.go': 10, 'core/coreapi/interface/interface.go': 2, 'core/coreapi/unixfs.go': 21, 'core/coreapi/unixfs_test.go': 17, 'core/coredag/cbor.go': 12, 'core/coredag/dagpb.go': 15, 'core/coredag/dagtransl.go': 11, 'core/coredag/raw.go': 15, 'core/corehttp/corehttp.go': 11, 'core/corehttp/gateway_handler.go': 24, 'core/corerepo/gc.go': 23, 'core/corerepo/pinning.go': 12, 'core/coreunix/metadata.go': 20, 'core/pathresolver.go': 18, 'exchange/bitswap/bitswap.go': 8, 'exchange/bitswap/decision/engine.go': 7, 'exchange/bitswap/decision/ledger.go': 7, 'exchange/bitswap/decision/peer_request_queue.go': 7, 'exchange/bitswap/get.go': 6, 'exchange/bitswap/notifications/notifications.go': 4, 'exchange/bitswap/notifications/notifications_test.go': 4, 'exchange/bitswap/session.go': 8, 'exchange/bitswap/session_test.go': 6, 'exchange/bitswap/stat.go': 4, 'exchange/bitswap/wantlist/wantlist.go': 4, 'exchange/bitswap/wantlist/wantlist_test.go': 4, 'exchange/bitswap/wantmanager.go': 7, 'exchange/bitswap/workers.go': 7, 'exchange/interface.go': 2, 'exchange/offline/offline.go': 2, 'exchange/offline/offline_test.go': 2, 'exchange/reprovide/providers.go': 17, 'exchange/reprovide/reprovide.go': 17, 'filestore/filestore.go': 18, 'filestore/filestore_test.go': 17, 'filestore/fsrefstore.go': 17, 'filestore/util.go': 17, 'fuse/ipns/ipns_unix.go': 23, 'fuse/readonly/readonly_unix.go': 24, 'importer/balanced/builder.go': 4, 'importer/chunk/splitting_test.go': 2, 'importer/helpers/helpers.go': 5, 'importer/importer_test.go': 6, 'importer/trickle/trickle_test.go': 6, 'importer/trickle/trickledag.go': 4, 'merkledag/batch.go': 2, 'merkledag/coding.go': 4, 'merkledag/merkledag.go': 5, 'merkledag/merkledag_test.go': 6, 'merkledag/node.go': 4, 'merkledag/node_test.go': 4, 'merkledag/raw.go': 4, 'merkledag/traverse/traverse.go': 4, 'merkledag/traverse/traverse_test.go': 4, 'merkledag/utils/diff.go': 4, 'merkledag/utils/diffenum.go': 4, 'merkledag/utils/diffenum_test.go': 4, 'merkledag/utils/utils.go': 6, 'mfs/dir.go': 8, 'mfs/file.go': 10, 'mfs/mfs_test.go': 10, 'mfs/ops.go': 7, 'mfs/system.go': 11, 'namesys/namesys.go': 20, 'namesys/publisher.go': 23, 'namesys/pubsub.go': 5, 'namesys/pubsub_test.go': 5, 'namesys/republisher/repub.go': 17, 'namesys/routing.go': 19, 'path/path.go': 5, 'path/resolver.go': 3, 'path/resolver_test.go': 2, 'pin/gc/gc.go': 18, 'pin/pin.go': 18, 'pin/pin_test.go': 17, 'pin/set.go': 15, 'pin/set_test.go': 17, 'plugin/ipld.go': 11, 'plugin/loader/initializer.go': 9, 'plugin/plugins/git/git.go': 11, 'repo/config/init.go': 7, 'repo/fsrepo/fsrepo.go': 13, 'repo/fsrepo/lock/lock.go': 3, 'repo/fsrepo/serialize/serialize.go': 3, 'repo/mock.go': 10, 'repo/repo.go': 11, 'routing/offline/offline.go': 3, 'tar/format.go': 23, 'test/dependencies/ma-pipe-unidir/main.go': 6, 'thirdparty/ds-help/key.go': 2, 'thirdparty/pollEndpoint/main.go': 11, 'thirdparty/posinfo/posinfo.go': 2, 'unixfs/archive/archive.go': 5, 'unixfs/archive/tar/writer.go': 5, 'unixfs/hamt/hamt.go': 4, 'unixfs/io/dagreader.go': 4, 'unixfs/io/dirbuilder.go': 3, 'unixfs/io/resolve.go': 4, 'unixfs/mod/dagmodifier.go': 6, 'unixfs/mod/dagmodifier_test.go': 3, 'unixfs/test/utils.go': 6, 'commands/legacy/command.go': 34, 'commands/legacy/legacy.go': 34, 'commands/legacy/legacy_test.go': 35, 'commands/legacy/request.go': 35, 'commands/legacy/response.go': 35, 'commands/legacy/responseemitter.go': 4, 'core/commands/env.go': 4, 'core/commands/commands_test.go': 44, 'test/sharness/t0040-add-and-cat.sh': 2, 'TODO.md': 2, 'test/sharness/t0110-gateway.sh': 1, 'test/sharness/t0410-api-add.sh': 1, 'core/coreapi/dag.go': 10, 'core/coreapi/dag_test.go': 3, 'core/coreapi/interface/options/dag.go': 8, 'core/coreapi/key.go': 17, 'core/coreapi/name.go': 18, 'merkledag/test/utils.go': 5, 'namesys/namesys_test.go': 21, 'repo/fsrepo/datastores.go': 10, 'repo/fsrepo/fsrepo_test.go': 7, 'thirdparty/datastore2/datastore_closer.go': 1, 'thirdparty/datastore2/delayed.go': 1, 'thirdparty/datastore2/threadsafe.go': 1, 'unixfs/io/pbdagreader.go': 3, 'cmd/ipfs/util/ulimit.go': 9, 'cmd/seccat/util.go': 9, 'core/corehttp/logs.go': 9, 'fuse/mount/mount.go': 9, 'fuse/node/mount_unix.go': 9, 'importer/chunk/splitting.go': 1, 'namesys/ipns_validate_test.go': 3, 'plugin/loader/load.go': 7, 'core/commands/files.go': 39, 'core/commands/root_test.go': 1, 'test/sharness/t0090-get.sh': 1, 'path/path_test.go': 1, 'test/api-startup/main.go': 1, 'blocks/blockstoreutil/remove.go': 14, 'blockservice/test/mock.go': 4, 'core/coreapi/pin.go': 16, 'keystore/keystore.go': 8, 'keystore/keystore_test.go': 5, 'keystore/memkeystore.go': 5, 'namesys/validator.go': 2, 'path/resolver/resolver.go': 4, 'thirdparty/verifbs/verifbs.go': 14, 'cmd/ipfs/util/ulimit_freebsd.go': 2, 'cmd/ipfs/util/ulimit_unix.go': 2, 'core/coreapi/block.go': 12, 'core/coreapi/block_test.go': 2, 'core/coreapi/interface/coreapi.go': 7, 'core/coreapi/interface/dag.go': 7, 'core/coreapi/interface/object.go': 7, 'core/coreapi/interface/options/block.go': 3, 'core/coreapi/interface/path.go': 9, 'core/coreapi/interface/unixfs.go': 10, 'core/coreapi/object.go': 18, 'fuse/ipns/link_unix.go': 2, 'fuse/mount/fuse.go': 2, 'fuse/node/mount_darwin.go': 2, 'merkledag/errservice.go': 2, 'merkledag/readonly.go': 2, 'merkledag/readonly_test.go': 2, 'merkledag/rwservice.go': 2, 'merkledag/session.go': 2, 'path/resolver/resolver_test.go': 2, 'thirdparty/verifcid/validate.go': 2, 'thirdparty/verifcid/validate_test.go': 2, 'unixfs/hamt/hamt_stress_test.go': 2, 'unixfs/hamt/hamt_test.go': 2, 'namesys/ipns_resolver_validation_test.go': 14, 'test/sharness/t0170-dht.sh': 1, 'core/commands/urlstore.go': 33, 'unixfs/io/directory.go': 1, 'core/coreapi/interface/key.go': 4, 'core/coreapi/name_test.go': 9, 'core/coreapi/path.go': 16, 'core/coreunix/cat.go': 7, 'core/pathresolver_test.go': 11, 'dagutils/diff.go': 12, 'dagutils/diffenum.go': 11, 'dagutils/diffenum_test.go': 11, 'dagutils/utils.go': 11, 'dagutils/utils_test.go': 11, 'filestore/pb/dataobj.pb.go': 3, 'mfs/fd.go': 4, 'namesys/base.go': 12, 'namesys/cache.go': 11, 'pin/internal/pb/header.pb.go': 3, 'thirdparty/cidv0v1/blockstore.go': 10, 'repo/fsrepo/config_test.go': 5, 'repo/fsrepo/misc.go': 5, 'test/bench/bench_cli_ipfs_add/main.go': 6, 'test/bench/offline_add/main.go': 6, 'core/commands/cmdenv/env.go': 22, 'core/commands/name/ipns.go': 24, 'core/commands/name/ipnsps.go': 22, 'core/commands/name/name.go': 22, 'core/commands/name/publish.go': 24, 'core/coreapi/dht.go': 8, 'core/coreapi/dht_test.go': 3, 'test/sharness/t0275-cid-security.sh': 1, 'test/sharness/lib/test-lib.sh': 1, 'core/coreapi/interface/dht.go': 2, 'p2p/listener.go': 4, 'p2p/local.go': 4, 'p2p/remote.go': 4, 'p2p/stream.go': 4, 'core/commands/cid.go': 20, 'core/coreapi/unixfile.go': 3, 'cmd/ipfs/dnsresolve_test.go': 2, 'core/coreapi/interface/options/unixfs.go': 1, 'core/coreapi/interface/pubsub.go': 1, 'core/coreapi/interface/swarm.go': 1, 'core/coreapi/pubsub.go': 6, 'core/coreapi/swarm.go': 6, 'test/dependencies/iptb/iptb.go': 5, 'commands/context.go': 12, 'core/commands/cmdenv/cidbase.go': 11, 'core/commands/cmdenv/cidbase_test.go': 3, 'test/sharness/t0045-ls.sh': 1, 'test/sharness/t0051-object-data/mixed.json': 1, 'test/sharness/t0051-object.sh': 1, 'test/sharness/t0053-dag.sh': 1, 'test/sharness/t0085-pins.sh': 1, 'test/sharness/t0095-refs.sh': 1, 'test/sharness/t0160-resolve.sh': 1, 'test/sharness/t0210-tar.sh': 1, 'test/sharness/t0250-files-api.sh': 1, 'test/sharness/t0271-filestore-utils.sh': 1, 'test/sharness/t0272-urlstore.sh': 1, 'core/commands/cmdenv/file.go': 3, 'core/coreapi/interface/tests/name.go': 1, 'core/coreapi/interface/tests/unixfs.go': 1, 'core/coreapi/test/api_test.go': 6, 'core/corehttp/ipns_hostname.go': 5, 'namesys/dns_test.go': 5, 'plugin/daemon.go': 5, 'plugin/loader/loader.go': 5, 'core/corehttp/proxy.go': 4, 'plugin/plugins/badgerds/badgerds.go': 3, 'plugin/plugins/flatfs/flatfs.go': 3, 'plugin/plugins/levelds/levelds.go': 2, 'core/corerepo/stat.go': 2, 'core/corehttp/metrics.go': 1, 'core/corehttp/proxy_test.go': 1, 'plugin/tracer.go': 1, 'thirdparty/notifier/notifier.go': 1, 'README.md': 1, 'go.mod': 2, 'go.sum': 2, 'package-list.json': 1, 'core/node/storage.go': 1}","('core/commands/add.go', 0.7922077922077922, 0.4206896551724138)"
core/commands/get.go,201,1368,2,"[{'cyclomatic_complexity': 9, 'nloc': 44, 'token_count': 310, 'name': '', 'long_name': '(req cmds.Request,res cmds.Response)', 'start_line': 53, 'end_line': 101, 'full_parameters': [], 'filename': '/home/dimi/Documents/Informatik_Studium/FSS/SoftEvo/DataCollection/FFS_SoftEvo/go-ipfs/core/commands/get.go', 'top_nesting_level': 0, 'length': 49, 'fan_in': 0, 'fan_out': 0, 'general_fan_out': 0}, {'cyclomatic_complexity': 5, 'nloc': 29, 'token_count': 199, 'name': '', 'long_name': '(req cmds.Request,res cmds.Response)', 'start_line': 102, 'end_line': 135, 'full_parameters': [], 'filename': '/home/dimi/Documents/Informatik_Studium/FSS/SoftEvo/DataCollection/FFS_SoftEvo/go-ipfs/core/commands/get.go', 'top_nesting_level': 0, 'length': 34, 'fan_in': 0, 'fan_out': 0, 'general_fan_out': 0}]",265,1643,0,[],64,275,-2,120,120,"[{'timestamp': 1491058697.0, 'added_lines': 71, 'deleted_lines': 54, 'nloc': 214}, {'timestamp': 1508770239.0, 'added_lines': 1, 'deleted_lines': 1, 'nloc': 214}, {'timestamp': 1509016767.0, 'added_lines': 1, 'deleted_lines': 1, 'nloc': 214}, {'timestamp': 1511031858.0, 'added_lines': 11, 'deleted_lines': 5, 'nloc': 219}, {'timestamp': 1499331469.0, 'added_lines': 2, 'deleted_lines': 2, 'nloc': 219}, {'timestamp': 1511223906.0, 'added_lines': 2, 'deleted_lines': 2, 'nloc': 219}, {'timestamp': 1511245249.0, 'added_lines': 1, 'deleted_lines': 1, 'nloc': 219}, {'timestamp': 1511373659.0, 'added_lines': 1, 'deleted_lines': 1, 'nloc': 219}, {'timestamp': 1512394054.0, 'added_lines': 1, 'deleted_lines': 2, 'nloc': 218}, {'timestamp': 1512365669.0, 'added_lines': 2, 'deleted_lines': 2, 'nloc': 218}, {'timestamp': 1511187070.0, 'added_lines': 23, 'deleted_lines': 19, 'nloc': 222}, {'timestamp': 1512121226.0, 'added_lines': 1, 'deleted_lines': 1, 'nloc': 222}, {'timestamp': 1512671605.0, 'added_lines': 3, 'deleted_lines': 3, 'nloc': 222}, {'timestamp': 1513436097.0, 'added_lines': 2, 'deleted_lines': 2, 'nloc': 222}, {'timestamp': 1513612261.0, 'added_lines': 2, 'deleted_lines': 2, 'nloc': 222}, {'timestamp': 1513764708.0, 'added_lines': 1, 'deleted_lines': 1, 'nloc': 222}, {'timestamp': 1513765470.0, 'added_lines': 1, 'deleted_lines': 1, 'nloc': 222}, {'timestamp': 1513766201.0, 'added_lines': 1, 'deleted_lines': 1, 'nloc': 222}, {'timestamp': 1513772654.0, 'added_lines': 1, 'deleted_lines': 1, 'nloc': 222}, {'timestamp': 1513773452.0, 'added_lines': 1, 'deleted_lines': 1, 'nloc': 222}, {'timestamp': 1515277696.0, 'added_lines': 2, 'deleted_lines': 2, 'nloc': 222}, {'timestamp': 1515465466.0, 'added_lines': 3, 'deleted_lines': 3, 'nloc': 222}, {'timestamp': 1515633079.0, 'added_lines': 1, 'deleted_lines': 1, 'nloc': 222}, {'timestamp': 1515713724.0, 'added_lines': 1, 'deleted_lines': 1, 'nloc': 222}, {'timestamp': 1516341168.0, 'added_lines': 1, 'deleted_lines': 1, 'nloc': 222}, {'timestamp': 1516438552.0, 'added_lines': 3, 'deleted_lines': 3, 'nloc': 222}, {'timestamp': 1516737686.0, 'added_lines': 1, 'deleted_lines': 5, 'nloc': 218}, {'timestamp': 1516838128.0, 'added_lines': 1, 'deleted_lines': 1, 'nloc': 218}, {'timestamp': 1517105039.0, 'added_lines': 1, 'deleted_lines': 1, 'nloc': 218}, {'timestamp': 1517453697.0, 'added_lines': 1, 'deleted_lines': 1, 'nloc': 218}, {'timestamp': 1519173780.0, 'added_lines': 1, 'deleted_lines': 1, 'nloc': 218}, {'timestamp': 1519177055.0, 'added_lines': 1, 'deleted_lines': 1, 'nloc': 218}, {'timestamp': 1520864546.0, 'added_lines': 3, 'deleted_lines': 3, 'nloc': 218}, {'timestamp': 1521314540.0, 'added_lines': 1, 'deleted_lines': 5, 'nloc': 214}, {'timestamp': 1521500314.0, 'added_lines': 1, 'deleted_lines': 1, 'nloc': 214}, {'timestamp': 1521651745.0, 'added_lines': 1, 'deleted_lines': 1, 'nloc': 214}, {'timestamp': 1521674924.0, 'added_lines': 1, 'deleted_lines': 1, 'nloc': 214}, {'timestamp': 1521827635.0, 'added_lines': 1, 'deleted_lines': 1, 'nloc': 214}, {'timestamp': 1521399286.0, 'added_lines': 1, 'deleted_lines': 1, 'nloc': 214}, {'timestamp': 1524596476.0, 'added_lines': 1, 'deleted_lines': 1, 'nloc': 214}, {'timestamp': 1525408792.0, 'added_lines': 2, 'deleted_lines': 2, 'nloc': 214}, {'timestamp': 1528520460.0, 'added_lines': 3, 'deleted_lines': 3, 'nloc': 214}, {'timestamp': 1529984485.0, 'added_lines': 1, 'deleted_lines': 1, 'nloc': 214}, {'timestamp': 1532764253.0, 'added_lines': 1, 'deleted_lines': 1, 'nloc': 214}, {'timestamp': 1532847462.0, 'added_lines': 1, 'deleted_lines': 1, 'nloc': 214}, {'timestamp': 1532986515.0, 'added_lines': 1, 'deleted_lines': 1, 'nloc': 214}, {'timestamp': 1533500571.0, 'added_lines': 3, 'deleted_lines': 3, 'nloc': 214}, {'timestamp': 1533618653.0, 'added_lines': 3, 'deleted_lines': 3, 'nloc': 214}, {'timestamp': 1533779477.0, 'added_lines': 4, 'deleted_lines': 4, 'nloc': 214}, {'timestamp': 1533946888.0, 'added_lines': 3, 'deleted_lines': 3, 'nloc': 214}, {'timestamp': 1534115707.0, 'added_lines': 3, 'deleted_lines': 3, 'nloc': 214}, {'timestamp': 1534195762.0, 'added_lines': 3, 'deleted_lines': 3, 'nloc': 214}, {'timestamp': 1534347022.0, 'added_lines': 3, 'deleted_lines': 3, 'nloc': 214}, {'timestamp': 1534896611.0, 'added_lines': 5, 'deleted_lines': 5, 'nloc': 214}, {'timestamp': 1534903410.0, 'added_lines': 5, 'deleted_lines': 4, 'nloc': 215}, {'timestamp': 1535601896.0, 'added_lines': 3, 'deleted_lines': 3, 'nloc': 215}, {'timestamp': 1536388808.0, 'added_lines': 3, 'deleted_lines': 3, 'nloc': 215}, {'timestamp': 1536718784.0, 'added_lines': 3, 'deleted_lines': 3, 'nloc': 215}, {'timestamp': 1536723292.0, 'added_lines': 3, 'deleted_lines': 3, 'nloc': 215}, {'timestamp': 1523628870.0, 'added_lines': 42, 'deleted_lines': 56, 'nloc': 202}, {'timestamp': 1535044155.0, 'added_lines': 1, 'deleted_lines': 1, 'nloc': 202}, {'timestamp': 1537193530.0, 'added_lines': 1, 'deleted_lines': 1, 'nloc': 202}, {'timestamp': 1537276863.0, 'added_lines': 1, 'deleted_lines': 3, 'nloc': 201}, {'timestamp': 1537391809.0, 'added_lines': 1, 'deleted_lines': 1, 'nloc': 201}, {'timestamp': 1537790637.0, 'added_lines': 3, 'deleted_lines': 3, 'nloc': 201}, {'timestamp': 1537792589.0, 'added_lines': 4, 'deleted_lines': 4, 'nloc': 201}, {'timestamp': 1538544957.0, 'added_lines': 3, 'deleted_lines': 3, 'nloc': 201}, {'timestamp': 1538694687.0, 'added_lines': 3, 'deleted_lines': 3, 'nloc': 201}, {'timestamp': 1538695953.0, 'added_lines': 3, 'deleted_lines': 3, 'nloc': 201}, {'timestamp': 1538662493.0, 'added_lines': 16, 'deleted_lines': 9, 'nloc': 207}, {'timestamp': 1538773916.0, 'added_lines': 3, 'deleted_lines': 3, 'nloc': 207}, {'timestamp': 1539176817.0, 'added_lines': 3, 'deleted_lines': 3, 'nloc': 207}, {'timestamp': 1539357340.0, 'added_lines': 3, 'deleted_lines': 3, 'nloc': 207}, {'timestamp': 1539850591.0, 'added_lines': 3, 'deleted_lines': 3, 'nloc': 207}, {'timestamp': 1540400358.0, 'added_lines': 3, 'deleted_lines': 3, 'nloc': 207}, {'timestamp': 1540410565.0, 'added_lines': 3, 'deleted_lines': 3, 'nloc': 207}, {'timestamp': 1540418491.0, 'added_lines': 3, 'deleted_lines': 3, 'nloc': 207}, {'timestamp': 1540552487.0, 'added_lines': 1, 'deleted_lines': 1, 'nloc': 207}, {'timestamp': 1540597832.0, 'added_lines': 1, 'deleted_lines': 1, 'nloc': 207}, {'timestamp': 1540603818.0, 'added_lines': 3, 'deleted_lines': 3, 'nloc': 207}, {'timestamp': 1540916861.0, 'added_lines': 1, 'deleted_lines': 1, 'nloc': 207}, {'timestamp': 1541106379.0, 'added_lines': 1, 'deleted_lines': 1, 'nloc': 207}, {'timestamp': 1541189794.0, 'added_lines': 3, 'deleted_lines': 3, 'nloc': 207}, {'timestamp': 1541204121.0, 'added_lines': 4, 'deleted_lines': 4, 'nloc': 207}, {'timestamp': 1541903826.0, 'added_lines': 3, 'deleted_lines': 3, 'nloc': 207}, {'timestamp': 1543443696.0, 'added_lines': 3, 'deleted_lines': 3, 'nloc': 207}, {'timestamp': 1544225843.0, 'added_lines': 3, 'deleted_lines': 3, 'nloc': 207}, {'timestamp': 1544661332.0, 'added_lines': 1, 'deleted_lines': 1, 'nloc': 207}, {'timestamp': 1540556089.0, 'added_lines': 2, 'deleted_lines': 2, 'nloc': 207}, {'timestamp': 1545582404.0, 'added_lines': 1, 'deleted_lines': 1, 'nloc': 207}, {'timestamp': 1547003974.0, 'added_lines': 3, 'deleted_lines': 3, 'nloc': 207}, {'timestamp': 1547152271.0, 'added_lines': 1, 'deleted_lines': 1, 'nloc': 207}, {'timestamp': 1547499910.0, 'added_lines': 3, 'deleted_lines': 3, 'nloc': 207}, {'timestamp': 1548353261.0, 'added_lines': 16, 'deleted_lines': 21, 'nloc': 200}, {'timestamp': 1548865223.0, 'added_lines': 95, 'deleted_lines': 2, 'nloc': 269}, {'timestamp': 1548866534.0, 'added_lines': 2, 'deleted_lines': 2, 'nloc': 269}, {'timestamp': 1549672857.0, 'added_lines': 1, 'deleted_lines': 1, 'nloc': 269}, {'timestamp': 1549673846.0, 'added_lines': 1, 'deleted_lines': 1, 'nloc': 269}, {'timestamp': 1549903582.0, 'added_lines': 3, 'deleted_lines': 3, 'nloc': 269}, {'timestamp': 1550185115.0, 'added_lines': 1, 'deleted_lines': 1, 'nloc': 269}, {'timestamp': 1550507829.0, 'added_lines': 2, 'deleted_lines': 2, 'nloc': 269}, {'timestamp': 1550576884.0, 'added_lines': 1, 'deleted_lines': 1, 'nloc': 269}, {'timestamp': 1550610741.0, 'added_lines': 1, 'deleted_lines': 1, 'nloc': 269}, {'timestamp': 1550711994.0, 'added_lines': 1, 'deleted_lines': 1, 'nloc': 269}, {'timestamp': 1550723346.0, 'added_lines': 1, 'deleted_lines': 1, 'nloc': 269}, {'timestamp': 1551138343.0, 'added_lines': 1, 'deleted_lines': 1, 'nloc': 269}, {'timestamp': 1551229859.0, 'added_lines': 1, 'deleted_lines': 1, 'nloc': 269}, {'timestamp': 1551299964.0, 'added_lines': 2, 'deleted_lines': 2, 'nloc': 269}, {'timestamp': 1551471469.0, 'added_lines': 1, 'deleted_lines': 1, 'nloc': 269}, {'timestamp': 1551551196.0, 'added_lines': 6, 'deleted_lines': 6, 'nloc': 269}, {'timestamp': 1551708626.0, 'added_lines': 5, 'deleted_lines': 5, 'nloc': 269}, {'timestamp': 1553697989.0, 'added_lines': 1, 'deleted_lines': 1, 'nloc': 269}, {'timestamp': 1553529899.0, 'added_lines': 1, 'deleted_lines': 4, 'nloc': 266}, {'timestamp': 1553608614.0, 'added_lines': 5, 'deleted_lines': 5, 'nloc': 266}, {'timestamp': 1553609463.0, 'added_lines': 1, 'deleted_lines': 1, 'nloc': 266}, {'timestamp': 1557554420.0, 'added_lines': 8, 'deleted_lines': 9, 'nloc': 265}, {'timestamp': 1587221101.0, 'added_lines': 1, 'deleted_lines': 1, 'nloc': 265}, {'timestamp': 1600726105.0, 'added_lines': 1, 'deleted_lines': 1, 'nloc': 265}, {'timestamp': 1624037214.0, 'added_lines': 1, 'deleted_lines': 1, 'nloc': 265}, {'timestamp': 1624037214.0, 'added_lines': 1, 'deleted_lines': 1, 'nloc': 265}]","{'blocks/blockstore/caching.go': 1, 'blocks/blockstore/util/remove.go': 3, 'cmd/ipfs/daemon.go': 61, 'cmd/ipfs/init.go': 45, 'cmd/ipfs/ipfs.go': 51, 'cmd/ipfs/main.go': 61, 'cmd/ipfs/main_test.go': 4, 'cmd/ipfswatch/main.go': 24, 'cmd/seccat/seccat.go': 28, None: 36, 'commands/channelmarshaler.go': 1, 'commands/cli/cmd_suggestion.go': 1, 'commands/cli/helptext.go': 3, 'commands/cli/helptext_test.go': 2, 'commands/cli/parse.go': 2, 'commands/cli/parse_test.go': 2, 'commands/command.go': 29, 'commands/command_test.go': 20, 'commands/http/client.go': 2, 'commands/http/handler.go': 2, 'commands/http/multifilereader.go': 2, 'commands/http/multifilereader_test.go': 2, 'commands/http/parse.go': 2, 'commands/reqlog.go': 2, 'commands/request.go': 44, 'commands/response.go': 24, 'commands/response_test.go': 20, 'core/bootstrap.go': 25, 'core/commands/active.go': 25, 'core/commands/add.go': 83, 'core/commands/bitswap.go': 82, 'core/commands/block.go': 70, 'core/commands/bootstrap.go': 33, 'core/commands/cat.go': 67, 'core/commands/commands.go': 56, 'core/commands/config.go': 37, 'core/commands/dag/dag.go': 72, 'core/commands/dht.go': 69, 'core/commands/diag.go': 23, 'core/commands/dns.go': 34, 'core/commands/e/error.go': 1, 'core/commands/external.go': 23, 'core/commands/files/files.go': 13, 'core/commands/filestore.go': 59, 'core/commands/helptext_test.go': 51, 'core/commands/id.go': 51, 'core/commands/ipns.go': 17, 'core/commands/keystore.go': 45, 'core/commands/log.go': 29, 'core/commands/ls.go': 72, 'core/commands/mount_nofuse.go': 23, 'core/commands/mount_unix.go': 33, 'core/commands/mount_windows.go': 22, 'core/commands/name.go': 10, 'core/commands/object/diff.go': 35, 'core/commands/object/object.go': 80, 'core/commands/object/patch.go': 54, 'core/commands/p2p.go': 39, 'core/commands/pin.go': 73, 'core/commands/ping.go': 44, 'core/commands/publish.go': 23, 'core/commands/pubsub.go': 71, 'core/commands/refs.go': 62, 'core/commands/repo.go': 73, 'core/commands/resolve.go': 70, 'core/commands/root.go': 55, 'core/commands/shutdown.go': 33, 'core/commands/stat.go': 60, 'core/commands/swarm.go': 50, 'core/commands/sysdiag.go': 29, 'core/commands/tar.go': 60, 'core/commands/unixfs/ls.go': 66, 'core/commands/unixfs/unixfs.go': 23, 'core/commands/version.go': 27, 'core/core_test.go': 17, 'core/corehttp/commands.go': 84, 'core/corehttp/gateway.go': 37, 'core/coreunix/add.go': 62, 'core/coreunix/add_test.go': 59, 'core/coreunix/metadata_test.go': 52, 'exchange/bitswap/bitswap_test.go': 10, 'exchange/bitswap/decision/engine_test.go': 8, 'exchange/bitswap/message/message_test.go': 4, 'exchange/bitswap/message/pb/Makefile': 1, 'exchange/bitswap/testnet/network_test.go': 8, 'exchange/bitswap/testnet/peernet.go': 9, 'exchange/reprovide/reprovide_test.go': 33, 'fuse/ipns/common.go': 48, 'fuse/node/mount_test.go': 31, 'importer/balanced/balanced_test.go': 8, 'importer/chunk/rabin_test.go': 3, 'importer/helpers/dagbuilder.go': 12, 'importer/importer.go': 11, 'merkledag/utils/utils_test.go': 4, 'mfs/repub_test.go': 11, 'namesys/dns.go': 44, 'namesys/interface.go': 46, 'namesys/ipns_select_test.go': 5, 'namesys/proquint.go': 44, 'namesys/republisher/repub_test.go': 51, 'package.json': 91, 'repo/config/identity.go': 3, 'routing/offline/offline_test.go': 6, 'test/integration/addcat_test.go': 36, 'test/integration/bench_cat_test.go': 35, 'test/integration/bitswap_wo_routing_test.go': 36, 'test/integration/three_legged_cat_test.go': 35, 'test/sharness/t0600-issues-and-regressions-online.sh': 2, 'core/commands/get_test.go': 51, 'core/bootstrap_test.go': 23, 'core/commands/dht_test.go': 22, 'core/core.go': 57, 'core/corehttp/gateway_test.go': 55, 'core/corehttp/metrics_test.go': 32, 'core/mock/mock.go': 32, 'exchange/bitswap/decision/bench_test.go': 7, 'exchange/bitswap/decision/peer_request_queue_test.go': 7, 'exchange/bitswap/message/message.go': 7, 'exchange/bitswap/network/interface.go': 7, 'exchange/bitswap/network/ipfs_impl.go': 7, 'exchange/bitswap/testnet/interface.go': 7, 'exchange/bitswap/testnet/virtual.go': 8, 'exchange/bitswap/testutils.go': 8, 'fuse/ipns/ipns_test.go': 32, 'fuse/readonly/ipfs_test.go': 61, 'namesys/publisher_test.go': 30, 'namesys/resolve_test.go': 48, 'p2p/p2p.go': 23, 'p2p/registry.go': 11, 'repo/config/bootstrap_peers.go': 9, 'routing/mock/centralized_client.go': 4, 'routing/mock/centralized_server.go': 4, 'routing/mock/centralized_test.go': 4, 'routing/mock/interface.go': 4, 'routing/none/none_client.go': 4, 'test/integration/bench_test.go': 17, 'assets/assets.go': 51, 'blocks/blockstore/arc_cache.go': 2, 'blocks/blockstore/arc_cache_test.go': 2, 'blocks/blockstore/blockstore.go': 3, 'blocks/blockstore/blockstore_test.go': 2, 'blocks/blockstore/bloom_cache.go': 2, 'blocks/blockstore/bloom_cache_test.go': 2, 'blocks/blocksutil/block_generator.go': 2, 'blockservice/blockservice.go': 6, 'blockservice/blockservice_test.go': 5, 'blockservice/test/blocks_test.go': 5, 'core/builder.go': 54, 'core/commands/ipnsps.go': 9, 'core/coreapi/coreapi.go': 25, 'core/coreapi/interface/interface.go': 2, 'core/coreapi/unixfs.go': 55, 'core/coreapi/unixfs_test.go': 40, 'core/coredag/cbor.go': 16, 'core/coredag/dagpb.go': 41, 'core/coredag/dagtransl.go': 12, 'core/coredag/raw.go': 41, 'core/corehttp/corehttp.go': 15, 'core/corehttp/gateway_handler.go': 61, 'core/corerepo/gc.go': 49, 'core/corerepo/pinning.go': 20, 'core/coreunix/metadata.go': 48, 'core/pathresolver.go': 45, 'exchange/bitswap/bitswap.go': 6, 'exchange/bitswap/decision/engine.go': 6, 'exchange/bitswap/decision/ledger.go': 6, 'exchange/bitswap/decision/peer_request_queue.go': 6, 'exchange/bitswap/get.go': 5, 'exchange/bitswap/notifications/notifications.go': 3, 'exchange/bitswap/notifications/notifications_test.go': 3, 'exchange/bitswap/session.go': 7, 'exchange/bitswap/session_test.go': 5, 'exchange/bitswap/stat.go': 3, 'exchange/bitswap/wantlist/wantlist.go': 3, 'exchange/bitswap/wantlist/wantlist_test.go': 3, 'exchange/bitswap/wantmanager.go': 6, 'exchange/bitswap/workers.go': 6, 'exchange/interface.go': 2, 'exchange/offline/offline.go': 2, 'exchange/offline/offline_test.go': 2, 'exchange/reprovide/providers.go': 43, 'exchange/reprovide/reprovide.go': 27, 'filestore/filestore.go': 25, 'filestore/filestore_test.go': 43, 'filestore/fsrefstore.go': 24, 'filestore/util.go': 22, 'fuse/ipns/ipns_unix.go': 55, 'fuse/readonly/readonly_unix.go': 56, 'importer/balanced/builder.go': 3, 'importer/chunk/splitting_test.go': 2, 'importer/helpers/helpers.go': 4, 'importer/importer_test.go': 6, 'importer/trickle/trickle_test.go': 7, 'importer/trickle/trickledag.go': 5, 'merkledag/batch.go': 2, 'merkledag/coding.go': 4, 'merkledag/merkledag.go': 4, 'merkledag/merkledag_test.go': 6, 'merkledag/node.go': 3, 'merkledag/node_test.go': 3, 'merkledag/raw.go': 3, 'merkledag/traverse/traverse.go': 3, 'merkledag/traverse/traverse_test.go': 3, 'merkledag/utils/diff.go': 3, 'merkledag/utils/diffenum.go': 3, 'merkledag/utils/diffenum_test.go': 3, 'merkledag/utils/utils.go': 5, 'mfs/dir.go': 12, 'mfs/file.go': 14, 'mfs/mfs_test.go': 16, 'mfs/ops.go': 10, 'mfs/system.go': 15, 'namesys/namesys.go': 52, 'namesys/publisher.go': 53, 'namesys/pubsub.go': 6, 'namesys/pubsub_test.go': 5, 'namesys/republisher/repub.go': 45, 'namesys/routing.go': 50, 'path/path.go': 3, 'path/resolver.go': 3, 'path/resolver_test.go': 2, 'pin/gc/gc.go': 44, 'pin/pin.go': 45, 'pin/pin_test.go': 44, 'pin/set.go': 41, 'pin/set_test.go': 43, 'plugin/ipld.go': 12, 'plugin/loader/initializer.go': 9, 'plugin/plugins/git/git.go': 12, 'repo/config/init.go': 9, 'repo/fsrepo/fsrepo.go': 23, 'repo/fsrepo/lock/lock.go': 3, 'repo/fsrepo/serialize/serialize.go': 4, 'repo/mock.go': 16, 'repo/repo.go': 20, 'routing/offline/offline.go': 3, 'tar/format.go': 53, 'test/dependencies/ma-pipe-unidir/main.go': 10, 'thirdparty/ds-help/key.go': 2, 'thirdparty/pollEndpoint/main.go': 15, 'thirdparty/posinfo/posinfo.go': 2, 'unixfs/archive/archive.go': 4, 'unixfs/archive/tar/writer.go': 5, 'unixfs/hamt/hamt.go': 5, 'unixfs/io/dagreader.go': 5, 'unixfs/io/dirbuilder.go': 3, 'unixfs/io/resolve.go': 5, 'unixfs/mod/dagmodifier.go': 7, 'unixfs/mod/dagmodifier_test.go': 4, 'unixfs/test/utils.go': 8, 'commands/legacy/command.go': 34, 'commands/legacy/legacy.go': 34, 'commands/legacy/legacy_test.go': 35, 'commands/legacy/request.go': 38, 'commands/legacy/response.go': 36, 'commands/legacy/responseemitter.go': 4, 'core/commands/env.go': 4, 'core/commands/commands_test.go': 44, 'test/sharness/t0040-add-and-cat.sh': 2, 'TODO.md': 2, 'test/sharness/t0110-gateway.sh': 2, 'test/sharness/t0410-api-add.sh': 2, 'core/coreapi/dag.go': 11, 'core/coreapi/dag_test.go': 3, 'core/coreapi/interface/options/dag.go': 7, 'core/coreapi/key.go': 51, 'core/coreapi/name.go': 51, 'merkledag/test/utils.go': 4, 'namesys/namesys_test.go': 55, 'repo/fsrepo/datastores.go': 15, 'repo/fsrepo/fsrepo_test.go': 17, 'thirdparty/datastore2/datastore_closer.go': 1, 'thirdparty/datastore2/delayed.go': 1, 'thirdparty/datastore2/threadsafe.go': 1, 'unixfs/io/pbdagreader.go': 5, 'cmd/ipfs/util/ulimit.go': 10, 'cmd/seccat/util.go': 9, 'core/corehttp/logs.go': 9, 'fuse/mount/mount.go': 10, 'fuse/node/mount_unix.go': 11, 'importer/chunk/splitting.go': 1, 'namesys/ipns_validate_test.go': 3, 'plugin/loader/load.go': 7, 'core/commands/files.go': 77, 'core/coreapi/block.go': 20, 'core/coreapi/object_test.go': 1, 'core/commands/root_test.go': 1, 'test/sharness/t0090-get.sh': 2, 'core/coreapi/object.go': 52, 'fuse/mount/fuse.go': 5, 'keystore/keystore_test.go': 8, 'namesys/dns_test.go': 11, 'repo/config/config.go': 1, 'unixfs/unixfs.go': 3, 'blocks/blockstoreutil/remove.go': 21, 'blockservice/test/mock.go': 3, 'core/coreapi/pin.go': 47, 'keystore/keystore.go': 9, 'keystore/memkeystore.go': 6, 'namesys/validator.go': 2, 'path/resolver/resolver.go': 4, 'thirdparty/verifbs/verifbs.go': 20, 'cmd/ipfs/util/ulimit_freebsd.go': 2, 'cmd/ipfs/util/ulimit_unix.go': 2, 'core/coreapi/block_test.go': 2, 'core/coreapi/interface/coreapi.go': 8, 'core/coreapi/interface/dag.go': 8, 'core/coreapi/interface/object.go': 8, 'core/coreapi/interface/options/block.go': 3, 'core/coreapi/interface/path.go': 33, 'core/coreapi/interface/unixfs.go': 11, 'fuse/ipns/link_unix.go': 3, 'fuse/node/mount_darwin.go': 3, 'merkledag/errservice.go': 1, 'merkledag/readonly.go': 1, 'merkledag/readonly_test.go': 1, 'merkledag/rwservice.go': 1, 'merkledag/session.go': 1, 'path/resolver/resolver_test.go': 2, 'thirdparty/verifcid/validate.go': 1, 'thirdparty/verifcid/validate_test.go': 1, 'unixfs/hamt/hamt_stress_test.go': 3, 'unixfs/hamt/hamt_test.go': 3, 'namesys/ipns_resolver_validation_test.go': 44, 'test/sharness/t0170-dht.sh': 1, 'Rules.mk': 1, 'dagutils/diff.go': 43, 'dagutils/diffenum.go': 38, 'dagutils/diffenum_test.go': 38, 'dagutils/utils.go': 41, 'dagutils/utils_test.go': 40, 'unixfs/io/dagreader_test.go': 2, 'unixfs/io/directory.go': 2, 'unixfs/io/directory_test.go': 2, 'core/coreapi/name_test.go': 32, 'core/coreapi/path.go': 52, 'core/coreunix/cat.go': 16, 'core/pathresolver_test.go': 39, 'namesys/base.go': 43, 'namesys/cache.go': 39, 'core/commands/urlstore.go': 58, 'mfs/fd.go': 8, 'unixfs/importer/balanced/balanced_test.go': 1, 'unixfs/importer/balanced/builder.go': 1, 'unixfs/importer/helpers/dagbuilder.go': 1, 'unixfs/importer/helpers/helpers.go': 1, 'unixfs/importer/importer.go': 1, 'unixfs/importer/importer_test.go': 1, 'unixfs/importer/trickle/trickle_test.go': 1, 'unixfs/importer/trickle/trickledag.go': 1, 'unixfs/unixfs_test.go': 1, 'core/coreapi/interface/key.go': 6, 'filestore/pb/dataobj.pb.go': 3, 'pin/internal/pb/header.pb.go': 3, 'thirdparty/cidv0v1/blockstore.go': 16, 'repo/fsrepo/config_test.go': 12, 'repo/fsrepo/misc.go': 12, 'test/bench/bench_cli_ipfs_add/main.go': 14, 'test/bench/offline_add/main.go': 14, 'core/commands/cmdenv/env.go': 34, 'core/commands/name/ipns.go': 51, 'core/commands/name/ipnsps.go': 25, 'core/commands/name/name.go': 22, 'core/commands/name/publish.go': 38, 'core/coreapi/dht.go': 33, 'core/coreapi/dht_test.go': 5, 'test/sharness/t0275-cid-security.sh': 1, 'test/sharness/lib/test-lib.sh': 1, 'core/coreapi/interface/dht.go': 9, 'p2p/listener.go': 12, 'p2p/local.go': 12, 'p2p/remote.go': 13, 'p2p/stream.go': 13, 'core/coreapi/interface/swarm.go': 8, 'core/coreapi/swarm.go': 23, 'core/commands/cid.go': 20, 'core/coreapi/interface/options/unixfs.go': 14, 'core/coreapi/pubsub.go': 21, 'core/coreapi/unixfile.go': 17, 'cmd/ipfs/dnsresolve_test.go': 5, 'core/coreapi/interface/pubsub.go': 3, 'test/dependencies/iptb/iptb.go': 11, 'plugin/plugins/badgerds/badgerds.go': 4, 'plugin/plugins/flatfs/flatfs.go': 4, 'plugin/plugins/levelds/levelds.go': 3, 'commands/context.go': 20, 'core/corehttp/proxy.go': 8, 'core/coreapi/interface/tests/name.go': 3, 'core/coreapi/interface/tests/unixfs.go': 3, 'core/coreapi/test/api_test.go': 12, 'plugin/loader/loader.go': 13, 'core/commands/cmdenv/cidbase.go': 10, 'core/commands/cmdenv/file.go': 3, 'core/corehttp/ipns_hostname.go': 11, 'plugin/daemon.go': 10, 'core/corerepo/stat.go': 2, 'core/commands/cmdenv/cidbase_test.go': 2, 'core/corehttp/metrics.go': 1, 'core/corehttp/proxy_test.go': 1, 'plugin/tracer.go': 1, 'thirdparty/notifier/notifier.go': 2, 'go.mod': 5, 'go.sum': 5, 'core/corehttp/mutex_profile.go': 1, 'core/corehttp/option_test.go': 1, 'provider/queue.go': 1, 'provider/queue_test.go': 1, 'README.md': 2, 'package-list.json': 1, 'CHANGELOG.md': 1, 'Dockerfile': 1, 'bin/check_go_version': 1, 'coverage/Rules.mk': 1, 'docs/config.md': 1, 'docs/debug-guide.md': 1, 'docs/environment-variables.md': 1, 'gc/gc.go': 1, 'keystore/memkeystore_test.go': 1, 'misc/completion/ipfs-completion.bash': 1, 'plugin/plugins/gen_main.sh': 1, 'repo/fsrepo/migrations/migrations.go': 1, 'repo/onlyone.go': 1, 'test/3nodetest/run-test-on-img.sh': 1, 'test/ipfs-test-lib.sh': 1, 'test/sharness/README.md': 1, 'test/sharness/lib/iptb-lib.sh': 1, 'test/sharness/t0010-basic-commands.sh': 1, 'test/sharness/t0020-init.sh': 1, 'test/sharness/t0030-mount.sh': 1, 'test/sharness/t0031-mount-publish.sh': 1, 'test/sharness/t0050-block.sh': 1, 'test/sharness/t0051-object.sh': 1, 'test/sharness/t0053-dag.sh': 1, 'test/sharness/t0060-daemon.sh': 1, 'test/sharness/t0062-daemon-api.sh': 1, 'test/sharness/t0080-repo.sh': 1, 'test/sharness/t0087-repo-robust-gc.sh': 1, 'test/sharness/t0114-gateway-subdomains.sh': 1, 'test/sharness/t0131-multinode-client-routing.sh': 1, 'test/sharness/t0140-swarm.sh': 1, 'test/sharness/t0183-namesys-pubsub.sh': 1, 'test/sharness/t0250-files-api.sh': 1, 'test/sharness/t0270-filestore.sh': 1, 'test/sharness/t0272-urlstore.sh': 1, 'test/sharness_test_coverage_helper.sh': 1, 'thirdparty/README.md': 1, 'cmd/ipfs/util/ulimit_test.go': 1, 'cmd/ipfswatch/ipfswatch_test.go': 1, 'cmd/seccat/seccat_plan9.go': 1, 'cmd/seccat/seccat_posix.go': 1, 'fuse/node/mount_notsupp.go': 1}","('core/corehttp/commands.go', 0.7, 0.717948717948718)"
core/commands/helptext_test.go,28,190,2,"[{'cyclomatic_complexity': 6, 'nloc': 17, 'token_count': 146, 'name': 'checkHelptextRecursive', 'long_name': 'checkHelptextRecursive t * testing . T , name [ ] string , c * cmds . Command', 'start_line': 10, 'end_line': 30, 'full_parameters': ['t * testing . T', ' name [ ] string', ' c * cmds . Command'], 'filename': '/home/dimi/Documents/Informatik_Studium/FSS/SoftEvo/DataCollection/FFS_SoftEvo/go-ipfs/core/commands/helptext_test.go', 'top_nesting_level': 0, 'length': 21, 'fan_in': 0, 'fan_out': 0, 'general_fan_out': 0}, {'cyclomatic_complexity': 1, 'nloc': 5, 'token_count': 35, 'name': 'TestHelptexts', 'long_name': 'TestHelptexts t * testing . T', 'start_line': 32, 'end_line': 36, 'full_parameters': ['t * testing . T'], 'filename': '/home/dimi/Documents/Informatik_Studium/FSS/SoftEvo/DataCollection/FFS_SoftEvo/go-ipfs/core/commands/helptext_test.go', 'top_nesting_level': 0, 'length': 5, 'fan_in': 0, 'fan_out': 0, 'general_fan_out': 0}]",44,275,7,"[{'cyclomatic_complexity': 2, 'nloc': 5, 'token_count': 26, 'name': '', 'long_name': '(t*testing.T)', 'start_line': 18, 'end_line': 22, 'full_parameters': [], 'filename': '/home/dimi/Documents/Informatik_Studium/FSS/SoftEvo/DataCollection/FFS_SoftEvo/go-ipfs/core/commands/helptext_test.go', 'top_nesting_level': 0, 'length': 5, 'fan_in': 0, 'fan_out': 0, 'general_fan_out': 0}, {'cyclomatic_complexity': 2, 'nloc': 6, 'token_count': 32, 'name': '', 'long_name': '(t*testing.T)', 'start_line': 24, 'end_line': 29, 'full_parameters': [], 'filename': '/home/dimi/Documents/Informatik_Studium/FSS/SoftEvo/DataCollection/FFS_SoftEvo/go-ipfs/core/commands/helptext_test.go', 'top_nesting_level': 0, 'length': 6, 'fan_in': 0, 'fan_out': 0, 'general_fan_out': 0}, {'cyclomatic_complexity': 2, 'nloc': 6, 'token_count': 32, 'name': '', 'long_name': '(t*testing.T)', 'start_line': 31, 'end_line': 36, 'full_parameters': [], 'filename': '/home/dimi/Documents/Informatik_Studium/FSS/SoftEvo/DataCollection/FFS_SoftEvo/go-ipfs/core/commands/helptext_test.go', 'top_nesting_level': 0, 'length': 6, 'fan_in': 0, 'fan_out': 0, 'general_fan_out': 0}, {'cyclomatic_complexity': 2, 'nloc': 6, 'token_count': 32, 'name': '', 'long_name': '(t*testing.T)', 'start_line': 38, 'end_line': 43, 'full_parameters': [], 'filename': '/home/dimi/Documents/Informatik_Studium/FSS/SoftEvo/DataCollection/FFS_SoftEvo/go-ipfs/core/commands/helptext_test.go', 'top_nesting_level': 0, 'length': 6, 'fan_in': 0, 'fan_out': 0, 'general_fan_out': 0}, {'cyclomatic_complexity': 2, 'nloc': 9, 'token_count': 54, 'name': '', 'long_name': '(t*testing.T)', 'start_line': 13, 'end_line': 44, 'full_parameters': [], 'filename': '/home/dimi/Documents/Informatik_Studium/FSS/SoftEvo/DataCollection/FFS_SoftEvo/go-ipfs/core/commands/helptext_test.go', 'top_nesting_level': 0, 'length': 32, 'fan_in': 0, 'fan_out': 0, 'general_fan_out': 0}, {'cyclomatic_complexity': 2, 'nloc': 7, 'token_count': 66, 'name': 'checkHelptextRecursive', 'long_name': 'checkHelptextRecursive t * testing . T , name [ ] string , c * cmds . Command', 'start_line': 10, 'end_line': 49, 'full_parameters': ['t * testing . T', ' name [ ] string', ' c * cmds . Command'], 'filename': '/home/dimi/Documents/Informatik_Studium/FSS/SoftEvo/DataCollection/FFS_SoftEvo/go-ipfs/core/commands/helptext_test.go', 'top_nesting_level': 0, 'length': 40, 'fan_in': 0, 'fan_out': 0, 'general_fan_out': 0}, {'cyclomatic_complexity': 1, 'nloc': 4, 'token_count': 29, 'name': 'TestHelptexts', 'long_name': 'TestHelptexts t * testing . T', 'start_line': 51, 'end_line': 54, 'full_parameters': ['t * testing . T'], 'filename': '/home/dimi/Documents/Informatik_Studium/FSS/SoftEvo/DataCollection/FFS_SoftEvo/go-ipfs/core/commands/helptext_test.go', 'top_nesting_level': 0, 'length': 4, 'fan_in': 0, 'fan_out': 0, 'general_fan_out': 0}]",16,85,5,52,52,"[{'timestamp': 1491058697.0, 'added_lines': 1, 'deleted_lines': 1, 'nloc': 28}, {'timestamp': 1508770239.0, 'added_lines': 1, 'deleted_lines': 1, 'nloc': 28}, {'timestamp': 1509016767.0, 'added_lines': 1, 'deleted_lines': 1, 'nloc': 28}, {'timestamp': 1511223906.0, 'added_lines': 1, 'deleted_lines': 1, 'nloc': 28}, {'timestamp': 1511373659.0, 'added_lines': 1, 'deleted_lines': 1, 'nloc': 28}, {'timestamp': 1512365669.0, 'added_lines': 1, 'deleted_lines': 1, 'nloc': 28}, {'timestamp': 1511187070.0, 'added_lines': 1, 'deleted_lines': 1, 'nloc': 28}, {'timestamp': 1512121226.0, 'added_lines': 1, 'deleted_lines': 1, 'nloc': 28}, {'timestamp': 1513436097.0, 'added_lines': 1, 'deleted_lines': 1, 'nloc': 28}, {'timestamp': 1513612261.0, 'added_lines': 1, 'deleted_lines': 1, 'nloc': 28}, {'timestamp': 1513764708.0, 'added_lines': 1, 'deleted_lines': 1, 'nloc': 28}, {'timestamp': 1513765470.0, 'added_lines': 1, 'deleted_lines': 1, 'nloc': 28}, {'timestamp': 1513766201.0, 'added_lines': 1, 'deleted_lines': 1, 'nloc': 28}, {'timestamp': 1513772654.0, 'added_lines': 1, 'deleted_lines': 1, 'nloc': 28}, {'timestamp': 1513773452.0, 'added_lines': 1, 'deleted_lines': 1, 'nloc': 28}, {'timestamp': 1515465466.0, 'added_lines': 1, 'deleted_lines': 1, 'nloc': 28}, {'timestamp': 1515713724.0, 'added_lines': 1, 'deleted_lines': 1, 'nloc': 28}, {'timestamp': 1516341168.0, 'added_lines': 1, 'deleted_lines': 1, 'nloc': 28}, {'timestamp': 1516838128.0, 'added_lines': 1, 'deleted_lines': 1, 'nloc': 28}, {'timestamp': 1517105039.0, 'added_lines': 1, 'deleted_lines': 1, 'nloc': 28}, {'timestamp': 1517453697.0, 'added_lines': 1, 'deleted_lines': 1, 'nloc': 28}, {'timestamp': 1519173780.0, 'added_lines': 1, 'deleted_lines': 1, 'nloc': 28}, {'timestamp': 1521314540.0, 'added_lines': 1, 'deleted_lines': 1, 'nloc': 28}, {'timestamp': 1521500314.0, 'added_lines': 1, 'deleted_lines': 1, 'nloc': 28}, {'timestamp': 1524596476.0, 'added_lines': 1, 'deleted_lines': 1, 'nloc': 28}, {'timestamp': 1525408792.0, 'added_lines': 1, 'deleted_lines': 1, 'nloc': 28}, {'timestamp': 1528520460.0, 'added_lines': 1, 'deleted_lines': 1, 'nloc': 28}, {'timestamp': 1529984485.0, 'added_lines': 1, 'deleted_lines': 1, 'nloc': 28}, {'timestamp': 1533779477.0, 'added_lines': 1, 'deleted_lines': 1, 'nloc': 28}, {'timestamp': 1533946888.0, 'added_lines': 1, 'deleted_lines': 1, 'nloc': 28}, {'timestamp': 1534896611.0, 'added_lines': 1, 'deleted_lines': 1, 'nloc': 28}, {'timestamp': 1523628870.0, 'added_lines': 1, 'deleted_lines': 1, 'nloc': 28}, {'timestamp': 1535044155.0, 'added_lines': 1, 'deleted_lines': 1, 'nloc': 28}, {'timestamp': 1537193530.0, 'added_lines': 1, 'deleted_lines': 1, 'nloc': 28}, {'timestamp': 1537391809.0, 'added_lines': 1, 'deleted_lines': 1, 'nloc': 28}, {'timestamp': 1537792589.0, 'added_lines': 1, 'deleted_lines': 1, 'nloc': 28}, {'timestamp': 1539850591.0, 'added_lines': 1, 'deleted_lines': 1, 'nloc': 28}, {'timestamp': 1540552487.0, 'added_lines': 1, 'deleted_lines': 1, 'nloc': 28}, {'timestamp': 1540597832.0, 'added_lines': 1, 'deleted_lines': 1, 'nloc': 28}, {'timestamp': 1541204121.0, 'added_lines': 1, 'deleted_lines': 1, 'nloc': 28}, {'timestamp': 1544661332.0, 'added_lines': 1, 'deleted_lines': 1, 'nloc': 28}, {'timestamp': 1540556089.0, 'added_lines': 1, 'deleted_lines': 1, 'nloc': 28}, {'timestamp': 1546552047.0, 'added_lines': 34, 'deleted_lines': 16, 'nloc': 44}, {'timestamp': 1547152271.0, 'added_lines': 1, 'deleted_lines': 1, 'nloc': 44}, {'timestamp': 1548866534.0, 'added_lines': 1, 'deleted_lines': 1, 'nloc': 44}, {'timestamp': 1549903582.0, 'added_lines': 1, 'deleted_lines': 1, 'nloc': 44}, {'timestamp': 1550507829.0, 'added_lines': 1, 'deleted_lines': 1, 'nloc': 44}, {'timestamp': 1550610741.0, 'added_lines': 1, 'deleted_lines': 1, 'nloc': 44}, {'timestamp': 1551138343.0, 'added_lines': 1, 'deleted_lines': 1, 'nloc': 44}, {'timestamp': 1551299964.0, 'added_lines': 1, 'deleted_lines': 1, 'nloc': 44}, {'timestamp': 1551471469.0, 'added_lines': 1, 'deleted_lines': 1, 'nloc': 44}, {'timestamp': 1551551196.0, 'added_lines': 1, 'deleted_lines': 1, 'nloc': 44}]","{'blocks/blockstore/caching.go': 1, 'blocks/blockstore/util/remove.go': 3, 'cmd/ipfs/daemon.go': 51, 'cmd/ipfs/init.go': 33, 'cmd/ipfs/ipfs.go': 51, 'cmd/ipfs/main.go': 51, 'cmd/ipfs/main_test.go': 4, 'cmd/ipfswatch/main.go': 15, 'cmd/seccat/seccat.go': 14, None: 13, 'commands/channelmarshaler.go': 1, 'commands/cli/cmd_suggestion.go': 1, 'commands/cli/helptext.go': 2, 'commands/cli/helptext_test.go': 2, 'commands/cli/parse.go': 2, 'commands/cli/parse_test.go': 2, 'commands/command.go': 28, 'commands/command_test.go': 19, 'commands/http/client.go': 2, 'commands/http/handler.go': 2, 'commands/http/multifilereader.go': 2, 'commands/http/multifilereader_test.go': 2, 'commands/http/parse.go': 2, 'commands/reqlog.go': 1, 'commands/request.go': 36, 'commands/response.go': 23, 'commands/response_test.go': 19, 'core/bootstrap.go': 15, 'core/commands/active.go': 21, 'core/commands/add.go': 51, 'core/commands/bitswap.go': 51, 'core/commands/block.go': 51, 'core/commands/bootstrap.go': 23, 'core/commands/cat.go': 51, 'core/commands/commands.go': 51, 'core/commands/config.go': 24, 'core/commands/dag/dag.go': 27, 'core/commands/dht.go': 29, 'core/commands/diag.go': 21, 'core/commands/dns.go': 23, 'core/commands/e/error.go': 1, 'core/commands/external.go': 21, 'core/commands/files/files.go': 9, 'core/commands/filestore.go': 51, 'core/commands/get.go': 51, 'core/commands/id.go': 31, 'core/commands/ipns.go': 12, 'core/commands/keystore.go': 34, 'core/commands/log.go': 27, 'core/commands/ls.go': 27, 'core/commands/mount_nofuse.go': 21, 'core/commands/mount_unix.go': 23, 'core/commands/mount_windows.go': 20, 'core/commands/name.go': 9, 'core/commands/object/diff.go': 22, 'core/commands/object/object.go': 36, 'core/commands/object/patch.go': 36, 'core/commands/p2p.go': 25, 'core/commands/pin.go': 27, 'core/commands/ping.go': 28, 'core/commands/publish.go': 14, 'core/commands/pubsub.go': 51, 'core/commands/refs.go': 25, 'core/commands/repo.go': 51, 'core/commands/resolve.go': 27, 'core/commands/root.go': 51, 'core/commands/shutdown.go': 30, 'core/commands/stat.go': 51, 'core/commands/swarm.go': 31, 'core/commands/sysdiag.go': 24, 'core/commands/tar.go': 25, 'core/commands/unixfs/ls.go': 24, 'core/commands/unixfs/unixfs.go': 21, 'core/commands/version.go': 23, 'core/core_test.go': 7, 'core/corehttp/commands.go': 51, 'core/corehttp/gateway.go': 17, 'core/coreunix/add.go': 23, 'core/coreunix/add_test.go': 22, 'core/coreunix/metadata_test.go': 18, 'exchange/bitswap/bitswap_test.go': 10, 'exchange/bitswap/decision/engine_test.go': 8, 'exchange/bitswap/message/message_test.go': 4, 'exchange/bitswap/message/pb/Makefile': 1, 'exchange/bitswap/testnet/network_test.go': 8, 'exchange/bitswap/testnet/peernet.go': 9, 'exchange/reprovide/reprovide_test.go': 14, 'fuse/ipns/common.go': 14, 'fuse/node/mount_test.go': 14, 'importer/balanced/balanced_test.go': 6, 'importer/chunk/rabin_test.go': 3, 'importer/helpers/dagbuilder.go': 10, 'importer/importer.go': 10, 'merkledag/utils/utils_test.go': 4, 'mfs/repub_test.go': 9, 'namesys/dns.go': 9, 'namesys/interface.go': 10, 'namesys/ipns_select_test.go': 5, 'namesys/proquint.go': 9, 'namesys/republisher/repub_test.go': 17, 'package.json': 50, 'repo/config/identity.go': 3, 'routing/offline/offline_test.go': 6, 'test/integration/addcat_test.go': 19, 'test/integration/bench_cat_test.go': 18, 'test/integration/bitswap_wo_routing_test.go': 16, 'test/integration/three_legged_cat_test.go': 18, 'test/sharness/t0600-issues-and-regressions-online.sh': 1, 'core/bootstrap_test.go': 13, 'core/commands/dht_test.go': 13, 'core/commands/get_test.go': 48, 'core/core.go': 20, 'core/corehttp/gateway_test.go': 17, 'core/corehttp/metrics_test.go': 15, 'core/mock/mock.go': 15, 'exchange/bitswap/decision/bench_test.go': 7, 'exchange/bitswap/decision/peer_request_queue_test.go': 7, 'exchange/bitswap/message/message.go': 7, 'exchange/bitswap/network/interface.go': 7, 'exchange/bitswap/network/ipfs_impl.go': 7, 'exchange/bitswap/testnet/interface.go': 7, 'exchange/bitswap/testnet/virtual.go': 7, 'exchange/bitswap/testutils.go': 8, 'fuse/ipns/ipns_test.go': 13, 'fuse/readonly/ipfs_test.go': 19, 'namesys/publisher_test.go': 13, 'namesys/resolve_test.go': 14, 'p2p/p2p.go': 13, 'p2p/registry.go': 9, 'repo/config/bootstrap_peers.go': 9, 'routing/mock/centralized_client.go': 4, 'routing/mock/centralized_server.go': 4, 'routing/mock/centralized_test.go': 4, 'routing/mock/interface.go': 4, 'routing/none/none_client.go': 4, 'test/integration/bench_test.go': 13, 'assets/assets.go': 15, 'blocks/blockstore/arc_cache.go': 2, 'blocks/blockstore/arc_cache_test.go': 2, 'blocks/blockstore/blockstore.go': 3, 'blocks/blockstore/blockstore_test.go': 2, 'blocks/blockstore/bloom_cache.go': 2, 'blocks/blockstore/bloom_cache_test.go': 2, 'blocks/blocksutil/block_generator.go': 2, 'blockservice/blockservice.go': 6, 'blockservice/blockservice_test.go': 5, 'blockservice/test/blocks_test.go': 5, 'core/builder.go': 18, 'core/commands/ipnsps.go': 8, 'core/coreapi/coreapi.go': 8, 'core/coreapi/interface/interface.go': 2, 'core/coreapi/unixfs.go': 15, 'core/coreapi/unixfs_test.go': 13, 'core/coredag/cbor.go': 7, 'core/coredag/dagpb.go': 10, 'core/coredag/dagtransl.go': 6, 'core/coredag/raw.go': 10, 'core/corehttp/corehttp.go': 11, 'core/corehttp/gateway_handler.go': 19, 'core/corerepo/gc.go': 18, 'core/corerepo/pinning.go': 8, 'core/coreunix/metadata.go': 15, 'core/pathresolver.go': 13, 'exchange/bitswap/bitswap.go': 6, 'exchange/bitswap/decision/engine.go': 6, 'exchange/bitswap/decision/ledger.go': 6, 'exchange/bitswap/decision/peer_request_queue.go': 6, 'exchange/bitswap/get.go': 5, 'exchange/bitswap/notifications/notifications.go': 3, 'exchange/bitswap/notifications/notifications_test.go': 3, 'exchange/bitswap/session.go': 7, 'exchange/bitswap/session_test.go': 5, 'exchange/bitswap/stat.go': 3, 'exchange/bitswap/wantlist/wantlist.go': 3, 'exchange/bitswap/wantlist/wantlist_test.go': 3, 'exchange/bitswap/wantmanager.go': 6, 'exchange/bitswap/workers.go': 6, 'exchange/interface.go': 2, 'exchange/offline/offline.go': 2, 'exchange/offline/offline_test.go': 2, 'exchange/reprovide/providers.go': 12, 'exchange/reprovide/reprovide.go': 12, 'filestore/filestore.go': 12, 'filestore/filestore_test.go': 12, 'filestore/fsrefstore.go': 11, 'filestore/util.go': 11, 'fuse/ipns/ipns_unix.go': 18, 'fuse/readonly/readonly_unix.go': 19, 'importer/balanced/builder.go': 3, 'importer/chunk/splitting_test.go': 2, 'importer/helpers/helpers.go': 3, 'importer/importer_test.go': 5, 'importer/trickle/trickle_test.go': 5, 'importer/trickle/trickledag.go': 3, 'merkledag/batch.go': 2, 'merkledag/coding.go': 3, 'merkledag/merkledag.go': 3, 'merkledag/merkledag_test.go': 5, 'merkledag/node.go': 3, 'merkledag/node_test.go': 3, 'merkledag/raw.go': 3, 'merkledag/traverse/traverse.go': 3, 'merkledag/traverse/traverse_test.go': 3, 'merkledag/utils/diff.go': 3, 'merkledag/utils/diffenum.go': 3, 'merkledag/utils/diffenum_test.go': 3, 'merkledag/utils/utils.go': 5, 'mfs/dir.go': 5, 'mfs/file.go': 7, 'mfs/mfs_test.go': 7, 'mfs/ops.go': 4, 'mfs/system.go': 8, 'namesys/namesys.go': 15, 'namesys/publisher.go': 18, 'namesys/pubsub.go': 5, 'namesys/pubsub_test.go': 5, 'namesys/republisher/repub.go': 13, 'namesys/routing.go': 14, 'path/path.go': 3, 'path/resolver.go': 3, 'path/resolver_test.go': 2, 'pin/gc/gc.go': 13, 'pin/pin.go': 13, 'pin/pin_test.go': 12, 'pin/set.go': 10, 'pin/set_test.go': 12, 'plugin/ipld.go': 6, 'plugin/loader/initializer.go': 5, 'plugin/plugins/git/git.go': 6, 'repo/config/init.go': 7, 'repo/fsrepo/fsrepo.go': 12, 'repo/fsrepo/lock/lock.go': 3, 'repo/fsrepo/serialize/serialize.go': 3, 'repo/mock.go': 9, 'repo/repo.go': 10, 'routing/offline/offline.go': 3, 'tar/format.go': 18, 'test/dependencies/ma-pipe-unidir/main.go': 6, 'thirdparty/ds-help/key.go': 2, 'thirdparty/pollEndpoint/main.go': 11, 'thirdparty/posinfo/posinfo.go': 2, 'unixfs/archive/archive.go': 3, 'unixfs/archive/tar/writer.go': 3, 'unixfs/hamt/hamt.go': 3, 'unixfs/io/dagreader.go': 3, 'unixfs/io/dirbuilder.go': 3, 'unixfs/io/resolve.go': 3, 'unixfs/mod/dagmodifier.go': 5, 'unixfs/mod/dagmodifier_test.go': 3, 'unixfs/test/utils.go': 5, 'commands/legacy/command.go': 34, 'commands/legacy/legacy.go': 34, 'commands/legacy/legacy_test.go': 34, 'commands/legacy/request.go': 34, 'commands/legacy/response.go': 34, 'commands/legacy/responseemitter.go': 3, 'core/commands/env.go': 4, 'core/commands/commands_test.go': 44, 'test/sharness/t0040-add-and-cat.sh': 1, 'TODO.md': 2, 'test/sharness/t0110-gateway.sh': 1, 'test/sharness/t0410-api-add.sh': 1, 'core/coreapi/dag.go': 5, 'core/coreapi/dag_test.go': 3, 'core/coreapi/interface/options/dag.go': 4, 'core/coreapi/key.go': 13, 'core/coreapi/name.go': 13, 'merkledag/test/utils.go': 4, 'namesys/namesys_test.go': 16, 'repo/fsrepo/datastores.go': 10, 'repo/fsrepo/fsrepo_test.go': 7, 'thirdparty/datastore2/datastore_closer.go': 1, 'thirdparty/datastore2/delayed.go': 1, 'thirdparty/datastore2/threadsafe.go': 1, 'unixfs/io/pbdagreader.go': 2, 'cmd/ipfs/util/ulimit.go': 9, 'cmd/seccat/util.go': 9, 'core/corehttp/logs.go': 9, 'fuse/mount/mount.go': 9, 'fuse/node/mount_unix.go': 9, 'importer/chunk/splitting.go': 1, 'namesys/ipns_validate_test.go': 3, 'plugin/loader/load.go': 7, 'core/commands/files.go': 30, 'core/commands/root_test.go': 1, 'test/sharness/t0090-get.sh': 1, 'blocks/blockstoreutil/remove.go': 9, 'blockservice/test/mock.go': 3, 'core/coreapi/pin.go': 11, 'keystore/keystore.go': 8, 'keystore/keystore_test.go': 5, 'keystore/memkeystore.go': 5, 'namesys/validator.go': 2, 'path/resolver/resolver.go': 3, 'thirdparty/verifbs/verifbs.go': 9, 'cmd/ipfs/util/ulimit_freebsd.go': 2, 'cmd/ipfs/util/ulimit_unix.go': 2, 'core/coreapi/block.go': 7, 'core/coreapi/block_test.go': 2, 'core/coreapi/interface/coreapi.go': 3, 'core/coreapi/interface/dag.go': 3, 'core/coreapi/interface/object.go': 3, 'core/coreapi/interface/options/block.go': 2, 'core/coreapi/interface/path.go': 5, 'core/coreapi/interface/unixfs.go': 6, 'core/coreapi/object.go': 13, 'fuse/ipns/link_unix.go': 2, 'fuse/mount/fuse.go': 2, 'fuse/node/mount_darwin.go': 2, 'merkledag/errservice.go': 1, 'merkledag/readonly.go': 1, 'merkledag/readonly_test.go': 1, 'merkledag/rwservice.go': 1, 'merkledag/session.go': 1, 'path/resolver/resolver_test.go': 1, 'thirdparty/verifcid/validate.go': 1, 'thirdparty/verifcid/validate_test.go': 1, 'unixfs/hamt/hamt_stress_test.go': 1, 'unixfs/hamt/hamt_test.go': 1, 'namesys/ipns_resolver_validation_test.go': 9, 'test/sharness/t0170-dht.sh': 1, 'core/commands/urlstore.go': 24, 'core/coreapi/interface/key.go': 4, 'core/coreapi/name_test.go': 6, 'core/coreapi/path.go': 12, 'core/coreunix/cat.go': 4, 'core/pathresolver_test.go': 7, 'dagutils/diff.go': 8, 'dagutils/diffenum.go': 7, 'dagutils/diffenum_test.go': 7, 'dagutils/utils.go': 7, 'dagutils/utils_test.go': 7, 'filestore/pb/dataobj.pb.go': 3, 'mfs/fd.go': 2, 'namesys/base.go': 8, 'namesys/cache.go': 7, 'pin/internal/pb/header.pb.go': 3, 'thirdparty/cidv0v1/blockstore.go': 6, 'repo/fsrepo/config_test.go': 5, 'repo/fsrepo/misc.go': 5, 'test/bench/bench_cli_ipfs_add/main.go': 6, 'test/bench/offline_add/main.go': 6, 'core/commands/cmdenv/env.go': 20, 'core/commands/name/ipns.go': 20, 'core/commands/name/ipnsps.go': 20, 'core/commands/name/name.go': 20, 'core/commands/name/publish.go': 20, 'test/sharness/lib/test-lib.sh': 1, 'core/coreapi/dht.go': 6, 'core/coreapi/dht_test.go': 2, 'core/coreapi/interface/dht.go': 2, 'p2p/listener.go': 4, 'p2p/local.go': 4, 'p2p/remote.go': 4, 'p2p/stream.go': 4, 'core/commands/cid.go': 15, 'core/coreapi/unixfile.go': 3, 'cmd/ipfs/dnsresolve_test.go': 2, 'core/coreapi/interface/options/unixfs.go': 1, 'core/coreapi/interface/pubsub.go': 1, 'core/coreapi/interface/swarm.go': 1, 'core/coreapi/pubsub.go': 5, 'core/coreapi/swarm.go': 5, 'test/dependencies/iptb/iptb.go': 4, 'commands/context.go': 11, 'core/commands/cmdenv/cidbase.go': 8, 'core/commands/cmdenv/file.go': 3, 'core/coreapi/interface/tests/name.go': 1, 'core/coreapi/interface/tests/unixfs.go': 1, 'core/coreapi/test/api_test.go': 4, 'core/corehttp/ipns_hostname.go': 4, 'namesys/dns_test.go': 4, 'plugin/daemon.go': 4, 'plugin/loader/loader.go': 4, 'core/corehttp/proxy.go': 3, 'plugin/plugins/badgerds/badgerds.go': 3, 'plugin/plugins/flatfs/flatfs.go': 3, 'plugin/plugins/levelds/levelds.go': 2, 'core/corerepo/stat.go': 2, 'core/commands/cmdenv/cidbase_test.go': 1, 'core/corehttp/metrics.go': 1, 'core/corehttp/proxy_test.go': 1, 'plugin/tracer.go': 1, 'thirdparty/notifier/notifier.go': 1}","('cmd/ipfs/daemon.go', 0.9807692307692307, 0.3333333333333333)"
core/commands/id.go,183,1179,4,"[{'cyclomatic_complexity': 10, 'nloc': 45, 'token_count': 276, 'name': '', 'long_name': '(req cmds.Request,res cmds.Response)', 'start_line': 66, 'end_line': 116, 'full_parameters': [], 'filename': '/home/dimi/Documents/Informatik_Studium/FSS/SoftEvo/DataCollection/FFS_SoftEvo/go-ipfs/core/commands/id.go', 'top_nesting_level': 0, 'length': 51, 'fan_in': 0, 'fan_out': 0, 'general_fan_out': 0}, {'cyclomatic_complexity': 5, 'nloc': 28, 'token_count': 258, 'name': '', 'long_name': '(res cmds.Response)(io.Reader,error)', 'start_line': 118, 'end_line': 147, 'full_parameters': [], 'filename': '/home/dimi/Documents/Informatik_Studium/FSS/SoftEvo/DataCollection/FFS_SoftEvo/go-ipfs/core/commands/id.go', 'top_nesting_level': 0, 'length': 30, 'fan_in': 0, 'fan_out': 0, 'general_fan_out': 0}, {'cyclomatic_complexity': 1, 'nloc': 1, 'token_count': 17, 'name': 'printPeer', 'long_name': 'printPeer ps pstore . Peerstore , p peer . ID', 'start_line': 152, 'end_line': 152, 'full_parameters': ['ps pstore . Peerstore', ' p peer . ID'], 'filename': '/home/dimi/Documents/Informatik_Studium/FSS/SoftEvo/DataCollection/FFS_SoftEvo/go-ipfs/core/commands/id.go', 'top_nesting_level': 0, 'length': 1, 'fan_in': 0, 'fan_out': 0, 'general_fan_out': 0}, {'cyclomatic_complexity': 1, 'nloc': 1, 'token_count': 13, 'name': 'printSelf', 'long_name': 'printSelf node * core . IpfsNode', 'start_line': 187, 'end_line': 187, 'full_parameters': ['node * core . IpfsNode'], 'filename': '/home/dimi/Documents/Informatik_Studium/FSS/SoftEvo/DataCollection/FFS_SoftEvo/go-ipfs/core/commands/id.go', 'top_nesting_level': 0, 'length': 1, 'fan_in': 0, 'fan_out': 0, 'general_fan_out': 0}]",197,1276,2,"[{'cyclomatic_complexity': 1, 'nloc': 1, 'token_count': 22, 'name': 'printPeer', 'long_name': 'printPeer keyEnc ke . KeyEncoder , ps pstore . Peerstore , p peer . ID', 'start_line': 154, 'end_line': 154, 'full_parameters': ['keyEnc ke . KeyEncoder', ' ps pstore . Peerstore', ' p peer . ID'], 'filename': '/home/dimi/Documents/Informatik_Studium/FSS/SoftEvo/DataCollection/FFS_SoftEvo/go-ipfs/core/commands/id.go', 'top_nesting_level': 0, 'length': 1, 'fan_in': 0, 'fan_out': 0, 'general_fan_out': 0}, {'cyclomatic_complexity': 1, 'nloc': 1, 'token_count': 18, 'name': 'printSelf', 'long_name': 'printSelf keyEnc ke . KeyEncoder , node * core . IpfsNode', 'start_line': 202, 'end_line': 202, 'full_parameters': ['keyEnc ke . KeyEncoder', ' node * core . IpfsNode'], 'filename': '/home/dimi/Documents/Informatik_Studium/FSS/SoftEvo/DataCollection/FFS_SoftEvo/go-ipfs/core/commands/id.go', 'top_nesting_level': 0, 'length': 1, 'fan_in': 0, 'fan_out': 0, 'general_fan_out': 0}]",14,97,-2,77,77,"[{'timestamp': 1507304579.0, 'added_lines': 1, 'deleted_lines': 1, 'nloc': 183}, {'timestamp': 1508424715.0, 'added_lines': 1, 'deleted_lines': 1, 'nloc': 183}, {'timestamp': 1491058697.0, 'added_lines': 23, 'deleted_lines': 18, 'nloc': 188}, {'timestamp': 1511223906.0, 'added_lines': 3, 'deleted_lines': 3, 'nloc': 188}, {'timestamp': 1512365669.0, 'added_lines': 5, 'deleted_lines': 5, 'nloc': 188}, {'timestamp': 1511187070.0, 'added_lines': 2, 'deleted_lines': 1, 'nloc': 189}, {'timestamp': 1512058290.0, 'added_lines': 0, 'deleted_lines': 1, 'nloc': 188}, {'timestamp': 1513436097.0, 'added_lines': 1, 'deleted_lines': 1, 'nloc': 188}, {'timestamp': 1513612261.0, 'added_lines': 1, 'deleted_lines': 1, 'nloc': 188}, {'timestamp': 1515277696.0, 'added_lines': 1, 'deleted_lines': 1, 'nloc': 188}, {'timestamp': 1516838128.0, 'added_lines': 4, 'deleted_lines': 4, 'nloc': 188}, {'timestamp': 1516838710.0, 'added_lines': 3, 'deleted_lines': 3, 'nloc': 188}, {'timestamp': 1517105039.0, 'added_lines': 1, 'deleted_lines': 1, 'nloc': 188}, {'timestamp': 1517453697.0, 'added_lines': 4, 'deleted_lines': 4, 'nloc': 188}, {'timestamp': 1521399286.0, 'added_lines': 1, 'deleted_lines': 1, 'nloc': 188}, {'timestamp': 1525408792.0, 'added_lines': 5, 'deleted_lines': 5, 'nloc': 188}, {'timestamp': 1528131220.0, 'added_lines': 1, 'deleted_lines': 1, 'nloc': 188}, {'timestamp': 1528268108.0, 'added_lines': 3, 'deleted_lines': 3, 'nloc': 188}, {'timestamp': 1528520460.0, 'added_lines': 5, 'deleted_lines': 5, 'nloc': 188}, {'timestamp': 1529984485.0, 'added_lines': 4, 'deleted_lines': 4, 'nloc': 188}, {'timestamp': 1532146078.0, 'added_lines': 1, 'deleted_lines': 1, 'nloc': 188}, {'timestamp': 1533779477.0, 'added_lines': 5, 'deleted_lines': 5, 'nloc': 188}, {'timestamp': 1533946888.0, 'added_lines': 1, 'deleted_lines': 1, 'nloc': 188}, {'timestamp': 1534896611.0, 'added_lines': 5, 'deleted_lines': 5, 'nloc': 188}, {'timestamp': 1535601896.0, 'added_lines': 1, 'deleted_lines': 1, 'nloc': 188}, {'timestamp': 1536388808.0, 'added_lines': 3, 'deleted_lines': 3, 'nloc': 188}, {'timestamp': 1537792589.0, 'added_lines': 4, 'deleted_lines': 4, 'nloc': 188}, {'timestamp': 1538544957.0, 'added_lines': 3, 'deleted_lines': 3, 'nloc': 188}, {'timestamp': 1538695953.0, 'added_lines': 1, 'deleted_lines': 1, 'nloc': 188}, {'timestamp': 1538662493.0, 'added_lines': 6, 'deleted_lines': 2, 'nloc': 191}, {'timestamp': 1538773916.0, 'added_lines': 3, 'deleted_lines': 3, 'nloc': 191}, {'timestamp': 1539176817.0, 'added_lines': 3, 'deleted_lines': 3, 'nloc': 191}, {'timestamp': 1539357340.0, 'added_lines': 1, 'deleted_lines': 1, 'nloc': 191}, {'timestamp': 1539850591.0, 'added_lines': 1, 'deleted_lines': 1, 'nloc': 191}, {'timestamp': 1540400358.0, 'added_lines': 4, 'deleted_lines': 4, 'nloc': 191}, {'timestamp': 1540410565.0, 'added_lines': 1, 'deleted_lines': 1, 'nloc': 191}, {'timestamp': 1540418491.0, 'added_lines': 1, 'deleted_lines': 1, 'nloc': 191}, {'timestamp': 1540487471.0, 'added_lines': 31, 'deleted_lines': 46, 'nloc': 178}, {'timestamp': 1540552487.0, 'added_lines': 1, 'deleted_lines': 1, 'nloc': 178}, {'timestamp': 1540548172.0, 'added_lines': 7, 'deleted_lines': 13, 'nloc': 173}, {'timestamp': 1540597832.0, 'added_lines': 1, 'deleted_lines': 1, 'nloc': 173}, {'timestamp': 1541204121.0, 'added_lines': 6, 'deleted_lines': 6, 'nloc': 173}, {'timestamp': 1541903826.0, 'added_lines': 3, 'deleted_lines': 3, 'nloc': 173}, {'timestamp': 1544225843.0, 'added_lines': 4, 'deleted_lines': 4, 'nloc': 173}, {'timestamp': 1544661332.0, 'added_lines': 1, 'deleted_lines': 1, 'nloc': 173}, {'timestamp': 1544667474.0, 'added_lines': 0, 'deleted_lines': 6, 'nloc': 168}, {'timestamp': 1540556089.0, 'added_lines': 1, 'deleted_lines': 1, 'nloc': 168}, {'timestamp': 1547003974.0, 'added_lines': 3, 'deleted_lines': 3, 'nloc': 168}, {'timestamp': 1547152271.0, 'added_lines': 1, 'deleted_lines': 1, 'nloc': 168}, {'timestamp': 1548866534.0, 'added_lines': 1, 'deleted_lines': 1, 'nloc': 168}, {'timestamp': 1549588289.0, 'added_lines': 4, 'deleted_lines': 4, 'nloc': 168}, {'timestamp': 1549903582.0, 'added_lines': 1, 'deleted_lines': 1, 'nloc': 168}, {'timestamp': 1550185115.0, 'added_lines': 2, 'deleted_lines': 2, 'nloc': 168}, {'timestamp': 1550507829.0, 'added_lines': 6, 'deleted_lines': 6, 'nloc': 168}, {'timestamp': 1550610741.0, 'added_lines': 1, 'deleted_lines': 1, 'nloc': 168}, {'timestamp': 1550723346.0, 'added_lines': 1, 'deleted_lines': 1, 'nloc': 168}, {'timestamp': 1551138343.0, 'added_lines': 1, 'deleted_lines': 1, 'nloc': 168}, {'timestamp': 1551229859.0, 'added_lines': 4, 'deleted_lines': 4, 'nloc': 168}, {'timestamp': 1551299964.0, 'added_lines': 2, 'deleted_lines': 2, 'nloc': 168}, {'timestamp': 1551471469.0, 'added_lines': 1, 'deleted_lines': 1, 'nloc': 168}, {'timestamp': 1551754781.0, 'added_lines': 1, 'deleted_lines': 1, 'nloc': 168}, {'timestamp': 1551551196.0, 'added_lines': 7, 'deleted_lines': 7, 'nloc': 168}, {'timestamp': 1557554420.0, 'added_lines': 6, 'deleted_lines': 7, 'nloc': 167}, {'timestamp': 1559060517.0, 'added_lines': 3, 'deleted_lines': 3, 'nloc': 167}, {'timestamp': 1569537492.0, 'added_lines': 2, 'deleted_lines': 1, 'nloc': 168}, {'timestamp': 1576349311.0, 'added_lines': 1, 'deleted_lines': 1, 'nloc': 168}, {'timestamp': 1580917148.0, 'added_lines': 7, 'deleted_lines': 3, 'nloc': 172}, {'timestamp': 1590803241.0, 'added_lines': 7, 'deleted_lines': 1, 'nloc': 177}, {'timestamp': 1590616351.0, 'added_lines': 7, 'deleted_lines': 5, 'nloc': 178}, {'timestamp': 1590616588.0, 'added_lines': 8, 'deleted_lines': 0, 'nloc': 185}, {'timestamp': 1596937114.0, 'added_lines': 3, 'deleted_lines': 0, 'nloc': 188}, {'timestamp': 1596937158.0, 'added_lines': 2, 'deleted_lines': 0, 'nloc': 190}, {'timestamp': 1597189435.0, 'added_lines': 15, 'deleted_lines': 7, 'nloc': 197}, {'timestamp': 1599767599.0, 'added_lines': 1, 'deleted_lines': 1, 'nloc': 197}, {'timestamp': 1599767599.0, 'added_lines': 1, 'deleted_lines': 1, 'nloc': 197}, {'timestamp': 1616604074.0, 'added_lines': 1, 'deleted_lines': 1, 'nloc': 197}, {'timestamp': 1632249068.0, 'added_lines': 1, 'deleted_lines': 1, 'nloc': 197}]","{'core/bootstrap.go': 29, 'core/bootstrap_test.go': 26, 'core/commands/dht.go': 58, 'core/commands/dht_test.go': 25, 'core/commands/pubsub.go': 47, 'core/core.go': 48, 'core/corehttp/gateway.go': 41, 'core/corehttp/gateway_test.go': 42, 'core/corehttp/metrics_test.go': 38, 'core/mock/mock.go': 38, 'exchange/bitswap/bitswap_test.go': 14, 'exchange/bitswap/decision/bench_test.go': 8, 'exchange/bitswap/decision/engine_test.go': 10, 'exchange/bitswap/decision/peer_request_queue_test.go': 8, 'exchange/bitswap/network/ipfs_impl.go': 10, 'exchange/bitswap/testnet/interface.go': 8, 'exchange/bitswap/testnet/network_test.go': 11, 'exchange/bitswap/testnet/peernet.go': 14, 'exchange/bitswap/testnet/virtual.go': 11, 'exchange/bitswap/testutils.go': 13, 'exchange/reprovide/reprovide_test.go': 30, 'fuse/ipns/ipns_test.go': 29, 'fuse/node/mount_test.go': 30, 'fuse/readonly/ipfs_test.go': 39, 'mfs/repub_test.go': 10, 'namesys/publisher_test.go': 29, 'namesys/republisher/repub_test.go': 39, 'namesys/resolve_test.go': 36, 'p2p/p2p.go': 28, 'package.json': 54, 'routing/mock/centralized_client.go': 5, 'routing/mock/centralized_server.go': 5, 'routing/mock/centralized_test.go': 5, 'routing/mock/interface.go': 5, 'routing/none/none_client.go': 5, 'routing/offline/offline_test.go': 6, 'test/integration/addcat_test.go': 42, 'test/integration/bench_cat_test.go': 41, 'test/integration/bench_test.go': 20, 'test/integration/bitswap_wo_routing_test.go': 38, 'test/integration/three_legged_cat_test.go': 41, 'thirdparty/ipfsaddr/ipfsaddr.go': 2, 'core/commands/swarm.go': 53, 'blocks/blockstore/caching.go': 1, 'blocks/blockstore/util/remove.go': 3, 'cmd/ipfs/daemon.go': 41, 'cmd/ipfs/init.go': 40, 'cmd/ipfs/ipfs.go': 31, 'cmd/ipfs/main.go': 43, 'cmd/ipfs/main_test.go': 4, 'cmd/ipfswatch/main.go': 21, 'cmd/seccat/seccat.go': 29, None: 13, 'commands/channelmarshaler.go': 1, 'commands/cli/cmd_suggestion.go': 1, 'commands/cli/helptext.go': 2, 'commands/cli/helptext_test.go': 2, 'commands/cli/parse.go': 2, 'commands/cli/parse_test.go': 2, 'commands/command.go': 19, 'commands/command_test.go': 10, 'commands/http/client.go': 2, 'commands/http/handler.go': 2, 'commands/http/multifilereader.go': 2, 'commands/http/multifilereader_test.go': 2, 'commands/http/parse.go': 2, 'commands/reqlog.go': 1, 'commands/request.go': 25, 'commands/response.go': 14, 'commands/response_test.go': 10, 'core/commands/active.go': 24, 'core/commands/add.go': 43, 'core/commands/bitswap.go': 55, 'core/commands/block.go': 37, 'core/commands/bootstrap.go': 34, 'core/commands/cat.go': 39, 'core/commands/commands.go': 33, 'core/commands/config.go': 36, 'core/commands/dag/dag.go': 47, 'core/commands/diag.go': 23, 'core/commands/dns.go': 30, 'core/commands/e/error.go': 1, 'core/commands/external.go': 23, 'core/commands/files/files.go': 9, 'core/commands/filestore.go': 35, 'core/commands/get.go': 51, 'core/commands/helptext_test.go': 31, 'core/commands/ipns.go': 15, 'core/commands/keystore.go': 37, 'core/commands/log.go': 29, 'core/commands/ls.go': 47, 'core/commands/mount_nofuse.go': 23, 'core/commands/mount_unix.go': 34, 'core/commands/mount_windows.go': 22, 'core/commands/name.go': 10, 'core/commands/object/diff.go': 28, 'core/commands/object/object.go': 50, 'core/commands/object/patch.go': 35, 'core/commands/p2p.go': 40, 'core/commands/pin.go': 50, 'core/commands/ping.go': 47, 'core/commands/publish.go': 16, 'core/commands/refs.go': 45, 'core/commands/repo.go': 46, 'core/commands/resolve.go': 47, 'core/commands/root.go': 35, 'core/commands/shutdown.go': 30, 'core/commands/stat.go': 44, 'core/commands/sysdiag.go': 31, 'core/commands/tar.go': 45, 'core/commands/unixfs/ls.go': 43, 'core/commands/unixfs/unixfs.go': 23, 'core/commands/version.go': 27, 'core/core_test.go': 17, 'core/corehttp/commands.go': 49, 'core/coreunix/add.go': 42, 'core/coreunix/add_test.go': 41, 'core/coreunix/metadata_test.go': 36, 'exchange/bitswap/message/message_test.go': 4, 'exchange/bitswap/message/pb/Makefile': 1, 'fuse/ipns/common.go': 32, 'importer/balanced/balanced_test.go': 7, 'importer/chunk/rabin_test.go': 3, 'importer/helpers/dagbuilder.go': 11, 'importer/importer.go': 11, 'merkledag/utils/utils_test.go': 4, 'namesys/dns.go': 26, 'namesys/interface.go': 29, 'namesys/ipns_select_test.go': 5, 'namesys/proquint.go': 26, 'repo/config/identity.go': 3, 'core/commands/get_test.go': 32, 'exchange/bitswap/message/message.go': 8, 'exchange/bitswap/network/interface.go': 8, 'p2p/registry.go': 12, 'repo/config/bootstrap_peers.go': 12, 'assets/assets.go': 31, 'blocks/blockstore/arc_cache.go': 2, 'blocks/blockstore/arc_cache_test.go': 2, 'blocks/blockstore/blockstore.go': 3, 'blocks/blockstore/blockstore_test.go': 2, 'blocks/blockstore/bloom_cache.go': 2, 'blocks/blockstore/bloom_cache_test.go': 2, 'blocks/blocksutil/block_generator.go': 2, 'blockservice/blockservice.go': 7, 'blockservice/blockservice_test.go': 6, 'blockservice/test/blocks_test.go': 6, 'core/builder.go': 39, 'core/commands/ipnsps.go': 10, 'core/coreapi/coreapi.go': 20, 'core/coreapi/interface/interface.go': 2, 'core/coreapi/unixfs.go': 33, 'core/coreapi/unixfs_test.go': 26, 'core/coredag/cbor.go': 9, 'core/coredag/dagpb.go': 27, 'core/coredag/dagtransl.go': 7, 'core/coredag/raw.go': 27, 'core/corehttp/corehttp.go': 15, 'core/corehttp/gateway_handler.go': 39, 'core/corerepo/gc.go': 36, 'core/corerepo/pinning.go': 10, 'core/coreunix/metadata.go': 32, 'core/pathresolver.go': 30, 'exchange/bitswap/bitswap.go': 7, 'exchange/bitswap/decision/engine.go': 7, 'exchange/bitswap/decision/ledger.go': 6, 'exchange/bitswap/decision/peer_request_queue.go': 6, 'exchange/bitswap/get.go': 6, 'exchange/bitswap/notifications/notifications.go': 3, 'exchange/bitswap/notifications/notifications_test.go': 3, 'exchange/bitswap/session.go': 7, 'exchange/bitswap/session_test.go': 5, 'exchange/bitswap/stat.go': 3, 'exchange/bitswap/wantlist/wantlist.go': 3, 'exchange/bitswap/wantlist/wantlist_test.go': 3, 'exchange/bitswap/wantmanager.go': 7, 'exchange/bitswap/workers.go': 6, 'exchange/interface.go': 2, 'exchange/offline/offline.go': 2, 'exchange/offline/offline_test.go': 2, 'exchange/reprovide/providers.go': 30, 'exchange/reprovide/reprovide.go': 25, 'filestore/filestore.go': 18, 'filestore/filestore_test.go': 30, 'filestore/fsrefstore.go': 17, 'filestore/util.go': 17, 'fuse/ipns/ipns_unix.go': 37, 'fuse/readonly/readonly_unix.go': 37, 'importer/balanced/builder.go': 3, 'importer/chunk/splitting_test.go': 2, 'importer/helpers/helpers.go': 3, 'importer/importer_test.go': 5, 'importer/trickle/trickle_test.go': 6, 'importer/trickle/trickledag.go': 4, 'merkledag/batch.go': 2, 'merkledag/coding.go': 4, 'merkledag/merkledag.go': 4, 'merkledag/merkledag_test.go': 7, 'merkledag/node.go': 3, 'merkledag/node_test.go': 3, 'merkledag/raw.go': 3, 'merkledag/traverse/traverse.go': 3, 'merkledag/traverse/traverse_test.go': 3, 'merkledag/utils/diff.go': 3, 'merkledag/utils/diffenum.go': 3, 'merkledag/utils/diffenum_test.go': 3, 'merkledag/utils/utils.go': 6, 'mfs/dir.go': 5, 'mfs/file.go': 7, 'mfs/mfs_test.go': 9, 'mfs/ops.go': 4, 'mfs/system.go': 8, 'namesys/namesys.go': 35, 'namesys/publisher.go': 37, 'namesys/pubsub.go': 6, 'namesys/pubsub_test.go': 5, 'namesys/republisher/repub.go': 31, 'namesys/routing.go': 36, 'path/path.go': 3, 'path/resolver.go': 3, 'path/resolver_test.go': 2, 'pin/gc/gc.go': 31, 'pin/pin.go': 31, 'pin/pin_test.go': 30, 'pin/set.go': 27, 'pin/set_test.go': 30, 'plugin/ipld.go': 7, 'plugin/loader/initializer.go': 5, 'plugin/plugins/git/git.go': 7, 'repo/config/init.go': 8, 'repo/fsrepo/fsrepo.go': 24, 'repo/fsrepo/lock/lock.go': 3, 'repo/fsrepo/serialize/serialize.go': 4, 'repo/mock.go': 17, 'repo/repo.go': 20, 'routing/offline/offline.go': 3, 'tar/format.go': 35, 'test/dependencies/ma-pipe-unidir/main.go': 10, 'thirdparty/ds-help/key.go': 2, 'thirdparty/pollEndpoint/main.go': 16, 'thirdparty/posinfo/posinfo.go': 2, 'unixfs/archive/archive.go': 3, 'unixfs/archive/tar/writer.go': 3, 'unixfs/hamt/hamt.go': 3, 'unixfs/io/dagreader.go': 3, 'unixfs/io/dirbuilder.go': 3, 'unixfs/io/resolve.go': 3, 'unixfs/mod/dagmodifier.go': 5, 'unixfs/mod/dagmodifier_test.go': 3, 'unixfs/test/utils.go': 6, 'commands/legacy/command.go': 17, 'commands/legacy/legacy.go': 17, 'commands/legacy/legacy_test.go': 18, 'commands/legacy/request.go': 19, 'commands/legacy/response.go': 18, 'commands/legacy/responseemitter.go': 4, 'core/commands/env.go': 4, 'TODO.md': 2, 'core/commands/commands_test.go': 27, 'test/sharness/t0110-gateway.sh': 1, 'test/sharness/t0410-api-add.sh': 1, 'core/coreapi/dag.go': 6, 'core/coreapi/dag_test.go': 3, 'core/coreapi/interface/options/dag.go': 4, 'core/coreapi/key.go': 31, 'core/coreapi/name.go': 34, 'merkledag/test/utils.go': 5, 'namesys/namesys_test.go': 37, 'repo/fsrepo/datastores.go': 15, 'repo/fsrepo/fsrepo_test.go': 17, 'thirdparty/datastore2/datastore_closer.go': 1, 'thirdparty/datastore2/delayed.go': 1, 'thirdparty/datastore2/threadsafe.go': 1, 'unixfs/io/pbdagreader.go': 3, 'cmd/ipfs/util/ulimit.go': 9, 'cmd/seccat/util.go': 9, 'core/corehttp/logs.go': 9, 'fuse/mount/mount.go': 10, 'fuse/node/mount_unix.go': 10, 'importer/chunk/splitting.go': 1, 'namesys/ipns_validate_test.go': 5, 'plugin/loader/load.go': 7, 'core/coreapi/object.go': 31, 'fuse/mount/fuse.go': 3, 'keystore/keystore_test.go': 7, 'namesys/dns_test.go': 8, 'repo/config/config.go': 1, 'unixfs/unixfs.go': 1, 'blocks/blockstoreutil/remove.go': 15, 'blockservice/test/mock.go': 5, 'core/commands/files.go': 43, 'core/coreapi/pin.go': 29, 'keystore/keystore.go': 9, 'keystore/memkeystore.go': 6, 'namesys/validator.go': 3, 'path/resolver/resolver.go': 3, 'thirdparty/verifbs/verifbs.go': 15, 'cmd/ipfs/util/ulimit_freebsd.go': 2, 'cmd/ipfs/util/ulimit_unix.go': 2, 'core/coreapi/block.go': 10, 'core/coreapi/block_test.go': 2, 'core/coreapi/interface/coreapi.go': 3, 'core/coreapi/interface/dag.go': 3, 'core/coreapi/interface/object.go': 3, 'core/coreapi/interface/options/block.go': 2, 'core/coreapi/interface/path.go': 19, 'core/coreapi/interface/unixfs.go': 7, 'fuse/ipns/link_unix.go': 2, 'fuse/node/mount_darwin.go': 2, 'merkledag/errservice.go': 1, 'merkledag/readonly.go': 1, 'merkledag/readonly_test.go': 1, 'merkledag/rwservice.go': 1, 'merkledag/session.go': 1, 'path/resolver/resolver_test.go': 1, 'thirdparty/verifcid/validate.go': 1, 'thirdparty/verifcid/validate_test.go': 1, 'unixfs/hamt/hamt_stress_test.go': 1, 'unixfs/hamt/hamt_test.go': 1, 'namesys/ipns_resolver_validation_test.go': 27, 'test/sharness/t0170-dht.sh': 1, 'core/corehttp/metrics.go': 2, 'core/commands/urlstore.go': 37, 'core/coreapi/interface/key.go': 7, 'core/coreapi/name_test.go': 18, 'core/coreapi/path.go': 29, 'core/coreunix/cat.go': 6, 'core/pathresolver_test.go': 24, 'dagutils/diff.go': 25, 'dagutils/diffenum.go': 24, 'dagutils/diffenum_test.go': 24, 'dagutils/utils.go': 24, 'dagutils/utils_test.go': 24, 'filestore/pb/dataobj.pb.go': 3, 'mfs/fd.go': 2, 'namesys/base.go': 25, 'namesys/cache.go': 24, 'pin/internal/pb/header.pb.go': 3, 'thirdparty/cidv0v1/blockstore.go': 11, 'repo/fsrepo/config_test.go': 13, 'repo/fsrepo/misc.go': 13, 'test/bench/bench_cli_ipfs_add/main.go': 14, 'test/bench/offline_add/main.go': 14, 'core/commands/cmdenv/env.go': 26, 'core/commands/name/ipns.go': 34, 'core/commands/name/publish.go': 23, 'core/commands/name/ipnsps.go': 24, 'core/commands/name/name.go': 17, 'core/coreapi/dht.go': 22, 'core/coreapi/dht_test.go': 4, 'core/coreapi/interface/dht.go': 10, 'p2p/listener.go': 14, 'p2p/local.go': 14, 'p2p/remote.go': 14, 'p2p/stream.go': 14, 'core/coreapi/interface/swarm.go': 9, 'core/coreapi/swarm.go': 20, 'core/commands/cid.go': 18, 'core/coreapi/interface/options/unixfs.go': 11, 'core/coreapi/pubsub.go': 18, 'core/coreapi/unixfile.go': 12, 'cmd/ipfs/dnsresolve_test.go': 5, 'core/coreapi/interface/pubsub.go': 4, 'test/dependencies/iptb/iptb.go': 11, 'plugin/plugins/badgerds/badgerds.go': 4, 'plugin/plugins/flatfs/flatfs.go': 4, 'plugin/plugins/levelds/levelds.go': 3, 'commands/context.go': 17, 'core/corehttp/proxy.go': 10, 'core/coreapi/interface/tests/name.go': 3, 'core/coreapi/interface/tests/unixfs.go': 3, 'core/coreapi/test/api_test.go': 10, 'core/commands/cmdenv/cidbase.go': 10, 'core/commands/cmdenv/file.go': 3, 'core/corehttp/ipns_hostname.go': 7, 'plugin/daemon.go': 7, 'plugin/loader/loader.go': 7, 'core/corerepo/stat.go': 2, 'core/commands/cmdenv/cidbase_test.go': 2, 'core/corehttp/proxy_test.go': 2, 'plugin/tracer.go': 1, 'thirdparty/notifier/notifier.go': 1, 'README.md': 2, 'go.mod': 2, 'go.sum': 2, 'package-list.json': 1, 'core/bootstrap/bootstrap.go': 1, 'core/bootstrap/bootstrap_test.go': 1, 'core/node/builder.go': 1, 'core/node/core.go': 1, 'core/node/groups.go': 3, 'core/node/identity.go': 1, 'core/node/ipns.go': 1, 'core/node/libp2p/addrs.go': 1, 'core/node/libp2p/discovery.go': 1, 'core/node/libp2p/host.go': 1, 'core/node/libp2p/hostopt.go': 1, 'core/node/libp2p/libp2p.go': 3, 'core/node/libp2p/nat.go': 1, 'core/node/libp2p/pnet.go': 1, 'core/node/libp2p/pubsub.go': 1, 'core/node/libp2p/routing.go': 1, 'core/node/libp2p/routingopt.go': 1, 'core/node/libp2p/smux.go': 1, 'core/node/libp2p/transport.go': 1, 'core/node/provider.go': 1, 'provider/simple/provider.go': 1, 'provider/simple/provider_test.go': 1, 'provider/simple/reprovide.go': 1, 'provider/simple/reprovide_test.go': 1, 'version.go': 2, 'test/sharness/t0140-swarm.sh': 1, 'core/commands/pin/pin.go': 1, 'core/commands/stat_dht.go': 1, 'test/sharness/t0026-id.sh': 1}","('core/commands/dht.go', 0.7532467532467533, 0.5225225225225225)"
core/commands/keystore.go,336,2010,7,"[{'cyclomatic_complexity': 13, 'nloc': 67, 'token_count': 385, 'name': '', 'long_name': '(req cmds.Request,res cmds.Response)', 'start_line': 71, 'end_line': 149, 'full_parameters': [], 'filename': '/home/dimi/Documents/Informatik_Studium/FSS/SoftEvo/DataCollection/FFS_SoftEvo/go-ipfs/core/commands/keystore.go', 'top_nesting_level': 0, 'length': 79, 'fan_in': 0, 'fan_out': 0, 'general_fan_out': 0}, {'cyclomatic_complexity': 2, 'nloc': 7, 'token_count': 57, 'name': '', 'long_name': '(res cmds.Response)(io.Reader,error)', 'start_line': 151, 'end_line': 158, 'full_parameters': [], 'filename': '/home/dimi/Documents/Informatik_Studium/FSS/SoftEvo/DataCollection/FFS_SoftEvo/go-ipfs/core/commands/keystore.go', 'top_nesting_level': 0, 'length': 8, 'fan_in': 0, 'fan_out': 0, 'general_fan_out': 0}, {'cyclomatic_complexity': 6, 'nloc': 30, 'token_count': 229, 'name': '', 'long_name': '(req cmds.Request,res cmds.Response)', 'start_line': 170, 'end_line': 208, 'full_parameters': [], 'filename': '/home/dimi/Documents/Informatik_Studium/FSS/SoftEvo/DataCollection/FFS_SoftEvo/go-ipfs/core/commands/keystore.go', 'top_nesting_level': 0, 'length': 39, 'fan_in': 0, 'fan_out': 0, 'general_fan_out': 0}, {'cyclomatic_complexity': 12, 'nloc': 62, 'token_count': 352, 'name': '', 'long_name': '(req cmds.Request,res cmds.Response)', 'start_line': 226, 'end_line': 299, 'full_parameters': [], 'filename': '/home/dimi/Documents/Informatik_Studium/FSS/SoftEvo/DataCollection/FFS_SoftEvo/go-ipfs/core/commands/keystore.go', 'top_nesting_level': 0, 'length': 74, 'fan_in': 0, 'fan_out': 0, 'general_fan_out': 0}, {'cyclomatic_complexity': 3, 'nloc': 13, 'token_count': 97, 'name': '', 'long_name': '(res cmds.Response)(io.Reader,error)', 'start_line': 301, 'end_line': 315, 'full_parameters': [], 'filename': '/home/dimi/Documents/Informatik_Studium/FSS/SoftEvo/DataCollection/FFS_SoftEvo/go-ipfs/core/commands/keystore.go', 'top_nesting_level': 0, 'length': 15, 'fan_in': 0, 'fan_out': 0, 'general_fan_out': 0}, {'cyclomatic_complexity': 8, 'nloc': 35, 'token_count': 242, 'name': '', 'long_name': '(req cmds.Request,res cmds.Response)', 'start_line': 330, 'end_line': 372, 'full_parameters': [], 'filename': '/home/dimi/Documents/Informatik_Studium/FSS/SoftEvo/DataCollection/FFS_SoftEvo/go-ipfs/core/commands/keystore.go', 'top_nesting_level': 0, 'length': 43, 'fan_in': 0, 'fan_out': 0, 'general_fan_out': 0}, {'cyclomatic_complexity': 4, 'nloc': 18, 'token_count': 146, 'name': 'keyOutputListMarshaler', 'long_name': 'keyOutputListMarshaler res cmds . Response', 'start_line': 379, 'end_line': 398, 'full_parameters': ['res cmds . Response'], 'filename': '/home/dimi/Documents/Informatik_Studium/FSS/SoftEvo/DataCollection/FFS_SoftEvo/go-ipfs/core/commands/keystore.go', 'top_nesting_level': 0, 'length': 20, 'fan_in': 0, 'fan_out': 0, 'general_fan_out': 0}]",487,3105,3,"[{'cyclomatic_complexity': 8, 'nloc': 38, 'token_count': 262, 'name': 'doRotate', 'long_name': 'doRotate out io . Writer , repoRoot string , oldKey string , algorithm string , nBitsForKeypair int , nBitsGiven bool', 'start_line': 491, 'end_line': 539, 'full_parameters': ['out io . Writer', ' repoRoot string', ' oldKey string', ' algorithm string', ' nBitsForKeypair int', ' nBitsGiven bool'], 'filename': '/home/dimi/Documents/Informatik_Studium/FSS/SoftEvo/DataCollection/FFS_SoftEvo/go-ipfs/core/commands/keystore.go', 'top_nesting_level': 0, 'length': 49, 'fan_in': 0, 'fan_out': 0, 'general_fan_out': 0}, {'cyclomatic_complexity': 3, 'nloc': 13, 'token_count': 115, 'name': 'error', 'long_name': '(req*cmds.Request,w io.Writer,list*KeyOutputList)error', 'start_line': 542, 'end_line': 555, 'full_parameters': [], 'filename': '/home/dimi/Documents/Informatik_Studium/FSS/SoftEvo/DataCollection/FFS_SoftEvo/go-ipfs/core/commands/keystore.go', 'top_nesting_level': 0, 'length': 14, 'fan_in': 0, 'fan_out': 0, 'general_fan_out': 0}, {'cyclomatic_complexity': 3, 'nloc': 14, 'token_count': 75, 'name': 'DaemonNotRunning', 'long_name': 'DaemonNotRunning req * cmds . Request , env cmds . Environment', 'start_line': 560, 'end_line': 575, 'full_parameters': ['req * cmds . Request', ' env cmds . Environment'], 'filename': '/home/dimi/Documents/Informatik_Studium/FSS/SoftEvo/DataCollection/FFS_SoftEvo/go-ipfs/core/commands/keystore.go', 'top_nesting_level': 0, 'length': 16, 'fan_in': 0, 'fan_out': 0, 'general_fan_out': 0}]",151,1095,-4,81,81,"[{'timestamp': 1491058697.0, 'added_lines': 65, 'deleted_lines': 55, 'nloc': 346}, {'timestamp': 1511223906.0, 'added_lines': 1, 'deleted_lines': 1, 'nloc': 346}, {'timestamp': 1512365669.0, 'added_lines': 2, 'deleted_lines': 2, 'nloc': 346}, {'timestamp': 1511187070.0, 'added_lines': 1, 'deleted_lines': 1, 'nloc': 346}, {'timestamp': 1513436097.0, 'added_lines': 1, 'deleted_lines': 1, 'nloc': 346}, {'timestamp': 1513612261.0, 'added_lines': 1, 'deleted_lines': 1, 'nloc': 346}, {'timestamp': 1515277696.0, 'added_lines': 1, 'deleted_lines': 1, 'nloc': 346}, {'timestamp': 1516838128.0, 'added_lines': 1, 'deleted_lines': 1, 'nloc': 346}, {'timestamp': 1517453697.0, 'added_lines': 1, 'deleted_lines': 1, 'nloc': 346}, {'timestamp': 1524368737.0, 'added_lines': 5, 'deleted_lines': 1, 'nloc': 350}, {'timestamp': 1525408792.0, 'added_lines': 2, 'deleted_lines': 2, 'nloc': 350}, {'timestamp': 1528520460.0, 'added_lines': 2, 'deleted_lines': 2, 'nloc': 350}, {'timestamp': 1529984485.0, 'added_lines': 1, 'deleted_lines': 1, 'nloc': 350}, {'timestamp': 1533307603.0, 'added_lines': 71, 'deleted_lines': 219, 'nloc': 227}, {'timestamp': 1533643207.0, 'added_lines': 1, 'deleted_lines': 1, 'nloc': 227}, {'timestamp': 1533647434.0, 'added_lines': 6, 'deleted_lines': 6, 'nloc': 227}, {'timestamp': 1533779477.0, 'added_lines': 1, 'deleted_lines': 1, 'nloc': 227}, {'timestamp': 1533946888.0, 'added_lines': 2, 'deleted_lines': 2, 'nloc': 227}, {'timestamp': 1534896611.0, 'added_lines': 2, 'deleted_lines': 2, 'nloc': 227}, {'timestamp': 1534903410.0, 'added_lines': 5, 'deleted_lines': 4, 'nloc': 228}, {'timestamp': 1523628870.0, 'added_lines': 19, 'deleted_lines': 29, 'nloc': 218}, {'timestamp': 1535044155.0, 'added_lines': 1, 'deleted_lines': 1, 'nloc': 218}, {'timestamp': 1537193530.0, 'added_lines': 1, 'deleted_lines': 1, 'nloc': 218}, {'timestamp': 1537391809.0, 'added_lines': 1, 'deleted_lines': 1, 'nloc': 218}, {'timestamp': 1537792589.0, 'added_lines': 1, 'deleted_lines': 1, 'nloc': 218}, {'timestamp': 1538662493.0, 'added_lines': 15, 'deleted_lines': 6, 'nloc': 225}, {'timestamp': 1539850591.0, 'added_lines': 2, 'deleted_lines': 2, 'nloc': 225}, {'timestamp': 1540552487.0, 'added_lines': 1, 'deleted_lines': 1, 'nloc': 225}, {'timestamp': 1540597832.0, 'added_lines': 1, 'deleted_lines': 1, 'nloc': 225}, {'timestamp': 1541204121.0, 'added_lines': 1, 'deleted_lines': 1, 'nloc': 225}, {'timestamp': 1541822268.0, 'added_lines': 13, 'deleted_lines': 29, 'nloc': 212}, {'timestamp': 1544661332.0, 'added_lines': 1, 'deleted_lines': 1, 'nloc': 212}, {'timestamp': 1540556089.0, 'added_lines': 1, 'deleted_lines': 1, 'nloc': 212}, {'timestamp': 1544451987.0, 'added_lines': 4, 'deleted_lines': 4, 'nloc': 212}, {'timestamp': 1547152271.0, 'added_lines': 1, 'deleted_lines': 1, 'nloc': 212}, {'timestamp': 1548866534.0, 'added_lines': 1, 'deleted_lines': 1, 'nloc': 212}, {'timestamp': 1549672857.0, 'added_lines': 1, 'deleted_lines': 1, 'nloc': 212}, {'timestamp': 1549673846.0, 'added_lines': 1, 'deleted_lines': 1, 'nloc': 212}, {'timestamp': 1549903582.0, 'added_lines': 2, 'deleted_lines': 2, 'nloc': 212}, {'timestamp': 1550185115.0, 'added_lines': 1, 'deleted_lines': 1, 'nloc': 212}, {'timestamp': 1550507829.0, 'added_lines': 2, 'deleted_lines': 2, 'nloc': 212}, {'timestamp': 1550576884.0, 'added_lines': 1, 'deleted_lines': 1, 'nloc': 212}, {'timestamp': 1550610741.0, 'added_lines': 1, 'deleted_lines': 1, 'nloc': 212}, {'timestamp': 1550711994.0, 'added_lines': 1, 'deleted_lines': 1, 'nloc': 212}, {'timestamp': 1550723346.0, 'added_lines': 1, 'deleted_lines': 1, 'nloc': 212}, {'timestamp': 1551138343.0, 'added_lines': 1, 'deleted_lines': 1, 'nloc': 212}, {'timestamp': 1551229859.0, 'added_lines': 1, 'deleted_lines': 1, 'nloc': 212}, {'timestamp': 1551299964.0, 'added_lines': 2, 'deleted_lines': 2, 'nloc': 212}, {'timestamp': 1551471469.0, 'added_lines': 1, 'deleted_lines': 1, 'nloc': 212}, {'timestamp': 1551551196.0, 'added_lines': 3, 'deleted_lines': 3, 'nloc': 212}, {'timestamp': 1557554420.0, 'added_lines': 21, 'deleted_lines': 22, 'nloc': 211}, {'timestamp': 1580782221.0, 'added_lines': 1, 'deleted_lines': 1, 'nloc': 211}, {'timestamp': 1580821085.0, 'added_lines': 1, 'deleted_lines': 1, 'nloc': 211}, {'timestamp': 1585971296.0, 'added_lines': 1, 'deleted_lines': 1, 'nloc': 211}, {'timestamp': 1594656514.0, 'added_lines': 43, 'deleted_lines': 4, 'nloc': 248}, {'timestamp': 1594905937.0, 'added_lines': 260, 'deleted_lines': 19, 'nloc': 457}, {'timestamp': 1594911450.0, 'added_lines': 6, 'deleted_lines': 1, 'nloc': 460}, {'timestamp': 1596140735.0, 'added_lines': 0, 'deleted_lines': 43, 'nloc': 422}, {'timestamp': 1596246338.0, 'added_lines': 21, 'deleted_lines': 88, 'nloc': 364}, {'timestamp': 1596483975.0, 'added_lines': 52, 'deleted_lines': 27, 'nloc': 383}, {'timestamp': 1596490135.0, 'added_lines': 9, 'deleted_lines': 2, 'nloc': 390}, {'timestamp': 1596050774.0, 'added_lines': 27, 'deleted_lines': 27, 'nloc': 390}, {'timestamp': 1595277534.0, 'added_lines': 1, 'deleted_lines': 0, 'nloc': 391}, {'timestamp': 1597660382.0, 'added_lines': 110, 'deleted_lines': 4, 'nloc': 480}, {'timestamp': 1597662861.0, 'added_lines': 4, 'deleted_lines': 6, 'nloc': 478}, {'timestamp': 1596826508.0, 'added_lines': 2, 'deleted_lines': 2, 'nloc': 478}, {'timestamp': 1597086135.0, 'added_lines': 13, 'deleted_lines': 2, 'nloc': 489}, {'timestamp': 1597121102.0, 'added_lines': 10, 'deleted_lines': 10, 'nloc': 489}, {'timestamp': 1597160574.0, 'added_lines': 47, 'deleted_lines': 27, 'nloc': 506}, {'timestamp': 1597682811.0, 'added_lines': 10, 'deleted_lines': 47, 'nloc': 473}, {'timestamp': 1597765187.0, 'added_lines': 11, 'deleted_lines': 11, 'nloc': 473}, {'timestamp': 1597873815.0, 'added_lines': 1, 'deleted_lines': 1, 'nloc': 473}, {'timestamp': 1598031762.0, 'added_lines': 5, 'deleted_lines': 1, 'nloc': 477}, {'timestamp': 1599584933.0, 'added_lines': 10, 'deleted_lines': 10, 'nloc': 477}, {'timestamp': 1599584933.0, 'added_lines': 10, 'deleted_lines': 10, 'nloc': 477}, {'timestamp': 1608253728.0, 'added_lines': 4, 'deleted_lines': 4, 'nloc': 477}, {'timestamp': 1611864949.0, 'added_lines': 21, 'deleted_lines': 16, 'nloc': 479}, {'timestamp': 1616604074.0, 'added_lines': 4, 'deleted_lines': 4, 'nloc': 479}, {'timestamp': 1620397583.0, 'added_lines': 6, 'deleted_lines': 4, 'nloc': 479}, {'timestamp': 1620754787.0, 'added_lines': 10, 'deleted_lines': 0, 'nloc': 487}, {'timestamp': 1620756672.0, 'added_lines': 1, 'deleted_lines': 1, 'nloc': 487}]","{'blocks/blockstore/caching.go': 1, 'blocks/blockstore/util/remove.go': 3, 'cmd/ipfs/daemon.go': 38, 'cmd/ipfs/init.go': 37, 'cmd/ipfs/ipfs.go': 36, 'cmd/ipfs/main.go': 37, 'cmd/ipfs/main_test.go': 4, 'cmd/ipfswatch/main.go': 13, 'cmd/seccat/seccat.go': 15, None: 14, 'commands/channelmarshaler.go': 1, 'commands/cli/cmd_suggestion.go': 1, 'commands/cli/helptext.go': 2, 'commands/cli/helptext_test.go': 2, 'commands/cli/parse.go': 2, 'commands/cli/parse_test.go': 2, 'commands/command.go': 18, 'commands/command_test.go': 9, 'commands/http/client.go': 2, 'commands/http/handler.go': 2, 'commands/http/multifilereader.go': 2, 'commands/http/multifilereader_test.go': 2, 'commands/http/parse.go': 2, 'commands/reqlog.go': 1, 'commands/request.go': 24, 'commands/response.go': 13, 'commands/response_test.go': 9, 'core/bootstrap.go': 15, 'core/commands/active.go': 25, 'core/commands/add.go': 47, 'core/commands/bitswap.go': 43, 'core/commands/block.go': 47, 'core/commands/bootstrap.go': 27, 'core/commands/cat.go': 45, 'core/commands/commands.go': 37, 'core/commands/config.go': 29, 'core/commands/dag/dag.go': 37, 'core/commands/dht.go': 36, 'core/commands/diag.go': 23, 'core/commands/dns.go': 34, 'core/commands/e/error.go': 1, 'core/commands/external.go': 24, 'core/commands/files/files.go': 9, 'core/commands/filestore.go': 39, 'core/commands/get.go': 45, 'core/commands/helptext_test.go': 34, 'core/commands/id.go': 37, 'core/commands/ipns.go': 13, 'core/commands/log.go': 30, 'core/commands/ls.go': 39, 'core/commands/mount_nofuse.go': 23, 'core/commands/mount_unix.go': 28, 'core/commands/mount_windows.go': 22, 'core/commands/name.go': 10, 'core/commands/object/diff.go': 33, 'core/commands/object/object.go': 45, 'core/commands/object/patch.go': 45, 'core/commands/p2p.go': 31, 'core/commands/pin.go': 38, 'core/commands/ping.go': 35, 'core/commands/publish.go': 15, 'core/commands/pubsub.go': 48, 'core/commands/refs.go': 32, 'core/commands/repo.go': 42, 'core/commands/resolve.go': 40, 'core/commands/root.go': 39, 'core/commands/shutdown.go': 34, 'core/commands/stat.go': 40, 'core/commands/swarm.go': 37, 'core/commands/sysdiag.go': 27, 'core/commands/tar.go': 32, 'core/commands/unixfs/ls.go': 35, 'core/commands/unixfs/unixfs.go': 23, 'core/commands/version.go': 28, 'core/core_test.go': 8, 'core/corehttp/commands.go': 39, 'core/corehttp/gateway.go': 23, 'core/coreunix/add.go': 31, 'core/coreunix/add_test.go': 30, 'core/coreunix/metadata_test.go': 22, 'exchange/bitswap/bitswap_test.go': 8, 'exchange/bitswap/decision/engine_test.go': 8, 'exchange/bitswap/message/message_test.go': 4, 'exchange/bitswap/message/pb/Makefile': 1, 'exchange/bitswap/testnet/network_test.go': 8, 'exchange/bitswap/testnet/peernet.go': 8, 'exchange/reprovide/reprovide_test.go': 16, 'fuse/ipns/common.go': 18, 'fuse/node/mount_test.go': 15, 'importer/balanced/balanced_test.go': 6, 'importer/chunk/rabin_test.go': 3, 'importer/helpers/dagbuilder.go': 11, 'importer/importer.go': 11, 'merkledag/utils/utils_test.go': 4, 'mfs/repub_test.go': 9, 'namesys/dns.go': 16, 'namesys/interface.go': 17, 'namesys/ipns_select_test.go': 5, 'namesys/proquint.go': 16, 'namesys/republisher/repub_test.go': 19, 'package.json': 39, 'repo/config/identity.go': 3, 'routing/offline/offline_test.go': 5, 'test/integration/addcat_test.go': 21, 'test/integration/bench_cat_test.go': 20, 'test/integration/bitswap_wo_routing_test.go': 18, 'test/integration/three_legged_cat_test.go': 20, 'core/bootstrap_test.go': 14, 'core/commands/dht_test.go': 14, 'core/commands/get_test.go': 35, 'core/core.go': 23, 'core/corehttp/gateway_test.go': 23, 'core/corehttp/metrics_test.go': 17, 'core/mock/mock.go': 17, 'exchange/bitswap/decision/bench_test.go': 7, 'exchange/bitswap/decision/peer_request_queue_test.go': 7, 'exchange/bitswap/message/message.go': 7, 'exchange/bitswap/network/interface.go': 7, 'exchange/bitswap/network/ipfs_impl.go': 7, 'exchange/bitswap/testnet/interface.go': 7, 'exchange/bitswap/testnet/virtual.go': 7, 'exchange/bitswap/testutils.go': 7, 'fuse/ipns/ipns_test.go': 14, 'fuse/readonly/ipfs_test.go': 26, 'namesys/publisher_test.go': 15, 'namesys/resolve_test.go': 19, 'p2p/p2p.go': 14, 'p2p/registry.go': 9, 'repo/config/bootstrap_peers.go': 8, 'routing/mock/centralized_client.go': 4, 'routing/mock/centralized_server.go': 4, 'routing/mock/centralized_test.go': 4, 'routing/mock/interface.go': 4, 'routing/none/none_client.go': 4, 'test/integration/bench_test.go': 14, 'assets/assets.go': 22, 'blocks/blockstore/arc_cache.go': 2, 'blocks/blockstore/arc_cache_test.go': 2, 'blocks/blockstore/blockstore.go': 3, 'blocks/blockstore/blockstore_test.go': 2, 'blocks/blockstore/bloom_cache.go': 2, 'blocks/blockstore/bloom_cache_test.go': 2, 'blocks/blocksutil/block_generator.go': 2, 'blockservice/blockservice.go': 6, 'blockservice/blockservice_test.go': 5, 'blockservice/test/blocks_test.go': 5, 'core/builder.go': 22, 'core/commands/ipnsps.go': 9, 'core/coreapi/coreapi.go': 16, 'core/coreapi/interface/interface.go': 2, 'core/coreapi/unixfs.go': 24, 'core/coreapi/unixfs_test.go': 14, 'core/coredag/cbor.go': 9, 'core/coredag/dagpb.go': 14, 'core/coredag/dagtransl.go': 7, 'core/coredag/raw.go': 14, 'core/corehttp/corehttp.go': 12, 'core/corehttp/gateway_handler.go': 26, 'core/corerepo/gc.go': 22, 'core/corerepo/pinning.go': 8, 'core/coreunix/metadata.go': 19, 'core/pathresolver.go': 17, 'exchange/bitswap/bitswap.go': 6, 'exchange/bitswap/decision/engine.go': 6, 'exchange/bitswap/decision/ledger.go': 6, 'exchange/bitswap/decision/peer_request_queue.go': 6, 'exchange/bitswap/get.go': 5, 'exchange/bitswap/notifications/notifications.go': 3, 'exchange/bitswap/notifications/notifications_test.go': 3, 'exchange/bitswap/session.go': 6, 'exchange/bitswap/session_test.go': 5, 'exchange/bitswap/stat.go': 3, 'exchange/bitswap/wantlist/wantlist.go': 3, 'exchange/bitswap/wantlist/wantlist_test.go': 3, 'exchange/bitswap/wantmanager.go': 6, 'exchange/bitswap/workers.go': 6, 'exchange/interface.go': 2, 'exchange/offline/offline.go': 2, 'exchange/offline/offline_test.go': 2, 'exchange/reprovide/providers.go': 16, 'exchange/reprovide/reprovide.go': 14, 'filestore/filestore.go': 13, 'filestore/filestore_test.go': 16, 'filestore/fsrefstore.go': 12, 'filestore/util.go': 12, 'fuse/ipns/ipns_unix.go': 22, 'fuse/readonly/readonly_unix.go': 22, 'importer/balanced/builder.go': 3, 'importer/chunk/splitting_test.go': 2, 'importer/helpers/helpers.go': 3, 'importer/importer_test.go': 5, 'importer/trickle/trickle_test.go': 5, 'importer/trickle/trickledag.go': 3, 'merkledag/batch.go': 2, 'merkledag/coding.go': 3, 'merkledag/merkledag.go': 3, 'merkledag/merkledag_test.go': 5, 'merkledag/node.go': 3, 'merkledag/node_test.go': 3, 'merkledag/raw.go': 3, 'merkledag/traverse/traverse.go': 3, 'merkledag/traverse/traverse_test.go': 3, 'merkledag/utils/diff.go': 3, 'merkledag/utils/diffenum.go': 3, 'merkledag/utils/diffenum_test.go': 3, 'merkledag/utils/utils.go': 5, 'mfs/dir.go': 5, 'mfs/file.go': 7, 'mfs/mfs_test.go': 7, 'mfs/ops.go': 4, 'mfs/system.go': 8, 'namesys/namesys.go': 21, 'namesys/publisher.go': 23, 'namesys/pubsub.go': 4, 'namesys/pubsub_test.go': 4, 'namesys/republisher/repub.go': 17, 'namesys/routing.go': 21, 'path/path.go': 3, 'path/resolver.go': 3, 'path/resolver_test.go': 2, 'pin/gc/gc.go': 17, 'pin/pin.go': 17, 'pin/pin_test.go': 16, 'pin/set.go': 14, 'pin/set_test.go': 16, 'plugin/ipld.go': 7, 'plugin/loader/initializer.go': 5, 'plugin/plugins/git/git.go': 7, 'repo/config/init.go': 7, 'repo/fsrepo/fsrepo.go': 13, 'repo/fsrepo/lock/lock.go': 3, 'repo/fsrepo/serialize/serialize.go': 3, 'repo/mock.go': 10, 'repo/repo.go': 11, 'routing/offline/offline.go': 3, 'tar/format.go': 22, 'test/dependencies/ma-pipe-unidir/main.go': 7, 'thirdparty/ds-help/key.go': 2, 'thirdparty/pollEndpoint/main.go': 12, 'thirdparty/posinfo/posinfo.go': 2, 'unixfs/archive/archive.go': 3, 'unixfs/archive/tar/writer.go': 3, 'unixfs/hamt/hamt.go': 3, 'unixfs/io/dagreader.go': 3, 'unixfs/io/dirbuilder.go': 3, 'unixfs/io/resolve.go': 3, 'unixfs/mod/dagmodifier.go': 5, 'unixfs/mod/dagmodifier_test.go': 3, 'unixfs/test/utils.go': 5, 'commands/legacy/command.go': 20, 'commands/legacy/legacy.go': 20, 'commands/legacy/legacy_test.go': 21, 'commands/legacy/request.go': 21, 'commands/legacy/response.go': 21, 'commands/legacy/responseemitter.go': 4, 'core/commands/env.go': 4, 'TODO.md': 2, 'core/commands/commands_test.go': 33, 'test/sharness/t0110-gateway.sh': 1, 'test/sharness/t0410-api-add.sh': 1, 'core/coreapi/dag.go': 6, 'core/coreapi/dag_test.go': 3, 'core/coreapi/interface/options/dag.go': 4, 'core/coreapi/key.go': 24, 'core/coreapi/name.go': 21, 'merkledag/test/utils.go': 4, 'namesys/namesys_test.go': 23, 'repo/fsrepo/datastores.go': 10, 'repo/fsrepo/fsrepo_test.go': 8, 'thirdparty/datastore2/datastore_closer.go': 1, 'thirdparty/datastore2/delayed.go': 1, 'thirdparty/datastore2/threadsafe.go': 1, 'unixfs/io/pbdagreader.go': 2, 'cmd/ipfs/util/ulimit.go': 9, 'cmd/seccat/util.go': 9, 'core/corehttp/logs.go': 9, 'fuse/mount/mount.go': 9, 'fuse/node/mount_unix.go': 9, 'importer/chunk/splitting.go': 1, 'namesys/ipns_validate_test.go': 3, 'plugin/loader/load.go': 7, 'blocks/blockstoreutil/remove.go': 10, 'blockservice/test/mock.go': 3, 'core/commands/files.go': 38, 'core/coreapi/pin.go': 18, 'keystore/keystore.go': 8, 'keystore/keystore_test.go': 5, 'keystore/memkeystore.go': 5, 'namesys/validator.go': 2, 'path/resolver/resolver.go': 3, 'thirdparty/verifbs/verifbs.go': 10, 'cmd/ipfs/util/ulimit_freebsd.go': 2, 'cmd/ipfs/util/ulimit_unix.go': 2, 'core/coreapi/block.go': 14, 'core/coreapi/block_test.go': 2, 'core/coreapi/interface/coreapi.go': 3, 'core/coreapi/interface/dag.go': 3, 'core/coreapi/interface/object.go': 3, 'core/coreapi/interface/options/block.go': 2, 'core/coreapi/interface/path.go': 5, 'core/coreapi/interface/unixfs.go': 6, 'core/coreapi/object.go': 20, 'fuse/ipns/link_unix.go': 2, 'fuse/mount/fuse.go': 2, 'fuse/node/mount_darwin.go': 2, 'merkledag/errservice.go': 1, 'merkledag/readonly.go': 1, 'merkledag/readonly_test.go': 1, 'merkledag/rwservice.go': 1, 'merkledag/session.go': 1, 'path/resolver/resolver_test.go': 1, 'thirdparty/verifcid/validate.go': 1, 'thirdparty/verifcid/validate_test.go': 1, 'unixfs/hamt/hamt_stress_test.go': 1, 'unixfs/hamt/hamt_test.go': 1, 'namesys/ipns_resolver_validation_test.go': 16, 'test/sharness/t0170-dht.sh': 1, 'core/coreapi/interface/key.go': 5, 'core/commands/urlstore.go': 29, 'core/coreapi/name_test.go': 6, 'core/coreapi/path.go': 19, 'core/coreunix/cat.go': 4, 'core/pathresolver_test.go': 11, 'dagutils/diff.go': 15, 'dagutils/diffenum.go': 11, 'dagutils/diffenum_test.go': 11, 'dagutils/utils.go': 11, 'dagutils/utils_test.go': 11, 'filestore/pb/dataobj.pb.go': 3, 'mfs/fd.go': 2, 'namesys/base.go': 15, 'namesys/cache.go': 11, 'pin/internal/pb/header.pb.go': 3, 'thirdparty/cidv0v1/blockstore.go': 7, 'repo/fsrepo/config_test.go': 6, 'repo/fsrepo/misc.go': 6, 'test/bench/bench_cli_ipfs_add/main.go': 7, 'test/bench/offline_add/main.go': 7, 'core/commands/cmdenv/env.go': 30, 'core/commands/name/ipns.go': 31, 'core/commands/name/ipnsps.go': 29, 'core/commands/name/name.go': 22, 'core/commands/name/publish.go': 36, 'test/sharness/lib/test-lib.sh': 8, 'core/coreapi/dht.go': 13, 'core/coreapi/dht_test.go': 2, 'core/coreapi/interface/dht.go': 2, 'p2p/listener.go': 5, 'p2p/local.go': 5, 'p2p/remote.go': 5, 'p2p/stream.go': 5, 'core/commands/cid.go': 20, 'core/coreapi/unixfile.go': 3, 'cmd/ipfs/dnsresolve_test.go': 3, 'core/coreapi/interface/options/unixfs.go': 2, 'core/coreapi/interface/pubsub.go': 1, 'core/coreapi/interface/swarm.go': 1, 'core/coreapi/pubsub.go': 12, 'core/coreapi/swarm.go': 12, 'test/dependencies/iptb/iptb.go': 8, 'commands/context.go': 18, 'core/commands/cmdenv/cidbase.go': 10, 'core/commands/cmdenv/file.go': 3, 'core/coreapi/interface/tests/name.go': 1, 'core/coreapi/interface/tests/unixfs.go': 1, 'core/coreapi/test/api_test.go': 11, 'core/corehttp/ipns_hostname.go': 11, 'namesys/dns_test.go': 10, 'plugin/daemon.go': 10, 'plugin/loader/loader.go': 11, 'core/corehttp/proxy.go': 6, 'plugin/plugins/badgerds/badgerds.go': 3, 'plugin/plugins/flatfs/flatfs.go': 3, 'plugin/plugins/levelds/levelds.go': 2, 'core/corerepo/stat.go': 2, 'core/commands/cmdenv/cidbase_test.go': 2, 'core/corehttp/metrics.go': 1, 'core/corehttp/proxy_test.go': 1, 'plugin/tracer.go': 1, 'thirdparty/notifier/notifier.go': 1, 'README.md': 2, 'go.mod': 4, 'go.sum': 3, 'package-list.json': 1, 'test/sharness/t0100-name.sh': 5, 'test/sharness/t0160-resolve.sh': 4, 'test/sharness/t0165-keystore.sh': 14, '.circleci/config.yml': 1, 'test/sharness/t0600-issues-and-regressions-online.sh': 3, 'cmd/ipfs/rotate.go': 1, 'core/commands/extra.go': 1, 'test/sharness/t0027-rotate.sh': 3, 'test/sharness/t0114-gateway-subdomains.sh': 2, 'core/commands/keybase/keybase.go': 2, 'test/sharness/t0183-namesys-pubsub.sh': 1, 'core/commands/keyencode/keyencode.go': 3, 'core/commands/pin/remotepin.go': 1, 'core/commands/pin/pin.go': 1, 'core/commands/stat_dht.go': 1}","('core/commands/pubsub.go', 0.5925925925925926, 0.5393258426966292)"
core/commands/log.go,88,523,4,"[{'cyclomatic_complexity': 3, 'nloc': 14, 'token_count': 99, 'name': '', 'long_name': '(req cmds.Request,res cmds.Response)', 'start_line': 50, 'end_line': 67, 'full_parameters': [], 'filename': '/home/dimi/Documents/Informatik_Studium/FSS/SoftEvo/DataCollection/FFS_SoftEvo/go-ipfs/core/commands/log.go', 'top_nesting_level': 0, 'length': 18, 'fan_in': 0, 'fan_out': 0, 'general_fan_out': 0}, {'cyclomatic_complexity': 1, 'nloc': 3, 'token_count': 28, 'name': '', 'long_name': '(req cmds.Request,res cmds.Response)', 'start_line': 82, 'end_line': 84, 'full_parameters': [], 'filename': '/home/dimi/Documents/Informatik_Studium/FSS/SoftEvo/DataCollection/FFS_SoftEvo/go-ipfs/core/commands/log.go', 'top_nesting_level': 0, 'length': 3, 'fan_in': 0, 'fan_out': 0, 'general_fan_out': 0}, {'cyclomatic_complexity': 1, 'nloc': 4, 'token_count': 18, 'name': '', 'long_name': '()', 'start_line': 102, 'end_line': 105, 'full_parameters': [], 'filename': '/home/dimi/Documents/Informatik_Studium/FSS/SoftEvo/DataCollection/FFS_SoftEvo/go-ipfs/core/commands/log.go', 'top_nesting_level': 0, 'length': 4, 'fan_in': 0, 'fan_out': 0, 'general_fan_out': 0}, {'cyclomatic_complexity': 1, 'nloc': 7, 'token_count': 48, 'name': '', 'long_name': '(req cmds.Request,res cmds.Response)', 'start_line': 99, 'end_line': 108, 'full_parameters': [], 'filename': '/home/dimi/Documents/Informatik_Studium/FSS/SoftEvo/DataCollection/FFS_SoftEvo/go-ipfs/core/commands/log.go', 'top_nesting_level': 0, 'length': 10, 'fan_in': 0, 'fan_out': 0, 'general_fan_out': 0}]",104,695,1,"[{'cyclomatic_complexity': 1, 'nloc': 4, 'token_count': 18, 'name': '', 'long_name': '()', 'start_line': 118, 'end_line': 121, 'full_parameters': [], 'filename': '/home/dimi/Documents/Informatik_Studium/FSS/SoftEvo/DataCollection/FFS_SoftEvo/go-ipfs/core/commands/log.go', 'top_nesting_level': 0, 'length': 4, 'fan_in': 0, 'fan_out': 0, 'general_fan_out': 0}]",16,172,-3,39,39,"[{'timestamp': 1491058697.0, 'added_lines': 11, 'deleted_lines': 10, 'nloc': 90}, {'timestamp': 1511223906.0, 'added_lines': 1, 'deleted_lines': 1, 'nloc': 90}, {'timestamp': 1512365669.0, 'added_lines': 1, 'deleted_lines': 1, 'nloc': 90}, {'timestamp': 1511187070.0, 'added_lines': 1, 'deleted_lines': 1, 'nloc': 90}, {'timestamp': 1513436097.0, 'added_lines': 1, 'deleted_lines': 1, 'nloc': 90}, {'timestamp': 1513612261.0, 'added_lines': 1, 'deleted_lines': 1, 'nloc': 90}, {'timestamp': 1515277696.0, 'added_lines': 1, 'deleted_lines': 1, 'nloc': 90}, {'timestamp': 1517453697.0, 'added_lines': 1, 'deleted_lines': 1, 'nloc': 90}, {'timestamp': 1525408792.0, 'added_lines': 1, 'deleted_lines': 1, 'nloc': 90}, {'timestamp': 1528520460.0, 'added_lines': 4, 'deleted_lines': 3, 'nloc': 91}, {'timestamp': 1529984485.0, 'added_lines': 2, 'deleted_lines': 2, 'nloc': 91}, {'timestamp': 1533779477.0, 'added_lines': 2, 'deleted_lines': 2, 'nloc': 91}, {'timestamp': 1533946888.0, 'added_lines': 1, 'deleted_lines': 1, 'nloc': 91}, {'timestamp': 1534896611.0, 'added_lines': 1, 'deleted_lines': 1, 'nloc': 91}, {'timestamp': 1537792589.0, 'added_lines': 2, 'deleted_lines': 2, 'nloc': 91}, {'timestamp': 1536691815.0, 'added_lines': 22, 'deleted_lines': 0, 'nloc': 109}, {'timestamp': 1539850591.0, 'added_lines': 1, 'deleted_lines': 1, 'nloc': 109}, {'timestamp': 1540945609.0, 'added_lines': 18, 'deleted_lines': 4, 'nloc': 122}, {'timestamp': 1540986837.0, 'added_lines': 2, 'deleted_lines': 0, 'nloc': 122}, {'timestamp': 1541204121.0, 'added_lines': 2, 'deleted_lines': 2, 'nloc': 122}, {'timestamp': 1541207576.0, 'added_lines': 4, 'deleted_lines': 20, 'nloc': 109}, {'timestamp': 1540569270.0, 'added_lines': 23, 'deleted_lines': 40, 'nloc': 98}, {'timestamp': 1540951823.0, 'added_lines': 4, 'deleted_lines': 3, 'nloc': 98}, {'timestamp': 1544661332.0, 'added_lines': 1, 'deleted_lines': 1, 'nloc': 98}, {'timestamp': 1540556089.0, 'added_lines': 1, 'deleted_lines': 1, 'nloc': 98}, {'timestamp': 1547152271.0, 'added_lines': 1, 'deleted_lines': 1, 'nloc': 98}, {'timestamp': 1548866534.0, 'added_lines': 1, 'deleted_lines': 1, 'nloc': 98}, {'timestamp': 1549903582.0, 'added_lines': 1, 'deleted_lines': 1, 'nloc': 98}, {'timestamp': 1550507829.0, 'added_lines': 3, 'deleted_lines': 3, 'nloc': 98}, {'timestamp': 1550610741.0, 'added_lines': 1, 'deleted_lines': 1, 'nloc': 98}, {'timestamp': 1550800168.0, 'added_lines': 5, 'deleted_lines': 0, 'nloc': 102}, {'timestamp': 1551138343.0, 'added_lines': 1, 'deleted_lines': 1, 'nloc': 98}, {'timestamp': 1551299964.0, 'added_lines': 1, 'deleted_lines': 1, 'nloc': 98}, {'timestamp': 1551471469.0, 'added_lines': 1, 'deleted_lines': 1, 'nloc': 98}, {'timestamp': 1551551196.0, 'added_lines': 4, 'deleted_lines': 4, 'nloc': 102}, {'timestamp': 1557554420.0, 'added_lines': 7, 'deleted_lines': 8, 'nloc': 101}, {'timestamp': 1587603732.0, 'added_lines': 3, 'deleted_lines': 3, 'nloc': 101}, {'timestamp': 1587744780.0, 'added_lines': 4, 'deleted_lines': 2, 'nloc': 103}, {'timestamp': 1595277534.0, 'added_lines': 1, 'deleted_lines': 0, 'nloc': 104}]","{'blocks/blockstore/caching.go': 1, 'blocks/blockstore/util/remove.go': 2, 'cmd/ipfs/daemon.go': 30, 'cmd/ipfs/init.go': 29, 'cmd/ipfs/ipfs.go': 28, 'cmd/ipfs/main.go': 29, 'cmd/ipfs/main_test.go': 4, 'cmd/ipfswatch/main.go': 12, 'cmd/seccat/seccat.go': 13, None: 13, 'commands/channelmarshaler.go': 1, 'commands/cli/cmd_suggestion.go': 1, 'commands/cli/helptext.go': 2, 'commands/cli/helptext_test.go': 2, 'commands/cli/parse.go': 2, 'commands/cli/parse_test.go': 2, 'commands/command.go': 17, 'commands/command_test.go': 8, 'commands/http/client.go': 2, 'commands/http/handler.go': 2, 'commands/http/multifilereader.go': 2, 'commands/http/multifilereader_test.go': 2, 'commands/http/parse.go': 2, 'commands/reqlog.go': 1, 'commands/request.go': 17, 'commands/response.go': 12, 'commands/response_test.go': 8, 'core/bootstrap.go': 13, 'core/commands/active.go': 25, 'core/commands/add.go': 29, 'core/commands/bitswap.go': 29, 'core/commands/block.go': 29, 'core/commands/bootstrap.go': 25, 'core/commands/cat.go': 29, 'core/commands/commands.go': 30, 'core/commands/config.go': 27, 'core/commands/dag/dag.go': 27, 'core/commands/dht.go': 29, 'core/commands/diag.go': 24, 'core/commands/dns.go': 24, 'core/commands/e/error.go': 1, 'core/commands/external.go': 24, 'core/commands/files/files.go': 8, 'core/commands/filestore.go': 29, 'core/commands/get.go': 29, 'core/commands/helptext_test.go': 27, 'core/commands/id.go': 29, 'core/commands/ipns.go': 13, 'core/commands/keystore.go': 30, 'core/commands/ls.go': 28, 'core/commands/mount_nofuse.go': 25, 'core/commands/mount_unix.go': 26, 'core/commands/mount_windows.go': 24, 'core/commands/name.go': 10, 'core/commands/object/diff.go': 24, 'core/commands/object/object.go': 28, 'core/commands/object/patch.go': 29, 'core/commands/p2p.go': 26, 'core/commands/pin.go': 28, 'core/commands/ping.go': 29, 'core/commands/publish.go': 14, 'core/commands/pubsub.go': 29, 'core/commands/refs.go': 26, 'core/commands/repo.go': 30, 'core/commands/resolve.go': 26, 'core/commands/root.go': 31, 'core/commands/shutdown.go': 26, 'core/commands/stat.go': 29, 'core/commands/swarm.go': 30, 'core/commands/sysdiag.go': 26, 'core/commands/tar.go': 26, 'core/commands/unixfs/ls.go': 26, 'core/commands/unixfs/unixfs.go': 23, 'core/commands/version.go': 25, 'core/core_test.go': 7, 'core/corehttp/commands.go': 28, 'core/corehttp/gateway.go': 15, 'core/coreunix/add.go': 23, 'core/coreunix/add_test.go': 22, 'core/coreunix/metadata_test.go': 17, 'exchange/bitswap/bitswap_test.go': 7, 'exchange/bitswap/decision/engine_test.go': 7, 'exchange/bitswap/message/message_test.go': 3, 'exchange/bitswap/message/pb/Makefile': 1, 'exchange/bitswap/testnet/network_test.go': 7, 'exchange/bitswap/testnet/peernet.go': 7, 'exchange/reprovide/reprovide_test.go': 13, 'fuse/ipns/common.go': 14, 'fuse/node/mount_test.go': 13, 'importer/balanced/balanced_test.go': 5, 'importer/chunk/rabin_test.go': 2, 'importer/helpers/dagbuilder.go': 10, 'importer/importer.go': 10, 'merkledag/utils/utils_test.go': 3, 'mfs/repub_test.go': 8, 'namesys/dns.go': 9, 'namesys/interface.go': 10, 'namesys/ipns_select_test.go': 4, 'namesys/proquint.go': 9, 'namesys/republisher/repub_test.go': 14, 'package.json': 27, 'repo/config/identity.go': 3, 'routing/offline/offline_test.go': 4, 'test/integration/addcat_test.go': 17, 'test/integration/bench_cat_test.go': 16, 'test/integration/bitswap_wo_routing_test.go': 14, 'test/integration/three_legged_cat_test.go': 16, 'core/bootstrap_test.go': 12, 'core/commands/dht_test.go': 12, 'core/commands/get_test.go': 28, 'core/core.go': 18, 'core/corehttp/gateway_test.go': 15, 'core/corehttp/metrics_test.go': 13, 'core/mock/mock.go': 13, 'exchange/bitswap/decision/bench_test.go': 6, 'exchange/bitswap/decision/peer_request_queue_test.go': 6, 'exchange/bitswap/message/message.go': 6, 'exchange/bitswap/network/interface.go': 6, 'exchange/bitswap/network/ipfs_impl.go': 6, 'exchange/bitswap/testnet/interface.go': 6, 'exchange/bitswap/testnet/virtual.go': 6, 'exchange/bitswap/testutils.go': 6, 'fuse/ipns/ipns_test.go': 12, 'fuse/readonly/ipfs_test.go': 18, 'namesys/publisher_test.go': 12, 'namesys/resolve_test.go': 13, 'p2p/p2p.go': 12, 'p2p/registry.go': 8, 'repo/config/bootstrap_peers.go': 7, 'routing/mock/centralized_client.go': 3, 'routing/mock/centralized_server.go': 3, 'routing/mock/centralized_test.go': 3, 'routing/mock/interface.go': 3, 'routing/none/none_client.go': 3, 'test/integration/bench_test.go': 12, 'assets/assets.go': 14, 'blocks/blockstore/arc_cache.go': 1, 'blocks/blockstore/arc_cache_test.go': 1, 'blocks/blockstore/blockstore.go': 2, 'blocks/blockstore/blockstore_test.go': 1, 'blocks/blockstore/bloom_cache.go': 1, 'blocks/blockstore/bloom_cache_test.go': 1, 'blocks/blocksutil/block_generator.go': 1, 'blockservice/blockservice.go': 5, 'blockservice/blockservice_test.go': 4, 'blockservice/test/blocks_test.go': 4, 'core/builder.go': 17, 'core/commands/ipnsps.go': 9, 'core/coreapi/coreapi.go': 7, 'core/coreapi/interface/interface.go': 1, 'core/coreapi/unixfs.go': 15, 'core/coreapi/unixfs_test.go': 12, 'core/coredag/cbor.go': 6, 'core/coredag/dagpb.go': 9, 'core/coredag/dagtransl.go': 5, 'core/coredag/raw.go': 9, 'core/corehttp/corehttp.go': 10, 'core/corehttp/gateway_handler.go': 18, 'core/corerepo/gc.go': 17, 'core/corerepo/pinning.go': 7, 'core/coreunix/metadata.go': 14, 'core/pathresolver.go': 12, 'exchange/bitswap/bitswap.go': 5, 'exchange/bitswap/decision/engine.go': 5, 'exchange/bitswap/decision/ledger.go': 5, 'exchange/bitswap/decision/peer_request_queue.go': 5, 'exchange/bitswap/get.go': 4, 'exchange/bitswap/notifications/notifications.go': 2, 'exchange/bitswap/notifications/notifications_test.go': 2, 'exchange/bitswap/session.go': 5, 'exchange/bitswap/session_test.go': 4, 'exchange/bitswap/stat.go': 2, 'exchange/bitswap/wantlist/wantlist.go': 2, 'exchange/bitswap/wantlist/wantlist_test.go': 2, 'exchange/bitswap/wantmanager.go': 5, 'exchange/bitswap/workers.go': 5, 'exchange/interface.go': 1, 'exchange/offline/offline.go': 1, 'exchange/offline/offline_test.go': 1, 'exchange/reprovide/providers.go': 11, 'exchange/reprovide/reprovide.go': 11, 'filestore/filestore.go': 11, 'filestore/filestore_test.go': 11, 'filestore/fsrefstore.go': 10, 'filestore/util.go': 10, 'fuse/ipns/ipns_unix.go': 17, 'fuse/readonly/readonly_unix.go': 17, 'importer/balanced/builder.go': 2, 'importer/chunk/splitting_test.go': 1, 'importer/helpers/helpers.go': 2, 'importer/importer_test.go': 4, 'importer/trickle/trickle_test.go': 4, 'importer/trickle/trickledag.go': 2, 'merkledag/batch.go': 1, 'merkledag/coding.go': 2, 'merkledag/merkledag.go': 2, 'merkledag/merkledag_test.go': 4, 'merkledag/node.go': 2, 'merkledag/node_test.go': 2, 'merkledag/raw.go': 2, 'merkledag/traverse/traverse.go': 2, 'merkledag/traverse/traverse_test.go': 2, 'merkledag/utils/diff.go': 2, 'merkledag/utils/diffenum.go': 2, 'merkledag/utils/diffenum_test.go': 2, 'merkledag/utils/utils.go': 4, 'mfs/dir.go': 4, 'mfs/file.go': 6, 'mfs/mfs_test.go': 6, 'mfs/ops.go': 3, 'mfs/system.go': 7, 'namesys/namesys.go': 13, 'namesys/publisher.go': 17, 'namesys/pubsub.go': 3, 'namesys/pubsub_test.go': 3, 'namesys/republisher/repub.go': 12, 'namesys/routing.go': 13, 'path/path.go': 2, 'path/resolver.go': 2, 'path/resolver_test.go': 1, 'pin/gc/gc.go': 12, 'pin/pin.go': 12, 'pin/pin_test.go': 11, 'pin/set.go': 9, 'pin/set_test.go': 11, 'plugin/ipld.go': 5, 'plugin/loader/initializer.go': 4, 'plugin/plugins/git/git.go': 5, 'repo/config/init.go': 6, 'repo/fsrepo/fsrepo.go': 11, 'repo/fsrepo/lock/lock.go': 2, 'repo/fsrepo/serialize/serialize.go': 2, 'repo/mock.go': 8, 'repo/repo.go': 9, 'routing/offline/offline.go': 2, 'tar/format.go': 17, 'test/dependencies/ma-pipe-unidir/main.go': 5, 'thirdparty/ds-help/key.go': 1, 'thirdparty/pollEndpoint/main.go': 10, 'thirdparty/posinfo/posinfo.go': 1, 'unixfs/archive/archive.go': 2, 'unixfs/archive/tar/writer.go': 2, 'unixfs/hamt/hamt.go': 2, 'unixfs/io/dagreader.go': 2, 'unixfs/io/dirbuilder.go': 2, 'unixfs/io/resolve.go': 2, 'unixfs/mod/dagmodifier.go': 4, 'unixfs/mod/dagmodifier_test.go': 2, 'unixfs/test/utils.go': 4, 'commands/legacy/command.go': 13, 'commands/legacy/legacy.go': 13, 'commands/legacy/legacy_test.go': 14, 'commands/legacy/request.go': 14, 'commands/legacy/response.go': 14, 'commands/legacy/responseemitter.go': 4, 'core/commands/env.go': 4, 'TODO.md': 2, 'core/commands/commands_test.go': 23, 'test/sharness/t0110-gateway.sh': 1, 'test/sharness/t0410-api-add.sh': 1, 'cmd/ipfs/util/ulimit.go': 9, 'cmd/seccat/util.go': 9, 'core/coreapi/key.go': 12, 'core/coreapi/name.go': 12, 'core/corehttp/logs.go': 9, 'fuse/mount/mount.go': 9, 'fuse/node/mount_unix.go': 9, 'importer/chunk/splitting.go': 1, 'namesys/ipns_validate_test.go': 3, 'plugin/loader/load.go': 7, 'repo/fsrepo/datastores.go': 9, 'blocks/blockstoreutil/remove.go': 9, 'blockservice/test/mock.go': 3, 'core/commands/files.go': 21, 'core/coreapi/pin.go': 11, 'keystore/keystore.go': 8, 'keystore/keystore_test.go': 5, 'keystore/memkeystore.go': 5, 'merkledag/test/utils.go': 3, 'namesys/namesys_test.go': 15, 'namesys/validator.go': 2, 'path/resolver/resolver.go': 3, 'repo/fsrepo/fsrepo_test.go': 6, 'thirdparty/verifbs/verifbs.go': 9, 'cmd/ipfs/util/ulimit_freebsd.go': 2, 'cmd/ipfs/util/ulimit_unix.go': 2, 'core/coreapi/block.go': 7, 'core/coreapi/block_test.go': 2, 'core/coreapi/dag.go': 4, 'core/coreapi/dag_test.go': 2, 'core/coreapi/interface/coreapi.go': 3, 'core/coreapi/interface/dag.go': 3, 'core/coreapi/interface/object.go': 3, 'core/coreapi/interface/options/block.go': 2, 'core/coreapi/interface/options/dag.go': 3, 'core/coreapi/interface/path.go': 5, 'core/coreapi/interface/unixfs.go': 6, 'core/coreapi/object.go': 13, 'fuse/ipns/link_unix.go': 2, 'fuse/mount/fuse.go': 2, 'fuse/node/mount_darwin.go': 2, 'merkledag/errservice.go': 1, 'merkledag/readonly.go': 1, 'merkledag/readonly_test.go': 1, 'merkledag/rwservice.go': 1, 'merkledag/session.go': 1, 'path/resolver/resolver_test.go': 1, 'thirdparty/verifcid/validate.go': 1, 'thirdparty/verifcid/validate_test.go': 1, 'unixfs/hamt/hamt_stress_test.go': 1, 'unixfs/hamt/hamt_test.go': 1, 'unixfs/io/pbdagreader.go': 1, 'namesys/ipns_resolver_validation_test.go': 9, 'test/sharness/t0170-dht.sh': 1, 'core/commands/urlstore.go': 18, 'core/coreapi/interface/key.go': 4, 'core/coreapi/name_test.go': 6, 'core/coreapi/path.go': 12, 'core/coreunix/cat.go': 4, 'core/pathresolver_test.go': 7, 'dagutils/diff.go': 8, 'dagutils/diffenum.go': 7, 'dagutils/diffenum_test.go': 7, 'dagutils/utils.go': 7, 'dagutils/utils_test.go': 7, 'filestore/pb/dataobj.pb.go': 3, 'mfs/fd.go': 2, 'namesys/base.go': 8, 'namesys/cache.go': 7, 'pin/internal/pb/header.pb.go': 3, 'thirdparty/cidv0v1/blockstore.go': 6, 'repo/fsrepo/config_test.go': 5, 'repo/fsrepo/misc.go': 5, 'test/bench/bench_cli_ipfs_add/main.go': 6, 'test/bench/offline_add/main.go': 6, 'core/commands/cmdenv/env.go': 14, 'core/commands/name/ipns.go': 15, 'core/commands/name/ipnsps.go': 15, 'core/commands/name/name.go': 15, 'core/commands/name/publish.go': 15, 'core/coreapi/dht.go': 6, 'core/coreapi/dht_test.go': 2, 'core/coreapi/interface/dht.go': 2, 'p2p/listener.go': 4, 'p2p/local.go': 4, 'p2p/remote.go': 4, 'p2p/stream.go': 4, 'core/coreapi/interface/swarm.go': 2, 'core/coreapi/swarm.go': 6, 'core/commands/cid.go': 15, 'core/coreapi/unixfile.go': 3, 'cmd/ipfs/dnsresolve_test.go': 2, 'core/coreapi/interface/options/unixfs.go': 1, 'core/coreapi/interface/pubsub.go': 1, 'core/coreapi/pubsub.go': 5, 'test/dependencies/iptb/iptb.go': 4, 'commands/context.go': 11, 'core/commands/cmdenv/cidbase.go': 9, 'core/commands/cmdenv/file.go': 3, 'core/coreapi/interface/tests/name.go': 1, 'core/coreapi/interface/tests/unixfs.go': 1, 'core/coreapi/test/api_test.go': 4, 'core/corehttp/ipns_hostname.go': 4, 'namesys/dns_test.go': 4, 'plugin/daemon.go': 4, 'plugin/loader/loader.go': 4, 'core/corehttp/proxy.go': 3, 'plugin/plugins/badgerds/badgerds.go': 3, 'plugin/plugins/flatfs/flatfs.go': 3, 'plugin/plugins/levelds/levelds.go': 2, 'core/corerepo/stat.go': 2, 'core/commands/cmdenv/cidbase_test.go': 1, 'core/corehttp/metrics.go': 1, 'core/corehttp/proxy_test.go': 1, 'plugin/tracer.go': 1, 'thirdparty/notifier/notifier.go': 1, 'README.md': 1, 'go.mod': 2, 'go.sum': 2, 'package-list.json': 1, 'cmd/ipfs/rotate.go': 1, 'core/commands/extra.go': 1}","('core/commands/root.go', 0.7948717948717948, 0.2743362831858407)"
core/commands/ls.go,163,1000,2,"[{'cyclomatic_complexity': 19, 'nloc': 88, 'token_count': 585, 'name': '', 'long_name': '(req cmds.Request,res cmds.Response)', 'start_line': 57, 'end_line': 161, 'full_parameters': [], 'filename': '/home/dimi/Documents/Informatik_Studium/FSS/SoftEvo/DataCollection/FFS_SoftEvo/go-ipfs/core/commands/ls.go', 'top_nesting_level': 0, 'length': 105, 'fan_in': 0, 'fan_out': 0, 'general_fan_out': 0}, {'cyclomatic_complexity': 7, 'nloc': 25, 'token_count': 192, 'name': '', 'long_name': '(res cmds.Response)(io.Reader,error)', 'start_line': 163, 'end_line': 189, 'full_parameters': [], 'filename': '/home/dimi/Documents/Informatik_Studium/FSS/SoftEvo/DataCollection/FFS_SoftEvo/go-ipfs/core/commands/ls.go', 'top_nesting_level': 0, 'length': 27, 'fan_in': 0, 'fan_out': 0, 'general_fan_out': 0}]",215,1248,4,"[{'cyclomatic_complexity': 1, 'nloc': 7, 'token_count': 44, 'name': 'error', 'long_name': '(path string,link LsLink)error', 'start_line': 95, 'end_line': 101, 'full_parameters': [], 'filename': '/home/dimi/Documents/Informatik_Studium/FSS/SoftEvo/DataCollection/FFS_SoftEvo/go-ipfs/core/commands/ls.go', 'top_nesting_level': 0, 'length': 7, 'fan_in': 0, 'fan_out': 0, 'general_fan_out': 0}, {'cyclomatic_complexity': 1, 'nloc': 1, 'token_count': 7, 'name': '', 'long_name': '(i int)', 'start_line': 101, 'end_line': 101, 'full_parameters': [], 'filename': '/home/dimi/Documents/Informatik_Studium/FSS/SoftEvo/DataCollection/FFS_SoftEvo/go-ipfs/core/commands/ls.go', 'top_nesting_level': 0, 'length': 1, 'fan_in': 0, 'fan_out': 0, 'general_fan_out': 0}, {'cyclomatic_complexity': 1, 'nloc': 4, 'token_count': 21, 'name': 'error', 'long_name': '(path string,link LsLink)error', 'start_line': 111, 'end_line': 115, 'full_parameters': [], 'filename': '/home/dimi/Documents/Informatik_Studium/FSS/SoftEvo/DataCollection/FFS_SoftEvo/go-ipfs/core/commands/ls.go', 'top_nesting_level': 0, 'length': 5, 'fan_in': 0, 'fan_out': 0, 'general_fan_out': 0}, {'cyclomatic_complexity': 1, 'nloc': 3, 'token_count': 24, 'name': 'bool', 'long_name': '(i,j int)bool', 'start_line': 117, 'end_line': 119, 'full_parameters': [], 'filename': '/home/dimi/Documents/Informatik_Studium/FSS/SoftEvo/DataCollection/FFS_SoftEvo/go-ipfs/core/commands/ls.go', 'top_nesting_level': 0, 'length': 3, 'fan_in': 0, 'fan_out': 0, 'general_fan_out': 0}]",52,248,2,109,109,"[{'timestamp': 1491058697.0, 'added_lines': 28, 'deleted_lines': 16, 'nloc': 172}, {'timestamp': 1499331469.0, 'added_lines': 1, 'deleted_lines': 1, 'nloc': 172}, {'timestamp': 1511223906.0, 'added_lines': 1, 'deleted_lines': 1, 'nloc': 172}, {'timestamp': 1511245249.0, 'added_lines': 1, 'deleted_lines': 1, 'nloc': 172}, {'timestamp': 1512365669.0, 'added_lines': 2, 'deleted_lines': 2, 'nloc': 172}, {'timestamp': 1511187070.0, 'added_lines': 1, 'deleted_lines': 1, 'nloc': 172}, {'timestamp': 1513436097.0, 'added_lines': 1, 'deleted_lines': 1, 'nloc': 172}, {'timestamp': 1513612261.0, 'added_lines': 1, 'deleted_lines': 1, 'nloc': 172}, {'timestamp': 1515277696.0, 'added_lines': 1, 'deleted_lines': 1, 'nloc': 172}, {'timestamp': 1516838128.0, 'added_lines': 1, 'deleted_lines': 1, 'nloc': 172}, {'timestamp': 1516911711.0, 'added_lines': 1, 'deleted_lines': 1, 'nloc': 172}, {'timestamp': 1517255734.0, 'added_lines': 4, 'deleted_lines': 4, 'nloc': 172}, {'timestamp': 1518736190.0, 'added_lines': 2, 'deleted_lines': 1, 'nloc': 173}, {'timestamp': 1522292035.0, 'added_lines': 19, 'deleted_lines': 13, 'nloc': 179}, {'timestamp': 1522765832.0, 'added_lines': 1, 'deleted_lines': 1, 'nloc': 179}, {'timestamp': 1525408792.0, 'added_lines': 1, 'deleted_lines': 1, 'nloc': 179}, {'timestamp': 1528520460.0, 'added_lines': 4, 'deleted_lines': 4, 'nloc': 179}, {'timestamp': 1529984485.0, 'added_lines': 1, 'deleted_lines': 1, 'nloc': 179}, {'timestamp': 1531150662.0, 'added_lines': 1, 'deleted_lines': 1, 'nloc': 179}, {'timestamp': 1531779409.0, 'added_lines': 3, 'deleted_lines': 3, 'nloc': 179}, {'timestamp': 1532146078.0, 'added_lines': 1, 'deleted_lines': 1, 'nloc': 179}, {'timestamp': 1532740866.0, 'added_lines': 1, 'deleted_lines': 1, 'nloc': 179}, {'timestamp': 1532764253.0, 'added_lines': 1, 'deleted_lines': 1, 'nloc': 179}, {'timestamp': 1532847462.0, 'added_lines': 2, 'deleted_lines': 2, 'nloc': 179}, {'timestamp': 1532986515.0, 'added_lines': 3, 'deleted_lines': 3, 'nloc': 179}, {'timestamp': 1533500571.0, 'added_lines': 7, 'deleted_lines': 7, 'nloc': 179}, {'timestamp': 1533618653.0, 'added_lines': 9, 'deleted_lines': 9, 'nloc': 179}, {'timestamp': 1533779477.0, 'added_lines': 9, 'deleted_lines': 9, 'nloc': 179}, {'timestamp': 1533946888.0, 'added_lines': 4, 'deleted_lines': 4, 'nloc': 179}, {'timestamp': 1534115707.0, 'added_lines': 11, 'deleted_lines': 11, 'nloc': 179}, {'timestamp': 1534195762.0, 'added_lines': 9, 'deleted_lines': 9, 'nloc': 179}, {'timestamp': 1534347022.0, 'added_lines': 10, 'deleted_lines': 10, 'nloc': 179}, {'timestamp': 1534896611.0, 'added_lines': 12, 'deleted_lines': 12, 'nloc': 179}, {'timestamp': 1535601896.0, 'added_lines': 7, 'deleted_lines': 7, 'nloc': 179}, {'timestamp': 1536388808.0, 'added_lines': 9, 'deleted_lines': 9, 'nloc': 179}, {'timestamp': 1536718784.0, 'added_lines': 11, 'deleted_lines': 11, 'nloc': 179}, {'timestamp': 1536723292.0, 'added_lines': 8, 'deleted_lines': 8, 'nloc': 179}, {'timestamp': 1537507299.0, 'added_lines': 2, 'deleted_lines': 2, 'nloc': 179}, {'timestamp': 1537570943.0, 'added_lines': 3, 'deleted_lines': 1, 'nloc': 181}, {'timestamp': 1537790637.0, 'added_lines': 7, 'deleted_lines': 7, 'nloc': 179}, {'timestamp': 1537792589.0, 'added_lines': 8, 'deleted_lines': 8, 'nloc': 179}, {'timestamp': 1537957978.0, 'added_lines': 2, 'deleted_lines': 2, 'nloc': 179}, {'timestamp': 1537393245.0, 'added_lines': 13, 'deleted_lines': 14, 'nloc': 178}, {'timestamp': 1538544957.0, 'added_lines': 6, 'deleted_lines': 6, 'nloc': 180}, {'timestamp': 1538694687.0, 'added_lines': 5, 'deleted_lines': 5, 'nloc': 180}, {'timestamp': 1538695953.0, 'added_lines': 5, 'deleted_lines': 5, 'nloc': 180}, {'timestamp': 1538662493.0, 'added_lines': 10, 'deleted_lines': 5, 'nloc': 184}, {'timestamp': 1538773916.0, 'added_lines': 6, 'deleted_lines': 6, 'nloc': 184}, {'timestamp': 1539176817.0, 'added_lines': 5, 'deleted_lines': 5, 'nloc': 184}, {'timestamp': 1539357340.0, 'added_lines': 5, 'deleted_lines': 5, 'nloc': 184}, {'timestamp': 1539850591.0, 'added_lines': 4, 'deleted_lines': 4, 'nloc': 184}, {'timestamp': 1540400358.0, 'added_lines': 5, 'deleted_lines': 5, 'nloc': 184}, {'timestamp': 1540410565.0, 'added_lines': 5, 'deleted_lines': 5, 'nloc': 184}, {'timestamp': 1540418491.0, 'added_lines': 5, 'deleted_lines': 5, 'nloc': 184}, {'timestamp': 1540603818.0, 'added_lines': 5, 'deleted_lines': 5, 'nloc': 184}, {'timestamp': 1541106379.0, 'added_lines': 3, 'deleted_lines': 3, 'nloc': 184}, {'timestamp': 1541189794.0, 'added_lines': 4, 'deleted_lines': 4, 'nloc': 184}, {'timestamp': 1541204121.0, 'added_lines': 8, 'deleted_lines': 8, 'nloc': 184}, {'timestamp': 1541903826.0, 'added_lines': 6, 'deleted_lines': 6, 'nloc': 184}, {'timestamp': 1539856162.0, 'added_lines': 182, 'deleted_lines': 105, 'nloc': 255}, {'timestamp': 1541714862.0, 'added_lines': 66, 'deleted_lines': 62, 'nloc': 256}, {'timestamp': 1541722810.0, 'added_lines': 25, 'deleted_lines': 14, 'nloc': 263}, {'timestamp': 1541804965.0, 'added_lines': 36, 'deleted_lines': 61, 'nloc': 239}, {'timestamp': 1542230803.0, 'added_lines': 4, 'deleted_lines': 2, 'nloc': 239}, {'timestamp': 1542243626.0, 'added_lines': 71, 'deleted_lines': 52, 'nloc': 256}, {'timestamp': 1542653169.0, 'added_lines': 8, 'deleted_lines': 13, 'nloc': 251}, {'timestamp': 1543443696.0, 'added_lines': 4, 'deleted_lines': 4, 'nloc': 251}, {'timestamp': 1544225843.0, 'added_lines': 5, 'deleted_lines': 5, 'nloc': 251}, {'timestamp': 1544661332.0, 'added_lines': 1, 'deleted_lines': 1, 'nloc': 251}, {'timestamp': 1540556089.0, 'added_lines': 4, 'deleted_lines': 4, 'nloc': 251}, {'timestamp': 1544451987.0, 'added_lines': 1, 'deleted_lines': 1, 'nloc': 251}, {'timestamp': 1547003974.0, 'added_lines': 5, 'deleted_lines': 5, 'nloc': 251}, {'timestamp': 1547152271.0, 'added_lines': 1, 'deleted_lines': 1, 'nloc': 251}, {'timestamp': 1546965553.0, 'added_lines': 17, 'deleted_lines': 8, 'nloc': 260}, {'timestamp': 1547207390.0, 'added_lines': 4, 'deleted_lines': 4, 'nloc': 260}, {'timestamp': 1547209007.0, 'added_lines': 17, 'deleted_lines': 4, 'nloc': 272}, {'timestamp': 1547300067.0, 'added_lines': 1, 'deleted_lines': 1, 'nloc': 272}, {'timestamp': 1542878205.0, 'added_lines': 10, 'deleted_lines': 5, 'nloc': 277}, {'timestamp': 1547499910.0, 'added_lines': 6, 'deleted_lines': 6, 'nloc': 277}, {'timestamp': 1548866534.0, 'added_lines': 4, 'deleted_lines': 4, 'nloc': 277}, {'timestamp': 1549063124.0, 'added_lines': 57, 'deleted_lines': 135, 'nloc': 203}, {'timestamp': 1549075320.0, 'added_lines': 6, 'deleted_lines': 6, 'nloc': 203}, {'timestamp': 1549124008.0, 'added_lines': 1, 'deleted_lines': 2, 'nloc': 202}, {'timestamp': 1549124874.0, 'added_lines': 3, 'deleted_lines': 5, 'nloc': 200}, {'timestamp': 1549672857.0, 'added_lines': 2, 'deleted_lines': 2, 'nloc': 200}, {'timestamp': 1549673846.0, 'added_lines': 2, 'deleted_lines': 2, 'nloc': 200}, {'timestamp': 1549903582.0, 'added_lines': 3, 'deleted_lines': 3, 'nloc': 200}, {'timestamp': 1550185115.0, 'added_lines': 2, 'deleted_lines': 2, 'nloc': 200}, {'timestamp': 1550507829.0, 'added_lines': 3, 'deleted_lines': 3, 'nloc': 200}, {'timestamp': 1550576884.0, 'added_lines': 2, 'deleted_lines': 2, 'nloc': 200}, {'timestamp': 1550610741.0, 'added_lines': 1, 'deleted_lines': 1, 'nloc': 200}, {'timestamp': 1550711994.0, 'added_lines': 2, 'deleted_lines': 2, 'nloc': 200}, {'timestamp': 1550723346.0, 'added_lines': 2, 'deleted_lines': 2, 'nloc': 200}, {'timestamp': 1551138343.0, 'added_lines': 1, 'deleted_lines': 1, 'nloc': 200}, {'timestamp': 1551229859.0, 'added_lines': 2, 'deleted_lines': 2, 'nloc': 200}, {'timestamp': 1551299964.0, 'added_lines': 3, 'deleted_lines': 3, 'nloc': 200}, {'timestamp': 1551471469.0, 'added_lines': 1, 'deleted_lines': 1, 'nloc': 200}, {'timestamp': 1551551196.0, 'added_lines': 4, 'deleted_lines': 4, 'nloc': 200}, {'timestamp': 1551760156.0, 'added_lines': 29, 'deleted_lines': 13, 'nloc': 217}, {'timestamp': 1551813321.0, 'added_lines': 4, 'deleted_lines': 2, 'nloc': 219}, {'timestamp': 1553529899.0, 'added_lines': 1, 'deleted_lines': 6, 'nloc': 215}, {'timestamp': 1553608614.0, 'added_lines': 2, 'deleted_lines': 1, 'nloc': 216}, {'timestamp': 1553609463.0, 'added_lines': 1, 'deleted_lines': 1, 'nloc': 216}, {'timestamp': 1557554420.0, 'added_lines': 8, 'deleted_lines': 9, 'nloc': 215}, {'timestamp': 1562845914.0, 'added_lines': 1, 'deleted_lines': 1, 'nloc': 215}, {'timestamp': 1604733661.0, 'added_lines': 1, 'deleted_lines': 1, 'nloc': 215}, {'timestamp': 1605529882.0, 'added_lines': 2, 'deleted_lines': 2, 'nloc': 236}, {'timestamp': 1606206730.0, 'added_lines': 1, 'deleted_lines': 1, 'nloc': 215}, {'timestamp': 1608253728.0, 'added_lines': 1, 'deleted_lines': 1, 'nloc': 215}]","{'blocks/blockstore/caching.go': 1, 'blocks/blockstore/util/remove.go': 3, 'cmd/ipfs/daemon.go': 35, 'cmd/ipfs/init.go': 37, 'cmd/ipfs/ipfs.go': 27, 'cmd/ipfs/main.go': 35, 'cmd/ipfs/main_test.go': 4, 'cmd/ipfswatch/main.go': 19, 'cmd/seccat/seccat.go': 24, None: 45, 'commands/channelmarshaler.go': 1, 'commands/cli/cmd_suggestion.go': 1, 'commands/cli/helptext.go': 3, 'commands/cli/helptext_test.go': 2, 'commands/cli/parse.go': 2, 'commands/cli/parse_test.go': 2, 'commands/command.go': 17, 'commands/command_test.go': 8, 'commands/http/client.go': 2, 'commands/http/handler.go': 2, 'commands/http/multifilereader.go': 2, 'commands/http/multifilereader_test.go': 2, 'commands/http/parse.go': 2, 'commands/reqlog.go': 1, 'commands/request.go': 22, 'commands/response.go': 12, 'commands/response_test.go': 8, 'core/bootstrap.go': 23, 'core/commands/active.go': 25, 'core/commands/add.go': 59, 'core/commands/bitswap.go': 59, 'core/commands/block.go': 47, 'core/commands/bootstrap.go': 33, 'core/commands/cat.go': 41, 'core/commands/commands.go': 30, 'core/commands/config.go': 34, 'core/commands/dag/dag.go': 70, 'core/commands/dht.go': 67, 'core/commands/diag.go': 23, 'core/commands/dns.go': 33, 'core/commands/e/error.go': 1, 'core/commands/external.go': 23, 'core/commands/files/files.go': 12, 'core/commands/filestore.go': 36, 'core/commands/get.go': 72, 'core/commands/helptext_test.go': 27, 'core/commands/id.go': 47, 'core/commands/ipns.go': 18, 'core/commands/keystore.go': 39, 'core/commands/log.go': 28, 'core/commands/mount_nofuse.go': 23, 'core/commands/mount_unix.go': 33, 'core/commands/mount_windows.go': 22, 'core/commands/name.go': 10, 'core/commands/object/diff.go': 36, 'core/commands/object/object.go': 76, 'core/commands/object/patch.go': 44, 'core/commands/p2p.go': 37, 'core/commands/pin.go': 81, 'core/commands/ping.go': 42, 'core/commands/publish.go': 21, 'core/commands/pubsub.go': 50, 'core/commands/refs.go': 65, 'core/commands/repo.go': 49, 'core/commands/resolve.go': 66, 'core/commands/root.go': 32, 'core/commands/shutdown.go': 26, 'core/commands/stat.go': 35, 'core/commands/swarm.go': 46, 'core/commands/sysdiag.go': 29, 'core/commands/tar.go': 60, 'core/commands/unixfs/ls.go': 72, 'core/commands/unixfs/unixfs.go': 23, 'core/commands/version.go': 26, 'core/core_test.go': 17, 'core/corehttp/commands.go': 59, 'core/corehttp/gateway.go': 36, 'core/coreunix/add.go': 65, 'core/coreunix/add_test.go': 61, 'core/coreunix/metadata_test.go': 57, 'exchange/bitswap/bitswap_test.go': 9, 'exchange/bitswap/decision/engine_test.go': 9, 'exchange/bitswap/message/message_test.go': 5, 'exchange/bitswap/message/pb/Makefile': 1, 'exchange/bitswap/testnet/network_test.go': 8, 'exchange/bitswap/testnet/peernet.go': 9, 'exchange/reprovide/reprovide_test.go': 33, 'fuse/ipns/common.go': 47, 'fuse/node/mount_test.go': 30, 'importer/balanced/balanced_test.go': 10, 'importer/chunk/rabin_test.go': 3, 'importer/helpers/dagbuilder.go': 15, 'importer/importer.go': 14, 'merkledag/utils/utils_test.go': 7, 'mfs/repub_test.go': 11, 'namesys/dns.go': 43, 'namesys/interface.go': 44, 'namesys/ipns_select_test.go': 5, 'namesys/proquint.go': 43, 'namesys/republisher/repub_test.go': 46, 'package.json': 66, 'repo/config/identity.go': 3, 'routing/offline/offline_test.go': 4, 'test/integration/addcat_test.go': 35, 'test/integration/bench_cat_test.go': 34, 'test/integration/bitswap_wo_routing_test.go': 35, 'test/integration/three_legged_cat_test.go': 34, 'core/bootstrap_test.go': 22, 'core/commands/dht_test.go': 21, 'core/commands/get_test.go': 28, 'core/core.go': 58, 'core/corehttp/gateway_test.go': 53, 'core/corehttp/metrics_test.go': 30, 'core/mock/mock.go': 31, 'exchange/bitswap/decision/bench_test.go': 7, 'exchange/bitswap/decision/peer_request_queue_test.go': 7, 'exchange/bitswap/message/message.go': 7, 'exchange/bitswap/network/interface.go': 7, 'exchange/bitswap/network/ipfs_impl.go': 7, 'exchange/bitswap/testnet/interface.go': 6, 'exchange/bitswap/testnet/virtual.go': 7, 'exchange/bitswap/testutils.go': 8, 'fuse/ipns/ipns_test.go': 29, 'fuse/readonly/ipfs_test.go': 61, 'namesys/publisher_test.go': 30, 'namesys/resolve_test.go': 46, 'p2p/p2p.go': 22, 'p2p/registry.go': 10, 'repo/config/bootstrap_peers.go': 8, 'routing/mock/centralized_client.go': 3, 'routing/mock/centralized_server.go': 3, 'routing/mock/centralized_test.go': 3, 'routing/mock/interface.go': 3, 'routing/none/none_client.go': 3, 'test/integration/bench_test.go': 16, 'assets/assets.go': 52, 'blocks/blockstore/arc_cache.go': 2, 'blocks/blockstore/arc_cache_test.go': 2, 'blocks/blockstore/blockstore.go': 2, 'blocks/blockstore/blockstore_test.go': 2, 'blocks/blockstore/bloom_cache.go': 2, 'blocks/blockstore/bloom_cache_test.go': 2, 'blocks/blocksutil/block_generator.go': 2, 'blockservice/blockservice.go': 8, 'blockservice/blockservice_test.go': 8, 'blockservice/test/blocks_test.go': 9, 'core/builder.go': 56, 'core/commands/ipnsps.go': 9, 'core/coreapi/coreapi.go': 28, 'core/coreapi/interface/interface.go': 2, 'core/coreapi/unixfs.go': 62, 'core/coreapi/unixfs_test.go': 42, 'core/coredag/cbor.go': 18, 'core/coredag/dagpb.go': 43, 'core/coredag/dagtransl.go': 14, 'core/coredag/raw.go': 43, 'core/corehttp/corehttp.go': 13, 'core/corehttp/gateway_handler.go': 62, 'core/corerepo/gc.go': 47, 'core/corerepo/pinning.go': 23, 'core/coreunix/metadata.go': 50, 'core/pathresolver.go': 47, 'exchange/bitswap/bitswap.go': 7, 'exchange/bitswap/decision/engine.go': 7, 'exchange/bitswap/decision/ledger.go': 6, 'exchange/bitswap/decision/peer_request_queue.go': 6, 'exchange/bitswap/get.go': 7, 'exchange/bitswap/notifications/notifications.go': 4, 'exchange/bitswap/notifications/notifications_test.go': 4, 'exchange/bitswap/session.go': 6, 'exchange/bitswap/session_test.go': 6, 'exchange/bitswap/stat.go': 4, 'exchange/bitswap/wantlist/wantlist.go': 4, 'exchange/bitswap/wantlist/wantlist_test.go': 4, 'exchange/bitswap/wantmanager.go': 7, 'exchange/bitswap/workers.go': 6, 'exchange/interface.go': 2, 'exchange/offline/offline.go': 2, 'exchange/offline/offline_test.go': 2, 'exchange/reprovide/providers.go': 47, 'exchange/reprovide/reprovide.go': 27, 'filestore/filestore.go': 26, 'filestore/filestore_test.go': 45, 'filestore/fsrefstore.go': 26, 'filestore/util.go': 25, 'fuse/ipns/ipns_unix.go': 52, 'fuse/readonly/readonly_unix.go': 55, 'importer/balanced/builder.go': 5, 'importer/chunk/splitting_test.go': 2, 'importer/helpers/helpers.go': 7, 'importer/importer_test.go': 9, 'importer/trickle/trickle_test.go': 9, 'importer/trickle/trickledag.go': 6, 'merkledag/batch.go': 2, 'merkledag/coding.go': 5, 'merkledag/merkledag.go': 7, 'merkledag/merkledag_test.go': 11, 'merkledag/node.go': 6, 'merkledag/node_test.go': 6, 'merkledag/raw.go': 5, 'merkledag/traverse/traverse.go': 5, 'merkledag/traverse/traverse_test.go': 6, 'merkledag/utils/diff.go': 6, 'merkledag/utils/diffenum.go': 5, 'merkledag/utils/diffenum_test.go': 6, 'merkledag/utils/utils.go': 11, 'mfs/dir.go': 15, 'mfs/file.go': 17, 'mfs/mfs_test.go': 21, 'mfs/ops.go': 12, 'mfs/system.go': 17, 'namesys/namesys.go': 48, 'namesys/publisher.go': 52, 'namesys/pubsub.go': 3, 'namesys/pubsub_test.go': 3, 'namesys/republisher/repub.go': 43, 'namesys/routing.go': 49, 'path/path.go': 5, 'path/resolver.go': 4, 'path/resolver_test.go': 4, 'pin/gc/gc.go': 49, 'pin/pin.go': 46, 'pin/pin_test.go': 48, 'pin/set.go': 44, 'pin/set_test.go': 47, 'plugin/ipld.go': 14, 'plugin/loader/initializer.go': 11, 'plugin/plugins/git/git.go': 13, 'repo/config/init.go': 6, 'repo/fsrepo/fsrepo.go': 22, 'repo/fsrepo/lock/lock.go': 2, 'repo/fsrepo/serialize/serialize.go': 3, 'repo/mock.go': 16, 'repo/repo.go': 20, 'routing/offline/offline.go': 2, 'tar/format.go': 54, 'test/dependencies/ma-pipe-unidir/main.go': 9, 'thirdparty/ds-help/key.go': 2, 'thirdparty/pollEndpoint/main.go': 13, 'thirdparty/posinfo/posinfo.go': 3, 'unixfs/archive/archive.go': 7, 'unixfs/archive/tar/writer.go': 8, 'unixfs/hamt/hamt.go': 8, 'unixfs/io/dagreader.go': 8, 'unixfs/io/dirbuilder.go': 5, 'unixfs/io/resolve.go': 8, 'unixfs/mod/dagmodifier.go': 10, 'unixfs/mod/dagmodifier_test.go': 4, 'unixfs/test/utils.go': 10, 'commands/legacy/command.go': 13, 'commands/legacy/legacy.go': 13, 'commands/legacy/legacy_test.go': 14, 'commands/legacy/request.go': 14, 'commands/legacy/response.go': 14, 'commands/legacy/responseemitter.go': 4, 'core/commands/env.go': 4, 'TODO.md': 2, 'core/commands/commands_test.go': 23, 'test/sharness/t0110-gateway.sh': 1, 'test/sharness/t0410-api-add.sh': 1, 'core/coreapi/dag.go': 13, 'core/coreapi/dag_test.go': 3, 'core/coreapi/interface/options/dag.go': 8, 'core/coreapi/key.go': 49, 'core/coreapi/name.go': 50, 'merkledag/test/utils.go': 10, 'namesys/namesys_test.go': 53, 'repo/fsrepo/datastores.go': 15, 'repo/fsrepo/fsrepo_test.go': 17, 'thirdparty/datastore2/datastore_closer.go': 1, 'thirdparty/datastore2/delayed.go': 1, 'thirdparty/datastore2/threadsafe.go': 1, 'unixfs/io/pbdagreader.go': 7, 'mfs/fd.go': 9, 'unixfs/hamt/hamt_stress_test.go': 6, 'unixfs/hamt/hamt_test.go': 6, 'unixfs/io/dagreader_test.go': 3, 'unixfs/io/dirbuilder_test.go': 1, 'core/commands/files.go': 72, 'core/coreunix/cat.go': 17, 'path/resolver/resolver.go': 6, 'path/resolver/resolver_test.go': 4, 'core/coreapi/pin.go': 52, 'blocks/blockstoreutil/remove.go': 22, 'blockservice/test/mock.go': 4, 'cmd/ipfs/util/ulimit.go': 8, 'cmd/seccat/util.go': 8, 'core/corehttp/logs.go': 8, 'fuse/mount/mount.go': 8, 'fuse/node/mount_unix.go': 8, 'keystore/keystore.go': 8, 'keystore/keystore_test.go': 5, 'keystore/memkeystore.go': 5, 'namesys/ipns_validate_test.go': 2, 'namesys/validator.go': 2, 'plugin/loader/load.go': 6, 'thirdparty/verifbs/verifbs.go': 23, 'cmd/ipfs/util/ulimit_freebsd.go': 2, 'cmd/ipfs/util/ulimit_unix.go': 2, 'core/coreapi/block.go': 20, 'core/coreapi/block_test.go': 2, 'core/coreapi/interface/coreapi.go': 9, 'core/coreapi/interface/dag.go': 9, 'core/coreapi/interface/object.go': 9, 'core/coreapi/interface/options/block.go': 3, 'core/coreapi/interface/path.go': 33, 'core/coreapi/interface/unixfs.go': 14, 'core/coreapi/object.go': 52, 'fuse/ipns/link_unix.go': 2, 'fuse/mount/fuse.go': 2, 'fuse/node/mount_darwin.go': 2, 'merkledag/errservice.go': 2, 'merkledag/readonly.go': 2, 'merkledag/readonly_test.go': 2, 'merkledag/rwservice.go': 2, 'merkledag/session.go': 2, 'thirdparty/verifcid/validate.go': 2, 'thirdparty/verifcid/validate_test.go': 2, 'namesys/ipns_resolver_validation_test.go': 44, 'test/sharness/t0170-dht.sh': 1, 'core/commands/urlstore.go': 52, 'unixfs/io/directory.go': 3, 'core/corehttp/metrics.go': 2, 'Rules.mk': 1, 'dagutils/diff.go': 42, 'dagutils/diffenum.go': 38, 'dagutils/diffenum_test.go': 38, 'dagutils/utils.go': 39, 'dagutils/utils_test.go': 39, 'unixfs/io/directory_test.go': 2, 'unixfs/unixfs.go': 2, 'core/coreapi/name_test.go': 31, 'core/coreapi/path.go': 51, 'core/pathresolver_test.go': 38, 'namesys/base.go': 42, 'namesys/cache.go': 38, 'unixfs/importer/balanced/balanced_test.go': 1, 'unixfs/importer/balanced/builder.go': 1, 'unixfs/importer/helpers/dagbuilder.go': 1, 'unixfs/importer/helpers/helpers.go': 1, 'unixfs/importer/importer.go': 1, 'unixfs/importer/importer_test.go': 1, 'unixfs/importer/trickle/trickle_test.go': 1, 'unixfs/importer/trickle/trickledag.go': 1, 'unixfs/unixfs_test.go': 1, 'core/coreapi/interface/key.go': 6, 'filestore/pb/dataobj.pb.go': 3, 'pin/internal/pb/header.pb.go': 3, 'thirdparty/cidv0v1/blockstore.go': 16, 'repo/fsrepo/config_test.go': 12, 'repo/fsrepo/misc.go': 12, 'test/bench/bench_cli_ipfs_add/main.go': 13, 'test/bench/offline_add/main.go': 13, 'core/commands/cmdenv/env.go': 29, 'core/commands/name/ipns.go': 44, 'core/commands/name/publish.go': 33, 'core/coreapi/dht.go': 33, 'core/coreapi/dht_test.go': 5, 'test/sharness/t0275-cid-security.sh': 1, 'core/commands/name/ipnsps.go': 18, 'core/commands/name/name.go': 15, 'core/coreapi/interface/dht.go': 9, 'p2p/listener.go': 12, 'p2p/local.go': 12, 'p2p/remote.go': 12, 'p2p/stream.go': 12, 'core/coreapi/interface/util.go': 1, 'core/coreapi/interface/swarm.go': 8, 'core/coreapi/swarm.go': 22, 'core/commands/cid.go': 16, 'core/coreapi/interface/options/unixfs.go': 18, 'core/coreapi/pubsub.go': 20, 'core/coreapi/unixfile.go': 17, 'cmd/ipfs/dnsresolve_test.go': 5, 'core/coreapi/interface/pubsub.go': 3, 'test/dependencies/iptb/iptb.go': 11, 'plugin/plugins/badgerds/badgerds.go': 4, 'plugin/plugins/flatfs/flatfs.go': 4, 'plugin/plugins/levelds/levelds.go': 3, 'test/sharness/t0045-ls.sh': 7, 'commands/context.go': 20, 'core/corehttp/proxy.go': 8, 'core/coreapi/interface/tests/name.go': 3, 'core/coreapi/interface/tests/unixfs.go': 6, 'core/coreapi/test/api_test.go': 12, 'test/sharness/t0051-object.sh': 3, 'test/sharness/t0260-sharding.sh': 1, 'core/commands/cmdenv/cidbase.go': 11, 'core/commands/cmdenv/cidbase_test.go': 3, 'test/sharness/t0040-add-and-cat.sh': 1, 'test/sharness/t0051-object-data/mixed.json': 1, 'test/sharness/t0053-dag.sh': 1, 'test/sharness/t0085-pins.sh': 1, 'test/sharness/t0095-refs.sh': 1, 'test/sharness/t0160-resolve.sh': 1, 'test/sharness/t0210-tar.sh': 1, 'test/sharness/t0250-files-api.sh': 1, 'test/sharness/t0271-filestore-utils.sh': 1, 'test/sharness/t0272-urlstore.sh': 1, 'plugin/loader/loader.go': 12, 'core/commands/cmdenv/file.go': 3, 'core/corehttp/ipns_hostname.go': 11, 'namesys/dns_test.go': 10, 'plugin/daemon.go': 10, 'core/corerepo/stat.go': 2, 'core/corehttp/proxy_test.go': 1, 'plugin/tracer.go': 1, 'thirdparty/notifier/notifier.go': 1, 'README.md': 1, 'go.mod': 1, 'go.sum': 1, 'package-list.json': 1, 'core/commands/pin/remotepin.go': 1}","('core/commands/object/object.go', 0.6972477064220184, 0.6608695652173913)"
core/commands/mount_nofuse.go,17,57,0,[],17,57,0,[],0,0,0,29,29,"[{'timestamp': 1491058697.0, 'added_lines': 3, 'deleted_lines': 1, 'nloc': 18}, {'timestamp': 1511223906.0, 'added_lines': 1, 'deleted_lines': 1, 'nloc': 18}, {'timestamp': 1512365669.0, 'added_lines': 1, 'deleted_lines': 1, 'nloc': 18}, {'timestamp': 1511187070.0, 'added_lines': 1, 'deleted_lines': 1, 'nloc': 18}, {'timestamp': 1513436097.0, 'added_lines': 1, 'deleted_lines': 1, 'nloc': 18}, {'timestamp': 1513612261.0, 'added_lines': 1, 'deleted_lines': 1, 'nloc': 18}, {'timestamp': 1515277696.0, 'added_lines': 1, 'deleted_lines': 1, 'nloc': 18}, {'timestamp': 1526916180.0, 'added_lines': 1, 'deleted_lines': 1, 'nloc': 18}, {'timestamp': 1527086998.0, 'added_lines': 1, 'deleted_lines': 2, 'nloc': 18}, {'timestamp': 1528520460.0, 'added_lines': 1, 'deleted_lines': 1, 'nloc': 18}, {'timestamp': 1533946888.0, 'added_lines': 1, 'deleted_lines': 1, 'nloc': 18}, {'timestamp': 1534896611.0, 'added_lines': 1, 'deleted_lines': 1, 'nloc': 18}, {'timestamp': 1539850591.0, 'added_lines': 1, 'deleted_lines': 1, 'nloc': 18}, {'timestamp': 1540569270.0, 'added_lines': 2, 'deleted_lines': 3, 'nloc': 18}, {'timestamp': 1540572903.0, 'added_lines': 1, 'deleted_lines': 1, 'nloc': 18}, {'timestamp': 1540619689.0, 'added_lines': 1, 'deleted_lines': 1, 'nloc': 18}, {'timestamp': 1540951823.0, 'added_lines': 1, 'deleted_lines': 1, 'nloc': 18}, {'timestamp': 1544661332.0, 'added_lines': 1, 'deleted_lines': 1, 'nloc': 18}, {'timestamp': 1540556089.0, 'added_lines': 1, 'deleted_lines': 1, 'nloc': 18}, {'timestamp': 1547152271.0, 'added_lines': 1, 'deleted_lines': 1, 'nloc': 18}, {'timestamp': 1548866534.0, 'added_lines': 1, 'deleted_lines': 1, 'nloc': 18}, {'timestamp': 1549903582.0, 'added_lines': 1, 'deleted_lines': 1, 'nloc': 18}, {'timestamp': 1550507829.0, 'added_lines': 1, 'deleted_lines': 1, 'nloc': 18}, {'timestamp': 1550610741.0, 'added_lines': 1, 'deleted_lines': 1, 'nloc': 18}, {'timestamp': 1551138343.0, 'added_lines': 1, 'deleted_lines': 1, 'nloc': 18}, {'timestamp': 1551299964.0, 'added_lines': 1, 'deleted_lines': 1, 'nloc': 18}, {'timestamp': 1551471469.0, 'added_lines': 1, 'deleted_lines': 1, 'nloc': 18}, {'timestamp': 1551551196.0, 'added_lines': 2, 'deleted_lines': 2, 'nloc': 18}, {'timestamp': 1557554420.0, 'added_lines': 1, 'deleted_lines': 2, 'nloc': 17}]","{'blocks/blockstore/caching.go': 1, 'blocks/blockstore/util/remove.go': 2, 'cmd/ipfs/daemon.go': 23, 'cmd/ipfs/init.go': 23, 'cmd/ipfs/ipfs.go': 21, 'cmd/ipfs/main.go': 22, 'cmd/ipfs/main_test.go': 4, 'cmd/ipfswatch/main.go': 10, 'cmd/seccat/seccat.go': 7, None: 13, 'commands/channelmarshaler.go': 1, 'commands/cli/cmd_suggestion.go': 1, 'commands/cli/helptext.go': 2, 'commands/cli/helptext_test.go': 2, 'commands/cli/parse.go': 2, 'commands/cli/parse_test.go': 2, 'commands/command.go': 11, 'commands/command_test.go': 7, 'commands/http/client.go': 2, 'commands/http/handler.go': 2, 'commands/http/multifilereader.go': 2, 'commands/http/multifilereader_test.go': 2, 'commands/http/parse.go': 2, 'commands/reqlog.go': 1, 'commands/request.go': 11, 'commands/response.go': 11, 'commands/response_test.go': 7, 'core/bootstrap.go': 7, 'core/commands/active.go': 26, 'core/commands/add.go': 23, 'core/commands/bitswap.go': 23, 'core/commands/block.go': 23, 'core/commands/bootstrap.go': 23, 'core/commands/cat.go': 23, 'core/commands/commands.go': 23, 'core/commands/config.go': 24, 'core/commands/dag/dag.go': 23, 'core/commands/dht.go': 23, 'core/commands/diag.go': 26, 'core/commands/dns.go': 23, 'core/commands/e/error.go': 1, 'core/commands/external.go': 23, 'core/commands/files/files.go': 7, 'core/commands/filestore.go': 23, 'core/commands/get.go': 23, 'core/commands/helptext_test.go': 21, 'core/commands/id.go': 23, 'core/commands/ipns.go': 10, 'core/commands/keystore.go': 23, 'core/commands/log.go': 25, 'core/commands/ls.go': 23, 'core/commands/mount_unix.go': 25, 'core/commands/mount_windows.go': 26, 'core/commands/name.go': 10, 'core/commands/object/diff.go': 23, 'core/commands/object/object.go': 23, 'core/commands/object/patch.go': 23, 'core/commands/p2p.go': 23, 'core/commands/pin.go': 23, 'core/commands/ping.go': 23, 'core/commands/publish.go': 10, 'core/commands/pubsub.go': 23, 'core/commands/refs.go': 23, 'core/commands/repo.go': 23, 'core/commands/resolve.go': 23, 'core/commands/root.go': 24, 'core/commands/shutdown.go': 23, 'core/commands/stat.go': 23, 'core/commands/swarm.go': 23, 'core/commands/sysdiag.go': 24, 'core/commands/tar.go': 23, 'core/commands/unixfs/ls.go': 23, 'core/commands/unixfs/unixfs.go': 23, 'core/commands/version.go': 23, 'core/core_test.go': 4, 'core/corehttp/commands.go': 22, 'core/corehttp/gateway.go': 9, 'core/coreunix/add.go': 17, 'core/coreunix/add_test.go': 17, 'core/coreunix/metadata_test.go': 12, 'exchange/bitswap/bitswap_test.go': 4, 'exchange/bitswap/decision/engine_test.go': 4, 'exchange/bitswap/message/message_test.go': 3, 'exchange/bitswap/message/pb/Makefile': 1, 'exchange/bitswap/testnet/network_test.go': 4, 'exchange/bitswap/testnet/peernet.go': 4, 'exchange/reprovide/reprovide_test.go': 7, 'fuse/ipns/common.go': 10, 'fuse/node/mount_test.go': 7, 'importer/balanced/balanced_test.go': 3, 'importer/chunk/rabin_test.go': 2, 'importer/helpers/dagbuilder.go': 8, 'importer/importer.go': 8, 'merkledag/utils/utils_test.go': 3, 'mfs/repub_test.go': 4, 'namesys/dns.go': 6, 'namesys/interface.go': 6, 'namesys/ipns_select_test.go': 3, 'namesys/proquint.go': 6, 'namesys/republisher/repub_test.go': 8, 'package.json': 21, 'repo/config/identity.go': 1, 'routing/offline/offline_test.go': 3, 'test/integration/addcat_test.go': 11, 'test/integration/bench_cat_test.go': 10, 'test/integration/bitswap_wo_routing_test.go': 8, 'test/integration/three_legged_cat_test.go': 10, 'core/bootstrap_test.go': 6, 'core/commands/dht_test.go': 6, 'core/commands/get_test.go': 22, 'core/core.go': 12, 'core/corehttp/gateway_test.go': 9, 'core/corehttp/metrics_test.go': 7, 'core/mock/mock.go': 7, 'exchange/bitswap/decision/bench_test.go': 3, 'exchange/bitswap/decision/peer_request_queue_test.go': 3, 'exchange/bitswap/message/message.go': 3, 'exchange/bitswap/network/interface.go': 3, 'exchange/bitswap/network/ipfs_impl.go': 3, 'exchange/bitswap/testnet/interface.go': 3, 'exchange/bitswap/testnet/virtual.go': 3, 'exchange/bitswap/testutils.go': 3, 'fuse/ipns/ipns_test.go': 6, 'fuse/readonly/ipfs_test.go': 12, 'namesys/publisher_test.go': 6, 'namesys/resolve_test.go': 7, 'p2p/p2p.go': 6, 'p2p/registry.go': 4, 'repo/config/bootstrap_peers.go': 3, 'routing/mock/centralized_client.go': 2, 'routing/mock/centralized_server.go': 2, 'routing/mock/centralized_test.go': 2, 'routing/mock/interface.go': 2, 'routing/none/none_client.go': 2, 'test/integration/bench_test.go': 6, 'assets/assets.go': 11, 'blocks/blockstore/arc_cache.go': 1, 'blocks/blockstore/arc_cache_test.go': 1, 'blocks/blockstore/blockstore.go': 1, 'blocks/blockstore/blockstore_test.go': 1, 'blocks/blockstore/bloom_cache.go': 1, 'blocks/blockstore/bloom_cache_test.go': 1, 'blocks/blocksutil/block_generator.go': 1, 'blockservice/blockservice.go': 2, 'blockservice/blockservice_test.go': 2, 'blockservice/test/blocks_test.go': 2, 'core/builder.go': 11, 'core/commands/ipnsps.go': 7, 'core/coreapi/coreapi.go': 6, 'core/coreapi/interface/interface.go': 1, 'core/coreapi/unixfs.go': 12, 'core/coreapi/unixfs_test.go': 6, 'core/coredag/cbor.go': 4, 'core/coredag/dagpb.go': 6, 'core/coredag/dagtransl.go': 4, 'core/coredag/raw.go': 6, 'core/corehttp/corehttp.go': 4, 'core/corehttp/gateway_handler.go': 12, 'core/corerepo/gc.go': 11, 'core/corerepo/pinning.go': 4, 'core/coreunix/metadata.go': 11, 'core/pathresolver.go': 6, 'exchange/bitswap/bitswap.go': 2, 'exchange/bitswap/decision/engine.go': 2, 'exchange/bitswap/decision/ledger.go': 2, 'exchange/bitswap/decision/peer_request_queue.go': 2, 'exchange/bitswap/get.go': 2, 'exchange/bitswap/notifications/notifications.go': 2, 'exchange/bitswap/notifications/notifications_test.go': 2, 'exchange/bitswap/session.go': 2, 'exchange/bitswap/session_test.go': 2, 'exchange/bitswap/stat.go': 2, 'exchange/bitswap/wantlist/wantlist.go': 2, 'exchange/bitswap/wantlist/wantlist_test.go': 2, 'exchange/bitswap/wantmanager.go': 2, 'exchange/bitswap/workers.go': 2, 'exchange/interface.go': 1, 'exchange/offline/offline.go': 1, 'exchange/offline/offline_test.go': 1, 'exchange/reprovide/providers.go': 6, 'exchange/reprovide/reprovide.go': 5, 'filestore/filestore.go': 5, 'filestore/filestore_test.go': 6, 'filestore/fsrefstore.go': 5, 'filestore/util.go': 5, 'fuse/ipns/ipns_unix.go': 11, 'fuse/readonly/readonly_unix.go': 11, 'importer/balanced/builder.go': 2, 'importer/chunk/splitting_test.go': 1, 'importer/helpers/helpers.go': 2, 'importer/importer_test.go': 2, 'importer/trickle/trickle_test.go': 2, 'importer/trickle/trickledag.go': 2, 'merkledag/batch.go': 1, 'merkledag/coding.go': 2, 'merkledag/merkledag.go': 2, 'merkledag/merkledag_test.go': 2, 'merkledag/node.go': 2, 'merkledag/node_test.go': 2, 'merkledag/raw.go': 2, 'merkledag/traverse/traverse.go': 2, 'merkledag/traverse/traverse_test.go': 2, 'merkledag/utils/diff.go': 2, 'merkledag/utils/diffenum.go': 2, 'merkledag/utils/diffenum_test.go': 2, 'merkledag/utils/utils.go': 2, 'mfs/dir.go': 3, 'mfs/file.go': 3, 'mfs/mfs_test.go': 3, 'mfs/ops.go': 2, 'mfs/system.go': 3, 'namesys/namesys.go': 7, 'namesys/publisher.go': 11, 'namesys/pubsub.go': 1, 'namesys/pubsub_test.go': 1, 'namesys/republisher/repub.go': 6, 'namesys/routing.go': 7, 'path/path.go': 2, 'path/resolver.go': 1, 'path/resolver_test.go': 1, 'pin/gc/gc.go': 6, 'pin/pin.go': 6, 'pin/pin_test.go': 6, 'pin/set.go': 6, 'pin/set_test.go': 6, 'plugin/ipld.go': 4, 'plugin/loader/initializer.go': 3, 'plugin/plugins/git/git.go': 4, 'repo/config/init.go': 2, 'repo/fsrepo/fsrepo.go': 5, 'repo/fsrepo/lock/lock.go': 1, 'repo/fsrepo/serialize/serialize.go': 2, 'repo/mock.go': 5, 'repo/repo.go': 5, 'routing/offline/offline.go': 1, 'tar/format.go': 11, 'test/dependencies/ma-pipe-unidir/main.go': 3, 'thirdparty/ds-help/key.go': 1, 'thirdparty/pollEndpoint/main.go': 4, 'thirdparty/posinfo/posinfo.go': 1, 'unixfs/archive/archive.go': 2, 'unixfs/archive/tar/writer.go': 2, 'unixfs/hamt/hamt.go': 2, 'unixfs/io/dagreader.go': 2, 'unixfs/io/dirbuilder.go': 2, 'unixfs/io/resolve.go': 2, 'unixfs/mod/dagmodifier.go': 2, 'unixfs/mod/dagmodifier_test.go': 2, 'unixfs/test/utils.go': 2, 'commands/legacy/command.go': 7, 'commands/legacy/legacy.go': 7, 'commands/legacy/legacy_test.go': 8, 'commands/legacy/request.go': 8, 'commands/legacy/response.go': 8, 'commands/legacy/responseemitter.go': 4, 'core/commands/env.go': 3, 'TODO.md': 2, 'core/commands/commands_test.go': 17, 'test/sharness/t0110-gateway.sh': 1, 'test/sharness/t0410-api-add.sh': 1, 'fuse/node/mount_nofuse.go': 2, 'fuse/node/mount_unix.go': 4, 'blocks/blockstoreutil/remove.go': 4, 'blockservice/test/mock.go': 1, 'cmd/ipfs/util/ulimit.go': 3, 'cmd/ipfs/util/ulimit_freebsd.go': 2, 'cmd/ipfs/util/ulimit_unix.go': 2, 'cmd/seccat/util.go': 3, 'core/commands/files.go': 16, 'core/coreapi/block.go': 6, 'core/coreapi/block_test.go': 1, 'core/coreapi/dag.go': 3, 'core/coreapi/dag_test.go': 1, 'core/coreapi/interface/coreapi.go': 2, 'core/coreapi/interface/dag.go': 2, 'core/coreapi/interface/object.go': 2, 'core/coreapi/interface/options/block.go': 1, 'core/coreapi/interface/options/dag.go': 2, 'core/coreapi/interface/path.go': 2, 'core/coreapi/interface/unixfs.go': 5, 'core/coreapi/key.go': 6, 'core/coreapi/name.go': 6, 'core/coreapi/object.go': 10, 'core/coreapi/pin.go': 6, 'core/corehttp/logs.go': 3, 'fuse/ipns/link_unix.go': 2, 'fuse/mount/fuse.go': 2, 'fuse/mount/mount.go': 3, 'fuse/node/mount_darwin.go': 2, 'keystore/keystore.go': 3, 'merkledag/errservice.go': 1, 'merkledag/readonly.go': 1, 'merkledag/readonly_test.go': 1, 'merkledag/rwservice.go': 1, 'merkledag/session.go': 1, 'merkledag/test/utils.go': 1, 'namesys/ipns_validate_test.go': 1, 'namesys/namesys_test.go': 10, 'namesys/validator.go': 1, 'path/resolver/resolver.go': 1, 'path/resolver/resolver_test.go': 1, 'plugin/loader/load.go': 1, 'repo/fsrepo/datastores.go': 3, 'thirdparty/verifbs/verifbs.go': 4, 'thirdparty/verifcid/validate.go': 1, 'thirdparty/verifcid/validate_test.go': 1, 'unixfs/hamt/hamt_stress_test.go': 1, 'unixfs/hamt/hamt_test.go': 1, 'unixfs/io/pbdagreader.go': 1, 'core/commands/urlstore.go': 15, 'core/coreapi/path.go': 9, 'core/coreunix/cat.go': 2, 'mfs/fd.go': 1, 'core/coreapi/interface/key.go': 1, 'core/coreapi/name_test.go': 3, 'core/pathresolver_test.go': 4, 'dagutils/diff.go': 5, 'dagutils/diffenum.go': 4, 'dagutils/diffenum_test.go': 4, 'dagutils/utils.go': 4, 'dagutils/utils_test.go': 4, 'namesys/base.go': 5, 'namesys/cache.go': 4, 'namesys/ipns_resolver_validation_test.go': 5, 'repo/fsrepo/config_test.go': 3, 'repo/fsrepo/fsrepo_test.go': 3, 'repo/fsrepo/misc.go': 3, 'test/bench/bench_cli_ipfs_add/main.go': 4, 'test/bench/offline_add/main.go': 4, 'thirdparty/cidv0v1/blockstore.go': 3, 'core/commands/cid.go': 13, 'core/commands/cmdenv/env.go': 12, 'core/commands/name/ipns.go': 13, 'core/commands/name/ipnsps.go': 13, 'core/commands/name/name.go': 13, 'core/commands/name/publish.go': 13, 'core/coreapi/unixfile.go': 2, 'commands/context.go': 11, 'core/commands/cmdenv/cidbase.go': 9, 'core/commands/cmdenv/file.go': 3, 'core/coreapi/interface/tests/name.go': 1, 'core/coreapi/interface/tests/unixfs.go': 1, 'core/coreapi/dht.go': 4, 'core/coreapi/pubsub.go': 4, 'core/coreapi/swarm.go': 4, 'core/coreapi/test/api_test.go': 4, 'core/corehttp/ipns_hostname.go': 4, 'namesys/dns_test.go': 4, 'plugin/daemon.go': 4, 'plugin/loader/loader.go': 4, 'core/corehttp/proxy.go': 3, 'filestore/pb/dataobj.pb.go': 2, 'keystore/keystore_test.go': 2, 'keystore/memkeystore.go': 2, 'p2p/listener.go': 2, 'p2p/local.go': 2, 'p2p/remote.go': 2, 'p2p/stream.go': 2, 'pin/internal/pb/header.pb.go': 2, 'plugin/plugins/badgerds/badgerds.go': 3, 'plugin/plugins/flatfs/flatfs.go': 3, 'plugin/plugins/levelds/levelds.go': 2, 'test/dependencies/iptb/iptb.go': 3, 'core/corerepo/stat.go': 2, 'cmd/ipfs/dnsresolve_test.go': 1, 'core/commands/cmdenv/cidbase_test.go': 1, 'core/corehttp/metrics.go': 1, 'core/corehttp/proxy_test.go': 1, 'plugin/tracer.go': 1, 'thirdparty/notifier/notifier.go': 1, 'README.md': 1, 'go.mod': 1, 'go.sum': 1, 'package-list.json': 1}","('core/commands/active.go', 0.896551724137931, 0.8125)"
core/commands/mount_unix.go,114,693,2,"[{'cyclomatic_complexity': 9, 'nloc': 41, 'token_count': 234, 'name': '', 'long_name': '(req cmds.Request,res cmds.Response)', 'start_line': 77, 'end_line': 125, 'full_parameters': [], 'filename': '/home/dimi/Documents/Informatik_Studium/FSS/SoftEvo/DataCollection/FFS_SoftEvo/go-ipfs/core/commands/mount_unix.go', 'top_nesting_level': 0, 'length': 49, 'fan_in': 0, 'fan_out': 0, 'general_fan_out': 0}, {'cyclomatic_complexity': 1, 'nloc': 6, 'token_count': 63, 'name': '', 'long_name': '(res cmds.Response)(io.Reader,error)', 'start_line': 128, 'end_line': 133, 'full_parameters': [], 'filename': '/home/dimi/Documents/Informatik_Studium/FSS/SoftEvo/DataCollection/FFS_SoftEvo/go-ipfs/core/commands/mount_unix.go', 'top_nesting_level': 0, 'length': 6, 'fan_in': 0, 'fan_out': 0, 'general_fan_out': 0}]",105,618,0,[],-9,-75,-2,54,54,"[{'timestamp': 1491058697.0, 'added_lines': 25, 'deleted_lines': 13, 'nloc': 123}, {'timestamp': 1511223906.0, 'added_lines': 1, 'deleted_lines': 1, 'nloc': 123}, {'timestamp': 1512365669.0, 'added_lines': 1, 'deleted_lines': 1, 'nloc': 123}, {'timestamp': 1511187070.0, 'added_lines': 1, 'deleted_lines': 1, 'nloc': 123}, {'timestamp': 1513436097.0, 'added_lines': 1, 'deleted_lines': 1, 'nloc': 123}, {'timestamp': 1513612261.0, 'added_lines': 1, 'deleted_lines': 1, 'nloc': 123}, {'timestamp': 1515277696.0, 'added_lines': 1, 'deleted_lines': 1, 'nloc': 123}, {'timestamp': 1517297046.0, 'added_lines': 1, 'deleted_lines': 1, 'nloc': 123}, {'timestamp': 1521427288.0, 'added_lines': 2, 'deleted_lines': 2, 'nloc': 123}, {'timestamp': 1527086998.0, 'added_lines': 1, 'deleted_lines': 2, 'nloc': 123}, {'timestamp': 1528520460.0, 'added_lines': 1, 'deleted_lines': 1, 'nloc': 123}, {'timestamp': 1532357069.0, 'added_lines': 1, 'deleted_lines': 1, 'nloc': 123}, {'timestamp': 1532365899.0, 'added_lines': 1, 'deleted_lines': 1, 'nloc': 123}, {'timestamp': 1532388583.0, 'added_lines': 1, 'deleted_lines': 1, 'nloc': 123}, {'timestamp': 1533809170.0, 'added_lines': 1, 'deleted_lines': 1, 'nloc': 123}, {'timestamp': 1533946888.0, 'added_lines': 1, 'deleted_lines': 1, 'nloc': 123}, {'timestamp': 1534072974.0, 'added_lines': 1, 'deleted_lines': 1, 'nloc': 123}, {'timestamp': 1534896611.0, 'added_lines': 2, 'deleted_lines': 2, 'nloc': 123}, {'timestamp': 1534903410.0, 'added_lines': 1, 'deleted_lines': 1, 'nloc': 123}, {'timestamp': 1535255498.0, 'added_lines': 1, 'deleted_lines': 1, 'nloc': 123}, {'timestamp': 1535601896.0, 'added_lines': 1, 'deleted_lines': 1, 'nloc': 123}, {'timestamp': 1536388808.0, 'added_lines': 1, 'deleted_lines': 1, 'nloc': 123}, {'timestamp': 1537792589.0, 'added_lines': 1, 'deleted_lines': 1, 'nloc': 123}, {'timestamp': 1538544957.0, 'added_lines': 1, 'deleted_lines': 1, 'nloc': 123}, {'timestamp': 1538547366.0, 'added_lines': 1, 'deleted_lines': 1, 'nloc': 123}, {'timestamp': 1539850591.0, 'added_lines': 1, 'deleted_lines': 1, 'nloc': 123}, {'timestamp': 1540400358.0, 'added_lines': 1, 'deleted_lines': 1, 'nloc': 123}, {'timestamp': 1540489644.0, 'added_lines': 1, 'deleted_lines': 1, 'nloc': 123}, {'timestamp': 1541204121.0, 'added_lines': 1, 'deleted_lines': 1, 'nloc': 123}, {'timestamp': 1540568587.0, 'added_lines': 21, 'deleted_lines': 43, 'nloc': 103}, {'timestamp': 1540951823.0, 'added_lines': 12, 'deleted_lines': 7, 'nloc': 107}, {'timestamp': 1541470705.0, 'added_lines': 4, 'deleted_lines': 4, 'nloc': 106}, {'timestamp': 1543282933.0, 'added_lines': 1, 'deleted_lines': 1, 'nloc': 106}, {'timestamp': 1544225843.0, 'added_lines': 1, 'deleted_lines': 1, 'nloc': 106}, {'timestamp': 1544661332.0, 'added_lines': 1, 'deleted_lines': 1, 'nloc': 106}, {'timestamp': 1540556089.0, 'added_lines': 1, 'deleted_lines': 1, 'nloc': 106}, {'timestamp': 1545323704.0, 'added_lines': 1, 'deleted_lines': 1, 'nloc': 106}, {'timestamp': 1546553605.0, 'added_lines': 1, 'deleted_lines': 1, 'nloc': 106}, {'timestamp': 1547003974.0, 'added_lines': 1, 'deleted_lines': 1, 'nloc': 106}, {'timestamp': 1547152271.0, 'added_lines': 1, 'deleted_lines': 1, 'nloc': 106}, {'timestamp': 1548866534.0, 'added_lines': 1, 'deleted_lines': 1, 'nloc': 106}, {'timestamp': 1549588289.0, 'added_lines': 1, 'deleted_lines': 1, 'nloc': 106}, {'timestamp': 1549903582.0, 'added_lines': 1, 'deleted_lines': 1, 'nloc': 106}, {'timestamp': 1550507829.0, 'added_lines': 2, 'deleted_lines': 2, 'nloc': 106}, {'timestamp': 1550610741.0, 'added_lines': 1, 'deleted_lines': 1, 'nloc': 106}, {'timestamp': 1551138343.0, 'added_lines': 1, 'deleted_lines': 1, 'nloc': 106}, {'timestamp': 1551229859.0, 'added_lines': 1, 'deleted_lines': 1, 'nloc': 106}, {'timestamp': 1551299964.0, 'added_lines': 1, 'deleted_lines': 1, 'nloc': 106}, {'timestamp': 1551471469.0, 'added_lines': 1, 'deleted_lines': 1, 'nloc': 106}, {'timestamp': 1551754781.0, 'added_lines': 1, 'deleted_lines': 1, 'nloc': 106}, {'timestamp': 1551551196.0, 'added_lines': 3, 'deleted_lines': 3, 'nloc': 106}, {'timestamp': 1557554420.0, 'added_lines': 4, 'deleted_lines': 5, 'nloc': 105}, {'timestamp': 1577243561.0, 'added_lines': 1, 'deleted_lines': 1, 'nloc': 105}, {'timestamp': 1608253728.0, 'added_lines': 2, 'deleted_lines': 2, 'nloc': 105}]","{'blocks/blockstore/caching.go': 1, 'blocks/blockstore/util/remove.go': 2, 'cmd/ipfs/daemon.go': 30, 'cmd/ipfs/init.go': 45, 'cmd/ipfs/ipfs.go': 23, 'cmd/ipfs/main.go': 45, 'cmd/ipfs/main_test.go': 4, 'cmd/ipfswatch/main.go': 31, 'cmd/seccat/seccat.go': 18, None: 13, 'commands/channelmarshaler.go': 1, 'commands/cli/cmd_suggestion.go': 1, 'commands/cli/helptext.go': 2, 'commands/cli/helptext_test.go': 2, 'commands/cli/parse.go': 2, 'commands/cli/parse_test.go': 2, 'commands/command.go': 13, 'commands/command_test.go': 7, 'commands/http/client.go': 2, 'commands/http/handler.go': 2, 'commands/http/multifilereader.go': 2, 'commands/http/multifilereader_test.go': 2, 'commands/http/parse.go': 2, 'commands/reqlog.go': 1, 'commands/request.go': 27, 'commands/response.go': 11, 'commands/response_test.go': 7, 'core/bootstrap.go': 28, 'core/commands/active.go': 24, 'core/commands/add.go': 32, 'core/commands/bitswap.go': 35, 'core/commands/block.go': 28, 'core/commands/bootstrap.go': 44, 'core/commands/cat.go': 27, 'core/commands/commands.go': 25, 'core/commands/config.go': 46, 'core/commands/dag/dag.go': 34, 'core/commands/dht.go': 35, 'core/commands/diag.go': 24, 'core/commands/dns.go': 27, 'core/commands/e/error.go': 1, 'core/commands/external.go': 23, 'core/commands/files/files.go': 7, 'core/commands/filestore.go': 26, 'core/commands/get.go': 33, 'core/commands/helptext_test.go': 23, 'core/commands/id.go': 34, 'core/commands/ipns.go': 10, 'core/commands/keystore.go': 28, 'core/commands/log.go': 26, 'core/commands/ls.go': 33, 'core/commands/mount_nofuse.go': 25, 'core/commands/mount_windows.go': 23, 'core/commands/name.go': 10, 'core/commands/object/diff.go': 25, 'core/commands/object/object.go': 35, 'core/commands/object/patch.go': 27, 'core/commands/p2p.go': 33, 'core/commands/pin.go': 34, 'core/commands/ping.go': 34, 'core/commands/publish.go': 10, 'core/commands/pubsub.go': 31, 'core/commands/refs.go': 34, 'core/commands/repo.go': 45, 'core/commands/resolve.go': 34, 'core/commands/root.go': 27, 'core/commands/shutdown.go': 27, 'core/commands/stat.go': 31, 'core/commands/swarm.go': 45, 'core/commands/sysdiag.go': 31, 'core/commands/tar.go': 33, 'core/commands/unixfs/ls.go': 34, 'core/commands/unixfs/unixfs.go': 23, 'core/commands/version.go': 26, 'core/core_test.go': 24, 'core/corehttp/commands.go': 43, 'core/corehttp/gateway.go': 21, 'core/coreunix/add.go': 27, 'core/coreunix/add_test.go': 37, 'core/coreunix/metadata_test.go': 22, 'exchange/bitswap/bitswap_test.go': 4, 'exchange/bitswap/decision/engine_test.go': 4, 'exchange/bitswap/message/message_test.go': 3, 'exchange/bitswap/message/pb/Makefile': 1, 'exchange/bitswap/testnet/network_test.go': 4, 'exchange/bitswap/testnet/peernet.go': 4, 'exchange/reprovide/reprovide_test.go': 17, 'fuse/ipns/common.go': 20, 'fuse/node/mount_test.go': 17, 'importer/balanced/balanced_test.go': 3, 'importer/chunk/rabin_test.go': 2, 'importer/helpers/dagbuilder.go': 9, 'importer/importer.go': 8, 'merkledag/utils/utils_test.go': 3, 'mfs/repub_test.go': 4, 'namesys/dns.go': 16, 'namesys/interface.go': 16, 'namesys/ipns_select_test.go': 3, 'namesys/proquint.go': 16, 'namesys/republisher/repub_test.go': 18, 'package.json': 42, 'repo/config/identity.go': 1, 'routing/offline/offline_test.go': 3, 'test/integration/addcat_test.go': 21, 'test/integration/bench_cat_test.go': 20, 'test/integration/bitswap_wo_routing_test.go': 18, 'test/integration/three_legged_cat_test.go': 20, 'core/bootstrap_test.go': 26, 'core/commands/dht_test.go': 15, 'core/commands/get_test.go': 24, 'core/core.go': 34, 'core/corehttp/gateway_test.go': 29, 'core/corehttp/metrics_test.go': 17, 'core/mock/mock.go': 27, 'exchange/bitswap/decision/bench_test.go': 3, 'exchange/bitswap/decision/peer_request_queue_test.go': 3, 'exchange/bitswap/message/message.go': 3, 'exchange/bitswap/network/interface.go': 3, 'exchange/bitswap/network/ipfs_impl.go': 3, 'exchange/bitswap/testnet/interface.go': 3, 'exchange/bitswap/testnet/virtual.go': 3, 'exchange/bitswap/testutils.go': 3, 'fuse/ipns/ipns_test.go': 16, 'fuse/readonly/ipfs_test.go': 22, 'namesys/publisher_test.go': 16, 'namesys/resolve_test.go': 17, 'p2p/p2p.go': 16, 'p2p/registry.go': 6, 'repo/config/bootstrap_peers.go': 3, 'routing/mock/centralized_client.go': 2, 'routing/mock/centralized_server.go': 2, 'routing/mock/centralized_test.go': 2, 'routing/mock/interface.go': 2, 'routing/none/none_client.go': 2, 'test/integration/bench_test.go': 13, 'assets/assets.go': 20, 'blocks/blockstore/arc_cache.go': 1, 'blocks/blockstore/arc_cache_test.go': 1, 'blocks/blockstore/blockstore.go': 1, 'blocks/blockstore/blockstore_test.go': 1, 'blocks/blockstore/bloom_cache.go': 1, 'blocks/blockstore/bloom_cache_test.go': 1, 'blocks/blocksutil/block_generator.go': 1, 'blockservice/blockservice.go': 2, 'blockservice/blockservice_test.go': 2, 'blockservice/test/blocks_test.go': 2, 'core/builder.go': 34, 'core/commands/ipnsps.go': 7, 'core/coreapi/coreapi.go': 14, 'core/coreapi/interface/interface.go': 1, 'core/coreapi/unixfs.go': 22, 'core/coreapi/unixfs_test.go': 22, 'core/coredag/cbor.go': 6, 'core/coredag/dagpb.go': 16, 'core/coredag/dagtransl.go': 6, 'core/coredag/raw.go': 16, 'core/corehttp/corehttp.go': 9, 'core/corehttp/gateway_handler.go': 23, 'core/corerepo/gc.go': 21, 'core/corerepo/pinning.go': 9, 'core/coreunix/metadata.go': 21, 'core/pathresolver.go': 17, 'exchange/bitswap/bitswap.go': 3, 'exchange/bitswap/decision/engine.go': 2, 'exchange/bitswap/decision/ledger.go': 3, 'exchange/bitswap/decision/peer_request_queue.go': 2, 'exchange/bitswap/get.go': 2, 'exchange/bitswap/notifications/notifications.go': 2, 'exchange/bitswap/notifications/notifications_test.go': 2, 'exchange/bitswap/session.go': 2, 'exchange/bitswap/session_test.go': 2, 'exchange/bitswap/stat.go': 2, 'exchange/bitswap/wantlist/wantlist.go': 2, 'exchange/bitswap/wantlist/wantlist_test.go': 2, 'exchange/bitswap/wantmanager.go': 2, 'exchange/bitswap/workers.go': 2, 'exchange/interface.go': 1, 'exchange/offline/offline.go': 1, 'exchange/offline/offline_test.go': 1, 'exchange/reprovide/providers.go': 16, 'exchange/reprovide/reprovide.go': 14, 'filestore/filestore.go': 9, 'filestore/filestore_test.go': 16, 'filestore/fsrefstore.go': 9, 'filestore/util.go': 9, 'fuse/ipns/ipns_unix.go': 21, 'fuse/readonly/readonly_unix.go': 21, 'importer/balanced/builder.go': 2, 'importer/chunk/splitting_test.go': 1, 'importer/helpers/helpers.go': 2, 'importer/importer_test.go': 2, 'importer/trickle/trickle_test.go': 2, 'importer/trickle/trickledag.go': 3, 'merkledag/batch.go': 1, 'merkledag/coding.go': 2, 'merkledag/merkledag.go': 2, 'merkledag/merkledag_test.go': 2, 'merkledag/node.go': 2, 'merkledag/node_test.go': 2, 'merkledag/raw.go': 3, 'merkledag/traverse/traverse.go': 2, 'merkledag/traverse/traverse_test.go': 2, 'merkledag/utils/diff.go': 2, 'merkledag/utils/diffenum.go': 2, 'merkledag/utils/diffenum_test.go': 2, 'merkledag/utils/utils.go': 2, 'mfs/dir.go': 3, 'mfs/file.go': 3, 'mfs/mfs_test.go': 3, 'mfs/ops.go': 2, 'mfs/system.go': 3, 'namesys/namesys.go': 17, 'namesys/publisher.go': 21, 'namesys/pubsub.go': 2, 'namesys/pubsub_test.go': 1, 'namesys/republisher/repub.go': 16, 'namesys/routing.go': 17, 'path/path.go': 2, 'path/resolver.go': 1, 'path/resolver_test.go': 1, 'pin/gc/gc.go': 16, 'pin/pin.go': 17, 'pin/pin_test.go': 16, 'pin/set.go': 17, 'pin/set_test.go': 16, 'plugin/ipld.go': 5, 'plugin/loader/initializer.go': 4, 'plugin/plugins/git/git.go': 5, 'repo/config/init.go': 2, 'repo/fsrepo/fsrepo.go': 27, 'repo/fsrepo/lock/lock.go': 1, 'repo/fsrepo/serialize/serialize.go': 2, 'repo/mock.go': 26, 'repo/repo.go': 26, 'routing/offline/offline.go': 1, 'tar/format.go': 21, 'test/dependencies/ma-pipe-unidir/main.go': 7, 'thirdparty/ds-help/key.go': 1, 'thirdparty/pollEndpoint/main.go': 9, 'thirdparty/posinfo/posinfo.go': 1, 'unixfs/archive/archive.go': 2, 'unixfs/archive/tar/writer.go': 2, 'unixfs/hamt/hamt.go': 2, 'unixfs/io/dagreader.go': 2, 'unixfs/io/dirbuilder.go': 2, 'unixfs/io/resolve.go': 2, 'unixfs/mod/dagmodifier.go': 3, 'unixfs/mod/dagmodifier_test.go': 2, 'unixfs/test/utils.go': 2, 'commands/legacy/command.go': 9, 'commands/legacy/legacy.go': 9, 'commands/legacy/legacy_test.go': 10, 'commands/legacy/request.go': 10, 'commands/legacy/response.go': 10, 'commands/legacy/responseemitter.go': 4, 'core/commands/env.go': 8, 'TODO.md': 2, 'core/commands/commands_test.go': 19, 'test/sharness/t0110-gateway.sh': 1, 'test/sharness/t0410-api-add.sh': 1, 'CHANGELOG.md': 1, 'README.md': 2, 'bin/dist_get': 1, 'cmd/ipfs/util/ulimit_freebsd.go': 3, 'contribute.md': 1, 'core/coreapi/interface/options/pin.go': 1, 'docs/experimental-features.md': 1, 'docs/file-transfer.md': 1, 'docs/releases.md': 2, 'exchange/bitswap/README.md': 1, 'plugin/plugin.go': 1, 'repo/fsrepo/migrations/mfsr_test.go': 1, 'repo/fsrepo/migrations/migrations.go': 1, 'test/sharness/README.md': 2, 'thirdparty/dir/dir.go': 1, 'fuse/node/mount_nofuse.go': 1, 'fuse/node/mount_unix.go': 7, 'blocks/blockstoreutil/remove.go': 8, 'blockservice/test/mock.go': 1, 'cmd/ipfs/util/ulimit.go': 5, 'cmd/ipfs/util/ulimit_unix.go': 2, 'cmd/seccat/util.go': 5, 'core/commands/files.go': 27, 'core/coreapi/block.go': 8, 'core/coreapi/block_test.go': 2, 'core/coreapi/dag.go': 4, 'core/coreapi/dag_test.go': 2, 'core/coreapi/interface/coreapi.go': 3, 'core/coreapi/interface/dag.go': 3, 'core/coreapi/interface/object.go': 3, 'core/coreapi/interface/options/block.go': 2, 'core/coreapi/interface/options/dag.go': 3, 'core/coreapi/interface/path.go': 11, 'core/coreapi/interface/unixfs.go': 7, 'core/coreapi/key.go': 16, 'core/coreapi/name.go': 16, 'core/coreapi/object.go': 21, 'core/coreapi/pin.go': 16, 'core/corehttp/logs.go': 5, 'fuse/ipns/link_unix.go': 2, 'fuse/mount/fuse.go': 2, 'fuse/mount/mount.go': 5, 'fuse/node/mount_darwin.go': 2, 'keystore/keystore.go': 5, 'merkledag/errservice.go': 1, 'merkledag/readonly.go': 1, 'merkledag/readonly_test.go': 1, 'merkledag/rwservice.go': 1, 'merkledag/session.go': 1, 'merkledag/test/utils.go': 1, 'namesys/ipns_validate_test.go': 1, 'namesys/namesys_test.go': 20, 'namesys/validator.go': 1, 'path/resolver/resolver.go': 1, 'path/resolver/resolver_test.go': 1, 'plugin/loader/load.go': 3, 'repo/fsrepo/datastores.go': 7, 'thirdparty/verifbs/verifbs.go': 8, 'thirdparty/verifcid/validate.go': 1, 'thirdparty/verifcid/validate_test.go': 1, 'unixfs/hamt/hamt_stress_test.go': 1, 'unixfs/hamt/hamt_test.go': 1, 'unixfs/io/pbdagreader.go': 1, 'repo/fsrepo/misc.go': 24, 'cmd/ipfs/Rules.mk': 1, 'core/corehttp/option_test.go': 1, 'docs/windows.md': 1, 'repo/fsrepo/config_test.go': 23, 'repo/fsrepo/fsrepo_test.go': 23, 'repo/version.go': 1, 'test/bench/bench_cli_ipfs_add/main.go': 24, 'test/bench/offline_add/main.go': 24, 'core/commands/urlstore.go': 26, 'core/coreapi/path.go': 19, 'core/coreunix/cat.go': 5, 'mfs/fd.go': 1, 'core/coreapi/interface/key.go': 6, 'core/coreapi/name_test.go': 10, 'core/pathresolver_test.go': 14, 'dagutils/diff.go': 15, 'dagutils/diffenum.go': 14, 'dagutils/diffenum_test.go': 14, 'dagutils/utils.go': 14, 'dagutils/utils_test.go': 14, 'namesys/base.go': 15, 'namesys/cache.go': 14, 'namesys/ipns_resolver_validation_test.go': 15, 'thirdparty/cidv0v1/blockstore.go': 7, 'core/commands/cmdenv/env.go': 30, 'core/commands/name/ipns.go': 24, 'core/commands/name/ipnsps.go': 20, 'core/commands/name/name.go': 16, 'core/commands/name/publish.go': 21, 'core/coreapi/dht.go': 12, 'core/coreapi/dht_test.go': 4, 'core/coreapi/interface/dht.go': 7, 'p2p/listener.go': 10, 'p2p/local.go': 10, 'p2p/remote.go': 10, 'p2p/stream.go': 10, 'core/coreapi/interface/swarm.go': 6, 'core/coreapi/swarm.go': 11, 'core/commands/cid.go': 14, 'core/coreapi/unixfile.go': 6, 'cmd/ipfs/dnsresolve_test.go': 5, 'core/coreapi/interface/options/unixfs.go': 5, 'core/coreapi/interface/pubsub.go': 4, 'core/coreapi/pubsub.go': 11, 'test/sharness/t0180-pubsub.sh': 1, 'keystore/keystore_test.go': 3, 'keystore/memkeystore.go': 3, 'test/dependencies/iptb/iptb.go': 11, 'commands/context.go': 17, 'core/corehttp/proxy.go': 7, 'core/coreapi/test/api_test.go': 8, 'core/coreapi/interface/tests/name.go': 3, 'core/coreapi/interface/tests/unixfs.go': 3, 'core/commands/cmdenv/cidbase.go': 9, 'core/commands/cmdenv/file.go': 3, 'core/corehttp/ipns_hostname.go': 5, 'namesys/dns_test.go': 5, 'plugin/daemon.go': 5, 'plugin/loader/loader.go': 5, 'filestore/pb/dataobj.pb.go': 2, 'pin/internal/pb/header.pb.go': 2, 'plugin/plugins/badgerds/badgerds.go': 3, 'plugin/plugins/flatfs/flatfs.go': 3, 'plugin/plugins/levelds/levelds.go': 2, 'core/corerepo/stat.go': 2, 'core/commands/cmdenv/cidbase_test.go': 1, 'core/corehttp/metrics.go': 1, 'core/corehttp/proxy_test.go': 1, 'plugin/tracer.go': 1, 'thirdparty/notifier/notifier.go': 1, 'go.mod': 1, 'go.sum': 1, 'package-list.json': 1, 'mk/util.mk': 1, 'test/sharness/t0040-add-and-cat.sh': 1, 'test/sharness/t0175-reprovider.sh': 1, 'test/sharness/t0184-http-proxy-over-p2p.sh': 1, 'test/sharness/t0272-urlstore.sh': 1, 'core/commands/pin/remotepin.go': 1}","('core/commands/config.go', 0.8518518518518519, 0.5679012345679012)"
core/commands/mount_windows.go,14,65,1,"[{'cyclomatic_complexity': 1, 'nloc': 3, 'token_count': 29, 'name': '', 'long_name': '(req cmds.Request,res cmds.Response)', 'start_line': 15, 'end_line': 17, 'full_parameters': [], 'filename': '/home/dimi/Documents/Informatik_Studium/FSS/SoftEvo/DataCollection/FFS_SoftEvo/go-ipfs/core/commands/mount_windows.go', 'top_nesting_level': 0, 'length': 3, 'fan_in': 0, 'fan_out': 0, 'general_fan_out': 0}]",14,64,0,[],0,-1,-1,29,29,"[{'timestamp': 1491058697.0, 'added_lines': 4, 'deleted_lines': 2, 'nloc': 15}, {'timestamp': 1511070510.0, 'added_lines': 2, 'deleted_lines': 2, 'nloc': 15}, {'timestamp': 1499441579.0, 'added_lines': 1, 'deleted_lines': 1, 'nloc': 15}, {'timestamp': 1511548622.0, 'added_lines': 1, 'deleted_lines': 1, 'nloc': 15}, {'timestamp': 1512365669.0, 'added_lines': 1, 'deleted_lines': 1, 'nloc': 15}, {'timestamp': 1511187070.0, 'added_lines': 1, 'deleted_lines': 1, 'nloc': 15}, {'timestamp': 1513436097.0, 'added_lines': 1, 'deleted_lines': 1, 'nloc': 15}, {'timestamp': 1513612261.0, 'added_lines': 1, 'deleted_lines': 1, 'nloc': 15}, {'timestamp': 1515277696.0, 'added_lines': 1, 'deleted_lines': 1, 'nloc': 15}, {'timestamp': 1528520460.0, 'added_lines': 1, 'deleted_lines': 1, 'nloc': 15}, {'timestamp': 1533946888.0, 'added_lines': 1, 'deleted_lines': 1, 'nloc': 15}, {'timestamp': 1534896611.0, 'added_lines': 1, 'deleted_lines': 1, 'nloc': 15}, {'timestamp': 1539850591.0, 'added_lines': 1, 'deleted_lines': 1, 'nloc': 15}, {'timestamp': 1540569270.0, 'added_lines': 1, 'deleted_lines': 2, 'nloc': 15}, {'timestamp': 1540572903.0, 'added_lines': 3, 'deleted_lines': 3, 'nloc': 15}, {'timestamp': 1540619689.0, 'added_lines': 1, 'deleted_lines': 1, 'nloc': 15}, {'timestamp': 1540951823.0, 'added_lines': 1, 'deleted_lines': 1, 'nloc': 15}, {'timestamp': 1544661332.0, 'added_lines': 1, 'deleted_lines': 1, 'nloc': 15}, {'timestamp': 1540556089.0, 'added_lines': 1, 'deleted_lines': 1, 'nloc': 15}, {'timestamp': 1547152271.0, 'added_lines': 1, 'deleted_lines': 1, 'nloc': 15}, {'timestamp': 1548866534.0, 'added_lines': 1, 'deleted_lines': 1, 'nloc': 15}, {'timestamp': 1549903582.0, 'added_lines': 1, 'deleted_lines': 1, 'nloc': 15}, {'timestamp': 1550507829.0, 'added_lines': 1, 'deleted_lines': 1, 'nloc': 15}, {'timestamp': 1550610741.0, 'added_lines': 1, 'deleted_lines': 1, 'nloc': 15}, {'timestamp': 1551138343.0, 'added_lines': 1, 'deleted_lines': 1, 'nloc': 15}, {'timestamp': 1551299964.0, 'added_lines': 1, 'deleted_lines': 1, 'nloc': 15}, {'timestamp': 1551471469.0, 'added_lines': 1, 'deleted_lines': 1, 'nloc': 15}, {'timestamp': 1551551196.0, 'added_lines': 2, 'deleted_lines': 2, 'nloc': 15}, {'timestamp': 1557554420.0, 'added_lines': 1, 'deleted_lines': 2, 'nloc': 14}]","{'blocks/blockstore/caching.go': 1, 'blocks/blockstore/util/remove.go': 2, 'cmd/ipfs/daemon.go': 23, 'cmd/ipfs/init.go': 22, 'cmd/ipfs/ipfs.go': 20, 'cmd/ipfs/main.go': 21, 'cmd/ipfs/main_test.go': 3, 'cmd/ipfswatch/main.go': 9, 'cmd/seccat/seccat.go': 6, None: 13, 'commands/channelmarshaler.go': 1, 'commands/cli/cmd_suggestion.go': 1, 'commands/cli/helptext.go': 1, 'commands/cli/helptext_test.go': 1, 'commands/cli/parse.go': 1, 'commands/cli/parse_test.go': 1, 'commands/command.go': 10, 'commands/command_test.go': 6, 'commands/http/client.go': 1, 'commands/http/handler.go': 1, 'commands/http/multifilereader.go': 1, 'commands/http/multifilereader_test.go': 1, 'commands/http/parse.go': 1, 'commands/reqlog.go': 1, 'commands/request.go': 10, 'commands/response.go': 10, 'commands/response_test.go': 6, 'core/bootstrap.go': 6, 'core/commands/active.go': 25, 'core/commands/add.go': 22, 'core/commands/bitswap.go': 22, 'core/commands/block.go': 22, 'core/commands/bootstrap.go': 22, 'core/commands/cat.go': 22, 'core/commands/commands.go': 22, 'core/commands/config.go': 23, 'core/commands/dag/dag.go': 22, 'core/commands/dht.go': 22, 'core/commands/diag.go': 25, 'core/commands/dns.go': 22, 'core/commands/e/error.go': 1, 'core/commands/external.go': 22, 'core/commands/files/files.go': 6, 'core/commands/filestore.go': 22, 'core/commands/get.go': 22, 'core/commands/helptext_test.go': 20, 'core/commands/id.go': 22, 'core/commands/ipns.go': 9, 'core/commands/keystore.go': 22, 'core/commands/log.go': 24, 'core/commands/ls.go': 22, 'core/commands/mount_nofuse.go': 26, 'core/commands/mount_unix.go': 23, 'core/commands/name.go': 10, 'core/commands/object/diff.go': 22, 'core/commands/object/object.go': 22, 'core/commands/object/patch.go': 22, 'core/commands/p2p.go': 22, 'core/commands/pin.go': 22, 'core/commands/ping.go': 22, 'core/commands/publish.go': 9, 'core/commands/pubsub.go': 22, 'core/commands/refs.go': 22, 'core/commands/repo.go': 22, 'core/commands/resolve.go': 22, 'core/commands/root.go': 23, 'core/commands/shutdown.go': 22, 'core/commands/stat.go': 22, 'core/commands/swarm.go': 22, 'core/commands/sysdiag.go': 23, 'core/commands/tar.go': 22, 'core/commands/unixfs/ls.go': 22, 'core/commands/unixfs/unixfs.go': 22, 'core/commands/version.go': 22, 'core/core_test.go': 4, 'core/corehttp/commands.go': 21, 'core/corehttp/gateway.go': 8, 'core/coreunix/add.go': 16, 'core/coreunix/add_test.go': 16, 'core/coreunix/metadata_test.go': 12, 'exchange/bitswap/bitswap_test.go': 3, 'exchange/bitswap/decision/engine_test.go': 3, 'exchange/bitswap/message/message_test.go': 3, 'exchange/bitswap/message/pb/Makefile': 1, 'exchange/bitswap/testnet/network_test.go': 3, 'exchange/bitswap/testnet/peernet.go': 3, 'exchange/reprovide/reprovide_test.go': 6, 'fuse/ipns/common.go': 10, 'fuse/node/mount_test.go': 6, 'importer/balanced/balanced_test.go': 3, 'importer/chunk/rabin_test.go': 2, 'importer/helpers/dagbuilder.go': 7, 'importer/importer.go': 7, 'merkledag/utils/utils_test.go': 3, 'mfs/repub_test.go': 3, 'namesys/dns.go': 6, 'namesys/interface.go': 7, 'namesys/ipns_select_test.go': 3, 'namesys/proquint.go': 6, 'namesys/republisher/repub_test.go': 7, 'package.json': 20, 'repo/config/identity.go': 1, 'routing/offline/offline_test.go': 2, 'test/integration/addcat_test.go': 10, 'test/integration/bench_cat_test.go': 9, 'test/integration/bitswap_wo_routing_test.go': 7, 'test/integration/three_legged_cat_test.go': 9, 'core/builder.go': 12, 'core/commands/ipnsps.go': 8, 'core/core.go': 12, 'core/corehttp/gateway_test.go': 9, 'namesys/namesys.go': 8, 'namesys/namesys_test.go': 11, 'namesys/pubsub.go': 2, 'namesys/pubsub_test.go': 2, 'test/sharness/t0183-namesys-pubsub.sh': 1, 'assets/assets.go': 11, 'blocks/blockstore/arc_cache.go': 1, 'blocks/blockstore/arc_cache_test.go': 1, 'blocks/blockstore/blockstore.go': 1, 'blocks/blockstore/blockstore_test.go': 1, 'blocks/blockstore/bloom_cache.go': 1, 'blocks/blockstore/bloom_cache_test.go': 1, 'blocks/blocksutil/block_generator.go': 1, 'blockservice/blockservice.go': 2, 'blockservice/blockservice_test.go': 2, 'blockservice/test/blocks_test.go': 2, 'core/bootstrap_test.go': 5, 'core/commands/dht_test.go': 5, 'core/commands/get_test.go': 21, 'core/coreapi/coreapi.go': 6, 'core/coreapi/interface/interface.go': 1, 'core/coreapi/unixfs.go': 12, 'core/coreapi/unixfs_test.go': 6, 'core/coredag/cbor.go': 4, 'core/coredag/dagpb.go': 6, 'core/coredag/dagtransl.go': 4, 'core/coredag/raw.go': 6, 'core/corehttp/corehttp.go': 4, 'core/corehttp/gateway_handler.go': 12, 'core/corehttp/metrics_test.go': 6, 'core/corerepo/gc.go': 11, 'core/corerepo/pinning.go': 4, 'core/coreunix/metadata.go': 11, 'core/mock/mock.go': 6, 'core/pathresolver.go': 6, 'exchange/bitswap/bitswap.go': 2, 'exchange/bitswap/decision/bench_test.go': 2, 'exchange/bitswap/decision/engine.go': 2, 'exchange/bitswap/decision/ledger.go': 2, 'exchange/bitswap/decision/peer_request_queue.go': 2, 'exchange/bitswap/decision/peer_request_queue_test.go': 2, 'exchange/bitswap/get.go': 2, 'exchange/bitswap/message/message.go': 2, 'exchange/bitswap/network/interface.go': 2, 'exchange/bitswap/network/ipfs_impl.go': 2, 'exchange/bitswap/notifications/notifications.go': 2, 'exchange/bitswap/notifications/notifications_test.go': 2, 'exchange/bitswap/session.go': 2, 'exchange/bitswap/session_test.go': 2, 'exchange/bitswap/stat.go': 2, 'exchange/bitswap/testnet/interface.go': 2, 'exchange/bitswap/testnet/virtual.go': 2, 'exchange/bitswap/testutils.go': 2, 'exchange/bitswap/wantlist/wantlist.go': 2, 'exchange/bitswap/wantlist/wantlist_test.go': 2, 'exchange/bitswap/wantmanager.go': 2, 'exchange/bitswap/workers.go': 2, 'exchange/interface.go': 1, 'exchange/offline/offline.go': 1, 'exchange/offline/offline_test.go': 1, 'exchange/reprovide/providers.go': 6, 'exchange/reprovide/reprovide.go': 5, 'filestore/filestore.go': 5, 'filestore/filestore_test.go': 6, 'filestore/fsrefstore.go': 5, 'filestore/util.go': 5, 'fuse/ipns/ipns_test.go': 5, 'fuse/ipns/ipns_unix.go': 11, 'fuse/readonly/ipfs_test.go': 11, 'fuse/readonly/readonly_unix.go': 11, 'importer/balanced/builder.go': 2, 'importer/chunk/splitting_test.go': 1, 'importer/helpers/helpers.go': 2, 'importer/importer_test.go': 2, 'importer/trickle/trickle_test.go': 2, 'importer/trickle/trickledag.go': 2, 'merkledag/batch.go': 1, 'merkledag/coding.go': 2, 'merkledag/merkledag.go': 2, 'merkledag/merkledag_test.go': 2, 'merkledag/node.go': 2, 'merkledag/node_test.go': 2, 'merkledag/raw.go': 2, 'merkledag/traverse/traverse.go': 2, 'merkledag/traverse/traverse_test.go': 2, 'merkledag/utils/diff.go': 2, 'merkledag/utils/diffenum.go': 2, 'merkledag/utils/diffenum_test.go': 2, 'merkledag/utils/utils.go': 2, 'mfs/dir.go': 3, 'mfs/file.go': 3, 'mfs/mfs_test.go': 3, 'mfs/ops.go': 2, 'mfs/system.go': 3, 'namesys/publisher.go': 11, 'namesys/publisher_test.go': 5, 'namesys/republisher/repub.go': 6, 'namesys/resolve_test.go': 6, 'namesys/routing.go': 7, 'p2p/p2p.go': 5, 'p2p/registry.go': 3, 'path/path.go': 2, 'path/resolver.go': 1, 'path/resolver_test.go': 1, 'pin/gc/gc.go': 6, 'pin/pin.go': 6, 'pin/pin_test.go': 6, 'pin/set.go': 6, 'pin/set_test.go': 6, 'plugin/ipld.go': 4, 'plugin/loader/initializer.go': 3, 'plugin/plugins/git/git.go': 4, 'repo/config/bootstrap_peers.go': 2, 'repo/config/init.go': 2, 'repo/fsrepo/fsrepo.go': 5, 'repo/fsrepo/lock/lock.go': 1, 'repo/fsrepo/serialize/serialize.go': 2, 'repo/mock.go': 5, 'repo/repo.go': 5, 'routing/mock/centralized_client.go': 1, 'routing/mock/centralized_server.go': 1, 'routing/mock/centralized_test.go': 1, 'routing/mock/interface.go': 1, 'routing/none/none_client.go': 1, 'routing/offline/offline.go': 1, 'tar/format.go': 11, 'test/dependencies/ma-pipe-unidir/main.go': 3, 'test/integration/bench_test.go': 5, 'thirdparty/ds-help/key.go': 1, 'thirdparty/pollEndpoint/main.go': 4, 'thirdparty/posinfo/posinfo.go': 1, 'unixfs/archive/archive.go': 2, 'unixfs/archive/tar/writer.go': 2, 'unixfs/hamt/hamt.go': 2, 'unixfs/io/dagreader.go': 2, 'unixfs/io/dirbuilder.go': 2, 'unixfs/io/resolve.go': 2, 'unixfs/mod/dagmodifier.go': 2, 'unixfs/mod/dagmodifier_test.go': 2, 'unixfs/test/utils.go': 2, 'commands/legacy/command.go': 7, 'commands/legacy/legacy.go': 7, 'commands/legacy/legacy_test.go': 8, 'commands/legacy/request.go': 8, 'commands/legacy/response.go': 8, 'commands/legacy/responseemitter.go': 4, 'core/commands/env.go': 3, 'TODO.md': 2, 'core/commands/commands_test.go': 17, 'test/sharness/t0110-gateway.sh': 1, 'test/sharness/t0410-api-add.sh': 1, 'blocks/blockstoreutil/remove.go': 4, 'blockservice/test/mock.go': 1, 'cmd/ipfs/util/ulimit.go': 3, 'cmd/ipfs/util/ulimit_freebsd.go': 2, 'cmd/ipfs/util/ulimit_unix.go': 2, 'cmd/seccat/util.go': 3, 'core/commands/files.go': 16, 'core/coreapi/block.go': 6, 'core/coreapi/block_test.go': 1, 'core/coreapi/dag.go': 3, 'core/coreapi/dag_test.go': 1, 'core/coreapi/interface/coreapi.go': 2, 'core/coreapi/interface/dag.go': 2, 'core/coreapi/interface/object.go': 2, 'core/coreapi/interface/options/block.go': 1, 'core/coreapi/interface/options/dag.go': 2, 'core/coreapi/interface/path.go': 2, 'core/coreapi/interface/unixfs.go': 5, 'core/coreapi/key.go': 6, 'core/coreapi/name.go': 6, 'core/coreapi/object.go': 10, 'core/coreapi/pin.go': 6, 'core/corehttp/logs.go': 3, 'fuse/ipns/link_unix.go': 2, 'fuse/mount/fuse.go': 2, 'fuse/mount/mount.go': 3, 'fuse/node/mount_darwin.go': 2, 'fuse/node/mount_unix.go': 3, 'keystore/keystore.go': 3, 'merkledag/errservice.go': 1, 'merkledag/readonly.go': 1, 'merkledag/readonly_test.go': 1, 'merkledag/rwservice.go': 1, 'merkledag/session.go': 1, 'merkledag/test/utils.go': 1, 'namesys/ipns_validate_test.go': 1, 'namesys/validator.go': 1, 'path/resolver/resolver.go': 1, 'path/resolver/resolver_test.go': 1, 'plugin/loader/load.go': 1, 'repo/fsrepo/datastores.go': 3, 'thirdparty/verifbs/verifbs.go': 4, 'thirdparty/verifcid/validate.go': 1, 'thirdparty/verifcid/validate_test.go': 1, 'unixfs/hamt/hamt_stress_test.go': 1, 'unixfs/hamt/hamt_test.go': 1, 'unixfs/io/pbdagreader.go': 1, 'core/commands/urlstore.go': 15, 'core/coreapi/path.go': 9, 'core/coreunix/cat.go': 2, 'mfs/fd.go': 1, 'core/coreapi/interface/key.go': 1, 'core/coreapi/name_test.go': 3, 'core/pathresolver_test.go': 4, 'dagutils/diff.go': 5, 'dagutils/diffenum.go': 4, 'dagutils/diffenum_test.go': 4, 'dagutils/utils.go': 4, 'dagutils/utils_test.go': 4, 'namesys/base.go': 5, 'namesys/cache.go': 4, 'namesys/ipns_resolver_validation_test.go': 5, 'repo/fsrepo/config_test.go': 3, 'repo/fsrepo/fsrepo_test.go': 3, 'repo/fsrepo/misc.go': 3, 'test/bench/bench_cli_ipfs_add/main.go': 4, 'test/bench/offline_add/main.go': 4, 'thirdparty/cidv0v1/blockstore.go': 3, 'core/commands/cid.go': 13, 'core/commands/cmdenv/env.go': 12, 'core/commands/name/ipns.go': 13, 'core/commands/name/ipnsps.go': 13, 'core/commands/name/name.go': 13, 'core/commands/name/publish.go': 13, 'core/coreapi/unixfile.go': 2, 'commands/context.go': 11, 'core/commands/cmdenv/cidbase.go': 9, 'core/commands/cmdenv/file.go': 3, 'core/coreapi/interface/tests/name.go': 1, 'core/coreapi/interface/tests/unixfs.go': 1, 'core/coreapi/dht.go': 4, 'core/coreapi/pubsub.go': 4, 'core/coreapi/swarm.go': 4, 'core/coreapi/test/api_test.go': 4, 'core/corehttp/ipns_hostname.go': 4, 'namesys/dns_test.go': 4, 'plugin/daemon.go': 4, 'plugin/loader/loader.go': 4, 'core/corehttp/proxy.go': 3, 'filestore/pb/dataobj.pb.go': 2, 'keystore/keystore_test.go': 2, 'keystore/memkeystore.go': 2, 'p2p/listener.go': 2, 'p2p/local.go': 2, 'p2p/remote.go': 2, 'p2p/stream.go': 2, 'pin/internal/pb/header.pb.go': 2, 'plugin/plugins/badgerds/badgerds.go': 3, 'plugin/plugins/flatfs/flatfs.go': 3, 'plugin/plugins/levelds/levelds.go': 2, 'test/dependencies/iptb/iptb.go': 3, 'core/corerepo/stat.go': 2, 'cmd/ipfs/dnsresolve_test.go': 1, 'core/commands/cmdenv/cidbase_test.go': 1, 'core/corehttp/metrics.go': 1, 'core/corehttp/proxy_test.go': 1, 'plugin/tracer.go': 1, 'thirdparty/notifier/notifier.go': 1, 'README.md': 1, 'go.mod': 1, 'go.sum': 1, 'package-list.json': 1}","('core/commands/mount_nofuse.go', 0.896551724137931, 0.896551724137931)"
core/commands/p2p.go,327,2012,9,"[{'cyclomatic_complexity': 3, 'nloc': 15, 'token_count': 96, 'name': '', 'long_name': '(req cmds.Request,res cmds.Response)', 'start_line': 94, 'end_line': 112, 'full_parameters': [], 'filename': '/home/dimi/Documents/Informatik_Studium/FSS/SoftEvo/DataCollection/FFS_SoftEvo/go-ipfs/core/commands/p2p.go', 'top_nesting_level': 0, 'length': 19, 'fan_in': 0, 'fan_out': 0, 'general_fan_out': 0}, {'cyclomatic_complexity': 3, 'nloc': 14, 'token_count': 124, 'name': '', 'long_name': '(res cmds.Response)(io.Reader,error)', 'start_line': 115, 'end_line': 130, 'full_parameters': [], 'filename': '/home/dimi/Documents/Informatik_Studium/FSS/SoftEvo/DataCollection/FFS_SoftEvo/go-ipfs/core/commands/p2p.go', 'top_nesting_level': 0, 'length': 16, 'fan_in': 0, 'fan_out': 0, 'general_fan_out': 0}, {'cyclomatic_complexity': 3, 'nloc': 19, 'token_count': 139, 'name': '', 'long_name': '(req cmds.Request,res cmds.Response)', 'start_line': 141, 'end_line': 165, 'full_parameters': [], 'filename': '/home/dimi/Documents/Informatik_Studium/FSS/SoftEvo/DataCollection/FFS_SoftEvo/go-ipfs/core/commands/p2p.go', 'top_nesting_level': 0, 'length': 25, 'fan_in': 0, 'fan_out': 0, 'general_fan_out': 0}, {'cyclomatic_complexity': 3, 'nloc': 14, 'token_count': 132, 'name': '', 'long_name': '(res cmds.Response)(io.Reader,error)', 'start_line': 168, 'end_line': 183, 'full_parameters': [], 'filename': '/home/dimi/Documents/Informatik_Studium/FSS/SoftEvo/DataCollection/FFS_SoftEvo/go-ipfs/core/commands/p2p.go', 'top_nesting_level': 0, 'length': 16, 'fan_in': 0, 'fan_out': 0, 'general_fan_out': 0}, {'cyclomatic_complexity': 5, 'nloc': 26, 'token_count': 170, 'name': '', 'long_name': '(req cmds.Request,res cmds.Response)', 'start_line': 200, 'end_line': 230, 'full_parameters': [], 'filename': '/home/dimi/Documents/Informatik_Studium/FSS/SoftEvo/DataCollection/FFS_SoftEvo/go-ipfs/core/commands/p2p.go', 'top_nesting_level': 0, 'length': 31, 'fan_in': 0, 'fan_out': 0, 'general_fan_out': 0}, {'cyclomatic_complexity': 6, 'nloc': 31, 'token_count': 211, 'name': '', 'long_name': '(req cmds.Request,res cmds.Response)', 'start_line': 250, 'end_line': 286, 'full_parameters': [], 'filename': '/home/dimi/Documents/Informatik_Studium/FSS/SoftEvo/DataCollection/FFS_SoftEvo/go-ipfs/core/commands/p2p.go', 'top_nesting_level': 0, 'length': 37, 'fan_in': 0, 'fan_out': 0, 'general_fan_out': 0}, {'cyclomatic_complexity': 8, 'nloc': 25, 'token_count': 142, 'name': '', 'long_name': '(req cmds.Request,res cmds.Response)', 'start_line': 299, 'end_line': 327, 'full_parameters': [], 'filename': '/home/dimi/Documents/Informatik_Studium/FSS/SoftEvo/DataCollection/FFS_SoftEvo/go-ipfs/core/commands/p2p.go', 'top_nesting_level': 0, 'length': 29, 'fan_in': 0, 'fan_out': 0, 'general_fan_out': 0}, {'cyclomatic_complexity': 9, 'nloc': 29, 'token_count': 168, 'name': '', 'long_name': '(req cmds.Request,res cmds.Response)', 'start_line': 340, 'end_line': 372, 'full_parameters': [], 'filename': '/home/dimi/Documents/Informatik_Studium/FSS/SoftEvo/DataCollection/FFS_SoftEvo/go-ipfs/core/commands/p2p.go', 'top_nesting_level': 0, 'length': 33, 'fan_in': 0, 'fan_out': 0, 'general_fan_out': 0}, {'cyclomatic_complexity': 5, 'nloc': 17, 'token_count': 97, 'name': 'getNode', 'long_name': 'getNode req cmds . Request', 'start_line': 375, 'end_line': 395, 'full_parameters': ['req cmds . Request'], 'filename': '/home/dimi/Documents/Informatik_Studium/FSS/SoftEvo/DataCollection/FFS_SoftEvo/go-ipfs/core/commands/p2p.go', 'top_nesting_level': 0, 'length': 21, 'fan_in': 0, 'fan_out': 0, 'general_fan_out': 0}]",454,2837,5,"[{'cyclomatic_complexity': 9, 'nloc': 40, 'token_count': 207, 'name': 'parseIpfsAddr', 'long_name': 'parseIpfsAddr addr string', 'start_line': 136, 'end_line': 179, 'full_parameters': ['addr string'], 'filename': '/home/dimi/Documents/Informatik_Studium/FSS/SoftEvo/DataCollection/FFS_SoftEvo/go-ipfs/core/commands/p2p.go', 'top_nesting_level': 0, 'length': 44, 'fan_in': 0, 'fan_out': 0, 'general_fan_out': 0}, {'cyclomatic_complexity': 3, 'nloc': 11, 'token_count': 63, 'name': '', 'long_name': '()(string,error)', 'start_line': 240, 'end_line': 251, 'full_parameters': [], 'filename': '/home/dimi/Documents/Informatik_Studium/FSS/SoftEvo/DataCollection/FFS_SoftEvo/go-ipfs/core/commands/p2p.go', 'top_nesting_level': 0, 'length': 12, 'fan_in': 0, 'fan_out': 0, 'general_fan_out': 0}, {'cyclomatic_complexity': 4, 'nloc': 15, 'token_count': 62, 'name': 'checkPort', 'long_name': 'checkPort target ma . Multiaddr', 'start_line': 238, 'end_line': 268, 'full_parameters': ['target ma . Multiaddr'], 'filename': '/home/dimi/Documents/Informatik_Studium/FSS/SoftEvo/DataCollection/FFS_SoftEvo/go-ipfs/core/commands/p2p.go', 'top_nesting_level': 0, 'length': 31, 'fan_in': 0, 'fan_out': 0, 'general_fan_out': 0}, {'cyclomatic_complexity': 1, 'nloc': 5, 'token_count': 74, 'name': 'forwardLocal', 'long_name': 'forwardLocal ctx context . Context , p * p2p . P2P , ps pstore . Peerstore , proto protocol . ID , bindAddr ma . Multiaddr , addr * peer . AddrInfo', 'start_line': 271, 'end_line': 276, 'full_parameters': ['ctx context . Context', ' p * p2p . P2P', ' ps pstore . Peerstore', ' proto protocol . ID', ' bindAddr ma . Multiaddr', ' addr * peer . AddrInfo'], 'filename': '/home/dimi/Documents/Informatik_Studium/FSS/SoftEvo/DataCollection/FFS_SoftEvo/go-ipfs/core/commands/p2p.go', 'top_nesting_level': 0, 'length': 6, 'fan_in': 0, 'fan_out': 0, 'general_fan_out': 0}, {'cyclomatic_complexity': 5, 'nloc': 17, 'token_count': 92, 'name': 'p2pGetNode', 'long_name': 'p2pGetNode env cmds . Environment', 'start_line': 541, 'end_line': 561, 'full_parameters': ['env cmds . Environment'], 'filename': '/home/dimi/Documents/Informatik_Studium/FSS/SoftEvo/DataCollection/FFS_SoftEvo/go-ipfs/core/commands/p2p.go', 'top_nesting_level': 0, 'length': 21, 'fan_in': 0, 'fan_out': 0, 'general_fan_out': 0}]",127,825,-4,79,79,"[{'timestamp': 1491058697.0, 'added_lines': 60, 'deleted_lines': 45, 'nloc': 340}, {'timestamp': 1499331469.0, 'added_lines': 4, 'deleted_lines': 4, 'nloc': 340}, {'timestamp': 1511223906.0, 'added_lines': 1, 'deleted_lines': 1, 'nloc': 340}, {'timestamp': 1512365669.0, 'added_lines': 2, 'deleted_lines': 2, 'nloc': 340}, {'timestamp': 1511187070.0, 'added_lines': 1, 'deleted_lines': 1, 'nloc': 340}, {'timestamp': 1513436097.0, 'added_lines': 1, 'deleted_lines': 1, 'nloc': 340}, {'timestamp': 1513612261.0, 'added_lines': 1, 'deleted_lines': 1, 'nloc': 340}, {'timestamp': 1515277696.0, 'added_lines': 1, 'deleted_lines': 1, 'nloc': 340}, {'timestamp': 1516838128.0, 'added_lines': 1, 'deleted_lines': 1, 'nloc': 340}, {'timestamp': 1528520460.0, 'added_lines': 2, 'deleted_lines': 2, 'nloc': 340}, {'timestamp': 1529984485.0, 'added_lines': 1, 'deleted_lines': 1, 'nloc': 340}, {'timestamp': 1533946888.0, 'added_lines': 1, 'deleted_lines': 1, 'nloc': 340}, {'timestamp': 1534896611.0, 'added_lines': 1, 'deleted_lines': 1, 'nloc': 340}, {'timestamp': 1534903410.0, 'added_lines': 1, 'deleted_lines': 1, 'nloc': 340}, {'timestamp': 1523023896.0, 'added_lines': 7, 'deleted_lines': 7, 'nloc': 340}, {'timestamp': 1523023188.0, 'added_lines': 6, 'deleted_lines': 6, 'nloc': 340}, {'timestamp': 1526046114.0, 'added_lines': 7, 'deleted_lines': 2, 'nloc': 344}, {'timestamp': 1526991661.0, 'added_lines': 1, 'deleted_lines': 1, 'nloc': 344}, {'timestamp': 1527080702.0, 'added_lines': 101, 'deleted_lines': 1, 'nloc': 420}, {'timestamp': 1527084631.0, 'added_lines': 16, 'deleted_lines': 14, 'nloc': 422}, {'timestamp': 1527088423.0, 'added_lines': 24, 'deleted_lines': 38, 'nloc': 411}, {'timestamp': 1527256479.0, 'added_lines': 66, 'deleted_lines': 162, 'nloc': 331}, {'timestamp': 1527342995.0, 'added_lines': 28, 'deleted_lines': 6, 'nloc': 350}, {'timestamp': 1527345138.0, 'added_lines': 6, 'deleted_lines': 6, 'nloc': 350}, {'timestamp': 1527952248.0, 'added_lines': 10, 'deleted_lines': 8, 'nloc': 351}, {'timestamp': 1527961276.0, 'added_lines': 6, 'deleted_lines': 5, 'nloc': 352}, {'timestamp': 1529278287.0, 'added_lines': 8, 'deleted_lines': 6, 'nloc': 353}, {'timestamp': 1529280310.0, 'added_lines': 12, 'deleted_lines': 2, 'nloc': 361}, {'timestamp': 1529341047.0, 'added_lines': 56, 'deleted_lines': 21, 'nloc': 390}, {'timestamp': 1529500654.0, 'added_lines': 80, 'deleted_lines': 58, 'nloc': 409}, {'timestamp': 1529942600.0, 'added_lines': 8, 'deleted_lines': 1, 'nloc': 416}, {'timestamp': 1531470129.0, 'added_lines': 1, 'deleted_lines': 0, 'nloc': 417}, {'timestamp': 1531492811.0, 'added_lines': 12, 'deleted_lines': 1, 'nloc': 427}, {'timestamp': 1532963701.0, 'added_lines': 0, 'deleted_lines': 1, 'nloc': 426}, {'timestamp': 1535990095.0, 'added_lines': 3, 'deleted_lines': 3, 'nloc': 426}, {'timestamp': 1536181577.0, 'added_lines': 26, 'deleted_lines': 8, 'nloc': 443}, {'timestamp': 1536186957.0, 'added_lines': 1, 'deleted_lines': 1, 'nloc': 443}, {'timestamp': 1536224848.0, 'added_lines': 3, 'deleted_lines': 3, 'nloc': 443}, {'timestamp': 1536634719.0, 'added_lines': 2, 'deleted_lines': 2, 'nloc': 443}, {'timestamp': 1536787635.0, 'added_lines': 3, 'deleted_lines': 29, 'nloc': 418}, {'timestamp': 1537792589.0, 'added_lines': 2, 'deleted_lines': 2, 'nloc': 418}, {'timestamp': 1538544957.0, 'added_lines': 2, 'deleted_lines': 2, 'nloc': 418}, {'timestamp': 1538049196.0, 'added_lines': 20, 'deleted_lines': 12, 'nloc': 425}, {'timestamp': 1538286894.0, 'added_lines': 43, 'deleted_lines': 7, 'nloc': 456}, {'timestamp': 1538662493.0, 'added_lines': 25, 'deleted_lines': 18, 'nloc': 461}, {'timestamp': 1538024339.0, 'added_lines': 40, 'deleted_lines': 0, 'nloc': 485}, {'timestamp': 1538094008.0, 'added_lines': 1, 'deleted_lines': 1, 'nloc': 485}, {'timestamp': 1538773916.0, 'added_lines': 1, 'deleted_lines': 1, 'nloc': 461}, {'timestamp': 1539176817.0, 'added_lines': 1, 'deleted_lines': 1, 'nloc': 461}, {'timestamp': 1539850591.0, 'added_lines': 1, 'deleted_lines': 1, 'nloc': 461}, {'timestamp': 1540400358.0, 'added_lines': 4, 'deleted_lines': 4, 'nloc': 490}, {'timestamp': 1540611547.0, 'added_lines': 88, 'deleted_lines': 143, 'nloc': 441}, {'timestamp': 1540866271.0, 'added_lines': 3, 'deleted_lines': 3, 'nloc': 441}, {'timestamp': 1541204121.0, 'added_lines': 5, 'deleted_lines': 5, 'nloc': 441}, {'timestamp': 1541903826.0, 'added_lines': 1, 'deleted_lines': 1, 'nloc': 441}, {'timestamp': 1542074871.0, 'added_lines': 5, 'deleted_lines': 11, 'nloc': 438}, {'timestamp': 1544225843.0, 'added_lines': 2, 'deleted_lines': 2, 'nloc': 438}, {'timestamp': 1544661332.0, 'added_lines': 1, 'deleted_lines': 1, 'nloc': 438}, {'timestamp': 1540556089.0, 'added_lines': 1, 'deleted_lines': 1, 'nloc': 438}, {'timestamp': 1547003974.0, 'added_lines': 4, 'deleted_lines': 4, 'nloc': 438}, {'timestamp': 1547152271.0, 'added_lines': 1, 'deleted_lines': 1, 'nloc': 438}, {'timestamp': 1548866534.0, 'added_lines': 1, 'deleted_lines': 1, 'nloc': 438}, {'timestamp': 1549588289.0, 'added_lines': 2, 'deleted_lines': 2, 'nloc': 438}, {'timestamp': 1549903582.0, 'added_lines': 1, 'deleted_lines': 1, 'nloc': 438}, {'timestamp': 1550507829.0, 'added_lines': 3, 'deleted_lines': 3, 'nloc': 438}, {'timestamp': 1550610741.0, 'added_lines': 1, 'deleted_lines': 1, 'nloc': 438}, {'timestamp': 1551138343.0, 'added_lines': 1, 'deleted_lines': 1, 'nloc': 438}, {'timestamp': 1551229859.0, 'added_lines': 4, 'deleted_lines': 4, 'nloc': 438}, {'timestamp': 1551299964.0, 'added_lines': 1, 'deleted_lines': 1, 'nloc': 438}, {'timestamp': 1551471469.0, 'added_lines': 1, 'deleted_lines': 1, 'nloc': 438}, {'timestamp': 1551754781.0, 'added_lines': 1, 'deleted_lines': 1, 'nloc': 438}, {'timestamp': 1551551196.0, 'added_lines': 7, 'deleted_lines': 7, 'nloc': 438}, {'timestamp': 1553697989.0, 'added_lines': 4, 'deleted_lines': 1, 'nloc': 441}, {'timestamp': 1557554420.0, 'added_lines': 33, 'deleted_lines': 34, 'nloc': 440}, {'timestamp': 1558389443.0, 'added_lines': 14, 'deleted_lines': 6, 'nloc': 447}, {'timestamp': 1559060517.0, 'added_lines': 2, 'deleted_lines': 2, 'nloc': 447}, {'timestamp': 1559347612.0, 'added_lines': 34, 'deleted_lines': 26, 'nloc': 454}, {'timestamp': 1576348716.0, 'added_lines': 2, 'deleted_lines': 2, 'nloc': 454}, {'timestamp': 1616604074.0, 'added_lines': 2, 'deleted_lines': 2, 'nloc': 454}]","{'blocks/blockstore/caching.go': 1, 'blocks/blockstore/util/remove.go': 3, 'cmd/ipfs/daemon.go': 33, 'cmd/ipfs/init.go': 33, 'cmd/ipfs/ipfs.go': 25, 'cmd/ipfs/main.go': 34, 'cmd/ipfs/main_test.go': 4, 'cmd/ipfswatch/main.go': 19, 'cmd/seccat/seccat.go': 22, None: 15, 'commands/channelmarshaler.go': 1, 'commands/cli/cmd_suggestion.go': 1, 'commands/cli/helptext.go': 2, 'commands/cli/helptext_test.go': 2, 'commands/cli/parse.go': 2, 'commands/cli/parse_test.go': 2, 'commands/command.go': 15, 'commands/command_test.go': 8, 'commands/http/client.go': 2, 'commands/http/handler.go': 2, 'commands/http/multifilereader.go': 2, 'commands/http/multifilereader_test.go': 2, 'commands/http/parse.go': 2, 'commands/reqlog.go': 2, 'commands/request.go': 17, 'commands/response.go': 12, 'commands/response_test.go': 8, 'core/bootstrap.go': 20, 'core/commands/active.go': 25, 'core/commands/add.go': 32, 'core/commands/bitswap.go': 40, 'core/commands/block.go': 31, 'core/commands/bootstrap.go': 33, 'core/commands/cat.go': 30, 'core/commands/commands.go': 29, 'core/commands/config.go': 35, 'core/commands/dag/dag.go': 37, 'core/commands/dht.go': 41, 'core/commands/diag.go': 23, 'core/commands/dns.go': 29, 'core/commands/e/error.go': 1, 'core/commands/external.go': 23, 'core/commands/files/files.go': 9, 'core/commands/filestore.go': 29, 'core/commands/get.go': 39, 'core/commands/helptext_test.go': 25, 'core/commands/id.go': 40, 'core/commands/ipns.go': 12, 'core/commands/keystore.go': 31, 'core/commands/log.go': 26, 'core/commands/ls.go': 37, 'core/commands/mount_nofuse.go': 23, 'core/commands/mount_unix.go': 33, 'core/commands/mount_windows.go': 22, 'core/commands/name.go': 10, 'core/commands/object/diff.go': 26, 'core/commands/object/object.go': 38, 'core/commands/object/patch.go': 30, 'core/commands/pin.go': 38, 'core/commands/ping.go': 41, 'core/commands/publish.go': 12, 'core/commands/pubsub.go': 31, 'core/commands/refs.go': 37, 'core/commands/repo.go': 39, 'core/commands/resolve.go': 37, 'core/commands/root.go': 31, 'core/commands/shutdown.go': 28, 'core/commands/stat.go': 37, 'core/commands/swarm.go': 43, 'core/commands/sysdiag.go': 30, 'core/commands/tar.go': 35, 'core/commands/unixfs/ls.go': 34, 'core/commands/unixfs/unixfs.go': 23, 'core/commands/version.go': 27, 'core/core_test.go': 14, 'core/corehttp/commands.go': 35, 'core/corehttp/gateway.go': 22, 'core/coreunix/add.go': 30, 'core/coreunix/add_test.go': 31, 'core/coreunix/metadata_test.go': 26, 'exchange/bitswap/bitswap_test.go': 6, 'exchange/bitswap/decision/engine_test.go': 6, 'exchange/bitswap/message/message_test.go': 4, 'exchange/bitswap/message/pb/Makefile': 1, 'exchange/bitswap/testnet/network_test.go': 6, 'exchange/bitswap/testnet/peernet.go': 6, 'exchange/reprovide/reprovide_test.go': 21, 'fuse/ipns/common.go': 22, 'fuse/node/mount_test.go': 21, 'importer/balanced/balanced_test.go': 5, 'importer/chunk/rabin_test.go': 3, 'importer/helpers/dagbuilder.go': 10, 'importer/importer.go': 10, 'merkledag/utils/utils_test.go': 4, 'mfs/repub_test.go': 6, 'namesys/dns.go': 17, 'namesys/interface.go': 18, 'namesys/ipns_select_test.go': 4, 'namesys/proquint.go': 17, 'namesys/republisher/repub_test.go': 23, 'package.json': 35, 'repo/config/identity.go': 1, 'routing/offline/offline_test.go': 4, 'test/integration/addcat_test.go': 26, 'test/integration/bench_cat_test.go': 25, 'test/integration/bitswap_wo_routing_test.go': 22, 'test/integration/three_legged_cat_test.go': 25, 'core/bootstrap_test.go': 19, 'core/commands/dht_test.go': 20, 'core/commands/get_test.go': 26, 'core/core.go': 29, 'core/corehttp/gateway_test.go': 24, 'core/corehttp/metrics_test.go': 21, 'core/mock/mock.go': 21, 'exchange/bitswap/decision/bench_test.go': 5, 'exchange/bitswap/decision/peer_request_queue_test.go': 5, 'exchange/bitswap/message/message.go': 5, 'exchange/bitswap/network/interface.go': 5, 'exchange/bitswap/network/ipfs_impl.go': 5, 'exchange/bitswap/testnet/interface.go': 5, 'exchange/bitswap/testnet/virtual.go': 5, 'exchange/bitswap/testutils.go': 5, 'fuse/ipns/ipns_test.go': 21, 'fuse/readonly/ipfs_test.go': 27, 'namesys/publisher_test.go': 20, 'namesys/resolve_test.go': 21, 'p2p/p2p.go': 31, 'p2p/registry.go': 7, 'repo/config/bootstrap_peers.go': 5, 'routing/mock/centralized_client.go': 3, 'routing/mock/centralized_server.go': 3, 'routing/mock/centralized_test.go': 3, 'routing/mock/interface.go': 3, 'routing/none/none_client.go': 3, 'test/integration/bench_test.go': 16, 'assets/assets.go': 22, 'blocks/blockstore/arc_cache.go': 2, 'blocks/blockstore/arc_cache_test.go': 2, 'blocks/blockstore/blockstore.go': 2, 'blocks/blockstore/blockstore_test.go': 2, 'blocks/blockstore/bloom_cache.go': 2, 'blocks/blockstore/bloom_cache_test.go': 2, 'blocks/blocksutil/block_generator.go': 2, 'blockservice/blockservice.go': 4, 'blockservice/blockservice_test.go': 4, 'blockservice/test/blocks_test.go': 4, 'core/builder.go': 26, 'core/commands/ipnsps.go': 8, 'core/coreapi/coreapi.go': 16, 'core/coreapi/interface/interface.go': 2, 'core/coreapi/unixfs.go': 24, 'core/coreapi/unixfs_test.go': 16, 'core/coredag/cbor.go': 7, 'core/coredag/dagpb.go': 18, 'core/coredag/dagtransl.go': 6, 'core/coredag/raw.go': 18, 'core/corehttp/corehttp.go': 11, 'core/corehttp/gateway_handler.go': 27, 'core/corerepo/gc.go': 25, 'core/corerepo/pinning.go': 7, 'core/coreunix/metadata.go': 23, 'core/pathresolver.go': 19, 'exchange/bitswap/bitswap.go': 4, 'exchange/bitswap/decision/engine.go': 4, 'exchange/bitswap/decision/ledger.go': 4, 'exchange/bitswap/decision/peer_request_queue.go': 4, 'exchange/bitswap/get.go': 4, 'exchange/bitswap/notifications/notifications.go': 3, 'exchange/bitswap/notifications/notifications_test.go': 3, 'exchange/bitswap/session.go': 4, 'exchange/bitswap/session_test.go': 4, 'exchange/bitswap/stat.go': 3, 'exchange/bitswap/wantlist/wantlist.go': 3, 'exchange/bitswap/wantlist/wantlist_test.go': 3, 'exchange/bitswap/wantmanager.go': 4, 'exchange/bitswap/workers.go': 4, 'exchange/interface.go': 2, 'exchange/offline/offline.go': 2, 'exchange/offline/offline_test.go': 2, 'exchange/reprovide/providers.go': 19, 'exchange/reprovide/reprovide.go': 18, 'filestore/filestore.go': 12, 'filestore/filestore_test.go': 19, 'filestore/fsrefstore.go': 12, 'filestore/util.go': 12, 'fuse/ipns/ipns_unix.go': 25, 'fuse/readonly/readonly_unix.go': 24, 'importer/balanced/builder.go': 3, 'importer/chunk/splitting_test.go': 2, 'importer/helpers/helpers.go': 3, 'importer/importer_test.go': 4, 'importer/trickle/trickle_test.go': 4, 'importer/trickle/trickledag.go': 3, 'merkledag/batch.go': 2, 'merkledag/coding.go': 3, 'merkledag/merkledag.go': 3, 'merkledag/merkledag_test.go': 4, 'merkledag/node.go': 3, 'merkledag/node_test.go': 3, 'merkledag/raw.go': 3, 'merkledag/traverse/traverse.go': 3, 'merkledag/traverse/traverse_test.go': 3, 'merkledag/utils/diff.go': 3, 'merkledag/utils/diffenum.go': 3, 'merkledag/utils/diffenum_test.go': 3, 'merkledag/utils/utils.go': 4, 'mfs/dir.go': 4, 'mfs/file.go': 5, 'mfs/mfs_test.go': 5, 'mfs/ops.go': 3, 'mfs/system.go': 5, 'namesys/namesys.go': 22, 'namesys/publisher.go': 25, 'namesys/pubsub.go': 2, 'namesys/pubsub_test.go': 2, 'namesys/republisher/repub.go': 20, 'namesys/routing.go': 22, 'path/path.go': 3, 'path/resolver.go': 2, 'path/resolver_test.go': 2, 'pin/gc/gc.go': 19, 'pin/pin.go': 19, 'pin/pin_test.go': 20, 'pin/set.go': 18, 'pin/set_test.go': 19, 'plugin/ipld.go': 6, 'plugin/loader/initializer.go': 5, 'plugin/plugins/git/git.go': 6, 'repo/config/init.go': 4, 'repo/fsrepo/fsrepo.go': 17, 'repo/fsrepo/lock/lock.go': 2, 'repo/fsrepo/serialize/serialize.go': 3, 'repo/mock.go': 15, 'repo/repo.go': 17, 'routing/offline/offline.go': 2, 'tar/format.go': 24, 'test/dependencies/ma-pipe-unidir/main.go': 10, 'thirdparty/ds-help/key.go': 2, 'thirdparty/pollEndpoint/main.go': 11, 'thirdparty/posinfo/posinfo.go': 2, 'unixfs/archive/archive.go': 3, 'unixfs/archive/tar/writer.go': 3, 'unixfs/hamt/hamt.go': 3, 'unixfs/io/dagreader.go': 3, 'unixfs/io/dirbuilder.go': 3, 'unixfs/io/resolve.go': 3, 'unixfs/mod/dagmodifier.go': 4, 'unixfs/mod/dagmodifier_test.go': 3, 'unixfs/test/utils.go': 4, 'commands/legacy/command.go': 11, 'commands/legacy/legacy.go': 11, 'commands/legacy/legacy_test.go': 12, 'commands/legacy/request.go': 12, 'commands/legacy/response.go': 12, 'commands/legacy/responseemitter.go': 4, 'core/commands/env.go': 3, 'TODO.md': 2, 'core/commands/commands_test.go': 22, 'test/sharness/t0110-gateway.sh': 1, 'test/sharness/t0410-api-add.sh': 1, 'core/coreapi/dag.go': 5, 'core/coreapi/dag_test.go': 3, 'core/coreapi/interface/options/dag.go': 4, 'core/coreapi/key.go': 20, 'core/coreapi/name.go': 20, 'merkledag/test/utils.go': 3, 'namesys/namesys_test.go': 25, 'repo/fsrepo/datastores.go': 10, 'repo/fsrepo/fsrepo_test.go': 14, 'thirdparty/datastore2/datastore_closer.go': 1, 'thirdparty/datastore2/delayed.go': 1, 'thirdparty/datastore2/threadsafe.go': 1, 'unixfs/io/pbdagreader.go': 2, 'blocks/blockstoreutil/remove.go': 10, 'blockservice/test/mock.go': 2, 'cmd/ipfs/util/ulimit.go': 6, 'cmd/ipfs/util/ulimit_freebsd.go': 2, 'cmd/ipfs/util/ulimit_unix.go': 2, 'cmd/seccat/util.go': 6, 'core/commands/files.go': 32, 'core/coreapi/block.go': 8, 'core/coreapi/block_test.go': 2, 'core/coreapi/interface/coreapi.go': 3, 'core/coreapi/interface/dag.go': 3, 'core/coreapi/interface/object.go': 3, 'core/coreapi/interface/options/block.go': 2, 'core/coreapi/interface/path.go': 12, 'core/coreapi/interface/unixfs.go': 7, 'core/coreapi/object.go': 21, 'core/coreapi/pin.go': 18, 'core/corehttp/logs.go': 6, 'fuse/ipns/link_unix.go': 2, 'fuse/mount/fuse.go': 3, 'fuse/mount/mount.go': 6, 'fuse/node/mount_darwin.go': 2, 'fuse/node/mount_unix.go': 8, 'keystore/keystore.go': 7, 'merkledag/errservice.go': 1, 'merkledag/readonly.go': 1, 'merkledag/readonly_test.go': 1, 'merkledag/rwservice.go': 1, 'merkledag/session.go': 1, 'namesys/ipns_validate_test.go': 1, 'namesys/validator.go': 1, 'path/resolver/resolver.go': 2, 'path/resolver/resolver_test.go': 1, 'plugin/loader/load.go': 4, 'thirdparty/verifbs/verifbs.go': 10, 'thirdparty/verifcid/validate.go': 1, 'thirdparty/verifcid/validate_test.go': 1, 'unixfs/hamt/hamt_stress_test.go': 1, 'unixfs/hamt/hamt_test.go': 1, 'namesys/ipns_resolver_validation_test.go': 18, 'test/sharness/t0170-dht.sh': 1, 'core/commands/urlstore.go': 27, 'core/coreapi/path.go': 20, 'core/coreunix/cat.go': 3, 'mfs/fd.go': 1, 'core/coreapi/interface/key.go': 6, 'core/coreapi/name_test.go': 11, 'core/pathresolver_test.go': 15, 'dagutils/diff.go': 17, 'dagutils/diffenum.go': 15, 'dagutils/diffenum_test.go': 15, 'dagutils/utils.go': 16, 'dagutils/utils_test.go': 15, 'namesys/base.go': 16, 'namesys/cache.go': 15, 'repo/fsrepo/config_test.go': 11, 'repo/fsrepo/misc.go': 11, 'test/bench/bench_cli_ipfs_add/main.go': 13, 'test/bench/offline_add/main.go': 13, 'thirdparty/cidv0v1/blockstore.go': 8, 'core/commands/cmdenv/env.go': 21, 'core/commands/name/ipns.go': 25, 'core/commands/name/ipnsps.go': 22, 'core/commands/name/name.go': 16, 'core/commands/name/publish.go': 18, 'p2p/inbound.go': 2, 'p2p/outbound.go': 2, 'p2p/listener.go': 25, 'p2p/stream.go': 26, 'p2p/local.go': 29, 'p2p/remote.go': 29, 'test/sharness/t0180-p2p.sh': 10, 'docs/experimental-features.md': 6, 'p2p/local_listener.go': 1, 'p2p/p2p_listener.go': 1, 'core/coreapi/dht.go': 16, 'core/coreapi/dht_test.go': 4, 'core/coreapi/interface/dht.go': 10, 'core/coreapi/interface/swarm.go': 9, 'core/coreapi/swarm.go': 17, 'core/commands/cid.go': 16, 'core/coreapi/interface/options/unixfs.go': 8, 'core/coreapi/pubsub.go': 15, 'core/coreapi/unixfile.go': 9, 'cmd/ipfs/dnsresolve_test.go': 5, 'core/coreapi/interface/pubsub.go': 4, 'keystore/keystore_test.go': 5, 'keystore/memkeystore.go': 4, 'test/dependencies/iptb/iptb.go': 9, 'plugin/plugins/badgerds/badgerds.go': 4, 'plugin/plugins/flatfs/flatfs.go': 4, 'plugin/plugins/levelds/levelds.go': 3, 'commands/context.go': 15, 'core/corehttp/proxy.go': 8, 'core/coreapi/interface/tests/name.go': 3, 'core/coreapi/interface/tests/unixfs.go': 3, 'core/coreapi/test/api_test.go': 8, 'core/commands/cmdenv/cidbase.go': 9, 'core/commands/cmdenv/file.go': 3, 'core/corehttp/ipns_hostname.go': 5, 'namesys/dns_test.go': 5, 'plugin/daemon.go': 5, 'plugin/loader/loader.go': 6, 'filestore/pb/dataobj.pb.go': 2, 'pin/internal/pb/header.pb.go': 2, 'core/corerepo/stat.go': 2, 'core/commands/cmdenv/cidbase_test.go': 1, 'core/corehttp/metrics.go': 1, 'core/corehttp/proxy_test.go': 2, 'plugin/tracer.go': 1, 'thirdparty/notifier/notifier.go': 1, 'core/corehttp/mutex_profile.go': 1, 'core/corehttp/option_test.go': 1, 'provider/queue.go': 1, 'provider/queue_test.go': 1, 'README.md': 2, 'go.mod': 3, 'go.sum': 3, 'package-list.json': 1, 'core/bootstrap/bootstrap.go': 2, 'core/bootstrap/bootstrap_test.go': 2, 'core/node/builder.go': 1, 'core/node/core.go': 1, 'core/node/groups.go': 1, 'core/node/identity.go': 1, 'core/node/ipns.go': 1, 'core/node/libp2p/addrs.go': 1, 'core/node/libp2p/discovery.go': 1, 'core/node/libp2p/host.go': 1, 'core/node/libp2p/hostopt.go': 1, 'core/node/libp2p/libp2p.go': 1, 'core/node/libp2p/nat.go': 1, 'core/node/libp2p/pnet.go': 1, 'core/node/libp2p/pubsub.go': 1, 'core/node/libp2p/routing.go': 1, 'core/node/libp2p/routingopt.go': 1, 'core/node/libp2p/smux.go': 1, 'core/node/libp2p/transport.go': 1, 'core/node/provider.go': 1, 'provider/simple/provider.go': 1, 'provider/simple/provider_test.go': 1, 'provider/simple/reprovide.go': 1, 'provider/simple/reprovide_test.go': 1, 'docs/examples/go-ipfs-as-a-library/main.go': 1, 'docs/file-transfer.md': 1, 'docs/transports.md': 1, 'core/commands/pin/pin.go': 1, 'core/commands/stat_dht.go': 1}","('core/commands/swarm.go', 0.5443037974683544, 0.4574468085106383)"
core/commands/ping.go,183,1097,6,"[{'cyclomatic_complexity': 4, 'nloc': 15, 'token_count': 110, 'name': '', 'long_name': '(v interface{})(io.Reader,error)', 'start_line': 52, 'end_line': 67, 'full_parameters': [], 'filename': '/home/dimi/Documents/Informatik_Studium/FSS/SoftEvo/DataCollection/FFS_SoftEvo/go-ipfs/core/commands/ping.go', 'top_nesting_level': 0, 'length': 16, 'fan_in': 0, 'fan_out': 0, 'general_fan_out': 0}, {'cyclomatic_complexity': 2, 'nloc': 13, 'token_count': 86, 'name': '', 'long_name': '(res cmds.Response)(io.Reader,error)', 'start_line': 45, 'end_line': 74, 'full_parameters': [], 'filename': '/home/dimi/Documents/Informatik_Studium/FSS/SoftEvo/DataCollection/FFS_SoftEvo/go-ipfs/core/commands/ping.go', 'top_nesting_level': 0, 'length': 30, 'fan_in': 0, 'fan_out': 0, 'general_fan_out': 0}, {'cyclomatic_complexity': 6, 'nloc': 27, 'token_count': 176, 'name': '', 'long_name': '(req cmds.Request,res cmds.Response)', 'start_line': 76, 'end_line': 108, 'full_parameters': [], 'filename': '/home/dimi/Documents/Informatik_Studium/FSS/SoftEvo/DataCollection/FFS_SoftEvo/go-ipfs/core/commands/ping.go', 'top_nesting_level': 0, 'length': 33, 'fan_in': 0, 'fan_out': 0, 'general_fan_out': 0}, {'cyclomatic_complexity': 1, 'nloc': 1, 'token_count': 28, 'name': 'pingPeer', 'long_name': 'pingPeer ctx context . Context , n * core . IpfsNode , pid peer . ID , numPings int', 'start_line': 112, 'end_line': 112, 'full_parameters': ['ctx context . Context', ' n * core . IpfsNode', ' pid peer . ID', ' numPings int'], 'filename': '/home/dimi/Documents/Informatik_Studium/FSS/SoftEvo/DataCollection/FFS_SoftEvo/go-ipfs/core/commands/ping.go', 'top_nesting_level': 0, 'length': 1, 'fan_in': 0, 'fan_out': 0, 'general_fan_out': 0}, {'cyclomatic_complexity': 9, 'nloc': 57, 'token_count': 344, 'name': '', 'long_name': '()', 'start_line': 114, 'end_line': 177, 'full_parameters': [], 'filename': '/home/dimi/Documents/Informatik_Studium/FSS/SoftEvo/DataCollection/FFS_SoftEvo/go-ipfs/core/commands/ping.go', 'top_nesting_level': 0, 'length': 64, 'fan_in': 0, 'fan_out': 0, 'general_fan_out': 0}, {'cyclomatic_complexity': 6, 'nloc': 27, 'token_count': 155, 'name': 'ParsePeerParam', 'long_name': 'ParsePeerParam text string', 'start_line': 181, 'end_line': 216, 'full_parameters': ['text string'], 'filename': '/home/dimi/Documents/Informatik_Studium/FSS/SoftEvo/DataCollection/FFS_SoftEvo/go-ipfs/core/commands/ping.go', 'top_nesting_level': 0, 'length': 36, 'fan_in': 0, 'fan_out': 0, 'general_fan_out': 0}]",193,1087,1,"[{'cyclomatic_complexity': 4, 'nloc': 15, 'token_count': 98, 'name': 'ParsePeerParam', 'long_name': 'ParsePeerParam text string', 'start_line': 206, 'end_line': 222, 'full_parameters': ['text string'], 'filename': '/home/dimi/Documents/Informatik_Studium/FSS/SoftEvo/DataCollection/FFS_SoftEvo/go-ipfs/core/commands/ping.go', 'top_nesting_level': 0, 'length': 17, 'fan_in': 0, 'fan_out': 0, 'general_fan_out': 0}]",10,-10,-5,62,62,"[{'timestamp': 1491058697.0, 'added_lines': 27, 'deleted_lines': 37, 'nloc': 174}, {'timestamp': 1511223906.0, 'added_lines': 1, 'deleted_lines': 1, 'nloc': 174}, {'timestamp': 1511245249.0, 'added_lines': 1, 'deleted_lines': 1, 'nloc': 174}, {'timestamp': 1512365669.0, 'added_lines': 5, 'deleted_lines': 5, 'nloc': 174}, {'timestamp': 1515090180.0, 'added_lines': 9, 'deleted_lines': 0, 'nloc': 180}, {'timestamp': 1515091317.0, 'added_lines': 4, 'deleted_lines': 0, 'nloc': 183}, {'timestamp': 1515091536.0, 'added_lines': 1, 'deleted_lines': 1, 'nloc': 183}, {'timestamp': 1511187070.0, 'added_lines': 1, 'deleted_lines': 1, 'nloc': 183}, {'timestamp': 1513436097.0, 'added_lines': 1, 'deleted_lines': 1, 'nloc': 183}, {'timestamp': 1513612261.0, 'added_lines': 1, 'deleted_lines': 1, 'nloc': 183}, {'timestamp': 1515277696.0, 'added_lines': 1, 'deleted_lines': 1, 'nloc': 183}, {'timestamp': 1516838128.0, 'added_lines': 4, 'deleted_lines': 4, 'nloc': 183}, {'timestamp': 1517453697.0, 'added_lines': 2, 'deleted_lines': 2, 'nloc': 183}, {'timestamp': 1525408792.0, 'added_lines': 2, 'deleted_lines': 2, 'nloc': 183}, {'timestamp': 1528268108.0, 'added_lines': 1, 'deleted_lines': 1, 'nloc': 183}, {'timestamp': 1528520460.0, 'added_lines': 5, 'deleted_lines': 5, 'nloc': 183}, {'timestamp': 1529984485.0, 'added_lines': 3, 'deleted_lines': 3, 'nloc': 183}, {'timestamp': 1533779477.0, 'added_lines': 2, 'deleted_lines': 2, 'nloc': 183}, {'timestamp': 1533946888.0, 'added_lines': 1, 'deleted_lines': 1, 'nloc': 183}, {'timestamp': 1534896611.0, 'added_lines': 3, 'deleted_lines': 3, 'nloc': 183}, {'timestamp': 1534903410.0, 'added_lines': 1, 'deleted_lines': 1, 'nloc': 183}, {'timestamp': 1536388808.0, 'added_lines': 1, 'deleted_lines': 1, 'nloc': 183}, {'timestamp': 1536491322.0, 'added_lines': 31, 'deleted_lines': 9, 'nloc': 205}, {'timestamp': 1537792589.0, 'added_lines': 2, 'deleted_lines': 2, 'nloc': 205}, {'timestamp': 1538544957.0, 'added_lines': 1, 'deleted_lines': 1, 'nloc': 205}, {'timestamp': 1538662493.0, 'added_lines': 6, 'deleted_lines': 2, 'nloc': 208}, {'timestamp': 1538773916.0, 'added_lines': 1, 'deleted_lines': 1, 'nloc': 208}, {'timestamp': 1539176817.0, 'added_lines': 1, 'deleted_lines': 1, 'nloc': 208}, {'timestamp': 1539850591.0, 'added_lines': 1, 'deleted_lines': 1, 'nloc': 208}, {'timestamp': 1540400358.0, 'added_lines': 3, 'deleted_lines': 3, 'nloc': 208}, {'timestamp': 1540615030.0, 'added_lines': 27, 'deleted_lines': 48, 'nloc': 189}, {'timestamp': 1540662050.0, 'added_lines': 50, 'deleted_lines': 80, 'nloc': 160}, {'timestamp': 1540662898.0, 'added_lines': 8, 'deleted_lines': 30, 'nloc': 145}, {'timestamp': 1540907741.0, 'added_lines': 2, 'deleted_lines': 1, 'nloc': 146}, {'timestamp': 1541204121.0, 'added_lines': 6, 'deleted_lines': 6, 'nloc': 146}, {'timestamp': 1541903826.0, 'added_lines': 2, 'deleted_lines': 2, 'nloc': 146}, {'timestamp': 1544225843.0, 'added_lines': 4, 'deleted_lines': 4, 'nloc': 146}, {'timestamp': 1544661332.0, 'added_lines': 1, 'deleted_lines': 1, 'nloc': 146}, {'timestamp': 1540556089.0, 'added_lines': 1, 'deleted_lines': 1, 'nloc': 146}, {'timestamp': 1547003974.0, 'added_lines': 4, 'deleted_lines': 4, 'nloc': 146}, {'timestamp': 1547152271.0, 'added_lines': 1, 'deleted_lines': 1, 'nloc': 146}, {'timestamp': 1548866534.0, 'added_lines': 1, 'deleted_lines': 1, 'nloc': 146}, {'timestamp': 1549588289.0, 'added_lines': 4, 'deleted_lines': 4, 'nloc': 146}, {'timestamp': 1549903582.0, 'added_lines': 1, 'deleted_lines': 1, 'nloc': 146}, {'timestamp': 1550185115.0, 'added_lines': 1, 'deleted_lines': 1, 'nloc': 146}, {'timestamp': 1550507829.0, 'added_lines': 5, 'deleted_lines': 5, 'nloc': 146}, {'timestamp': 1550610741.0, 'added_lines': 1, 'deleted_lines': 1, 'nloc': 146}, {'timestamp': 1550723346.0, 'added_lines': 1, 'deleted_lines': 1, 'nloc': 146}, {'timestamp': 1551138343.0, 'added_lines': 1, 'deleted_lines': 1, 'nloc': 146}, {'timestamp': 1551229859.0, 'added_lines': 5, 'deleted_lines': 5, 'nloc': 146}, {'timestamp': 1551299964.0, 'added_lines': 2, 'deleted_lines': 2, 'nloc': 146}, {'timestamp': 1551471469.0, 'added_lines': 1, 'deleted_lines': 1, 'nloc': 146}, {'timestamp': 1551754781.0, 'added_lines': 1, 'deleted_lines': 1, 'nloc': 146}, {'timestamp': 1551551196.0, 'added_lines': 7, 'deleted_lines': 7, 'nloc': 146}, {'timestamp': 1557379198.0, 'added_lines': 25, 'deleted_lines': 16, 'nloc': 155}, {'timestamp': 1557381272.0, 'added_lines': 38, 'deleted_lines': 0, 'nloc': 191}, {'timestamp': 1557381756.0, 'added_lines': 2, 'deleted_lines': 2, 'nloc': 191}, {'timestamp': 1557382332.0, 'added_lines': 1, 'deleted_lines': 1, 'nloc': 191}, {'timestamp': 1557554420.0, 'added_lines': 5, 'deleted_lines': 6, 'nloc': 190}, {'timestamp': 1559060517.0, 'added_lines': 2, 'deleted_lines': 2, 'nloc': 190}, {'timestamp': 1559347612.0, 'added_lines': 6, 'deleted_lines': 3, 'nloc': 193}, {'timestamp': 1576349311.0, 'added_lines': 1, 'deleted_lines': 1, 'nloc': 193}]","{'blocks/blockstore/caching.go': 1, 'blocks/blockstore/util/remove.go': 3, 'cmd/ipfs/daemon.go': 36, 'cmd/ipfs/init.go': 36, 'cmd/ipfs/ipfs.go': 28, 'cmd/ipfs/main.go': 38, 'cmd/ipfs/main_test.go': 4, 'cmd/ipfswatch/main.go': 19, 'cmd/seccat/seccat.go': 26, None: 13, 'commands/channelmarshaler.go': 1, 'commands/cli/cmd_suggestion.go': 1, 'commands/cli/helptext.go': 3, 'commands/cli/helptext_test.go': 2, 'commands/cli/parse.go': 2, 'commands/cli/parse_test.go': 2, 'commands/command.go': 18, 'commands/command_test.go': 9, 'commands/http/client.go': 2, 'commands/http/handler.go': 2, 'commands/http/multifilereader.go': 2, 'commands/http/multifilereader_test.go': 2, 'commands/http/parse.go': 2, 'commands/reqlog.go': 1, 'commands/request.go': 22, 'commands/response.go': 13, 'commands/response_test.go': 9, 'core/bootstrap.go': 25, 'core/commands/active.go': 24, 'core/commands/add.go': 37, 'core/commands/bitswap.go': 47, 'core/commands/block.go': 36, 'core/commands/bootstrap.go': 34, 'core/commands/cat.go': 35, 'core/commands/commands.go': 30, 'core/commands/config.go': 33, 'core/commands/dag/dag.go': 41, 'core/commands/dht.go': 49, 'core/commands/diag.go': 23, 'core/commands/dns.go': 30, 'core/commands/e/error.go': 1, 'core/commands/external.go': 23, 'core/commands/files/files.go': 10, 'core/commands/filestore.go': 33, 'core/commands/get.go': 44, 'core/commands/helptext_test.go': 28, 'core/commands/id.go': 47, 'core/commands/ipns.go': 14, 'core/commands/keystore.go': 35, 'core/commands/log.go': 29, 'core/commands/ls.go': 42, 'core/commands/mount_nofuse.go': 23, 'core/commands/mount_unix.go': 34, 'core/commands/mount_windows.go': 22, 'core/commands/name.go': 10, 'core/commands/object/diff.go': 27, 'core/commands/object/object.go': 42, 'core/commands/object/patch.go': 33, 'core/commands/p2p.go': 41, 'core/commands/pin.go': 43, 'core/commands/publish.go': 16, 'core/commands/pubsub.go': 38, 'core/commands/refs.go': 41, 'core/commands/repo.go': 42, 'core/commands/resolve.go': 40, 'core/commands/root.go': 32, 'core/commands/shutdown.go': 28, 'core/commands/stat.go': 41, 'core/commands/swarm.go': 45, 'core/commands/sysdiag.go': 31, 'core/commands/tar.go': 38, 'core/commands/unixfs/ls.go': 38, 'core/commands/unixfs/unixfs.go': 23, 'core/commands/version.go': 25, 'core/core_test.go': 16, 'core/corehttp/commands.go': 41, 'core/corehttp/gateway.go': 29, 'core/coreunix/add.go': 36, 'core/coreunix/add_test.go': 35, 'core/coreunix/metadata_test.go': 30, 'exchange/bitswap/bitswap_test.go': 9, 'exchange/bitswap/decision/engine_test.go': 8, 'exchange/bitswap/message/message_test.go': 4, 'exchange/bitswap/message/pb/Makefile': 1, 'exchange/bitswap/testnet/network_test.go': 9, 'exchange/bitswap/testnet/peernet.go': 9, 'exchange/reprovide/reprovide_test.go': 26, 'fuse/ipns/common.go': 27, 'fuse/node/mount_test.go': 26, 'importer/balanced/balanced_test.go': 6, 'importer/chunk/rabin_test.go': 3, 'importer/helpers/dagbuilder.go': 11, 'importer/importer.go': 11, 'merkledag/utils/utils_test.go': 4, 'mfs/repub_test.go': 9, 'namesys/dns.go': 21, 'namesys/interface.go': 23, 'namesys/ipns_select_test.go': 5, 'namesys/proquint.go': 21, 'namesys/republisher/repub_test.go': 29, 'package.json': 41, 'repo/config/identity.go': 3, 'routing/offline/offline_test.go': 5, 'test/integration/addcat_test.go': 32, 'test/integration/bench_cat_test.go': 31, 'test/integration/bitswap_wo_routing_test.go': 28, 'test/integration/three_legged_cat_test.go': 31, 'core/bootstrap_test.go': 24, 'core/commands/dht_test.go': 24, 'core/commands/get_test.go': 29, 'core/core.go': 36, 'core/corehttp/gateway_test.go': 30, 'core/corehttp/metrics_test.go': 28, 'core/mock/mock.go': 28, 'exchange/bitswap/decision/bench_test.go': 7, 'exchange/bitswap/decision/peer_request_queue_test.go': 7, 'exchange/bitswap/message/message.go': 8, 'exchange/bitswap/network/interface.go': 8, 'exchange/bitswap/network/ipfs_impl.go': 8, 'exchange/bitswap/testnet/interface.go': 7, 'exchange/bitswap/testnet/virtual.go': 8, 'exchange/bitswap/testutils.go': 8, 'fuse/ipns/ipns_test.go': 25, 'fuse/readonly/ipfs_test.go': 32, 'namesys/publisher_test.go': 26, 'namesys/resolve_test.go': 28, 'p2p/p2p.go': 25, 'p2p/registry.go': 11, 'repo/config/bootstrap_peers.go': 9, 'routing/mock/centralized_client.go': 4, 'routing/mock/centralized_server.go': 4, 'routing/mock/centralized_test.go': 4, 'routing/mock/interface.go': 4, 'routing/none/none_client.go': 4, 'test/integration/bench_test.go': 19, 'assets/assets.go': 26, 'blocks/blockstore/arc_cache.go': 2, 'blocks/blockstore/arc_cache_test.go': 2, 'blocks/blockstore/blockstore.go': 3, 'blocks/blockstore/blockstore_test.go': 2, 'blocks/blockstore/bloom_cache.go': 2, 'blocks/blockstore/bloom_cache_test.go': 2, 'blocks/blocksutil/block_generator.go': 2, 'blockservice/blockservice.go': 6, 'blockservice/blockservice_test.go': 5, 'blockservice/test/blocks_test.go': 5, 'core/builder.go': 32, 'core/commands/ipnsps.go': 9, 'core/coreapi/coreapi.go': 18, 'core/coreapi/interface/interface.go': 2, 'core/coreapi/unixfs.go': 28, 'core/coreapi/unixfs_test.go': 20, 'core/coredag/cbor.go': 8, 'core/coredag/dagpb.go': 22, 'core/coredag/dagtransl.go': 7, 'core/coredag/raw.go': 22, 'core/corehttp/corehttp.go': 15, 'core/corehttp/gateway_handler.go': 34, 'core/corerepo/gc.go': 30, 'core/corerepo/pinning.go': 9, 'core/coreunix/metadata.go': 27, 'core/pathresolver.go': 25, 'exchange/bitswap/bitswap.go': 6, 'exchange/bitswap/decision/engine.go': 6, 'exchange/bitswap/decision/ledger.go': 6, 'exchange/bitswap/decision/peer_request_queue.go': 6, 'exchange/bitswap/get.go': 5, 'exchange/bitswap/notifications/notifications.go': 3, 'exchange/bitswap/notifications/notifications_test.go': 3, 'exchange/bitswap/session.go': 6, 'exchange/bitswap/session_test.go': 5, 'exchange/bitswap/stat.go': 3, 'exchange/bitswap/wantlist/wantlist.go': 3, 'exchange/bitswap/wantlist/wantlist_test.go': 3, 'exchange/bitswap/wantmanager.go': 6, 'exchange/bitswap/workers.go': 6, 'exchange/interface.go': 2, 'exchange/offline/offline.go': 2, 'exchange/offline/offline_test.go': 2, 'exchange/reprovide/providers.go': 24, 'exchange/reprovide/reprovide.go': 24, 'filestore/filestore.go': 17, 'filestore/filestore_test.go': 24, 'filestore/fsrefstore.go': 16, 'filestore/util.go': 16, 'fuse/ipns/ipns_unix.go': 31, 'fuse/readonly/readonly_unix.go': 30, 'importer/balanced/builder.go': 3, 'importer/chunk/splitting_test.go': 2, 'importer/helpers/helpers.go': 3, 'importer/importer_test.go': 5, 'importer/trickle/trickle_test.go': 5, 'importer/trickle/trickledag.go': 3, 'merkledag/batch.go': 2, 'merkledag/coding.go': 3, 'merkledag/merkledag.go': 3, 'merkledag/merkledag_test.go': 5, 'merkledag/node.go': 3, 'merkledag/node_test.go': 3, 'merkledag/raw.go': 3, 'merkledag/traverse/traverse.go': 3, 'merkledag/traverse/traverse_test.go': 3, 'merkledag/utils/diff.go': 3, 'merkledag/utils/diffenum.go': 3, 'merkledag/utils/diffenum_test.go': 3, 'merkledag/utils/utils.go': 5, 'mfs/dir.go': 5, 'mfs/file.go': 7, 'mfs/mfs_test.go': 7, 'mfs/ops.go': 4, 'mfs/system.go': 8, 'namesys/namesys.go': 29, 'namesys/publisher.go': 32, 'namesys/pubsub.go': 4, 'namesys/pubsub_test.go': 4, 'namesys/republisher/repub.go': 26, 'namesys/routing.go': 29, 'path/path.go': 3, 'path/resolver.go': 3, 'path/resolver_test.go': 2, 'pin/gc/gc.go': 25, 'pin/pin.go': 25, 'pin/pin_test.go': 24, 'pin/set.go': 22, 'pin/set_test.go': 24, 'plugin/ipld.go': 7, 'plugin/loader/initializer.go': 5, 'plugin/plugins/git/git.go': 7, 'repo/config/init.go': 7, 'repo/fsrepo/fsrepo.go': 21, 'repo/fsrepo/lock/lock.go': 3, 'repo/fsrepo/serialize/serialize.go': 3, 'repo/mock.go': 16, 'repo/repo.go': 19, 'routing/offline/offline.go': 3, 'tar/format.go': 30, 'test/dependencies/ma-pipe-unidir/main.go': 10, 'thirdparty/ds-help/key.go': 2, 'thirdparty/pollEndpoint/main.go': 15, 'thirdparty/posinfo/posinfo.go': 2, 'unixfs/archive/archive.go': 3, 'unixfs/archive/tar/writer.go': 3, 'unixfs/hamt/hamt.go': 3, 'unixfs/io/dagreader.go': 3, 'unixfs/io/dirbuilder.go': 3, 'unixfs/io/resolve.go': 3, 'unixfs/mod/dagmodifier.go': 5, 'unixfs/mod/dagmodifier_test.go': 3, 'unixfs/test/utils.go': 5, 'commands/legacy/command.go': 14, 'commands/legacy/legacy.go': 14, 'commands/legacy/legacy_test.go': 15, 'commands/legacy/request.go': 15, 'commands/legacy/response.go': 15, 'commands/legacy/responseemitter.go': 4, 'core/commands/env.go': 4, 'TODO.md': 2, 'core/commands/commands_test.go': 24, 'test/sharness/t0110-gateway.sh': 1, 'test/sharness/t0410-api-add.sh': 1, 'core/coreapi/dag.go': 6, 'core/coreapi/dag_test.go': 3, 'core/coreapi/interface/options/dag.go': 4, 'core/coreapi/key.go': 26, 'core/coreapi/name.go': 27, 'merkledag/test/utils.go': 4, 'namesys/namesys_test.go': 30, 'repo/fsrepo/datastores.go': 14, 'repo/fsrepo/fsrepo_test.go': 16, 'thirdparty/datastore2/datastore_closer.go': 1, 'thirdparty/datastore2/delayed.go': 1, 'thirdparty/datastore2/threadsafe.go': 1, 'unixfs/io/pbdagreader.go': 2, 'cmd/ipfs/util/ulimit.go': 9, 'cmd/seccat/util.go': 9, 'core/corehttp/logs.go': 9, 'fuse/mount/mount.go': 9, 'fuse/node/mount_unix.go': 10, 'importer/chunk/splitting.go': 1, 'namesys/ipns_validate_test.go': 4, 'plugin/loader/load.go': 7, 'blocks/blockstoreutil/remove.go': 14, 'blockservice/test/mock.go': 4, 'core/commands/files.go': 35, 'core/coreapi/pin.go': 23, 'keystore/keystore.go': 9, 'keystore/keystore_test.go': 6, 'keystore/memkeystore.go': 6, 'namesys/validator.go': 3, 'path/resolver/resolver.go': 3, 'thirdparty/verifbs/verifbs.go': 14, 'cmd/ipfs/util/ulimit_freebsd.go': 2, 'cmd/ipfs/util/ulimit_unix.go': 2, 'core/coreapi/block.go': 10, 'core/coreapi/block_test.go': 2, 'core/coreapi/interface/coreapi.go': 3, 'core/coreapi/interface/dag.go': 3, 'core/coreapi/interface/object.go': 3, 'core/coreapi/interface/options/block.go': 2, 'core/coreapi/interface/path.go': 14, 'core/coreapi/interface/unixfs.go': 7, 'core/coreapi/object.go': 25, 'fuse/ipns/link_unix.go': 2, 'fuse/mount/fuse.go': 2, 'fuse/node/mount_darwin.go': 2, 'merkledag/errservice.go': 1, 'merkledag/readonly.go': 1, 'merkledag/readonly_test.go': 1, 'merkledag/rwservice.go': 1, 'merkledag/session.go': 1, 'path/resolver/resolver_test.go': 1, 'thirdparty/verifcid/validate.go': 1, 'thirdparty/verifcid/validate_test.go': 1, 'unixfs/hamt/hamt_stress_test.go': 1, 'unixfs/hamt/hamt_test.go': 1, 'namesys/ipns_resolver_validation_test.go': 22, 'test/sharness/t0170-dht.sh': 1, 'core/commands/urlstore.go': 31, 'core/coreapi/interface/key.go': 7, 'core/coreapi/name_test.go': 13, 'core/coreapi/path.go': 24, 'core/coreunix/cat.go': 5, 'core/pathresolver_test.go': 19, 'dagutils/diff.go': 20, 'dagutils/diffenum.go': 19, 'dagutils/diffenum_test.go': 19, 'dagutils/utils.go': 19, 'dagutils/utils_test.go': 19, 'filestore/pb/dataobj.pb.go': 3, 'mfs/fd.go': 2, 'namesys/base.go': 20, 'namesys/cache.go': 19, 'pin/internal/pb/header.pb.go': 3, 'thirdparty/cidv0v1/blockstore.go': 11, 'repo/fsrepo/config_test.go': 12, 'repo/fsrepo/misc.go': 12, 'test/bench/bench_cli_ipfs_add/main.go': 13, 'test/bench/offline_add/main.go': 13, 'core/commands/cmdenv/env.go': 24, 'core/commands/name/ipns.go': 28, 'core/commands/name/ipnsps.go': 22, 'core/commands/name/name.go': 16, 'core/commands/name/publish.go': 21, 'core/coreapi/dht.go': 18, 'core/coreapi/dht_test.go': 4, 'core/coreapi/interface/dht.go': 10, 'p2p/listener.go': 14, 'p2p/local.go': 14, 'p2p/remote.go': 14, 'p2p/stream.go': 14, 'core/coreapi/interface/swarm.go': 9, 'core/coreapi/swarm.go': 18, 'core/commands/cid.go': 16, 'core/coreapi/interface/options/unixfs.go': 8, 'core/coreapi/pubsub.go': 16, 'core/coreapi/unixfile.go': 9, 'cmd/ipfs/dnsresolve_test.go': 5, 'core/coreapi/interface/pubsub.go': 4, 'test/dependencies/iptb/iptb.go': 11, 'plugin/plugins/badgerds/badgerds.go': 4, 'plugin/plugins/flatfs/flatfs.go': 4, 'plugin/plugins/levelds/levelds.go': 3, 'commands/context.go': 17, 'core/corehttp/proxy.go': 10, 'core/coreapi/interface/tests/name.go': 3, 'core/coreapi/interface/tests/unixfs.go': 3, 'core/coreapi/test/api_test.go': 10, 'core/commands/cmdenv/cidbase.go': 10, 'core/commands/cmdenv/file.go': 3, 'core/corehttp/ipns_hostname.go': 7, 'namesys/dns_test.go': 7, 'plugin/daemon.go': 7, 'plugin/loader/loader.go': 7, 'core/corerepo/stat.go': 2, 'core/commands/cmdenv/cidbase_test.go': 2, 'core/corehttp/metrics.go': 1, 'core/corehttp/proxy_test.go': 2, 'plugin/tracer.go': 1, 'thirdparty/notifier/notifier.go': 1, 'go.mod': 4, 'go.sum': 4, 'README.md': 1, 'package-list.json': 1, 'core/bootstrap/bootstrap.go': 2, 'core/bootstrap/bootstrap_test.go': 2, 'core/node/builder.go': 1, 'core/node/core.go': 1, 'core/node/groups.go': 2, 'core/node/identity.go': 1, 'core/node/ipns.go': 1, 'core/node/libp2p/addrs.go': 1, 'core/node/libp2p/discovery.go': 1, 'core/node/libp2p/host.go': 1, 'core/node/libp2p/hostopt.go': 1, 'core/node/libp2p/libp2p.go': 1, 'core/node/libp2p/nat.go': 1, 'core/node/libp2p/pnet.go': 1, 'core/node/libp2p/pubsub.go': 1, 'core/node/libp2p/routing.go': 1, 'core/node/libp2p/routingopt.go': 1, 'core/node/libp2p/smux.go': 1, 'core/node/libp2p/transport.go': 1, 'core/node/provider.go': 1, 'provider/simple/provider.go': 1, 'provider/simple/provider_test.go': 1, 'provider/simple/reprovide.go': 1, 'provider/simple/reprovide_test.go': 1}","('core/commands/dht.go', 0.7903225806451613, 0.44144144144144143)"
core/commands/pubsub.go,283,1896,14,"[{'cyclomatic_complexity': 5, 'nloc': 15, 'token_count': 78, 'name': '', 'long_name': '()', 'start_line': 102, 'end_line': 119, 'full_parameters': [], 'filename': '/home/dimi/Documents/Informatik_Studium/FSS/SoftEvo/DataCollection/FFS_SoftEvo/go-ipfs/core/commands/pubsub.go', 'top_nesting_level': 0, 'length': 18, 'fan_in': 0, 'fan_out': 0, 'general_fan_out': 0}, {'cyclomatic_complexity': 2, 'nloc': 9, 'token_count': 59, 'name': '', 'long_name': '()', 'start_line': 123, 'end_line': 132, 'full_parameters': [], 'filename': '/home/dimi/Documents/Informatik_Studium/FSS/SoftEvo/DataCollection/FFS_SoftEvo/go-ipfs/core/commands/pubsub.go', 'top_nesting_level': 0, 'length': 10, 'fan_in': 0, 'fan_out': 0, 'general_fan_out': 0}, {'cyclomatic_complexity': 6, 'nloc': 28, 'token_count': 180, 'name': '', 'long_name': '(req cmds.Request,res cmds.Response)', 'start_line': 74, 'end_line': 134, 'full_parameters': [], 'filename': '/home/dimi/Documents/Informatik_Studium/FSS/SoftEvo/DataCollection/FFS_SoftEvo/go-ipfs/core/commands/pubsub.go', 'top_nesting_level': 0, 'length': 61, 'fan_in': 0, 'fan_out': 0, 'general_fan_out': 0}, {'cyclomatic_complexity': 1, 'nloc': 3, 'token_count': 28, 'name': '', 'long_name': '(m*floodsub.Message)(io.Reader,error)', 'start_line': 136, 'end_line': 138, 'full_parameters': [], 'filename': '/home/dimi/Documents/Informatik_Studium/FSS/SoftEvo/DataCollection/FFS_SoftEvo/go-ipfs/core/commands/pubsub.go', 'top_nesting_level': 0, 'length': 3, 'fan_in': 0, 'fan_out': 0, 'general_fan_out': 0}, {'cyclomatic_complexity': 1, 'nloc': 4, 'token_count': 40, 'name': '', 'long_name': '(m*floodsub.Message)(io.Reader,error)', 'start_line': 139, 'end_line': 142, 'full_parameters': [], 'filename': '/home/dimi/Documents/Informatik_Studium/FSS/SoftEvo/DataCollection/FFS_SoftEvo/go-ipfs/core/commands/pubsub.go', 'top_nesting_level': 0, 'length': 4, 'fan_in': 0, 'fan_out': 0, 'general_fan_out': 0}, {'cyclomatic_complexity': 1, 'nloc': 5, 'token_count': 72, 'name': '', 'long_name': '(m*floodsub.Message)(io.Reader,error)', 'start_line': 143, 'end_line': 148, 'full_parameters': [], 'filename': '/home/dimi/Documents/Informatik_Studium/FSS/SoftEvo/DataCollection/FFS_SoftEvo/go-ipfs/core/commands/pubsub.go', 'top_nesting_level': 0, 'length': 6, 'fan_in': 0, 'fan_out': 0, 'general_fan_out': 0}, {'cyclomatic_complexity': 2, 'nloc': 11, 'token_count': 72, 'name': '', 'long_name': '(pi pstore.PeerInfo)', 'start_line': 161, 'end_line': 171, 'full_parameters': [], 'filename': '/home/dimi/Documents/Informatik_Studium/FSS/SoftEvo/DataCollection/FFS_SoftEvo/go-ipfs/core/commands/pubsub.go', 'top_nesting_level': 0, 'length': 11, 'fan_in': 0, 'fan_out': 0, 'general_fan_out': 0}, {'cyclomatic_complexity': 2, 'nloc': 11, 'token_count': 81, 'name': 'connectToPubSubPeers', 'long_name': 'connectToPubSubPeers ctx context . Context , n * core . IpfsNode , cid * cid . Cid', 'start_line': 153, 'end_line': 175, 'full_parameters': ['ctx context . Context', ' n * core . IpfsNode', ' cid * cid . Cid'], 'filename': '/home/dimi/Documents/Informatik_Studium/FSS/SoftEvo/DataCollection/FFS_SoftEvo/go-ipfs/core/commands/pubsub.go', 'top_nesting_level': 0, 'length': 23, 'fan_in': 0, 'fan_out': 0, 'general_fan_out': 0}, {'cyclomatic_complexity': 3, 'nloc': 10, 'token_count': 63, 'name': '', 'long_name': '(v interface{})(io.Reader,error)', 'start_line': 184, 'end_line': 194, 'full_parameters': [], 'filename': '/home/dimi/Documents/Informatik_Studium/FSS/SoftEvo/DataCollection/FFS_SoftEvo/go-ipfs/core/commands/pubsub.go', 'top_nesting_level': 0, 'length': 11, 'fan_in': 0, 'fan_out': 0, 'general_fan_out': 0}, {'cyclomatic_complexity': 2, 'nloc': 12, 'token_count': 71, 'name': '', 'long_name': '(res cmds.Response)(io.Reader,error)', 'start_line': 178, 'end_line': 201, 'full_parameters': [], 'filename': '/home/dimi/Documents/Informatik_Studium/FSS/SoftEvo/DataCollection/FFS_SoftEvo/go-ipfs/core/commands/pubsub.go', 'top_nesting_level': 0, 'length': 24, 'fan_in': 0, 'fan_out': 0, 'general_fan_out': 0}, {'cyclomatic_complexity': 1, 'nloc': 3, 'token_count': 37, 'name': 'getPsMsgMarshaler', 'long_name': 'getPsMsgMarshaler f func m * floodsub . Message io . Reader , error', 'start_line': 177, 'end_line': 202, 'full_parameters': ['f func m * floodsub . Message io . Reader', ' error'], 'filename': '/home/dimi/Documents/Informatik_Studium/FSS/SoftEvo/DataCollection/FFS_SoftEvo/go-ipfs/core/commands/pubsub.go', 'top_nesting_level': 0, 'length': 26, 'fan_in': 0, 'fan_out': 0, 'general_fan_out': 0}, {'cyclomatic_complexity': 6, 'nloc': 22, 'token_count': 150, 'name': '', 'long_name': '(req cmds.Request,res cmds.Response)', 'start_line': 220, 'end_line': 246, 'full_parameters': [], 'filename': '/home/dimi/Documents/Informatik_Studium/FSS/SoftEvo/DataCollection/FFS_SoftEvo/go-ipfs/core/commands/pubsub.go', 'top_nesting_level': 0, 'length': 27, 'fan_in': 0, 'fan_out': 0, 'general_fan_out': 0}, {'cyclomatic_complexity': 4, 'nloc': 16, 'token_count': 104, 'name': '', 'long_name': '(req cmds.Request,res cmds.Response)', 'start_line': 261, 'end_line': 280, 'full_parameters': [], 'filename': '/home/dimi/Documents/Informatik_Studium/FSS/SoftEvo/DataCollection/FFS_SoftEvo/go-ipfs/core/commands/pubsub.go', 'top_nesting_level': 0, 'length': 20, 'fan_in': 0, 'fan_out': 0, 'general_fan_out': 0}, {'cyclomatic_complexity': 6, 'nloc': 24, 'token_count': 157, 'name': '', 'long_name': '(req cmds.Request,res cmds.Response)', 'start_line': 304, 'end_line': 332, 'full_parameters': [], 'filename': '/home/dimi/Documents/Informatik_Studium/FSS/SoftEvo/DataCollection/FFS_SoftEvo/go-ipfs/core/commands/pubsub.go', 'top_nesting_level': 0, 'length': 29, 'fan_in': 0, 'fan_out': 0, 'general_fan_out': 0}]",222,1531,0,[],-61,-365,-14,89,89,"[{'timestamp': 1507304579.0, 'added_lines': 1, 'deleted_lines': 1, 'nloc': 283}, {'timestamp': 1508424715.0, 'added_lines': 1, 'deleted_lines': 1, 'nloc': 283}, {'timestamp': 1491058697.0, 'added_lines': 84, 'deleted_lines': 106, 'nloc': 265}, {'timestamp': 1508770239.0, 'added_lines': 2, 'deleted_lines': 2, 'nloc': 265}, {'timestamp': 1509016767.0, 'added_lines': 1, 'deleted_lines': 1, 'nloc': 265}, {'timestamp': 1511223906.0, 'added_lines': 3, 'deleted_lines': 3, 'nloc': 265}, {'timestamp': 1511178696.0, 'added_lines': 5, 'deleted_lines': 0, 'nloc': 269}, {'timestamp': 1511373659.0, 'added_lines': 1, 'deleted_lines': 1, 'nloc': 269}, {'timestamp': 1512365669.0, 'added_lines': 6, 'deleted_lines': 6, 'nloc': 269}, {'timestamp': 1511187070.0, 'added_lines': 21, 'deleted_lines': 21, 'nloc': 269}, {'timestamp': 1512121226.0, 'added_lines': 1, 'deleted_lines': 1, 'nloc': 269}, {'timestamp': 1513436097.0, 'added_lines': 2, 'deleted_lines': 2, 'nloc': 269}, {'timestamp': 1513612261.0, 'added_lines': 2, 'deleted_lines': 2, 'nloc': 269}, {'timestamp': 1513764708.0, 'added_lines': 1, 'deleted_lines': 1, 'nloc': 269}, {'timestamp': 1513765470.0, 'added_lines': 1, 'deleted_lines': 1, 'nloc': 269}, {'timestamp': 1513766201.0, 'added_lines': 1, 'deleted_lines': 1, 'nloc': 269}, {'timestamp': 1513772654.0, 'added_lines': 1, 'deleted_lines': 1, 'nloc': 269}, {'timestamp': 1513773452.0, 'added_lines': 1, 'deleted_lines': 1, 'nloc': 269}, {'timestamp': 1515277696.0, 'added_lines': 1, 'deleted_lines': 1, 'nloc': 269}, {'timestamp': 1515465466.0, 'added_lines': 5, 'deleted_lines': 5, 'nloc': 269}, {'timestamp': 1515713724.0, 'added_lines': 1, 'deleted_lines': 1, 'nloc': 269}, {'timestamp': 1516341168.0, 'added_lines': 1, 'deleted_lines': 1, 'nloc': 269}, {'timestamp': 1516838128.0, 'added_lines': 5, 'deleted_lines': 5, 'nloc': 269}, {'timestamp': 1516911711.0, 'added_lines': 2, 'deleted_lines': 2, 'nloc': 269}, {'timestamp': 1517105039.0, 'added_lines': 2, 'deleted_lines': 2, 'nloc': 269}, {'timestamp': 1517453697.0, 'added_lines': 3, 'deleted_lines': 3, 'nloc': 269}, {'timestamp': 1519173780.0, 'added_lines': 1, 'deleted_lines': 1, 'nloc': 269}, {'timestamp': 1520276415.0, 'added_lines': 6, 'deleted_lines': 0, 'nloc': 274}, {'timestamp': 1521205297.0, 'added_lines': 2, 'deleted_lines': 4, 'nloc': 272}, {'timestamp': 1521208416.0, 'added_lines': 28, 'deleted_lines': 4, 'nloc': 294}, {'timestamp': 1521314540.0, 'added_lines': 2, 'deleted_lines': 2, 'nloc': 294}, {'timestamp': 1521500314.0, 'added_lines': 1, 'deleted_lines': 1, 'nloc': 294}, {'timestamp': 1521399286.0, 'added_lines': 2, 'deleted_lines': 2, 'nloc': 294}, {'timestamp': 1524596476.0, 'added_lines': 1, 'deleted_lines': 1, 'nloc': 294}, {'timestamp': 1525408792.0, 'added_lines': 3, 'deleted_lines': 3, 'nloc': 294}, {'timestamp': 1528131220.0, 'added_lines': 1, 'deleted_lines': 1, 'nloc': 294}, {'timestamp': 1528268108.0, 'added_lines': 2, 'deleted_lines': 2, 'nloc': 294}, {'timestamp': 1528520460.0, 'added_lines': 6, 'deleted_lines': 6, 'nloc': 294}, {'timestamp': 1529984485.0, 'added_lines': 3, 'deleted_lines': 3, 'nloc': 294}, {'timestamp': 1531779409.0, 'added_lines': 2, 'deleted_lines': 2, 'nloc': 294}, {'timestamp': 1532146078.0, 'added_lines': 1, 'deleted_lines': 1, 'nloc': 294}, {'timestamp': 1533779477.0, 'added_lines': 3, 'deleted_lines': 3, 'nloc': 294}, {'timestamp': 1533946888.0, 'added_lines': 2, 'deleted_lines': 2, 'nloc': 294}, {'timestamp': 1534115707.0, 'added_lines': 3, 'deleted_lines': 3, 'nloc': 294}, {'timestamp': 1534347022.0, 'added_lines': 2, 'deleted_lines': 2, 'nloc': 294}, {'timestamp': 1534896611.0, 'added_lines': 6, 'deleted_lines': 6, 'nloc': 294}, {'timestamp': 1534903410.0, 'added_lines': 9, 'deleted_lines': 8, 'nloc': 295}, {'timestamp': 1535601896.0, 'added_lines': 1, 'deleted_lines': 1, 'nloc': 295}, {'timestamp': 1536388808.0, 'added_lines': 2, 'deleted_lines': 2, 'nloc': 295}, {'timestamp': 1536718784.0, 'added_lines': 3, 'deleted_lines': 3, 'nloc': 295}, {'timestamp': 1523628870.0, 'added_lines': 31, 'deleted_lines': 41, 'nloc': 284}, {'timestamp': 1535044155.0, 'added_lines': 1, 'deleted_lines': 1, 'nloc': 284}, {'timestamp': 1537193530.0, 'added_lines': 1, 'deleted_lines': 1, 'nloc': 284}, {'timestamp': 1537391809.0, 'added_lines': 1, 'deleted_lines': 1, 'nloc': 284}, {'timestamp': 1537792589.0, 'added_lines': 3, 'deleted_lines': 3, 'nloc': 284}, {'timestamp': 1538544957.0, 'added_lines': 2, 'deleted_lines': 2, 'nloc': 284}, {'timestamp': 1538694687.0, 'added_lines': 1, 'deleted_lines': 1, 'nloc': 284}, {'timestamp': 1538695953.0, 'added_lines': 1, 'deleted_lines': 1, 'nloc': 284}, {'timestamp': 1538662493.0, 'added_lines': 6, 'deleted_lines': 2, 'nloc': 287}, {'timestamp': 1536663160.0, 'added_lines': 35, 'deleted_lines': 99, 'nloc': 236}, {'timestamp': 1537979075.0, 'added_lines': 3, 'deleted_lines': 0, 'nloc': 239}, {'timestamp': 1539850591.0, 'added_lines': 2, 'deleted_lines': 2, 'nloc': 239}, {'timestamp': 1540552487.0, 'added_lines': 1, 'deleted_lines': 1, 'nloc': 239}, {'timestamp': 1540597832.0, 'added_lines': 1, 'deleted_lines': 1, 'nloc': 239}, {'timestamp': 1540906996.0, 'added_lines': 4, 'deleted_lines': 2, 'nloc': 241}, {'timestamp': 1541204121.0, 'added_lines': 1, 'deleted_lines': 1, 'nloc': 241}, {'timestamp': 1541822268.0, 'added_lines': 12, 'deleted_lines': 32, 'nloc': 224}, {'timestamp': 1544661332.0, 'added_lines': 1, 'deleted_lines': 1, 'nloc': 224}, {'timestamp': 1540556089.0, 'added_lines': 1, 'deleted_lines': 1, 'nloc': 224}, {'timestamp': 1544451987.0, 'added_lines': 4, 'deleted_lines': 4, 'nloc': 224}, {'timestamp': 1547152271.0, 'added_lines': 1, 'deleted_lines': 1, 'nloc': 224}, {'timestamp': 1548866534.0, 'added_lines': 1, 'deleted_lines': 1, 'nloc': 224}, {'timestamp': 1549672857.0, 'added_lines': 1, 'deleted_lines': 1, 'nloc': 224}, {'timestamp': 1549673846.0, 'added_lines': 1, 'deleted_lines': 1, 'nloc': 224}, {'timestamp': 1549903582.0, 'added_lines': 2, 'deleted_lines': 2, 'nloc': 224}, {'timestamp': 1550185115.0, 'added_lines': 1, 'deleted_lines': 1, 'nloc': 224}, {'timestamp': 1550507829.0, 'added_lines': 2, 'deleted_lines': 2, 'nloc': 224}, {'timestamp': 1550576884.0, 'added_lines': 1, 'deleted_lines': 1, 'nloc': 224}, {'timestamp': 1550610741.0, 'added_lines': 1, 'deleted_lines': 1, 'nloc': 224}, {'timestamp': 1550711994.0, 'added_lines': 1, 'deleted_lines': 1, 'nloc': 224}, {'timestamp': 1550723346.0, 'added_lines': 1, 'deleted_lines': 1, 'nloc': 224}, {'timestamp': 1551138343.0, 'added_lines': 1, 'deleted_lines': 1, 'nloc': 224}, {'timestamp': 1551229859.0, 'added_lines': 1, 'deleted_lines': 1, 'nloc': 224}, {'timestamp': 1551299964.0, 'added_lines': 2, 'deleted_lines': 2, 'nloc': 224}, {'timestamp': 1551471469.0, 'added_lines': 1, 'deleted_lines': 1, 'nloc': 224}, {'timestamp': 1551551196.0, 'added_lines': 3, 'deleted_lines': 3, 'nloc': 224}, {'timestamp': 1557554420.0, 'added_lines': 14, 'deleted_lines': 15, 'nloc': 223}, {'timestamp': 1590792870.0, 'added_lines': 2, 'deleted_lines': 4, 'nloc': 222}, {'timestamp': 1608253728.0, 'added_lines': 1, 'deleted_lines': 1, 'nloc': 222}]","{'core/bootstrap.go': 22, 'core/bootstrap_test.go': 19, 'core/commands/dht.go': 52, 'core/commands/dht_test.go': 17, 'core/commands/id.go': 47, 'core/core.go': 40, 'core/corehttp/gateway.go': 33, 'core/corehttp/gateway_test.go': 38, 'core/corehttp/metrics_test.go': 27, 'core/mock/mock.go': 27, 'exchange/bitswap/bitswap_test.go': 16, 'exchange/bitswap/decision/bench_test.go': 9, 'exchange/bitswap/decision/engine_test.go': 11, 'exchange/bitswap/decision/peer_request_queue_test.go': 9, 'exchange/bitswap/network/ipfs_impl.go': 11, 'exchange/bitswap/testnet/interface.go': 8, 'exchange/bitswap/testnet/network_test.go': 12, 'exchange/bitswap/testnet/peernet.go': 15, 'exchange/bitswap/testnet/virtual.go': 12, 'exchange/bitswap/testutils.go': 14, 'exchange/reprovide/reprovide_test.go': 27, 'fuse/ipns/ipns_test.go': 24, 'fuse/node/mount_test.go': 25, 'fuse/readonly/ipfs_test.go': 38, 'mfs/repub_test.go': 13, 'namesys/publisher_test.go': 25, 'namesys/republisher/repub_test.go': 34, 'namesys/resolve_test.go': 32, 'p2p/p2p.go': 20, 'package.json': 70, 'routing/mock/centralized_client.go': 5, 'routing/mock/centralized_server.go': 5, 'routing/mock/centralized_test.go': 5, 'routing/mock/interface.go': 5, 'routing/none/none_client.go': 5, 'routing/offline/offline_test.go': 7, 'test/integration/addcat_test.go': 31, 'test/integration/bench_cat_test.go': 30, 'test/integration/bench_test.go': 15, 'test/integration/bitswap_wo_routing_test.go': 32, 'test/integration/three_legged_cat_test.go': 30, 'thirdparty/ipfsaddr/ipfsaddr.go': 2, 'core/commands/swarm.go': 46, 'blocks/blockstore/caching.go': 1, 'blocks/blockstore/util/remove.go': 3, 'cmd/ipfs/daemon.go': 56, 'cmd/ipfs/init.go': 40, 'cmd/ipfs/ipfs.go': 51, 'cmd/ipfs/main.go': 57, 'cmd/ipfs/main_test.go': 4, 'cmd/ipfswatch/main.go': 19, 'cmd/seccat/seccat.go': 21, None: 14, 'commands/channelmarshaler.go': 1, 'commands/cli/cmd_suggestion.go': 1, 'commands/cli/helptext.go': 2, 'commands/cli/helptext_test.go': 2, 'commands/cli/parse.go': 2, 'commands/cli/parse_test.go': 2, 'commands/command.go': 29, 'commands/command_test.go': 20, 'commands/http/client.go': 2, 'commands/http/handler.go': 2, 'commands/http/multifilereader.go': 2, 'commands/http/multifilereader_test.go': 2, 'commands/http/parse.go': 2, 'commands/reqlog.go': 1, 'commands/request.go': 40, 'commands/response.go': 24, 'commands/response_test.go': 20, 'core/commands/active.go': 24, 'core/commands/add.go': 73, 'core/commands/bitswap.go': 69, 'core/commands/block.go': 68, 'core/commands/bootstrap.go': 30, 'core/commands/cat.go': 63, 'core/commands/commands.go': 53, 'core/commands/config.go': 32, 'core/commands/dag/dag.go': 47, 'core/commands/diag.go': 23, 'core/commands/dns.go': 35, 'core/commands/e/error.go': 1, 'core/commands/external.go': 23, 'core/commands/files/files.go': 11, 'core/commands/filestore.go': 60, 'core/commands/get.go': 71, 'core/commands/helptext_test.go': 51, 'core/commands/ipns.go': 18, 'core/commands/keystore.go': 48, 'core/commands/log.go': 29, 'core/commands/ls.go': 50, 'core/commands/mount_nofuse.go': 23, 'core/commands/mount_unix.go': 31, 'core/commands/mount_windows.go': 22, 'core/commands/name.go': 10, 'core/commands/object/diff.go': 32, 'core/commands/object/object.go': 58, 'core/commands/object/patch.go': 48, 'core/commands/p2p.go': 31, 'core/commands/pin.go': 50, 'core/commands/ping.go': 38, 'core/commands/publish.go': 18, 'core/commands/refs.go': 42, 'core/commands/repo.go': 66, 'core/commands/resolve.go': 47, 'core/commands/root.go': 54, 'core/commands/shutdown.go': 33, 'core/commands/stat.go': 58, 'core/commands/sysdiag.go': 28, 'core/commands/tar.go': 41, 'core/commands/unixfs/ls.go': 43, 'core/commands/unixfs/unixfs.go': 23, 'core/commands/version.go': 27, 'core/core_test.go': 11, 'core/corehttp/commands.go': 64, 'core/coreunix/add.go': 42, 'core/coreunix/add_test.go': 41, 'core/coreunix/metadata_test.go': 33, 'exchange/bitswap/message/message_test.go': 5, 'exchange/bitswap/message/pb/Makefile': 1, 'fuse/ipns/common.go': 26, 'importer/balanced/balanced_test.go': 9, 'importer/chunk/rabin_test.go': 3, 'importer/helpers/dagbuilder.go': 13, 'importer/importer.go': 13, 'merkledag/utils/utils_test.go': 6, 'namesys/dns.go': 24, 'namesys/interface.go': 26, 'namesys/ipns_select_test.go': 5, 'namesys/proquint.go': 24, 'repo/config/identity.go': 3, 'test/sharness/t0600-issues-and-regressions-online.sh': 1, 'core/commands/get_test.go': 50, 'exchange/bitswap/message/message.go': 9, 'exchange/bitswap/network/interface.go': 9, 'p2p/registry.go': 12, 'repo/config/bootstrap_peers.go': 12, 'assets/assets.go': 31, 'blocks/blockstore/arc_cache.go': 2, 'blocks/blockstore/arc_cache_test.go': 2, 'blocks/blockstore/blockstore.go': 3, 'blocks/blockstore/blockstore_test.go': 2, 'blocks/blockstore/bloom_cache.go': 2, 'blocks/blockstore/bloom_cache_test.go': 2, 'blocks/blocksutil/block_generator.go': 2, 'blockservice/blockservice.go': 9, 'blockservice/blockservice_test.go': 7, 'blockservice/test/blocks_test.go': 8, 'core/builder.go': 33, 'core/commands/ipnsps.go': 9, 'core/coreapi/coreapi.go': 19, 'core/coreapi/interface/interface.go': 2, 'core/coreapi/unixfs.go': 33, 'core/coreapi/unixfs_test.go': 24, 'core/coredag/cbor.go': 13, 'core/coredag/dagpb.go': 23, 'core/coredag/dagtransl.go': 11, 'core/coredag/raw.go': 23, 'core/corehttp/corehttp.go': 13, 'core/corehttp/gateway_handler.go': 37, 'core/corerepo/gc.go': 33, 'core/corerepo/pinning.go': 14, 'core/coreunix/metadata.go': 29, 'core/pathresolver.go': 26, 'exchange/bitswap/bitswap.go': 8, 'exchange/bitswap/decision/engine.go': 8, 'exchange/bitswap/decision/ledger.go': 7, 'exchange/bitswap/decision/peer_request_queue.go': 7, 'exchange/bitswap/get.go': 7, 'exchange/bitswap/notifications/notifications.go': 4, 'exchange/bitswap/notifications/notifications_test.go': 4, 'exchange/bitswap/session.go': 8, 'exchange/bitswap/session_test.go': 6, 'exchange/bitswap/stat.go': 4, 'exchange/bitswap/wantlist/wantlist.go': 4, 'exchange/bitswap/wantlist/wantlist_test.go': 4, 'exchange/bitswap/wantmanager.go': 8, 'exchange/bitswap/workers.go': 7, 'exchange/interface.go': 2, 'exchange/offline/offline.go': 2, 'exchange/offline/offline_test.go': 2, 'exchange/reprovide/providers.go': 27, 'exchange/reprovide/reprovide.go': 22, 'filestore/filestore.go': 20, 'filestore/filestore_test.go': 26, 'filestore/fsrefstore.go': 19, 'filestore/util.go': 19, 'fuse/ipns/ipns_unix.go': 32, 'fuse/readonly/readonly_unix.go': 34, 'importer/balanced/builder.go': 4, 'importer/chunk/splitting_test.go': 2, 'importer/helpers/helpers.go': 5, 'importer/importer_test.go': 7, 'importer/trickle/trickle_test.go': 8, 'importer/trickle/trickledag.go': 5, 'merkledag/batch.go': 2, 'merkledag/coding.go': 5, 'merkledag/merkledag.go': 6, 'merkledag/merkledag_test.go': 9, 'merkledag/node.go': 5, 'merkledag/node_test.go': 5, 'merkledag/raw.go': 4, 'merkledag/traverse/traverse.go': 4, 'merkledag/traverse/traverse_test.go': 5, 'merkledag/utils/diff.go': 5, 'merkledag/utils/diffenum.go': 4, 'merkledag/utils/diffenum_test.go': 5, 'merkledag/utils/utils.go': 8, 'mfs/dir.go': 9, 'mfs/file.go': 11, 'mfs/mfs_test.go': 13, 'mfs/ops.go': 7, 'mfs/system.go': 12, 'namesys/namesys.go': 32, 'namesys/publisher.go': 33, 'namesys/pubsub.go': 6, 'namesys/pubsub_test.go': 5, 'namesys/republisher/repub.go': 25, 'namesys/routing.go': 33, 'path/path.go': 4, 'path/resolver.go': 4, 'path/resolver_test.go': 3, 'pin/gc/gc.go': 28, 'pin/pin.go': 28, 'pin/pin_test.go': 27, 'pin/set.go': 24, 'pin/set_test.go': 26, 'plugin/ipld.go': 11, 'plugin/loader/initializer.go': 9, 'plugin/plugins/git/git.go': 11, 'repo/config/init.go': 8, 'repo/fsrepo/fsrepo.go': 18, 'repo/fsrepo/lock/lock.go': 3, 'repo/fsrepo/serialize/serialize.go': 4, 'repo/mock.go': 13, 'repo/repo.go': 14, 'routing/offline/offline.go': 3, 'tar/format.go': 32, 'test/dependencies/ma-pipe-unidir/main.go': 8, 'thirdparty/ds-help/key.go': 2, 'thirdparty/pollEndpoint/main.go': 14, 'thirdparty/posinfo/posinfo.go': 2, 'unixfs/archive/archive.go': 5, 'unixfs/archive/tar/writer.go': 5, 'unixfs/hamt/hamt.go': 5, 'unixfs/io/dagreader.go': 5, 'unixfs/io/dirbuilder.go': 4, 'unixfs/io/resolve.go': 5, 'unixfs/mod/dagmodifier.go': 7, 'unixfs/mod/dagmodifier_test.go': 3, 'unixfs/test/utils.go': 8, 'commands/legacy/command.go': 34, 'commands/legacy/legacy.go': 34, 'commands/legacy/legacy_test.go': 35, 'commands/legacy/request.go': 36, 'commands/legacy/response.go': 35, 'commands/legacy/responseemitter.go': 4, 'core/commands/env.go': 4, 'core/commands/commands_test.go': 44, 'test/sharness/t0040-add-and-cat.sh': 1, 'TODO.md': 2, 'test/sharness/t0110-gateway.sh': 1, 'test/sharness/t0410-api-add.sh': 1, 'core/coreapi/dag.go': 11, 'core/coreapi/dag_test.go': 3, 'core/coreapi/interface/options/dag.go': 8, 'core/coreapi/key.go': 28, 'core/coreapi/name.go': 31, 'merkledag/test/utils.go': 7, 'namesys/namesys_test.go': 35, 'repo/fsrepo/datastores.go': 13, 'repo/fsrepo/fsrepo_test.go': 11, 'thirdparty/datastore2/datastore_closer.go': 1, 'thirdparty/datastore2/delayed.go': 1, 'thirdparty/datastore2/threadsafe.go': 1, 'unixfs/io/pbdagreader.go': 5, 'mfs/fd.go': 5, 'unixfs/hamt/hamt_stress_test.go': 3, 'unixfs/hamt/hamt_test.go': 3, 'unixfs/io/dagreader_test.go': 1, 'unixfs/io/dirbuilder_test.go': 1, 'cmd/ipfs/util/ulimit.go': 9, 'cmd/seccat/util.go': 9, 'core/corehttp/logs.go': 9, 'fuse/mount/mount.go': 10, 'fuse/node/mount_unix.go': 9, 'importer/chunk/splitting.go': 1, 'namesys/ipns_validate_test.go': 5, 'plugin/loader/load.go': 7, 'core/commands/files.go': 51, 'test/sharness/t0180-pubsub.sh': 1, 'core/commands/root_test.go': 1, 'test/sharness/t0090-get.sh': 1, 'core/coreapi/object.go': 30, 'fuse/mount/fuse.go': 3, 'keystore/keystore_test.go': 6, 'namesys/dns_test.go': 11, 'repo/config/config.go': 1, 'unixfs/unixfs.go': 1, 'blocks/blockstoreutil/remove.go': 17, 'blockservice/test/mock.go': 6, 'core/coreapi/pin.go': 28, 'keystore/keystore.go': 8, 'keystore/memkeystore.go': 5, 'namesys/validator.go': 3, 'path/resolver/resolver.go': 4, 'thirdparty/verifbs/verifbs.go': 17, 'cmd/ipfs/util/ulimit_freebsd.go': 2, 'cmd/ipfs/util/ulimit_unix.go': 2, 'core/coreapi/block.go': 18, 'core/coreapi/block_test.go': 2, 'core/coreapi/interface/coreapi.go': 7, 'core/coreapi/interface/dag.go': 7, 'core/coreapi/interface/object.go': 7, 'core/coreapi/interface/options/block.go': 3, 'core/coreapi/interface/path.go': 14, 'core/coreapi/interface/unixfs.go': 10, 'fuse/ipns/link_unix.go': 2, 'fuse/node/mount_darwin.go': 2, 'merkledag/errservice.go': 2, 'merkledag/readonly.go': 2, 'merkledag/readonly_test.go': 2, 'merkledag/rwservice.go': 2, 'merkledag/session.go': 2, 'path/resolver/resolver_test.go': 2, 'thirdparty/verifcid/validate.go': 2, 'thirdparty/verifcid/validate_test.go': 2, 'namesys/ipns_resolver_validation_test.go': 25, 'test/sharness/t0170-dht.sh': 1, 'core/commands/urlstore.go': 38, 'unixfs/io/directory.go': 1, 'core/corehttp/metrics.go': 2, 'core/coreapi/interface/key.go': 4, 'core/coreapi/name_test.go': 14, 'core/coreapi/path.go': 27, 'core/coreunix/cat.go': 9, 'core/pathresolver_test.go': 19, 'dagutils/diff.go': 23, 'dagutils/diffenum.go': 19, 'dagutils/diffenum_test.go': 19, 'dagutils/utils.go': 19, 'dagutils/utils_test.go': 19, 'filestore/pb/dataobj.pb.go': 3, 'namesys/base.go': 23, 'namesys/cache.go': 19, 'pin/internal/pb/header.pb.go': 3, 'thirdparty/cidv0v1/blockstore.go': 12, 'repo/fsrepo/config_test.go': 9, 'repo/fsrepo/misc.go': 9, 'test/bench/bench_cli_ipfs_add/main.go': 10, 'test/bench/offline_add/main.go': 10, 'core/commands/cmdenv/env.go': 33, 'core/commands/name/ipns.go': 37, 'core/commands/name/ipnsps.go': 24, 'core/commands/name/name.go': 22, 'core/commands/name/publish.go': 36, 'core/coreapi/dht.go': 17, 'core/coreapi/dht_test.go': 3, 'test/sharness/t0275-cid-security.sh': 1, 'test/sharness/lib/test-lib.sh': 1, 'core/coreapi/interface/dht.go': 3, 'p2p/listener.go': 6, 'p2p/local.go': 6, 'p2p/remote.go': 6, 'p2p/stream.go': 6, 'core/coreapi/interface/swarm.go': 2, 'core/coreapi/swarm.go': 14, 'core/commands/cid.go': 19, 'core/coreapi/interface/pubsub.go': 3, 'core/coreapi/pubsub.go': 14, 'core/coreapi/unixfile.go': 3, 'cmd/ipfs/dnsresolve_test.go': 3, 'core/coreapi/interface/options/unixfs.go': 2, 'test/dependencies/iptb/iptb.go': 8, 'commands/context.go': 18, 'core/commands/cmdenv/cidbase.go': 10, 'core/commands/cmdenv/file.go': 3, 'core/coreapi/interface/tests/name.go': 1, 'core/coreapi/interface/tests/unixfs.go': 1, 'core/coreapi/test/api_test.go': 11, 'core/corehttp/ipns_hostname.go': 11, 'plugin/daemon.go': 10, 'plugin/loader/loader.go': 11, 'core/corehttp/proxy.go': 6, 'plugin/plugins/badgerds/badgerds.go': 3, 'plugin/plugins/flatfs/flatfs.go': 3, 'plugin/plugins/levelds/levelds.go': 2, 'core/corerepo/stat.go': 2, 'core/commands/cmdenv/cidbase_test.go': 2, 'core/corehttp/proxy_test.go': 1, 'plugin/tracer.go': 1, 'thirdparty/notifier/notifier.go': 1, 'README.md': 1, 'go.mod': 1, 'go.sum': 1, 'package-list.json': 1, 'core/commands/pin/remotepin.go': 1}","('core/commands/add.go', 0.8202247191011236, 0.503448275862069)"
core/commands/refs.go,274,1653,13,"[{'cyclomatic_complexity': 2, 'nloc': 8, 'token_count': 64, 'name': 'KeyListTextMarshaler', 'long_name': 'KeyListTextMarshaler res cmds . Response', 'start_line': 26, 'end_line': 33, 'full_parameters': ['res cmds . Response'], 'filename': '/home/dimi/Documents/Informatik_Studium/FSS/SoftEvo/DataCollection/FFS_SoftEvo/go-ipfs/core/commands/refs.go', 'top_nesting_level': 0, 'length': 8, 'fan_in': 0, 'fan_out': 0, 'general_fan_out': 0}, {'cyclomatic_complexity': 3, 'nloc': 17, 'token_count': 82, 'name': '', 'long_name': '()', 'start_line': 109, 'end_line': 127, 'full_parameters': [], 'filename': '/home/dimi/Documents/Informatik_Studium/FSS/SoftEvo/DataCollection/FFS_SoftEvo/go-ipfs/core/commands/refs.go', 'top_nesting_level': 0, 'length': 19, 'fan_in': 0, 'fan_out': 0, 'general_fan_out': 0}, {'cyclomatic_complexity': 9, 'nloc': 44, 'token_count': 274, 'name': '', 'long_name': '(req cmds.Request,res cmds.Response)', 'start_line': 59, 'end_line': 128, 'full_parameters': [], 'filename': '/home/dimi/Documents/Informatik_Studium/FSS/SoftEvo/DataCollection/FFS_SoftEvo/go-ipfs/core/commands/refs.go', 'top_nesting_level': 0, 'length': 70, 'fan_in': 0, 'fan_out': 0, 'general_fan_out': 0}, {'cyclomatic_complexity': 2, 'nloc': 6, 'token_count': 31, 'name': '', 'long_name': '()', 'start_line': 159, 'end_line': 165, 'full_parameters': [], 'filename': '/home/dimi/Documents/Informatik_Studium/FSS/SoftEvo/DataCollection/FFS_SoftEvo/go-ipfs/core/commands/refs.go', 'top_nesting_level': 0, 'length': 7, 'fan_in': 0, 'fan_out': 0, 'general_fan_out': 0}, {'cyclomatic_complexity': 3, 'nloc': 16, 'token_count': 109, 'name': '', 'long_name': '(req cmds.Request,res cmds.Response)', 'start_line': 141, 'end_line': 166, 'full_parameters': [], 'filename': '/home/dimi/Documents/Informatik_Studium/FSS/SoftEvo/DataCollection/FFS_SoftEvo/go-ipfs/core/commands/refs.go', 'top_nesting_level': 0, 'length': 26, 'fan_in': 0, 'fan_out': 0, 'general_fan_out': 0}, {'cyclomatic_complexity': 3, 'nloc': 10, 'token_count': 71, 'name': '', 'long_name': '(v interface{})(io.Reader,error)', 'start_line': 178, 'end_line': 189, 'full_parameters': [], 'filename': '/home/dimi/Documents/Informatik_Studium/FSS/SoftEvo/DataCollection/FFS_SoftEvo/go-ipfs/core/commands/refs.go', 'top_nesting_level': 0, 'length': 12, 'fan_in': 0, 'fan_out': 0, 'general_fan_out': 0}, {'cyclomatic_complexity': 2, 'nloc': 12, 'token_count': 71, 'name': '', 'long_name': '(res cmds.Response)(io.Reader,error)', 'start_line': 172, 'end_line': 196, 'full_parameters': [], 'filename': '/home/dimi/Documents/Informatik_Studium/FSS/SoftEvo/DataCollection/FFS_SoftEvo/go-ipfs/core/commands/refs.go', 'top_nesting_level': 0, 'length': 25, 'fan_in': 0, 'fan_out': 0, 'general_fan_out': 0}, {'cyclomatic_complexity': 4, 'nloc': 15, 'token_count': 114, 'name': 'objectsForPaths', 'long_name': 'objectsForPaths ctx context . Context , n * core . IpfsNode , paths [ ] string', 'start_line': 199, 'end_line': 214, 'full_parameters': ['ctx context . Context', ' n * core . IpfsNode', ' paths [ ] string'], 'filename': '/home/dimi/Documents/Informatik_Studium/FSS/SoftEvo/DataCollection/FFS_SoftEvo/go-ipfs/core/commands/refs.go', 'top_nesting_level': 0, 'length': 16, 'fan_in': 0, 'fan_out': 0, 'general_fan_out': 0}, {'cyclomatic_complexity': 2, 'nloc': 6, 'token_count': 40, 'name': 'WriteRefs', 'long_name': '(rw*RefWriter)WriteRefs n node . Node', 'start_line': 234, 'end_line': 239, 'full_parameters': ['n node . Node'], 'filename': '/home/dimi/Documents/Informatik_Studium/FSS/SoftEvo/DataCollection/FFS_SoftEvo/go-ipfs/core/commands/refs.go', 'top_nesting_level': 0, 'length': 6, 'fan_in': 0, 'fan_out': 0, 'general_fan_out': 0}, {'cyclomatic_complexity': 6, 'nloc': 23, 'token_count': 155, 'name': 'writeRefsRecursive', 'long_name': '(rw*RefWriter)writeRefsRecursive n node . Node', 'start_line': 241, 'end_line': 267, 'full_parameters': ['n node . Node'], 'filename': '/home/dimi/Documents/Informatik_Studium/FSS/SoftEvo/DataCollection/FFS_SoftEvo/go-ipfs/core/commands/refs.go', 'top_nesting_level': 0, 'length': 27, 'fan_in': 0, 'fan_out': 0, 'general_fan_out': 0}, {'cyclomatic_complexity': 5, 'nloc': 18, 'token_count': 102, 'name': 'writeRefsSingle', 'long_name': '(rw*RefWriter)writeRefsSingle n node . Node', 'start_line': 269, 'end_line': 289, 'full_parameters': ['n node . Node'], 'filename': '/home/dimi/Documents/Informatik_Studium/FSS/SoftEvo/DataCollection/FFS_SoftEvo/go-ipfs/core/commands/refs.go', 'top_nesting_level': 0, 'length': 21, 'fan_in': 0, 'fan_out': 0, 'general_fan_out': 0}, {'cyclomatic_complexity': 4, 'nloc': 13, 'token_count': 68, 'name': 'skip', 'long_name': '(rw*RefWriter)skip c * cid . Cid', 'start_line': 292, 'end_line': 306, 'full_parameters': ['c * cid . Cid'], 'filename': '/home/dimi/Documents/Informatik_Studium/FSS/SoftEvo/DataCollection/FFS_SoftEvo/go-ipfs/core/commands/refs.go', 'top_nesting_level': 0, 'length': 15, 'fan_in': 0, 'fan_out': 0, 'general_fan_out': 0}, {'cyclomatic_complexity': 4, 'nloc': 21, 'token_count': 148, 'name': 'WriteEdge', 'long_name': '(rw*RefWriter)WriteEdge from , to * cid . Cid , linkname string', 'start_line': 309, 'end_line': 331, 'full_parameters': ['from', ' to * cid . Cid', ' linkname string'], 'filename': '/home/dimi/Documents/Informatik_Studium/FSS/SoftEvo/DataCollection/FFS_SoftEvo/go-ipfs/core/commands/refs.go', 'top_nesting_level': 0, 'length': 23, 'fan_in': 0, 'fan_out': 0, 'general_fan_out': 0}]",238,1445,1,"[{'cyclomatic_complexity': 3, 'nloc': 11, 'token_count': 94, 'name': 'objectsForPaths', 'long_name': 'objectsForPaths ctx context . Context , n iface . CoreAPI , paths [ ] string', 'start_line': 169, 'end_line': 179, 'full_parameters': ['ctx context . Context', ' n iface . CoreAPI', ' paths [ ] string'], 'filename': '/home/dimi/Documents/Informatik_Studium/FSS/SoftEvo/DataCollection/FFS_SoftEvo/go-ipfs/core/commands/refs.go', 'top_nesting_level': 0, 'length': 11, 'fan_in': 0, 'fan_out': 0, 'general_fan_out': 0}]",-36,-208,-12,78,78,"[{'timestamp': 1491058697.0, 'added_lines': 40, 'deleted_lines': 38, 'nloc': 275}, {'timestamp': 1499331469.0, 'added_lines': 3, 'deleted_lines': 3, 'nloc': 275}, {'timestamp': 1511223906.0, 'added_lines': 1, 'deleted_lines': 1, 'nloc': 275}, {'timestamp': 1511245249.0, 'added_lines': 1, 'deleted_lines': 1, 'nloc': 275}, {'timestamp': 1512365669.0, 'added_lines': 3, 'deleted_lines': 3, 'nloc': 275}, {'timestamp': 1511187070.0, 'added_lines': 1, 'deleted_lines': 1, 'nloc': 275}, {'timestamp': 1513436097.0, 'added_lines': 1, 'deleted_lines': 1, 'nloc': 275}, {'timestamp': 1513612261.0, 'added_lines': 1, 'deleted_lines': 1, 'nloc': 275}, {'timestamp': 1515277696.0, 'added_lines': 1, 'deleted_lines': 1, 'nloc': 275}, {'timestamp': 1516838128.0, 'added_lines': 2, 'deleted_lines': 2, 'nloc': 275}, {'timestamp': 1516911711.0, 'added_lines': 2, 'deleted_lines': 3, 'nloc': 274}, {'timestamp': 1517255734.0, 'added_lines': 8, 'deleted_lines': 8, 'nloc': 274}, {'timestamp': 1521427288.0, 'added_lines': 1, 'deleted_lines': 1, 'nloc': 274}, {'timestamp': 1526326693.0, 'added_lines': 9, 'deleted_lines': 2, 'nloc': 281}, {'timestamp': 1528520460.0, 'added_lines': 3, 'deleted_lines': 3, 'nloc': 281}, {'timestamp': 1531779409.0, 'added_lines': 2, 'deleted_lines': 2, 'nloc': 281}, {'timestamp': 1532847462.0, 'added_lines': 1, 'deleted_lines': 1, 'nloc': 281}, {'timestamp': 1533500571.0, 'added_lines': 1, 'deleted_lines': 1, 'nloc': 281}, {'timestamp': 1533618653.0, 'added_lines': 1, 'deleted_lines': 1, 'nloc': 281}, {'timestamp': 1533779477.0, 'added_lines': 1, 'deleted_lines': 1, 'nloc': 281}, {'timestamp': 1533946888.0, 'added_lines': 1, 'deleted_lines': 1, 'nloc': 281}, {'timestamp': 1534115707.0, 'added_lines': 3, 'deleted_lines': 3, 'nloc': 281}, {'timestamp': 1534195762.0, 'added_lines': 1, 'deleted_lines': 1, 'nloc': 281}, {'timestamp': 1534347022.0, 'added_lines': 3, 'deleted_lines': 3, 'nloc': 281}, {'timestamp': 1534896611.0, 'added_lines': 4, 'deleted_lines': 4, 'nloc': 281}, {'timestamp': 1533291524.0, 'added_lines': 107, 'deleted_lines': 55, 'nloc': 282}, {'timestamp': 1535601896.0, 'added_lines': 1, 'deleted_lines': 1, 'nloc': 282}, {'timestamp': 1536388808.0, 'added_lines': 1, 'deleted_lines': 1, 'nloc': 282}, {'timestamp': 1536718784.0, 'added_lines': 6, 'deleted_lines': 6, 'nloc': 282}, {'timestamp': 1536723292.0, 'added_lines': 1, 'deleted_lines': 1, 'nloc': 282}, {'timestamp': 1537790637.0, 'added_lines': 1, 'deleted_lines': 1, 'nloc': 282}, {'timestamp': 1537792589.0, 'added_lines': 1, 'deleted_lines': 1, 'nloc': 282}, {'timestamp': 1538544957.0, 'added_lines': 1, 'deleted_lines': 1, 'nloc': 282}, {'timestamp': 1538694687.0, 'added_lines': 1, 'deleted_lines': 1, 'nloc': 282}, {'timestamp': 1538695953.0, 'added_lines': 1, 'deleted_lines': 1, 'nloc': 282}, {'timestamp': 1538662493.0, 'added_lines': 18, 'deleted_lines': 10, 'nloc': 289}, {'timestamp': 1538773916.0, 'added_lines': 1, 'deleted_lines': 1, 'nloc': 289}, {'timestamp': 1539176817.0, 'added_lines': 1, 'deleted_lines': 1, 'nloc': 289}, {'timestamp': 1539357340.0, 'added_lines': 1, 'deleted_lines': 1, 'nloc': 289}, {'timestamp': 1539850591.0, 'added_lines': 1, 'deleted_lines': 1, 'nloc': 289}, {'timestamp': 1540400358.0, 'added_lines': 1, 'deleted_lines': 1, 'nloc': 289}, {'timestamp': 1540410565.0, 'added_lines': 1, 'deleted_lines': 1, 'nloc': 289}, {'timestamp': 1540418491.0, 'added_lines': 1, 'deleted_lines': 1, 'nloc': 289}, {'timestamp': 1540603818.0, 'added_lines': 2, 'deleted_lines': 2, 'nloc': 289}, {'timestamp': 1540916861.0, 'added_lines': 1, 'deleted_lines': 1, 'nloc': 289}, {'timestamp': 1541189794.0, 'added_lines': 1, 'deleted_lines': 1, 'nloc': 289}, {'timestamp': 1541204121.0, 'added_lines': 3, 'deleted_lines': 3, 'nloc': 289}, {'timestamp': 1540644903.0, 'added_lines': 52, 'deleted_lines': 58, 'nloc': 282}, {'timestamp': 1540651944.0, 'added_lines': 6, 'deleted_lines': 13, 'nloc': 277}, {'timestamp': 1541472719.0, 'added_lines': 22, 'deleted_lines': 66, 'nloc': 240}, {'timestamp': 1541581116.0, 'added_lines': 16, 'deleted_lines': 25, 'nloc': 233}, {'timestamp': 1541903826.0, 'added_lines': 1, 'deleted_lines': 1, 'nloc': 233}, {'timestamp': 1543443696.0, 'added_lines': 1, 'deleted_lines': 1, 'nloc': 233}, {'timestamp': 1544225843.0, 'added_lines': 1, 'deleted_lines': 1, 'nloc': 233}, {'timestamp': 1544661332.0, 'added_lines': 1, 'deleted_lines': 1, 'nloc': 233}, {'timestamp': 1540556089.0, 'added_lines': 1, 'deleted_lines': 1, 'nloc': 233}, {'timestamp': 1547003974.0, 'added_lines': 1, 'deleted_lines': 1, 'nloc': 233}, {'timestamp': 1547152271.0, 'added_lines': 1, 'deleted_lines': 1, 'nloc': 233}, {'timestamp': 1542878205.0, 'added_lines': 16, 'deleted_lines': 10, 'nloc': 238}, {'timestamp': 1547499910.0, 'added_lines': 2, 'deleted_lines': 2, 'nloc': 238}, {'timestamp': 1548866534.0, 'added_lines': 1, 'deleted_lines': 1, 'nloc': 238}, {'timestamp': 1549588289.0, 'added_lines': 1, 'deleted_lines': 1, 'nloc': 238}, {'timestamp': 1549903582.0, 'added_lines': 1, 'deleted_lines': 1, 'nloc': 238}, {'timestamp': 1550185115.0, 'added_lines': 1, 'deleted_lines': 1, 'nloc': 238}, {'timestamp': 1550507829.0, 'added_lines': 2, 'deleted_lines': 2, 'nloc': 238}, {'timestamp': 1550610741.0, 'added_lines': 1, 'deleted_lines': 1, 'nloc': 238}, {'timestamp': 1550711994.0, 'added_lines': 1, 'deleted_lines': 1, 'nloc': 238}, {'timestamp': 1550723346.0, 'added_lines': 4, 'deleted_lines': 4, 'nloc': 238}, {'timestamp': 1551138343.0, 'added_lines': 1, 'deleted_lines': 1, 'nloc': 238}, {'timestamp': 1551229859.0, 'added_lines': 1, 'deleted_lines': 1, 'nloc': 238}, {'timestamp': 1551299964.0, 'added_lines': 2, 'deleted_lines': 2, 'nloc': 238}, {'timestamp': 1551471469.0, 'added_lines': 1, 'deleted_lines': 1, 'nloc': 238}, {'timestamp': 1551551196.0, 'added_lines': 6, 'deleted_lines': 6, 'nloc': 238}, {'timestamp': 1554256305.0, 'added_lines': 2, 'deleted_lines': 1, 'nloc': 239}, {'timestamp': 1557554420.0, 'added_lines': 10, 'deleted_lines': 11, 'nloc': 238}, {'timestamp': 1566437146.0, 'added_lines': 7, 'deleted_lines': 13, 'nloc': 233}, {'timestamp': 1590711120.0, 'added_lines': 14, 'deleted_lines': 8, 'nloc': 238}, {'timestamp': 1590711120.0, 'added_lines': 14, 'deleted_lines': 8, 'nloc': 238}]","{'blocks/blockstore/caching.go': 1, 'blocks/blockstore/util/remove.go': 3, 'cmd/ipfs/daemon.go': 32, 'cmd/ipfs/init.go': 37, 'cmd/ipfs/ipfs.go': 25, 'cmd/ipfs/main.go': 35, 'cmd/ipfs/main_test.go': 4, 'cmd/ipfswatch/main.go': 20, 'cmd/seccat/seccat.go': 24, None: 18, 'commands/channelmarshaler.go': 1, 'commands/cli/cmd_suggestion.go': 1, 'commands/cli/helptext.go': 3, 'commands/cli/helptext_test.go': 2, 'commands/cli/parse.go': 2, 'commands/cli/parse_test.go': 2, 'commands/command.go': 15, 'commands/command_test.go': 8, 'commands/http/client.go': 2, 'commands/http/handler.go': 2, 'commands/http/multifilereader.go': 2, 'commands/http/multifilereader_test.go': 2, 'commands/http/parse.go': 2, 'commands/reqlog.go': 1, 'commands/request.go': 21, 'commands/response.go': 12, 'commands/response_test.go': 8, 'core/bootstrap.go': 22, 'core/commands/active.go': 25, 'core/commands/add.go': 48, 'core/commands/bitswap.go': 58, 'core/commands/block.go': 39, 'core/commands/bootstrap.go': 34, 'core/commands/cat.go': 32, 'core/commands/commands.go': 28, 'core/commands/config.go': 35, 'core/commands/dag/dag.go': 67, 'core/commands/dht.go': 66, 'core/commands/diag.go': 23, 'core/commands/dns.go': 30, 'core/commands/e/error.go': 1, 'core/commands/external.go': 23, 'core/commands/files/files.go': 12, 'core/commands/filestore.go': 35, 'core/commands/get.go': 62, 'core/commands/helptext_test.go': 25, 'core/commands/id.go': 45, 'core/commands/ipns.go': 16, 'core/commands/keystore.go': 32, 'core/commands/log.go': 26, 'core/commands/ls.go': 65, 'core/commands/mount_nofuse.go': 23, 'core/commands/mount_unix.go': 34, 'core/commands/mount_windows.go': 22, 'core/commands/name.go': 10, 'core/commands/object/diff.go': 29, 'core/commands/object/object.go': 65, 'core/commands/object/patch.go': 33, 'core/commands/p2p.go': 37, 'core/commands/pin.go': 65, 'core/commands/ping.go': 41, 'core/commands/publish.go': 19, 'core/commands/pubsub.go': 42, 'core/commands/repo.go': 47, 'core/commands/resolve.go': 62, 'core/commands/root.go': 31, 'core/commands/shutdown.go': 26, 'core/commands/stat.go': 34, 'core/commands/swarm.go': 43, 'core/commands/sysdiag.go': 28, 'core/commands/tar.go': 62, 'core/commands/unixfs/ls.go': 58, 'core/commands/unixfs/unixfs.go': 23, 'core/commands/version.go': 26, 'core/core_test.go': 17, 'core/corehttp/commands.go': 59, 'core/corehttp/gateway.go': 31, 'core/coreunix/add.go': 56, 'core/coreunix/add_test.go': 54, 'core/coreunix/metadata_test.go': 50, 'exchange/bitswap/bitswap_test.go': 6, 'exchange/bitswap/decision/engine_test.go': 6, 'exchange/bitswap/message/message_test.go': 5, 'exchange/bitswap/message/pb/Makefile': 1, 'exchange/bitswap/testnet/network_test.go': 6, 'exchange/bitswap/testnet/peernet.go': 6, 'exchange/reprovide/reprovide_test.go': 31, 'fuse/ipns/common.go': 46, 'fuse/node/mount_test.go': 29, 'importer/balanced/balanced_test.go': 7, 'importer/chunk/rabin_test.go': 3, 'importer/helpers/dagbuilder.go': 13, 'importer/importer.go': 12, 'merkledag/utils/utils_test.go': 7, 'mfs/repub_test.go': 9, 'namesys/dns.go': 42, 'namesys/interface.go': 42, 'namesys/ipns_select_test.go': 4, 'namesys/proquint.go': 42, 'namesys/republisher/repub_test.go': 45, 'package.json': 59, 'repo/config/identity.go': 2, 'routing/offline/offline_test.go': 4, 'test/integration/addcat_test.go': 32, 'test/integration/bench_cat_test.go': 31, 'test/integration/bitswap_wo_routing_test.go': 33, 'test/integration/three_legged_cat_test.go': 31, 'core/bootstrap_test.go': 21, 'core/commands/dht_test.go': 20, 'core/commands/get_test.go': 26, 'core/core.go': 52, 'core/corehttp/gateway_test.go': 47, 'core/corehttp/metrics_test.go': 28, 'core/mock/mock.go': 29, 'exchange/bitswap/decision/bench_test.go': 5, 'exchange/bitswap/decision/peer_request_queue_test.go': 5, 'exchange/bitswap/message/message.go': 5, 'exchange/bitswap/network/interface.go': 5, 'exchange/bitswap/network/ipfs_impl.go': 5, 'exchange/bitswap/testnet/interface.go': 4, 'exchange/bitswap/testnet/virtual.go': 5, 'exchange/bitswap/testutils.go': 5, 'fuse/ipns/ipns_test.go': 28, 'fuse/readonly/ipfs_test.go': 50, 'namesys/publisher_test.go': 29, 'namesys/resolve_test.go': 45, 'p2p/p2p.go': 21, 'p2p/registry.go': 8, 'repo/config/bootstrap_peers.go': 5, 'routing/mock/centralized_client.go': 3, 'routing/mock/centralized_server.go': 3, 'routing/mock/centralized_test.go': 3, 'routing/mock/interface.go': 3, 'routing/none/none_client.go': 3, 'test/integration/bench_test.go': 15, 'assets/assets.go': 46, 'blocks/blockstore/arc_cache.go': 2, 'blocks/blockstore/arc_cache_test.go': 2, 'blocks/blockstore/blockstore.go': 2, 'blocks/blockstore/blockstore_test.go': 2, 'blocks/blockstore/bloom_cache.go': 2, 'blocks/blockstore/bloom_cache_test.go': 2, 'blocks/blocksutil/block_generator.go': 2, 'blockservice/blockservice.go': 5, 'blockservice/blockservice_test.go': 4, 'blockservice/test/blocks_test.go': 5, 'core/builder.go': 50, 'core/commands/ipnsps.go': 8, 'core/coreapi/coreapi.go': 25, 'core/coreapi/interface/interface.go': 2, 'core/coreapi/unixfs.go': 50, 'core/coreapi/unixfs_test.go': 36, 'core/coredag/cbor.go': 18, 'core/coredag/dagpb.go': 43, 'core/coredag/dagtransl.go': 15, 'core/coredag/raw.go': 43, 'core/corehttp/corehttp.go': 11, 'core/corehttp/gateway_handler.go': 53, 'core/corerepo/gc.go': 46, 'core/corerepo/pinning.go': 21, 'core/coreunix/metadata.go': 48, 'core/pathresolver.go': 46, 'exchange/bitswap/bitswap.go': 5, 'exchange/bitswap/decision/engine.go': 4, 'exchange/bitswap/decision/ledger.go': 5, 'exchange/bitswap/decision/peer_request_queue.go': 4, 'exchange/bitswap/get.go': 4, 'exchange/bitswap/notifications/notifications.go': 4, 'exchange/bitswap/notifications/notifications_test.go': 4, 'exchange/bitswap/session.go': 4, 'exchange/bitswap/session_test.go': 4, 'exchange/bitswap/stat.go': 4, 'exchange/bitswap/wantlist/wantlist.go': 4, 'exchange/bitswap/wantlist/wantlist_test.go': 4, 'exchange/bitswap/wantmanager.go': 4, 'exchange/bitswap/workers.go': 4, 'exchange/interface.go': 2, 'exchange/offline/offline.go': 2, 'exchange/offline/offline_test.go': 2, 'exchange/reprovide/providers.go': 44, 'exchange/reprovide/reprovide.go': 25, 'filestore/filestore.go': 23, 'filestore/filestore_test.go': 42, 'filestore/fsrefstore.go': 23, 'filestore/util.go': 22, 'fuse/ipns/ipns_unix.go': 50, 'fuse/readonly/readonly_unix.go': 51, 'importer/balanced/builder.go': 5, 'importer/chunk/splitting_test.go': 2, 'importer/helpers/helpers.go': 6, 'importer/importer_test.go': 6, 'importer/trickle/trickle_test.go': 6, 'importer/trickle/trickledag.go': 6, 'merkledag/batch.go': 2, 'merkledag/coding.go': 5, 'merkledag/merkledag.go': 6, 'merkledag/merkledag_test.go': 6, 'merkledag/node.go': 6, 'merkledag/node_test.go': 6, 'merkledag/raw.go': 6, 'merkledag/traverse/traverse.go': 5, 'merkledag/traverse/traverse_test.go': 6, 'merkledag/utils/diff.go': 6, 'merkledag/utils/diffenum.go': 5, 'merkledag/utils/diffenum_test.go': 6, 'merkledag/utils/utils.go': 6, 'mfs/dir.go': 13, 'mfs/file.go': 13, 'mfs/mfs_test.go': 14, 'mfs/ops.go': 12, 'mfs/system.go': 13, 'namesys/namesys.go': 45, 'namesys/publisher.go': 49, 'namesys/pubsub.go': 3, 'namesys/pubsub_test.go': 2, 'namesys/republisher/repub.go': 43, 'namesys/routing.go': 45, 'path/path.go': 4, 'path/resolver.go': 4, 'path/resolver_test.go': 4, 'pin/gc/gc.go': 44, 'pin/pin.go': 45, 'pin/pin_test.go': 43, 'pin/set.go': 45, 'pin/set_test.go': 42, 'plugin/ipld.go': 14, 'plugin/loader/initializer.go': 11, 'plugin/plugins/git/git.go': 13, 'repo/config/init.go': 4, 'repo/fsrepo/fsrepo.go': 21, 'repo/fsrepo/lock/lock.go': 2, 'repo/fsrepo/serialize/serialize.go': 3, 'repo/mock.go': 16, 'repo/repo.go': 19, 'routing/offline/offline.go': 2, 'tar/format.go': 51, 'test/dependencies/ma-pipe-unidir/main.go': 8, 'thirdparty/ds-help/key.go': 2, 'thirdparty/pollEndpoint/main.go': 11, 'thirdparty/posinfo/posinfo.go': 3, 'unixfs/archive/archive.go': 6, 'unixfs/archive/tar/writer.go': 6, 'unixfs/hamt/hamt.go': 6, 'unixfs/io/dagreader.go': 6, 'unixfs/io/dirbuilder.go': 5, 'unixfs/io/resolve.go': 6, 'unixfs/mod/dagmodifier.go': 7, 'unixfs/mod/dagmodifier_test.go': 3, 'unixfs/test/utils.go': 6, 'commands/legacy/command.go': 11, 'commands/legacy/legacy.go': 11, 'commands/legacy/legacy_test.go': 12, 'commands/legacy/request.go': 12, 'commands/legacy/response.go': 12, 'commands/legacy/responseemitter.go': 4, 'core/commands/env.go': 4, 'TODO.md': 2, 'core/commands/commands_test.go': 21, 'test/sharness/t0110-gateway.sh': 1, 'test/sharness/t0410-api-add.sh': 1, 'core/coreapi/dag.go': 15, 'core/coreapi/dag_test.go': 3, 'core/coreapi/interface/options/dag.go': 8, 'core/coreapi/key.go': 43, 'core/coreapi/name.go': 44, 'merkledag/test/utils.go': 5, 'namesys/namesys_test.go': 48, 'repo/fsrepo/datastores.go': 12, 'repo/fsrepo/fsrepo_test.go': 17, 'thirdparty/datastore2/datastore_closer.go': 1, 'thirdparty/datastore2/delayed.go': 1, 'thirdparty/datastore2/threadsafe.go': 1, 'unixfs/io/pbdagreader.go': 5, 'mfs/fd.go': 8, 'unixfs/hamt/hamt_stress_test.go': 4, 'unixfs/hamt/hamt_test.go': 4, 'unixfs/io/dagreader_test.go': 1, 'unixfs/io/dirbuilder_test.go': 1, 'CHANGELOG.md': 1, 'README.md': 2, 'bin/dist_get': 1, 'cmd/ipfs/util/ulimit_freebsd.go': 3, 'contribute.md': 1, 'core/coreapi/interface/options/pin.go': 1, 'docs/experimental-features.md': 1, 'docs/file-transfer.md': 1, 'docs/releases.md': 1, 'exchange/bitswap/README.md': 1, 'plugin/plugin.go': 1, 'repo/fsrepo/migrations/mfsr_test.go': 1, 'repo/fsrepo/migrations/migrations.go': 1, 'test/sharness/README.md': 1, 'thirdparty/dir/dir.go': 1, 'blocks/blockstoreutil/remove.go': 19, 'blockservice/test/mock.go': 2, 'cmd/ipfs/util/ulimit.go': 6, 'cmd/ipfs/util/ulimit_unix.go': 2, 'cmd/seccat/util.go': 6, 'core/commands/files.go': 55, 'core/coreapi/block.go': 15, 'core/coreapi/block_test.go': 2, 'core/coreapi/interface/coreapi.go': 9, 'core/coreapi/interface/dag.go': 9, 'core/coreapi/interface/object.go': 9, 'core/coreapi/interface/options/block.go': 3, 'core/coreapi/interface/path.go': 35, 'core/coreapi/interface/unixfs.go': 13, 'core/coreapi/object.go': 45, 'core/coreapi/pin.go': 41, 'core/corehttp/logs.go': 6, 'fuse/ipns/link_unix.go': 2, 'fuse/mount/fuse.go': 2, 'fuse/mount/mount.go': 6, 'fuse/node/mount_darwin.go': 2, 'fuse/node/mount_unix.go': 6, 'keystore/keystore.go': 6, 'merkledag/errservice.go': 2, 'merkledag/readonly.go': 2, 'merkledag/readonly_test.go': 2, 'merkledag/rwservice.go': 2, 'merkledag/session.go': 2, 'namesys/ipns_validate_test.go': 1, 'namesys/validator.go': 1, 'path/resolver/resolver.go': 2, 'path/resolver/resolver_test.go': 2, 'plugin/loader/load.go': 4, 'thirdparty/verifbs/verifbs.go': 19, 'thirdparty/verifcid/validate.go': 2, 'thirdparty/verifcid/validate_test.go': 2, 'core/commands/urlstore.go': 51, 'namesys/ipns_resolver_validation_test.go': 42, 'unixfs/io/directory.go': 1, 'core/coreapi/name_test.go': 32, 'core/coreapi/path.go': 46, 'core/coreunix/cat.go': 15, 'core/pathresolver_test.go': 40, 'dagutils/utils.go': 40, 'dagutils/utils_test.go': 40, 'namesys/base.go': 41, 'namesys/cache.go': 40, 'dagutils/diff.go': 39, 'dagutils/diffenum.go': 38, 'dagutils/diffenum_test.go': 38, 'core/coreapi/interface/key.go': 7, 'filestore/pb/dataobj.pb.go': 3, 'keystore/keystore_test.go': 4, 'keystore/memkeystore.go': 4, 'pin/internal/pb/header.pb.go': 3, 'thirdparty/cidv0v1/blockstore.go': 16, 'repo/fsrepo/config_test.go': 13, 'repo/fsrepo/misc.go': 13, 'test/bench/bench_cli_ipfs_add/main.go': 14, 'test/bench/offline_add/main.go': 14, 'core/commands/cmdenv/env.go': 25, 'core/commands/name/ipns.go': 42, 'core/commands/name/publish.go': 25, 'core/coreapi/dht.go': 30, 'core/coreapi/dht_test.go': 5, 'test/sharness/t0275-cid-security.sh': 1, 'core/commands/name/ipnsps.go': 19, 'core/commands/name/name.go': 15, 'core/coreapi/interface/dht.go': 10, 'p2p/listener.go': 13, 'p2p/local.go': 13, 'p2p/remote.go': 13, 'p2p/stream.go': 13, 'core/coreapi/interface/swarm.go': 9, 'core/coreapi/swarm.go': 20, 'core/commands/cid.go': 16, 'core/coreapi/interface/options/unixfs.go': 15, 'core/coreapi/pubsub.go': 18, 'core/coreapi/unixfile.go': 16, 'cmd/ipfs/dnsresolve_test.go': 5, 'core/coreapi/interface/pubsub.go': 4, 'test/dependencies/iptb/iptb.go': 12, 'plugin/plugins/badgerds/badgerds.go': 4, 'plugin/plugins/flatfs/flatfs.go': 4, 'plugin/plugins/levelds/levelds.go': 3, 'commands/context.go': 18, 'core/corehttp/proxy.go': 9, 'core/coreapi/interface/tests/name.go': 4, 'core/coreapi/interface/tests/unixfs.go': 4, 'core/coreapi/test/api_test.go': 10, 'core/commands/cmdenv/cidbase.go': 11, 'core/commands/cmdenv/cidbase_test.go': 3, 'test/sharness/t0040-add-and-cat.sh': 1, 'test/sharness/t0045-ls.sh': 1, 'test/sharness/t0051-object-data/mixed.json': 1, 'test/sharness/t0051-object.sh': 1, 'test/sharness/t0053-dag.sh': 1, 'test/sharness/t0085-pins.sh': 1, 'test/sharness/t0095-refs.sh': 1, 'test/sharness/t0160-resolve.sh': 1, 'test/sharness/t0210-tar.sh': 1, 'test/sharness/t0250-files-api.sh': 1, 'test/sharness/t0271-filestore-utils.sh': 1, 'test/sharness/t0272-urlstore.sh': 1, 'plugin/loader/loader.go': 9, 'core/commands/cmdenv/file.go': 3, 'core/corehttp/ipns_hostname.go': 8, 'namesys/dns_test.go': 8, 'plugin/daemon.go': 8, 'core/corerepo/stat.go': 2, 'core/corehttp/metrics.go': 1, 'core/corehttp/proxy_test.go': 1, 'plugin/tracer.go': 1, 'thirdparty/notifier/notifier.go': 1, 'namesys/resolve/pathresolver_test.go': 1, 'namesys/resolve/resolve.go': 1, 'go.mod': 2, 'go.sum': 1, 'package-list.json': 1}","('core/commands/dag/dag.go', 0.8589743589743589, 0.5583333333333333)"
core/commands/repo.go,336,2123,14,"[{'cyclomatic_complexity': 1, 'nloc': 3, 'token_count': 20, 'name': '', 'long_name': '(k*cid.Cid)', 'start_line': 93, 'end_line': 95, 'full_parameters': [], 'filename': '/home/dimi/Documents/Informatik_Studium/FSS/SoftEvo/DataCollection/FFS_SoftEvo/go-ipfs/core/commands/repo.go', 'top_nesting_level': 0, 'length': 3, 'fan_in': 0, 'fan_out': 0, 'general_fan_out': 0}, {'cyclomatic_complexity': 6, 'nloc': 22, 'token_count': 120, 'name': '', 'long_name': '()', 'start_line': 77, 'end_line': 100, 'full_parameters': [], 'filename': '/home/dimi/Documents/Informatik_Studium/FSS/SoftEvo/DataCollection/FFS_SoftEvo/go-ipfs/core/commands/repo.go', 'top_nesting_level': 0, 'length': 24, 'fan_in': 0, 'fan_out': 0, 'general_fan_out': 0}, {'cyclomatic_complexity': 2, 'nloc': 12, 'token_count': 112, 'name': '', 'long_name': '(req cmds.Request,res cmds.Response)', 'start_line': 63, 'end_line': 101, 'full_parameters': [], 'filename': '/home/dimi/Documents/Informatik_Studium/FSS/SoftEvo/DataCollection/FFS_SoftEvo/go-ipfs/core/commands/repo.go', 'top_nesting_level': 0, 'length': 39, 'fan_in': 0, 'fan_out': 0, 'general_fan_out': 0}, {'cyclomatic_complexity': 4, 'nloc': 15, 'token_count': 109, 'name': '', 'long_name': '(v interface{})(io.Reader,error)', 'start_line': 115, 'end_line': 131, 'full_parameters': [], 'filename': '/home/dimi/Documents/Informatik_Studium/FSS/SoftEvo/DataCollection/FFS_SoftEvo/go-ipfs/core/commands/repo.go', 'top_nesting_level': 0, 'length': 17, 'fan_in': 0, 'fan_out': 0, 'general_fan_out': 0}, {'cyclomatic_complexity': 3, 'nloc': 16, 'token_count': 101, 'name': '', 'long_name': '(res cmds.Response)(io.Reader,error)', 'start_line': 104, 'end_line': 138, 'full_parameters': [], 'filename': '/home/dimi/Documents/Informatik_Studium/FSS/SoftEvo/DataCollection/FFS_SoftEvo/go-ipfs/core/commands/repo.go', 'top_nesting_level': 0, 'length': 35, 'fan_in': 0, 'fan_out': 0, 'general_fan_out': 0}, {'cyclomatic_complexity': 3, 'nloc': 13, 'token_count': 83, 'name': '', 'long_name': '(req cmds.Request,res cmds.Response)', 'start_line': 154, 'end_line': 168, 'full_parameters': [], 'filename': '/home/dimi/Documents/Informatik_Studium/FSS/SoftEvo/DataCollection/FFS_SoftEvo/go-ipfs/core/commands/repo.go', 'top_nesting_level': 0, 'length': 15, 'fan_in': 0, 'fan_out': 0, 'general_fan_out': 0}, {'cyclomatic_complexity': 7, 'nloc': 29, 'token_count': 234, 'name': '', 'long_name': '(res cmds.Response)(io.Reader,error)', 'start_line': 174, 'end_line': 205, 'full_parameters': [], 'filename': '/home/dimi/Documents/Informatik_Studium/FSS/SoftEvo/DataCollection/FFS_SoftEvo/go-ipfs/core/commands/repo.go', 'top_nesting_level': 0, 'length': 32, 'fan_in': 0, 'fan_out': 0, 'general_fan_out': 0}, {'cyclomatic_complexity': 8, 'nloc': 30, 'token_count': 215, 'name': '', 'long_name': '(req cmds.Request,res cmds.Response)', 'start_line': 218, 'end_line': 252, 'full_parameters': [], 'filename': '/home/dimi/Documents/Informatik_Studium/FSS/SoftEvo/DataCollection/FFS_SoftEvo/go-ipfs/core/commands/repo.go', 'top_nesting_level': 0, 'length': 35, 'fan_in': 0, 'fan_out': 0, 'general_fan_out': 0}, {'cyclomatic_complexity': 5, 'nloc': 28, 'token_count': 149, 'name': '', 'long_name': '()', 'start_line': 276, 'end_line': 306, 'full_parameters': [], 'filename': '/home/dimi/Documents/Informatik_Studium/FSS/SoftEvo/DataCollection/FFS_SoftEvo/go-ipfs/core/commands/repo.go', 'top_nesting_level': 0, 'length': 31, 'fan_in': 0, 'fan_out': 0, 'general_fan_out': 0}, {'cyclomatic_complexity': 2, 'nloc': 10, 'token_count': 73, 'name': '', 'long_name': '(req cmds.Request,res cmds.Response)', 'start_line': 268, 'end_line': 309, 'full_parameters': [], 'filename': '/home/dimi/Documents/Informatik_Studium/FSS/SoftEvo/DataCollection/FFS_SoftEvo/go-ipfs/core/commands/repo.go', 'top_nesting_level': 0, 'length': 42, 'fan_in': 0, 'fan_out': 0, 'general_fan_out': 0}, {'cyclomatic_complexity': 5, 'nloc': 19, 'token_count': 125, 'name': '', 'long_name': '(v interface{})(io.Reader,error)', 'start_line': 315, 'end_line': 335, 'full_parameters': [], 'filename': '/home/dimi/Documents/Informatik_Studium/FSS/SoftEvo/DataCollection/FFS_SoftEvo/go-ipfs/core/commands/repo.go', 'top_nesting_level': 0, 'length': 21, 'fan_in': 0, 'fan_out': 0, 'general_fan_out': 0}, {'cyclomatic_complexity': 1, 'nloc': 9, 'token_count': 56, 'name': '', 'long_name': '(res cmds.Response)(io.Reader,error)', 'start_line': 312, 'end_line': 342, 'full_parameters': [], 'filename': '/home/dimi/Documents/Informatik_Studium/FSS/SoftEvo/DataCollection/FFS_SoftEvo/go-ipfs/core/commands/repo.go', 'top_nesting_level': 0, 'length': 31, 'fan_in': 0, 'fan_out': 0, 'general_fan_out': 0}, {'cyclomatic_complexity': 1, 'nloc': 5, 'token_count': 34, 'name': '', 'long_name': '(req cmds.Request,res cmds.Response)', 'start_line': 357, 'end_line': 361, 'full_parameters': [], 'filename': '/home/dimi/Documents/Informatik_Studium/FSS/SoftEvo/DataCollection/FFS_SoftEvo/go-ipfs/core/commands/repo.go', 'top_nesting_level': 0, 'length': 5, 'fan_in': 0, 'fan_out': 0, 'general_fan_out': 0}, {'cyclomatic_complexity': 3, 'nloc': 14, 'token_count': 111, 'name': '', 'long_name': '(res cmds.Response)(io.Reader,error)', 'start_line': 364, 'end_line': 380, 'full_parameters': [], 'filename': '/home/dimi/Documents/Informatik_Studium/FSS/SoftEvo/DataCollection/FFS_SoftEvo/go-ipfs/core/commands/repo.go', 'top_nesting_level': 0, 'length': 17, 'fan_in': 0, 'fan_out': 0, 'general_fan_out': 0}]",319,1909,5,"[{'cyclomatic_complexity': 1, 'nloc': 3, 'token_count': 23, 'name': '', 'long_name': '(k cid.Cid)', 'start_line': 97, 'end_line': 102, 'full_parameters': [], 'filename': '/home/dimi/Documents/Informatik_Studium/FSS/SoftEvo/DataCollection/FFS_SoftEvo/go-ipfs/core/commands/repo.go', 'top_nesting_level': 0, 'length': 6, 'fan_in': 0, 'fan_out': 0, 'general_fan_out': 0}, {'cyclomatic_complexity': 2, 'nloc': 7, 'token_count': 44, 'name': '', 'long_name': '(name string,size uint64)', 'start_line': 187, 'end_line': 194, 'full_parameters': [], 'filename': '/home/dimi/Documents/Informatik_Studium/FSS/SoftEvo/DataCollection/FFS_SoftEvo/go-ipfs/core/commands/repo.go', 'top_nesting_level': 0, 'length': 8, 'fan_in': 0, 'fan_out': 0, 'general_fan_out': 0}, {'cyclomatic_complexity': 7, 'nloc': 19, 'token_count': 112, 'name': 'verifyWorkerRun', 'long_name': 'verifyWorkerRun ctx context . Context , wg * sync . WaitGroup , keys < - chan cid . Cid , results chan < - string , bs bstore . Blockstore', 'start_line': 238, 'end_line': 259, 'full_parameters': ['ctx context . Context', ' wg * sync . WaitGroup', ' keys < - chan cid . Cid', ' results chan < - string', ' bs bstore . Blockstore'], 'filename': '/home/dimi/Documents/Informatik_Studium/FSS/SoftEvo/DataCollection/FFS_SoftEvo/go-ipfs/core/commands/repo.go', 'top_nesting_level': 0, 'length': 22, 'fan_in': 0, 'fan_out': 0, 'general_fan_out': 0}, {'cyclomatic_complexity': 2, 'nloc': 9, 'token_count': 59, 'name': '', 'long_name': '()', 'start_line': 264, 'end_line': 275, 'full_parameters': [], 'filename': '/home/dimi/Documents/Informatik_Studium/FSS/SoftEvo/DataCollection/FFS_SoftEvo/go-ipfs/core/commands/repo.go', 'top_nesting_level': 0, 'length': 12, 'fan_in': 0, 'fan_out': 0, 'general_fan_out': 0}, {'cyclomatic_complexity': 1, 'nloc': 5, 'token_count': 40, 'name': 'verifyResultChan', 'long_name': 'verifyResultChan ctx context . Context , keys < - chan cid . Cid , bs bstore . Blockstore', 'start_line': 261, 'end_line': 278, 'full_parameters': ['ctx context . Context', ' keys < - chan cid . Cid', ' bs bstore . Blockstore'], 'filename': '/home/dimi/Documents/Informatik_Studium/FSS/SoftEvo/DataCollection/FFS_SoftEvo/go-ipfs/core/commands/repo.go', 'top_nesting_level': 0, 'length': 18, 'fan_in': 0, 'fan_out': 0, 'general_fan_out': 0}]",-17,-214,-9,107,107,"[{'timestamp': 1491058697.0, 'added_lines': 132, 'deleted_lines': 131, 'nloc': 336}, {'timestamp': 1508770239.0, 'added_lines': 2, 'deleted_lines': 2, 'nloc': 336}, {'timestamp': 1509016767.0, 'added_lines': 1, 'deleted_lines': 1, 'nloc': 336}, {'timestamp': 1499331469.0, 'added_lines': 3, 'deleted_lines': 3, 'nloc': 336}, {'timestamp': 1511223906.0, 'added_lines': 2, 'deleted_lines': 2, 'nloc': 336}, {'timestamp': 1511307596.0, 'added_lines': 29, 'deleted_lines': 6, 'nloc': 359}, {'timestamp': 1511373659.0, 'added_lines': 1, 'deleted_lines': 1, 'nloc': 359}, {'timestamp': 1512365669.0, 'added_lines': 3, 'deleted_lines': 3, 'nloc': 359}, {'timestamp': 1511187070.0, 'added_lines': 13, 'deleted_lines': 17, 'nloc': 355}, {'timestamp': 1512121226.0, 'added_lines': 1, 'deleted_lines': 1, 'nloc': 355}, {'timestamp': 1513436097.0, 'added_lines': 2, 'deleted_lines': 2, 'nloc': 355}, {'timestamp': 1513612261.0, 'added_lines': 2, 'deleted_lines': 2, 'nloc': 355}, {'timestamp': 1513764708.0, 'added_lines': 1, 'deleted_lines': 1, 'nloc': 355}, {'timestamp': 1513765470.0, 'added_lines': 1, 'deleted_lines': 1, 'nloc': 355}, {'timestamp': 1513766201.0, 'added_lines': 1, 'deleted_lines': 1, 'nloc': 355}, {'timestamp': 1513772654.0, 'added_lines': 1, 'deleted_lines': 1, 'nloc': 355}, {'timestamp': 1513773452.0, 'added_lines': 1, 'deleted_lines': 1, 'nloc': 355}, {'timestamp': 1515277696.0, 'added_lines': 1, 'deleted_lines': 1, 'nloc': 355}, {'timestamp': 1515465466.0, 'added_lines': 2, 'deleted_lines': 2, 'nloc': 355}, {'timestamp': 1515713724.0, 'added_lines': 1, 'deleted_lines': 1, 'nloc': 355}, {'timestamp': 1516341168.0, 'added_lines': 1, 'deleted_lines': 1, 'nloc': 355}, {'timestamp': 1516838128.0, 'added_lines': 2, 'deleted_lines': 2, 'nloc': 355}, {'timestamp': 1517105039.0, 'added_lines': 1, 'deleted_lines': 1, 'nloc': 355}, {'timestamp': 1517453697.0, 'added_lines': 1, 'deleted_lines': 1, 'nloc': 355}, {'timestamp': 1518714221.0, 'added_lines': 2, 'deleted_lines': 2, 'nloc': 355}, {'timestamp': 1519173780.0, 'added_lines': 1, 'deleted_lines': 1, 'nloc': 355}, {'timestamp': 1521314540.0, 'added_lines': 1, 'deleted_lines': 1, 'nloc': 355}, {'timestamp': 1521500314.0, 'added_lines': 1, 'deleted_lines': 1, 'nloc': 355}, {'timestamp': 1519761835.0, 'added_lines': 1, 'deleted_lines': 1, 'nloc': 355}, {'timestamp': 1517406188.0, 'added_lines': 1, 'deleted_lines': 2, 'nloc': 354}, {'timestamp': 1524596476.0, 'added_lines': 1, 'deleted_lines': 1, 'nloc': 354}, {'timestamp': 1525408792.0, 'added_lines': 2, 'deleted_lines': 2, 'nloc': 354}, {'timestamp': 1528520460.0, 'added_lines': 4, 'deleted_lines': 4, 'nloc': 354}, {'timestamp': 1529984485.0, 'added_lines': 2, 'deleted_lines': 2, 'nloc': 354}, {'timestamp': 1515171178.0, 'added_lines': 28, 'deleted_lines': 11, 'nloc': 365}, {'timestamp': 1528974765.0, 'added_lines': 28, 'deleted_lines': 25, 'nloc': 370}, {'timestamp': 1529051853.0, 'added_lines': 0, 'deleted_lines': 1, 'nloc': 369}, {'timestamp': 1531779409.0, 'added_lines': 2, 'deleted_lines': 2, 'nloc': 369}, {'timestamp': 1532146078.0, 'added_lines': 1, 'deleted_lines': 1, 'nloc': 369}, {'timestamp': 1533618653.0, 'added_lines': 1, 'deleted_lines': 1, 'nloc': 369}, {'timestamp': 1533779477.0, 'added_lines': 2, 'deleted_lines': 2, 'nloc': 369}, {'timestamp': 1532357069.0, 'added_lines': 1, 'deleted_lines': 1, 'nloc': 369}, {'timestamp': 1532365899.0, 'added_lines': 1, 'deleted_lines': 1, 'nloc': 369}, {'timestamp': 1532388583.0, 'added_lines': 1, 'deleted_lines': 1, 'nloc': 369}, {'timestamp': 1533809170.0, 'added_lines': 1, 'deleted_lines': 1, 'nloc': 369}, {'timestamp': 1533946888.0, 'added_lines': 2, 'deleted_lines': 2, 'nloc': 369}, {'timestamp': 1534115707.0, 'added_lines': 2, 'deleted_lines': 2, 'nloc': 369}, {'timestamp': 1534195762.0, 'added_lines': 1, 'deleted_lines': 1, 'nloc': 369}, {'timestamp': 1534347022.0, 'added_lines': 2, 'deleted_lines': 2, 'nloc': 369}, {'timestamp': 1534072974.0, 'added_lines': 1, 'deleted_lines': 1, 'nloc': 369}, {'timestamp': 1534896611.0, 'added_lines': 5, 'deleted_lines': 5, 'nloc': 369}, {'timestamp': 1534903410.0, 'added_lines': 2, 'deleted_lines': 1, 'nloc': 370}, {'timestamp': 1535255498.0, 'added_lines': 1, 'deleted_lines': 1, 'nloc': 370}, {'timestamp': 1535601896.0, 'added_lines': 1, 'deleted_lines': 1, 'nloc': 370}, {'timestamp': 1536388808.0, 'added_lines': 2, 'deleted_lines': 2, 'nloc': 370}, {'timestamp': 1536718784.0, 'added_lines': 4, 'deleted_lines': 4, 'nloc': 370}, {'timestamp': 1536723292.0, 'added_lines': 1, 'deleted_lines': 1, 'nloc': 370}, {'timestamp': 1523628870.0, 'added_lines': 8, 'deleted_lines': 11, 'nloc': 367}, {'timestamp': 1535044155.0, 'added_lines': 1, 'deleted_lines': 1, 'nloc': 367}, {'timestamp': 1537193530.0, 'added_lines': 1, 'deleted_lines': 1, 'nloc': 367}, {'timestamp': 1537354376.0, 'added_lines': 2, 'deleted_lines': 1, 'nloc': 368}, {'timestamp': 1537356048.0, 'added_lines': 41, 'deleted_lines': 65, 'nloc': 346}, {'timestamp': 1537391809.0, 'added_lines': 1, 'deleted_lines': 1, 'nloc': 346}, {'timestamp': 1537792589.0, 'added_lines': 3, 'deleted_lines': 3, 'nloc': 346}, {'timestamp': 1538544957.0, 'added_lines': 2, 'deleted_lines': 2, 'nloc': 346}, {'timestamp': 1538547366.0, 'added_lines': 1, 'deleted_lines': 1, 'nloc': 346}, {'timestamp': 1538662493.0, 'added_lines': 20, 'deleted_lines': 10, 'nloc': 354}, {'timestamp': 1538773916.0, 'added_lines': 1, 'deleted_lines': 1, 'nloc': 354}, {'timestamp': 1539850591.0, 'added_lines': 2, 'deleted_lines': 2, 'nloc': 354}, {'timestamp': 1540400358.0, 'added_lines': 1, 'deleted_lines': 1, 'nloc': 354}, {'timestamp': 1540489644.0, 'added_lines': 1, 'deleted_lines': 1, 'nloc': 354}, {'timestamp': 1540552487.0, 'added_lines': 1, 'deleted_lines': 1, 'nloc': 354}, {'timestamp': 1540597832.0, 'added_lines': 1, 'deleted_lines': 1, 'nloc': 354}, {'timestamp': 1540799354.0, 'added_lines': 6, 'deleted_lines': 2, 'nloc': 358}, {'timestamp': 1541147225.0, 'added_lines': 50, 'deleted_lines': 6, 'nloc': 391}, {'timestamp': 1541204121.0, 'added_lines': 4, 'deleted_lines': 4, 'nloc': 391}, {'timestamp': 1540618782.0, 'added_lines': 28, 'deleted_lines': 40, 'nloc': 381}, {'timestamp': 1540698369.0, 'added_lines': 24, 'deleted_lines': 51, 'nloc': 356}, {'timestamp': 1540867737.0, 'added_lines': 2, 'deleted_lines': 2, 'nloc': 356}, {'timestamp': 1541822268.0, 'added_lines': 5, 'deleted_lines': 16, 'nloc': 347}, {'timestamp': 1541903826.0, 'added_lines': 1, 'deleted_lines': 1, 'nloc': 347}, {'timestamp': 1543282933.0, 'added_lines': 1, 'deleted_lines': 1, 'nloc': 347}, {'timestamp': 1544225843.0, 'added_lines': 1, 'deleted_lines': 1, 'nloc': 347}, {'timestamp': 1544661332.0, 'added_lines': 1, 'deleted_lines': 1, 'nloc': 347}, {'timestamp': 1540556089.0, 'added_lines': 1, 'deleted_lines': 1, 'nloc': 347}, {'timestamp': 1545323704.0, 'added_lines': 1, 'deleted_lines': 1, 'nloc': 347}, {'timestamp': 1546553605.0, 'added_lines': 1, 'deleted_lines': 1, 'nloc': 347}, {'timestamp': 1547003974.0, 'added_lines': 1, 'deleted_lines': 1, 'nloc': 347}, {'timestamp': 1547152271.0, 'added_lines': 1, 'deleted_lines': 1, 'nloc': 347}, {'timestamp': 1548866534.0, 'added_lines': 1, 'deleted_lines': 1, 'nloc': 347}, {'timestamp': 1549588289.0, 'added_lines': 1, 'deleted_lines': 1, 'nloc': 347}, {'timestamp': 1549903582.0, 'added_lines': 1, 'deleted_lines': 1, 'nloc': 347}, {'timestamp': 1550507829.0, 'added_lines': 3, 'deleted_lines': 3, 'nloc': 347}, {'timestamp': 1550610741.0, 'added_lines': 1, 'deleted_lines': 1, 'nloc': 347}, {'timestamp': 1550723346.0, 'added_lines': 2, 'deleted_lines': 2, 'nloc': 347}, {'timestamp': 1551138343.0, 'added_lines': 1, 'deleted_lines': 1, 'nloc': 347}, {'timestamp': 1551229859.0, 'added_lines': 1, 'deleted_lines': 1, 'nloc': 347}, {'timestamp': 1551299964.0, 'added_lines': 1, 'deleted_lines': 1, 'nloc': 347}, {'timestamp': 1551471469.0, 'added_lines': 1, 'deleted_lines': 1, 'nloc': 347}, {'timestamp': 1551551196.0, 'added_lines': 5, 'deleted_lines': 5, 'nloc': 347}, {'timestamp': 1553096144.0, 'added_lines': 7, 'deleted_lines': 6, 'nloc': 347}, {'timestamp': 1553697989.0, 'added_lines': 7, 'deleted_lines': 5, 'nloc': 346}, {'timestamp': 1557554420.0, 'added_lines': 14, 'deleted_lines': 15, 'nloc': 345}, {'timestamp': 1561799730.0, 'added_lines': 2, 'deleted_lines': 37, 'nloc': 315}, {'timestamp': 1574034718.0, 'added_lines': 2, 'deleted_lines': 2, 'nloc': 315}, {'timestamp': 1595277534.0, 'added_lines': 1, 'deleted_lines': 0, 'nloc': 316}, {'timestamp': 1615490447.0, 'added_lines': 4, 'deleted_lines': 0, 'nloc': 319}]","{'blocks/blockstore/caching.go': 1, 'blocks/blockstore/util/remove.go': 3, 'cmd/ipfs/daemon.go': 60, 'cmd/ipfs/init.go': 56, 'cmd/ipfs/ipfs.go': 52, 'cmd/ipfs/main.go': 73, 'cmd/ipfs/main_test.go': 4, 'cmd/ipfswatch/main.go': 35, 'cmd/seccat/seccat.go': 25, None: 23, 'commands/channelmarshaler.go': 1, 'commands/cli/cmd_suggestion.go': 1, 'commands/cli/helptext.go': 2, 'commands/cli/helptext_test.go': 2, 'commands/cli/parse.go': 2, 'commands/cli/parse_test.go': 2, 'commands/command.go': 29, 'commands/command_test.go': 20, 'commands/http/client.go': 2, 'commands/http/handler.go': 2, 'commands/http/multifilereader.go': 2, 'commands/http/multifilereader_test.go': 2, 'commands/http/parse.go': 2, 'commands/reqlog.go': 2, 'commands/request.go': 50, 'commands/response.go': 24, 'commands/response_test.go': 20, 'core/bootstrap.go': 36, 'core/commands/active.go': 26, 'core/commands/add.go': 70, 'core/commands/bitswap.go': 74, 'core/commands/block.go': 63, 'core/commands/bootstrap.go': 45, 'core/commands/cat.go': 57, 'core/commands/commands.go': 56, 'core/commands/config.go': 49, 'core/commands/dag/dag.go': 48, 'core/commands/dht.go': 53, 'core/commands/diag.go': 23, 'core/commands/dns.go': 30, 'core/commands/e/error.go': 1, 'core/commands/external.go': 24, 'core/commands/files/files.go': 11, 'core/commands/filestore.go': 61, 'core/commands/get.go': 73, 'core/commands/helptext_test.go': 51, 'core/commands/id.go': 46, 'core/commands/ipns.go': 19, 'core/commands/keystore.go': 42, 'core/commands/log.go': 30, 'core/commands/ls.go': 49, 'core/commands/mount_nofuse.go': 23, 'core/commands/mount_unix.go': 45, 'core/commands/mount_windows.go': 22, 'core/commands/name.go': 10, 'core/commands/object/diff.go': 26, 'core/commands/object/object.go': 57, 'core/commands/object/patch.go': 42, 'core/commands/p2p.go': 39, 'core/commands/pin.go': 50, 'core/commands/ping.go': 42, 'core/commands/publish.go': 19, 'core/commands/pubsub.go': 66, 'core/commands/refs.go': 47, 'core/commands/resolve.go': 50, 'core/commands/root.go': 55, 'core/commands/shutdown.go': 33, 'core/commands/stat.go': 60, 'core/commands/swarm.go': 60, 'core/commands/sysdiag.go': 31, 'core/commands/tar.go': 44, 'core/commands/unixfs/ls.go': 43, 'core/commands/unixfs/unixfs.go': 23, 'core/commands/version.go': 30, 'core/core_test.go': 28, 'core/corehttp/commands.go': 80, 'core/corehttp/gateway.go': 31, 'core/coreunix/add.go': 45, 'core/coreunix/add_test.go': 55, 'core/coreunix/metadata_test.go': 40, 'exchange/bitswap/bitswap_test.go': 14, 'exchange/bitswap/decision/engine_test.go': 12, 'exchange/bitswap/message/message_test.go': 5, 'exchange/bitswap/message/pb/Makefile': 1, 'exchange/bitswap/testnet/network_test.go': 10, 'exchange/bitswap/testnet/peernet.go': 12, 'exchange/reprovide/reprovide_test.go': 36, 'fuse/ipns/common.go': 31, 'fuse/node/mount_test.go': 31, 'importer/balanced/balanced_test.go': 7, 'importer/chunk/rabin_test.go': 3, 'importer/helpers/dagbuilder.go': 12, 'importer/importer.go': 12, 'merkledag/utils/utils_test.go': 5, 'mfs/repub_test.go': 12, 'namesys/dns.go': 26, 'namesys/interface.go': 27, 'namesys/ipns_select_test.go': 5, 'namesys/proquint.go': 26, 'namesys/republisher/repub_test.go': 36, 'package.json': 84, 'repo/config/identity.go': 3, 'routing/offline/offline_test.go': 6, 'test/integration/addcat_test.go': 32, 'test/integration/bench_cat_test.go': 31, 'test/integration/bitswap_wo_routing_test.go': 33, 'test/integration/three_legged_cat_test.go': 31, 'test/sharness/t0600-issues-and-regressions-online.sh': 1, 'core/bootstrap_test.go': 33, 'core/commands/dht_test.go': 22, 'core/commands/get_test.go': 50, 'core/core.go': 53, 'core/corehttp/gateway_test.go': 46, 'core/corehttp/metrics_test.go': 27, 'core/mock/mock.go': 38, 'exchange/bitswap/decision/bench_test.go': 8, 'exchange/bitswap/decision/peer_request_queue_test.go': 8, 'exchange/bitswap/message/message.go': 8, 'exchange/bitswap/network/interface.go': 8, 'exchange/bitswap/network/ipfs_impl.go': 8, 'exchange/bitswap/testnet/interface.go': 7, 'exchange/bitswap/testnet/virtual.go': 9, 'exchange/bitswap/testutils.go': 12, 'fuse/ipns/ipns_test.go': 31, 'fuse/readonly/ipfs_test.go': 38, 'namesys/publisher_test.go': 31, 'namesys/resolve_test.go': 33, 'p2p/p2p.go': 23, 'p2p/registry.go': 11, 'repo/config/bootstrap_peers.go': 10, 'routing/mock/centralized_client.go': 4, 'routing/mock/centralized_server.go': 4, 'routing/mock/centralized_test.go': 4, 'routing/mock/interface.go': 4, 'routing/none/none_client.go': 4, 'test/integration/bench_test.go': 18, 'assets/assets.go': 32, 'blocks/blockstore/arc_cache.go': 2, 'blocks/blockstore/arc_cache_test.go': 2, 'blocks/blockstore/blockstore.go': 3, 'blocks/blockstore/blockstore_test.go': 2, 'blocks/blockstore/bloom_cache.go': 2, 'blocks/blockstore/bloom_cache_test.go': 2, 'blocks/blocksutil/block_generator.go': 2, 'blockservice/blockservice.go': 10, 'blockservice/blockservice_test.go': 9, 'blockservice/test/blocks_test.go': 9, 'core/builder.go': 51, 'core/commands/ipnsps.go': 9, 'core/coreapi/coreapi.go': 16, 'core/coreapi/interface/interface.go': 2, 'core/coreapi/unixfs.go': 34, 'core/coreapi/unixfs_test.go': 36, 'core/coredag/cbor.go': 12, 'core/coredag/dagpb.go': 28, 'core/coredag/dagtransl.go': 11, 'core/coredag/raw.go': 28, 'core/corehttp/corehttp.go': 14, 'core/corehttp/gateway_handler.go': 37, 'core/corerepo/gc.go': 35, 'core/corerepo/pinning.go': 17, 'core/coreunix/metadata.go': 33, 'core/pathresolver.go': 31, 'exchange/bitswap/bitswap.go': 10, 'exchange/bitswap/decision/engine.go': 10, 'exchange/bitswap/decision/ledger.go': 7, 'exchange/bitswap/decision/peer_request_queue.go': 7, 'exchange/bitswap/get.go': 9, 'exchange/bitswap/notifications/notifications.go': 4, 'exchange/bitswap/notifications/notifications_test.go': 4, 'exchange/bitswap/session.go': 8, 'exchange/bitswap/session_test.go': 6, 'exchange/bitswap/stat.go': 4, 'exchange/bitswap/wantlist/wantlist.go': 4, 'exchange/bitswap/wantlist/wantlist_test.go': 4, 'exchange/bitswap/wantmanager.go': 8, 'exchange/bitswap/workers.go': 7, 'exchange/interface.go': 2, 'exchange/offline/offline.go': 4, 'exchange/offline/offline_test.go': 4, 'exchange/reprovide/providers.go': 33, 'exchange/reprovide/reprovide.go': 26, 'filestore/filestore.go': 27, 'filestore/filestore_test.go': 33, 'filestore/fsrefstore.go': 26, 'filestore/util.go': 26, 'fuse/ipns/ipns_unix.go': 36, 'fuse/readonly/readonly_unix.go': 37, 'importer/balanced/builder.go': 4, 'importer/chunk/splitting_test.go': 2, 'importer/helpers/helpers.go': 4, 'importer/importer_test.go': 6, 'importer/trickle/trickle_test.go': 6, 'importer/trickle/trickledag.go': 4, 'merkledag/batch.go': 2, 'merkledag/coding.go': 4, 'merkledag/merkledag.go': 4, 'merkledag/merkledag_test.go': 7, 'merkledag/node.go': 4, 'merkledag/node_test.go': 4, 'merkledag/raw.go': 4, 'merkledag/traverse/traverse.go': 4, 'merkledag/traverse/traverse_test.go': 4, 'merkledag/utils/diff.go': 4, 'merkledag/utils/diffenum.go': 4, 'merkledag/utils/diffenum_test.go': 4, 'merkledag/utils/utils.go': 9, 'mfs/dir.go': 10, 'mfs/file.go': 12, 'mfs/mfs_test.go': 15, 'mfs/ops.go': 9, 'mfs/system.go': 13, 'namesys/namesys.go': 35, 'namesys/publisher.go': 37, 'namesys/pubsub.go': 6, 'namesys/pubsub_test.go': 6, 'namesys/republisher/repub.go': 31, 'namesys/routing.go': 34, 'path/path.go': 4, 'path/resolver.go': 3, 'path/resolver_test.go': 2, 'pin/gc/gc.go': 34, 'pin/pin.go': 32, 'pin/pin_test.go': 34, 'pin/set.go': 28, 'pin/set_test.go': 33, 'plugin/ipld.go': 11, 'plugin/loader/initializer.go': 9, 'plugin/plugins/git/git.go': 11, 'repo/config/init.go': 7, 'repo/fsrepo/fsrepo.go': 38, 'repo/fsrepo/lock/lock.go': 3, 'repo/fsrepo/serialize/serialize.go': 3, 'repo/mock.go': 28, 'repo/repo.go': 33, 'routing/offline/offline.go': 3, 'tar/format.go': 36, 'test/dependencies/ma-pipe-unidir/main.go': 10, 'thirdparty/ds-help/key.go': 2, 'thirdparty/pollEndpoint/main.go': 14, 'thirdparty/posinfo/posinfo.go': 2, 'unixfs/archive/archive.go': 4, 'unixfs/archive/tar/writer.go': 4, 'unixfs/hamt/hamt.go': 4, 'unixfs/io/dagreader.go': 4, 'unixfs/io/dirbuilder.go': 3, 'unixfs/io/resolve.go': 4, 'unixfs/mod/dagmodifier.go': 6, 'unixfs/mod/dagmodifier_test.go': 3, 'unixfs/test/utils.go': 6, 'commands/legacy/command.go': 34, 'commands/legacy/legacy.go': 34, 'commands/legacy/legacy_test.go': 35, 'commands/legacy/request.go': 35, 'commands/legacy/response.go': 35, 'commands/legacy/responseemitter.go': 4, 'core/commands/env.go': 9, 'core/commands/commands_test.go': 44, 'test/sharness/t0040-add-and-cat.sh': 1, 'TODO.md': 2, 'test/sharness/t0110-gateway.sh': 1, 'test/sharness/t0410-api-add.sh': 1, 'core/coreapi/dag.go': 10, 'core/coreapi/dag_test.go': 3, 'core/coreapi/interface/options/dag.go': 8, 'core/coreapi/key.go': 30, 'core/coreapi/name.go': 32, 'merkledag/test/utils.go': 8, 'namesys/namesys_test.go': 36, 'repo/fsrepo/datastores.go': 17, 'repo/fsrepo/fsrepo_test.go': 29, 'thirdparty/datastore2/datastore_closer.go': 2, 'thirdparty/datastore2/delayed.go': 2, 'thirdparty/datastore2/threadsafe.go': 2, 'unixfs/io/pbdagreader.go': 3, 'cmd/ipfs/util/ulimit.go': 9, 'cmd/seccat/util.go': 9, 'core/corehttp/logs.go': 9, 'fuse/mount/mount.go': 9, 'fuse/node/mount_unix.go': 10, 'importer/chunk/splitting.go': 1, 'namesys/ipns_validate_test.go': 4, 'plugin/loader/load.go': 7, 'blocks/blockstoreutil/remove.go': 24, 'core/coreapi/block.go': 14, 'core/commands/files.go': 53, 'core/commands/root_test.go': 1, 'test/sharness/t0090-get.sh': 1, 'blockservice/test/mock.go': 5, 'namesys/validator.go': 3, 'core/coreapi/pin.go': 30, 'keystore/keystore.go': 8, 'keystore/keystore_test.go': 6, 'keystore/memkeystore.go': 5, 'path/resolver/resolver.go': 4, 'thirdparty/verifbs/verifbs.go': 22, 'cmd/ipfs/util/ulimit_freebsd.go': 2, 'cmd/ipfs/util/ulimit_unix.go': 2, 'core/coreapi/block_test.go': 2, 'core/coreapi/interface/coreapi.go': 7, 'core/coreapi/interface/dag.go': 7, 'core/coreapi/interface/object.go': 7, 'core/coreapi/interface/options/block.go': 3, 'core/coreapi/interface/path.go': 21, 'core/coreapi/interface/unixfs.go': 11, 'core/coreapi/object.go': 31, 'fuse/ipns/link_unix.go': 2, 'fuse/mount/fuse.go': 3, 'fuse/node/mount_darwin.go': 2, 'merkledag/errservice.go': 2, 'merkledag/readonly.go': 2, 'merkledag/readonly_test.go': 2, 'merkledag/rwservice.go': 2, 'merkledag/session.go': 2, 'path/resolver/resolver_test.go': 2, 'thirdparty/verifcid/validate.go': 2, 'thirdparty/verifcid/validate_test.go': 2, 'unixfs/hamt/hamt_stress_test.go': 2, 'unixfs/hamt/hamt_test.go': 2, 'namesys/ipns_resolver_validation_test.go': 27, 'test/sharness/t0170-dht.sh': 1, 'core/corerepo/stat.go': 4, 'core/commands/urlstore.go': 43, 'unixfs/io/directory.go': 1, 'core/corehttp/metrics.go': 2, 'core/coreapi/name_test.go': 19, 'core/coreapi/path.go': 29, 'core/coreunix/cat.go': 12, 'core/pathresolver_test.go': 24, 'dagutils/diff.go': 26, 'dagutils/diffenum.go': 24, 'dagutils/diffenum_test.go': 24, 'dagutils/utils.go': 25, 'dagutils/utils_test.go': 24, 'mfs/fd.go': 6, 'namesys/base.go': 25, 'namesys/cache.go': 24, 'core/coreapi/interface/key.go': 7, 'filestore/pb/dataobj.pb.go': 3, 'pin/internal/pb/header.pb.go': 3, 'thirdparty/cidv0v1/blockstore.go': 16, 'repo/fsrepo/misc.go': 24, 'cmd/ipfs/Rules.mk': 1, 'core/corehttp/option_test.go': 2, 'docs/releases.md': 1, 'docs/windows.md': 1, 'repo/fsrepo/config_test.go': 23, 'repo/version.go': 1, 'test/bench/bench_cli_ipfs_add/main.go': 25, 'test/bench/offline_add/main.go': 25, 'core/commands/cmdenv/env.go': 36, 'core/commands/name/ipns.go': 36, 'core/commands/name/ipnsps.go': 27, 'core/commands/name/name.go': 22, 'core/commands/name/publish.go': 30, 'core/coreapi/dht.go': 17, 'core/coreapi/dht_test.go': 5, 'test/sharness/t0275-cid-security.sh': 1, 'test/sharness/lib/test-lib.sh': 1, 'core/coreapi/interface/dht.go': 9, 'p2p/listener.go': 12, 'p2p/local.go': 12, 'p2p/remote.go': 13, 'p2p/stream.go': 13, 'core/coreapi/interface/swarm.go': 8, 'core/coreapi/swarm.go': 15, 'core/commands/cid.go': 21, 'core/coreapi/interface/options/unixfs.go': 7, 'core/coreapi/pubsub.go': 15, 'core/coreapi/unixfile.go': 8, 'cmd/ipfs/dnsresolve_test.go': 5, 'core/coreapi/interface/pubsub.go': 4, 'test/sharness/t0180-pubsub.sh': 1, 'test/dependencies/iptb/iptb.go': 13, 'plugin/plugins/badgerds/badgerds.go': 4, 'plugin/plugins/flatfs/flatfs.go': 4, 'plugin/plugins/levelds/levelds.go': 3, 'commands/context.go': 18, 'core/corehttp/proxy.go': 8, 'core/coreapi/test/api_test.go': 9, 'core/coreapi/interface/tests/name.go': 3, 'core/coreapi/interface/tests/unixfs.go': 3, 'core/commands/cmdenv/cidbase.go': 10, 'core/commands/cmdenv/file.go': 3, 'core/corehttp/ipns_hostname.go': 6, 'namesys/dns_test.go': 6, 'plugin/daemon.go': 6, 'plugin/loader/loader.go': 7, 'core/commands/cmdenv/cidbase_test.go': 2, 'core/corehttp/proxy_test.go': 1, 'plugin/tracer.go': 1, 'thirdparty/notifier/notifier.go': 1, 'core/corehttp/mutex_profile.go': 1, 'provider/queue.go': 1, 'provider/queue_test.go': 1, 'README.md': 1, 'go.mod': 2, 'go.sum': 2, 'package-list.json': 1, 'cmd/ipfs/rotate.go': 1, 'core/commands/extra.go': 1}","('core/corehttp/commands.go', 0.7476635514018691, 0.6837606837606838)"
core/commands/resolve.go,96,629,2,"[{'cyclomatic_complexity': 10, 'nloc': 37, 'token_count': 261, 'name': '', 'long_name': '(req cmds.Request,res cmds.Response)', 'start_line': 64, 'end_line': 111, 'full_parameters': [], 'filename': '/home/dimi/Documents/Informatik_Studium/FSS/SoftEvo/DataCollection/FFS_SoftEvo/go-ipfs/core/commands/resolve.go', 'top_nesting_level': 0, 'length': 48, 'fan_in': 0, 'fan_out': 0, 'general_fan_out': 0}, {'cyclomatic_complexity': 2, 'nloc': 7, 'token_count': 60, 'name': '', 'long_name': '(res cmds.Response)(io.Reader,error)', 'start_line': 113, 'end_line': 119, 'full_parameters': [], 'filename': '/home/dimi/Documents/Informatik_Studium/FSS/SoftEvo/DataCollection/FFS_SoftEvo/go-ipfs/core/commands/resolve.go', 'top_nesting_level': 0, 'length': 7, 'fan_in': 0, 'fan_out': 0, 'general_fan_out': 0}]",123,813,0,[],27,184,-2,91,91,"[{'timestamp': 1491058697.0, 'added_lines': 20, 'deleted_lines': 13, 'nloc': 101}, {'timestamp': 1499331469.0, 'added_lines': 1, 'deleted_lines': 1, 'nloc': 101}, {'timestamp': 1511223906.0, 'added_lines': 1, 'deleted_lines': 1, 'nloc': 101}, {'timestamp': 1512365669.0, 'added_lines': 1, 'deleted_lines': 1, 'nloc': 101}, {'timestamp': 1511187070.0, 'added_lines': 1, 'deleted_lines': 1, 'nloc': 101}, {'timestamp': 1513436097.0, 'added_lines': 1, 'deleted_lines': 1, 'nloc': 101}, {'timestamp': 1513612261.0, 'added_lines': 1, 'deleted_lines': 1, 'nloc': 101}, {'timestamp': 1515277696.0, 'added_lines': 1, 'deleted_lines': 1, 'nloc': 101}, {'timestamp': 1519404450.0, 'added_lines': 14, 'deleted_lines': 1, 'nloc': 114}, {'timestamp': 1519855044.0, 'added_lines': 5, 'deleted_lines': 5, 'nloc': 114}, {'timestamp': 1521737529.0, 'added_lines': 13, 'deleted_lines': 3, 'nloc': 124}, {'timestamp': 1528520460.0, 'added_lines': 1, 'deleted_lines': 1, 'nloc': 124}, {'timestamp': 1532847462.0, 'added_lines': 1, 'deleted_lines': 1, 'nloc': 124}, {'timestamp': 1533500571.0, 'added_lines': 1, 'deleted_lines': 1, 'nloc': 124}, {'timestamp': 1533618653.0, 'added_lines': 1, 'deleted_lines': 1, 'nloc': 124}, {'timestamp': 1533779477.0, 'added_lines': 1, 'deleted_lines': 1, 'nloc': 124}, {'timestamp': 1533946888.0, 'added_lines': 1, 'deleted_lines': 1, 'nloc': 124}, {'timestamp': 1534115707.0, 'added_lines': 1, 'deleted_lines': 1, 'nloc': 124}, {'timestamp': 1534195762.0, 'added_lines': 1, 'deleted_lines': 1, 'nloc': 124}, {'timestamp': 1534347022.0, 'added_lines': 1, 'deleted_lines': 1, 'nloc': 124}, {'timestamp': 1534896611.0, 'added_lines': 2, 'deleted_lines': 2, 'nloc': 124}, {'timestamp': 1534903410.0, 'added_lines': 5, 'deleted_lines': 8, 'nloc': 122}, {'timestamp': 1535601896.0, 'added_lines': 1, 'deleted_lines': 1, 'nloc': 122}, {'timestamp': 1536388808.0, 'added_lines': 1, 'deleted_lines': 1, 'nloc': 122}, {'timestamp': 1536718784.0, 'added_lines': 1, 'deleted_lines': 1, 'nloc': 122}, {'timestamp': 1536723292.0, 'added_lines': 1, 'deleted_lines': 1, 'nloc': 122}, {'timestamp': 1537225684.0, 'added_lines': 8, 'deleted_lines': 1, 'nloc': 128}, {'timestamp': 1537229830.0, 'added_lines': 20, 'deleted_lines': 30, 'nloc': 120}, {'timestamp': 1537237833.0, 'added_lines': 26, 'deleted_lines': 18, 'nloc': 126}, {'timestamp': 1537350702.0, 'added_lines': 8, 'deleted_lines': 5, 'nloc': 129}, {'timestamp': 1537391809.0, 'added_lines': 1, 'deleted_lines': 1, 'nloc': 129}, {'timestamp': 1537393395.0, 'added_lines': 11, 'deleted_lines': 20, 'nloc': 120}, {'timestamp': 1537790637.0, 'added_lines': 1, 'deleted_lines': 1, 'nloc': 120}, {'timestamp': 1537792589.0, 'added_lines': 2, 'deleted_lines': 2, 'nloc': 120}, {'timestamp': 1538544957.0, 'added_lines': 1, 'deleted_lines': 1, 'nloc': 120}, {'timestamp': 1538694687.0, 'added_lines': 1, 'deleted_lines': 1, 'nloc': 120}, {'timestamp': 1538695953.0, 'added_lines': 1, 'deleted_lines': 1, 'nloc': 120}, {'timestamp': 1538662493.0, 'added_lines': 12, 'deleted_lines': 6, 'nloc': 125}, {'timestamp': 1538773916.0, 'added_lines': 1, 'deleted_lines': 1, 'nloc': 125}, {'timestamp': 1539176817.0, 'added_lines': 1, 'deleted_lines': 1, 'nloc': 125}, {'timestamp': 1539357340.0, 'added_lines': 1, 'deleted_lines': 1, 'nloc': 125}, {'timestamp': 1539850591.0, 'added_lines': 2, 'deleted_lines': 2, 'nloc': 125}, {'timestamp': 1540400358.0, 'added_lines': 1, 'deleted_lines': 1, 'nloc': 125}, {'timestamp': 1540410565.0, 'added_lines': 1, 'deleted_lines': 1, 'nloc': 125}, {'timestamp': 1540418491.0, 'added_lines': 1, 'deleted_lines': 1, 'nloc': 125}, {'timestamp': 1540552487.0, 'added_lines': 1, 'deleted_lines': 1, 'nloc': 125}, {'timestamp': 1540597832.0, 'added_lines': 1, 'deleted_lines': 1, 'nloc': 125}, {'timestamp': 1540603818.0, 'added_lines': 1, 'deleted_lines': 1, 'nloc': 125}, {'timestamp': 1540916861.0, 'added_lines': 1, 'deleted_lines': 1, 'nloc': 125}, {'timestamp': 1540928072.0, 'added_lines': 4, 'deleted_lines': 2, 'nloc': 127}, {'timestamp': 1540929775.0, 'added_lines': 3, 'deleted_lines': 1, 'nloc': 127}, {'timestamp': 1541189794.0, 'added_lines': 1, 'deleted_lines': 1, 'nloc': 127}, {'timestamp': 1541204121.0, 'added_lines': 2, 'deleted_lines': 2, 'nloc': 127}, {'timestamp': 1541822268.0, 'added_lines': 4, 'deleted_lines': 10, 'nloc': 122}, {'timestamp': 1541903826.0, 'added_lines': 1, 'deleted_lines': 1, 'nloc': 122}, {'timestamp': 1543443696.0, 'added_lines': 1, 'deleted_lines': 1, 'nloc': 122}, {'timestamp': 1544225843.0, 'added_lines': 1, 'deleted_lines': 1, 'nloc': 122}, {'timestamp': 1544661332.0, 'added_lines': 1, 'deleted_lines': 1, 'nloc': 122}, {'timestamp': 1544667474.0, 'added_lines': 0, 'deleted_lines': 12, 'nloc': 112}, {'timestamp': 1540556089.0, 'added_lines': 1, 'deleted_lines': 1, 'nloc': 112}, {'timestamp': 1545034475.0, 'added_lines': 1, 'deleted_lines': 1, 'nloc': 112}, {'timestamp': 1547003974.0, 'added_lines': 1, 'deleted_lines': 1, 'nloc': 112}, {'timestamp': 1547152271.0, 'added_lines': 1, 'deleted_lines': 1, 'nloc': 112}, {'timestamp': 1542878205.0, 'added_lines': 9, 'deleted_lines': 1, 'nloc': 119}, {'timestamp': 1548089993.0, 'added_lines': 16, 'deleted_lines': 6, 'nloc': 127}, {'timestamp': 1547499910.0, 'added_lines': 1, 'deleted_lines': 1, 'nloc': 127}, {'timestamp': 1548866534.0, 'added_lines': 1, 'deleted_lines': 1, 'nloc': 127}, {'timestamp': 1549588289.0, 'added_lines': 1, 'deleted_lines': 1, 'nloc': 127}, {'timestamp': 1549650181.0, 'added_lines': 1, 'deleted_lines': 1, 'nloc': 127}, {'timestamp': 1549672857.0, 'added_lines': 3, 'deleted_lines': 3, 'nloc': 127}, {'timestamp': 1549673846.0, 'added_lines': 2, 'deleted_lines': 2, 'nloc': 127}, {'timestamp': 1549903582.0, 'added_lines': 4, 'deleted_lines': 4, 'nloc': 127}, {'timestamp': 1550185115.0, 'added_lines': 4, 'deleted_lines': 4, 'nloc': 127}, {'timestamp': 1550507829.0, 'added_lines': 5, 'deleted_lines': 5, 'nloc': 127}, {'timestamp': 1550576884.0, 'added_lines': 3, 'deleted_lines': 3, 'nloc': 127}, {'timestamp': 1540920154.0, 'added_lines': 4, 'deleted_lines': 5, 'nloc': 128}, {'timestamp': 1550610741.0, 'added_lines': 1, 'deleted_lines': 1, 'nloc': 127}, {'timestamp': 1550711994.0, 'added_lines': 4, 'deleted_lines': 4, 'nloc': 128}, {'timestamp': 1550723346.0, 'added_lines': 5, 'deleted_lines': 5, 'nloc': 128}, {'timestamp': 1551138343.0, 'added_lines': 1, 'deleted_lines': 1, 'nloc': 128}, {'timestamp': 1551229859.0, 'added_lines': 4, 'deleted_lines': 4, 'nloc': 128}, {'timestamp': 1551299964.0, 'added_lines': 5, 'deleted_lines': 5, 'nloc': 128}, {'timestamp': 1551471469.0, 'added_lines': 1, 'deleted_lines': 1, 'nloc': 128}, {'timestamp': 1551551196.0, 'added_lines': 7, 'deleted_lines': 7, 'nloc': 128}, {'timestamp': 1552702853.0, 'added_lines': 1, 'deleted_lines': 1, 'nloc': 128}, {'timestamp': 1553529899.0, 'added_lines': 1, 'deleted_lines': 6, 'nloc': 124}, {'timestamp': 1553608614.0, 'added_lines': 5, 'deleted_lines': 5, 'nloc': 124}, {'timestamp': 1553609463.0, 'added_lines': 1, 'deleted_lines': 1, 'nloc': 124}, {'timestamp': 1557554420.0, 'added_lines': 7, 'deleted_lines': 8, 'nloc': 123}, {'timestamp': 1596826508.0, 'added_lines': 17, 'deleted_lines': 17, 'nloc': 123}, {'timestamp': 1613691223.0, 'added_lines': 1, 'deleted_lines': 1, 'nloc': 123}]","{'blocks/blockstore/caching.go': 1, 'blocks/blockstore/util/remove.go': 2, 'cmd/ipfs/daemon.go': 33, 'cmd/ipfs/init.go': 40, 'cmd/ipfs/ipfs.go': 27, 'cmd/ipfs/main.go': 36, 'cmd/ipfs/main_test.go': 4, 'cmd/ipfswatch/main.go': 20, 'cmd/seccat/seccat.go': 22, None: 38, 'commands/channelmarshaler.go': 1, 'commands/cli/cmd_suggestion.go': 1, 'commands/cli/helptext.go': 2, 'commands/cli/helptext_test.go': 2, 'commands/cli/parse.go': 2, 'commands/cli/parse_test.go': 2, 'commands/command.go': 14, 'commands/command_test.go': 7, 'commands/http/client.go': 2, 'commands/http/handler.go': 2, 'commands/http/multifilereader.go': 2, 'commands/http/multifilereader_test.go': 2, 'commands/http/parse.go': 2, 'commands/reqlog.go': 1, 'commands/request.go': 21, 'commands/response.go': 11, 'commands/response_test.go': 7, 'core/bootstrap.go': 21, 'core/commands/active.go': 25, 'core/commands/add.go': 51, 'core/commands/bitswap.go': 61, 'core/commands/block.go': 45, 'core/commands/bootstrap.go': 34, 'core/commands/cat.go': 43, 'core/commands/commands.go': 30, 'core/commands/config.go': 35, 'core/commands/dag/dag.go': 69, 'core/commands/dht.go': 62, 'core/commands/diag.go': 23, 'core/commands/dns.go': 39, 'core/commands/e/error.go': 1, 'core/commands/external.go': 23, 'core/commands/files/files.go': 8, 'core/commands/filestore.go': 36, 'core/commands/get.go': 70, 'core/commands/helptext_test.go': 27, 'core/commands/id.go': 47, 'core/commands/ipns.go': 18, 'core/commands/keystore.go': 40, 'core/commands/log.go': 26, 'core/commands/ls.go': 66, 'core/commands/mount_nofuse.go': 23, 'core/commands/mount_unix.go': 34, 'core/commands/mount_windows.go': 22, 'core/commands/name.go': 10, 'core/commands/object/diff.go': 35, 'core/commands/object/object.go': 69, 'core/commands/object/patch.go': 42, 'core/commands/p2p.go': 37, 'core/commands/pin.go': 67, 'core/commands/ping.go': 40, 'core/commands/publish.go': 17, 'core/commands/pubsub.go': 47, 'core/commands/refs.go': 62, 'core/commands/repo.go': 50, 'core/commands/root.go': 33, 'core/commands/shutdown.go': 30, 'core/commands/stat.go': 36, 'core/commands/swarm.go': 46, 'core/commands/sysdiag.go': 27, 'core/commands/tar.go': 61, 'core/commands/unixfs/ls.go': 64, 'core/commands/unixfs/unixfs.go': 23, 'core/commands/version.go': 27, 'core/core_test.go': 17, 'core/corehttp/commands.go': 61, 'core/corehttp/gateway.go': 33, 'core/coreunix/add.go': 56, 'core/coreunix/add_test.go': 54, 'core/coreunix/metadata_test.go': 46, 'exchange/bitswap/bitswap_test.go': 4, 'exchange/bitswap/decision/engine_test.go': 4, 'exchange/bitswap/message/message_test.go': 3, 'exchange/bitswap/message/pb/Makefile': 1, 'exchange/bitswap/testnet/network_test.go': 4, 'exchange/bitswap/testnet/peernet.go': 4, 'exchange/reprovide/reprovide_test.go': 29, 'fuse/ipns/common.go': 47, 'fuse/node/mount_test.go': 28, 'importer/balanced/balanced_test.go': 3, 'importer/chunk/rabin_test.go': 2, 'importer/helpers/dagbuilder.go': 8, 'importer/importer.go': 8, 'merkledag/utils/utils_test.go': 3, 'mfs/repub_test.go': 7, 'namesys/dns.go': 48, 'namesys/interface.go': 48, 'namesys/ipns_select_test.go': 3, 'namesys/proquint.go': 48, 'namesys/republisher/repub_test.go': 46, 'package.json': 61, 'repo/config/identity.go': 2, 'routing/offline/offline_test.go': 3, 'test/integration/addcat_test.go': 31, 'test/integration/bench_cat_test.go': 30, 'test/integration/bitswap_wo_routing_test.go': 31, 'test/integration/three_legged_cat_test.go': 30, 'core/bootstrap_test.go': 20, 'core/commands/dht_test.go': 20, 'core/commands/get_test.go': 28, 'core/core.go': 50, 'core/corehttp/gateway_test.go': 52, 'core/corehttp/metrics_test.go': 27, 'core/mock/mock.go': 28, 'exchange/bitswap/decision/bench_test.go': 3, 'exchange/bitswap/decision/peer_request_queue_test.go': 3, 'exchange/bitswap/message/message.go': 3, 'exchange/bitswap/network/interface.go': 3, 'exchange/bitswap/network/ipfs_impl.go': 3, 'exchange/bitswap/testnet/interface.go': 3, 'exchange/bitswap/testnet/virtual.go': 3, 'exchange/bitswap/testutils.go': 3, 'fuse/ipns/ipns_test.go': 27, 'fuse/readonly/ipfs_test.go': 52, 'namesys/publisher_test.go': 27, 'namesys/resolve_test.go': 46, 'p2p/p2p.go': 20, 'p2p/registry.go': 7, 'repo/config/bootstrap_peers.go': 4, 'routing/mock/centralized_client.go': 2, 'routing/mock/centralized_server.go': 2, 'routing/mock/centralized_test.go': 2, 'routing/mock/interface.go': 2, 'routing/none/none_client.go': 2, 'test/integration/bench_test.go': 14, 'assets/assets.go': 48, 'blocks/blockstore/arc_cache.go': 1, 'blocks/blockstore/arc_cache_test.go': 1, 'blocks/blockstore/blockstore.go': 1, 'blocks/blockstore/blockstore_test.go': 1, 'blocks/blockstore/bloom_cache.go': 1, 'blocks/blockstore/bloom_cache_test.go': 1, 'blocks/blocksutil/block_generator.go': 1, 'blockservice/blockservice.go': 2, 'blockservice/blockservice_test.go': 2, 'blockservice/test/blocks_test.go': 2, 'core/builder.go': 48, 'core/commands/ipnsps.go': 8, 'core/coreapi/coreapi.go': 27, 'core/coreapi/interface/interface.go': 1, 'core/coreapi/unixfs.go': 53, 'core/coreapi/unixfs_test.go': 34, 'core/coredag/cbor.go': 15, 'core/coredag/dagpb.go': 40, 'core/coredag/dagtransl.go': 11, 'core/coredag/raw.go': 40, 'core/corehttp/corehttp.go': 10, 'core/corehttp/gateway_handler.go': 54, 'core/corerepo/gc.go': 43, 'core/corerepo/pinning.go': 18, 'core/coreunix/metadata.go': 45, 'core/pathresolver.go': 44, 'exchange/bitswap/bitswap.go': 2, 'exchange/bitswap/decision/engine.go': 2, 'exchange/bitswap/decision/ledger.go': 2, 'exchange/bitswap/decision/peer_request_queue.go': 2, 'exchange/bitswap/get.go': 2, 'exchange/bitswap/notifications/notifications.go': 2, 'exchange/bitswap/notifications/notifications_test.go': 2, 'exchange/bitswap/session.go': 2, 'exchange/bitswap/session_test.go': 2, 'exchange/bitswap/stat.go': 2, 'exchange/bitswap/wantlist/wantlist.go': 2, 'exchange/bitswap/wantlist/wantlist_test.go': 2, 'exchange/bitswap/wantmanager.go': 2, 'exchange/bitswap/workers.go': 2, 'exchange/interface.go': 1, 'exchange/offline/offline.go': 1, 'exchange/offline/offline_test.go': 1, 'exchange/reprovide/providers.go': 40, 'exchange/reprovide/reprovide.go': 23, 'filestore/filestore.go': 21, 'filestore/filestore_test.go': 40, 'filestore/fsrefstore.go': 21, 'filestore/util.go': 20, 'fuse/ipns/ipns_unix.go': 49, 'fuse/readonly/readonly_unix.go': 47, 'importer/balanced/builder.go': 2, 'importer/chunk/splitting_test.go': 1, 'importer/helpers/helpers.go': 2, 'importer/importer_test.go': 2, 'importer/trickle/trickle_test.go': 2, 'importer/trickle/trickledag.go': 2, 'merkledag/batch.go': 1, 'merkledag/coding.go': 2, 'merkledag/merkledag.go': 2, 'merkledag/merkledag_test.go': 2, 'merkledag/node.go': 2, 'merkledag/node_test.go': 2, 'merkledag/raw.go': 2, 'merkledag/traverse/traverse.go': 2, 'merkledag/traverse/traverse_test.go': 2, 'merkledag/utils/diff.go': 2, 'merkledag/utils/diffenum.go': 2, 'merkledag/utils/diffenum_test.go': 2, 'merkledag/utils/utils.go': 2, 'mfs/dir.go': 9, 'mfs/file.go': 9, 'mfs/mfs_test.go': 10, 'mfs/ops.go': 9, 'mfs/system.go': 9, 'namesys/namesys.go': 49, 'namesys/publisher.go': 48, 'namesys/pubsub.go': 3, 'namesys/pubsub_test.go': 3, 'namesys/republisher/repub.go': 42, 'namesys/routing.go': 49, 'path/path.go': 2, 'path/resolver.go': 1, 'path/resolver_test.go': 1, 'pin/gc/gc.go': 40, 'pin/pin.go': 40, 'pin/pin_test.go': 40, 'pin/set.go': 40, 'pin/set_test.go': 40, 'plugin/ipld.go': 11, 'plugin/loader/initializer.go': 8, 'plugin/plugins/git/git.go': 11, 'repo/config/init.go': 3, 'repo/fsrepo/fsrepo.go': 20, 'repo/fsrepo/lock/lock.go': 1, 'repo/fsrepo/serialize/serialize.go': 2, 'repo/mock.go': 16, 'repo/repo.go': 19, 'routing/offline/offline.go': 1, 'tar/format.go': 47, 'test/dependencies/ma-pipe-unidir/main.go': 7, 'thirdparty/ds-help/key.go': 1, 'thirdparty/pollEndpoint/main.go': 10, 'thirdparty/posinfo/posinfo.go': 1, 'unixfs/archive/archive.go': 2, 'unixfs/archive/tar/writer.go': 2, 'unixfs/hamt/hamt.go': 2, 'unixfs/io/dagreader.go': 2, 'unixfs/io/dirbuilder.go': 2, 'unixfs/io/resolve.go': 2, 'unixfs/mod/dagmodifier.go': 2, 'unixfs/mod/dagmodifier_test.go': 2, 'unixfs/test/utils.go': 2, 'commands/legacy/command.go': 13, 'commands/legacy/legacy.go': 13, 'commands/legacy/legacy_test.go': 14, 'commands/legacy/request.go': 14, 'commands/legacy/response.go': 14, 'commands/legacy/responseemitter.go': 4, 'core/commands/env.go': 4, 'TODO.md': 2, 'core/commands/commands_test.go': 23, 'test/sharness/t0110-gateway.sh': 1, 'test/sharness/t0410-api-add.sh': 1, 'core/coreapi/name.go': 55, 'core/corehttp/ipns_hostname.go': 14, 'namesys/base.go': 47, 'namesys/ipns_validate_test.go': 3, 'namesys/namesys_test.go': 52, 'namesys/opts.go': 1, 'namesys/dns_test.go': 12, 'namesys/opts/opts.go': 1, 'blocks/blockstoreutil/remove.go': 18, 'blockservice/test/mock.go': 1, 'cmd/ipfs/util/ulimit.go': 6, 'cmd/ipfs/util/ulimit_freebsd.go': 2, 'cmd/ipfs/util/ulimit_unix.go': 2, 'cmd/seccat/util.go': 6, 'core/commands/files.go': 64, 'core/coreapi/block.go': 19, 'core/coreapi/block_test.go': 2, 'core/coreapi/dag.go': 10, 'core/coreapi/dag_test.go': 2, 'core/coreapi/interface/coreapi.go': 8, 'core/coreapi/interface/dag.go': 8, 'core/coreapi/interface/object.go': 8, 'core/coreapi/interface/options/block.go': 3, 'core/coreapi/interface/options/dag.go': 6, 'core/coreapi/interface/path.go': 34, 'core/coreapi/interface/unixfs.go': 12, 'core/coreapi/key.go': 48, 'core/coreapi/object.go': 49, 'core/coreapi/pin.go': 45, 'core/corehttp/logs.go': 6, 'fuse/ipns/link_unix.go': 2, 'fuse/mount/fuse.go': 2, 'fuse/mount/mount.go': 6, 'fuse/node/mount_darwin.go': 2, 'fuse/node/mount_unix.go': 6, 'keystore/keystore.go': 6, 'merkledag/errservice.go': 1, 'merkledag/readonly.go': 1, 'merkledag/readonly_test.go': 1, 'merkledag/rwservice.go': 1, 'merkledag/session.go': 1, 'merkledag/test/utils.go': 1, 'namesys/validator.go': 1, 'path/resolver/resolver.go': 1, 'path/resolver/resolver_test.go': 1, 'plugin/loader/load.go': 4, 'repo/fsrepo/datastores.go': 11, 'thirdparty/verifbs/verifbs.go': 18, 'thirdparty/verifcid/validate.go': 1, 'thirdparty/verifcid/validate_test.go': 1, 'unixfs/hamt/hamt_stress_test.go': 1, 'unixfs/hamt/hamt_test.go': 1, 'unixfs/io/pbdagreader.go': 1, 'core/coreapi/name_test.go': 32, 'core/coreapi/path.go': 53, 'core/coreunix/cat.go': 15, 'core/pathresolver_test.go': 40, 'dagutils/utils.go': 40, 'dagutils/utils_test.go': 40, 'namesys/cache.go': 40, 'namesys/ipns_resolver_validation_test.go': 45, 'core/commands/urlstore.go': 54, 'dagutils/diff.go': 42, 'dagutils/diffenum.go': 38, 'dagutils/diffenum_test.go': 38, 'mfs/fd.go': 7, 'core/coreapi/interface/key.go': 7, 'filestore/pb/dataobj.pb.go': 3, 'keystore/keystore_test.go': 4, 'keystore/memkeystore.go': 4, 'pin/internal/pb/header.pb.go': 3, 'thirdparty/cidv0v1/blockstore.go': 16, 'repo/fsrepo/fsrepo_test.go': 16, 'repo/fsrepo/config_test.go': 13, 'repo/fsrepo/misc.go': 13, 'test/bench/bench_cli_ipfs_add/main.go': 14, 'test/bench/offline_add/main.go': 14, 'core/commands/cmdenv/env.go': 32, 'core/commands/name/ipns.go': 53, 'core/commands/name/ipnsps.go': 24, 'core/commands/name/name.go': 19, 'core/commands/name/publish.go': 36, 'core/coreapi/dht.go': 35, 'core/coreapi/dht_test.go': 5, 'test/sharness/t0275-cid-security.sh': 1, 'test/sharness/t0260-sharding.sh': 1, 'core/coreapi/interface/options/name.go': 3, 'core/coreapi/interface/dht.go': 10, 'p2p/listener.go': 13, 'p2p/local.go': 13, 'p2p/remote.go': 13, 'p2p/stream.go': 13, 'core/coreapi/interface/swarm.go': 9, 'core/coreapi/swarm.go': 23, 'core/commands/cid.go': 19, 'core/coreapi/interface/options/unixfs.go': 15, 'core/coreapi/pubsub.go': 22, 'core/coreapi/unixfile.go': 16, 'cmd/ipfs/dnsresolve_test.go': 5, 'core/coreapi/interface/pubsub.go': 4, 'test/sharness/t0160-resolve.sh': 4, 'test/dependencies/iptb/iptb.go': 12, 'plugin/plugins/badgerds/badgerds.go': 4, 'plugin/plugins/flatfs/flatfs.go': 4, 'plugin/plugins/levelds/levelds.go': 3, 'commands/context.go': 21, 'core/corehttp/proxy.go': 9, 'core/coreapi/interface/tests/name.go': 4, 'core/coreapi/interface/tests/unixfs.go': 4, 'core/coreapi/test/api_test.go': 14, 'core/commands/cmdenv/cidbase.go': 12, 'core/commands/cmdenv/cidbase_test.go': 4, 'test/sharness/t0040-add-and-cat.sh': 1, 'test/sharness/t0045-ls.sh': 1, 'test/sharness/t0051-object-data/mixed.json': 1, 'test/sharness/t0051-object.sh': 1, 'test/sharness/t0053-dag.sh': 1, 'test/sharness/t0085-pins.sh': 1, 'test/sharness/t0095-refs.sh': 1, 'test/sharness/t0210-tar.sh': 1, 'test/sharness/t0250-files-api.sh': 1, 'test/sharness/t0271-filestore-utils.sh': 1, 'test/sharness/t0272-urlstore.sh': 1, 'plugin/loader/loader.go': 12, 'core/commands/cmdenv/file.go': 3, 'core/coreapi/interface/options/namesys/opts.go': 1, 'plugin/daemon.go': 10, 'core/corerepo/stat.go': 2, 'core/corehttp/metrics.go': 1, 'core/corehttp/proxy_test.go': 1, 'plugin/tracer.go': 1, 'thirdparty/notifier/notifier.go': 1, 'README.md': 1, 'go.mod': 2, 'go.sum': 2, 'package-list.json': 1, 'test/sharness/t0165-keystore.sh': 1, 'core/corehttp/hostname.go': 1, 'core/node/ipns.go': 1}","('core/commands/get.go', 0.7692307692307693, 0.5833333333333334)"
core/commands/root.go,166,916,2,"[{'cyclomatic_complexity': 1, 'nloc': 8, 'token_count': 45, 'name': 'init', 'long_name': 'init', 'start_line': 177, 'end_line': 187, 'full_parameters': [], 'filename': '/home/dimi/Documents/Informatik_Studium/FSS/SoftEvo/DataCollection/FFS_SoftEvo/go-ipfs/core/commands/root.go', 'top_nesting_level': 0, 'length': 11, 'fan_in': 0, 'fan_out': 0, 'general_fan_out': 0}, {'cyclomatic_complexity': 1, 'nloc': 3, 'token_count': 37, 'name': 'MessageTextMarshaler', 'long_name': 'MessageTextMarshaler res cmds . Response', 'start_line': 193, 'end_line': 195, 'full_parameters': ['res cmds . Response'], 'filename': '/home/dimi/Documents/Informatik_Studium/FSS/SoftEvo/DataCollection/FFS_SoftEvo/go-ipfs/core/commands/root.go', 'top_nesting_level': 0, 'length': 3, 'fan_in': 0, 'fan_out': 0, 'general_fan_out': 0}]",188,984,1,"[{'cyclomatic_complexity': 1, 'nloc': 12, 'token_count': 76, 'name': 'init', 'long_name': 'init', 'start_line': 207, 'end_line': 227, 'full_parameters': [], 'filename': '/home/dimi/Documents/Informatik_Studium/FSS/SoftEvo/DataCollection/FFS_SoftEvo/go-ipfs/core/commands/root.go', 'top_nesting_level': 0, 'length': 21, 'fan_in': 0, 'fan_out': 0, 'general_fan_out': 0}]",22,68,-1,113,113,"[{'timestamp': 1491058697.0, 'added_lines': 54, 'deleted_lines': 31, 'nloc': 184}, {'timestamp': 1508770239.0, 'added_lines': 1, 'deleted_lines': 1, 'nloc': 184}, {'timestamp': 1509016767.0, 'added_lines': 1, 'deleted_lines': 1, 'nloc': 184}, {'timestamp': 1499331469.0, 'added_lines': 4, 'deleted_lines': 4, 'nloc': 184}, {'timestamp': 1511223906.0, 'added_lines': 2, 'deleted_lines': 2, 'nloc': 184}, {'timestamp': 1511373659.0, 'added_lines': 1, 'deleted_lines': 1, 'nloc': 184}, {'timestamp': 1512365669.0, 'added_lines': 2, 'deleted_lines': 2, 'nloc': 184}, {'timestamp': 1513130181.0, 'added_lines': 0, 'deleted_lines': 1, 'nloc': 183}, {'timestamp': 1511187070.0, 'added_lines': 44, 'deleted_lines': 46, 'nloc': 181}, {'timestamp': 1512121226.0, 'added_lines': 1, 'deleted_lines': 1, 'nloc': 181}, {'timestamp': 1513436097.0, 'added_lines': 2, 'deleted_lines': 2, 'nloc': 181}, {'timestamp': 1513612261.0, 'added_lines': 2, 'deleted_lines': 2, 'nloc': 181}, {'timestamp': 1513764628.0, 'added_lines': 5, 'deleted_lines': 1, 'nloc': 181}, {'timestamp': 1513764708.0, 'added_lines': 1, 'deleted_lines': 1, 'nloc': 181}, {'timestamp': 1513765470.0, 'added_lines': 1, 'deleted_lines': 1, 'nloc': 181}, {'timestamp': 1513766201.0, 'added_lines': 1, 'deleted_lines': 1, 'nloc': 181}, {'timestamp': 1513772654.0, 'added_lines': 1, 'deleted_lines': 1, 'nloc': 181}, {'timestamp': 1513773452.0, 'added_lines': 1, 'deleted_lines': 1, 'nloc': 181}, {'timestamp': 1515277696.0, 'added_lines': 1, 'deleted_lines': 1, 'nloc': 181}, {'timestamp': 1515465466.0, 'added_lines': 1, 'deleted_lines': 1, 'nloc': 181}, {'timestamp': 1515713724.0, 'added_lines': 1, 'deleted_lines': 1, 'nloc': 181}, {'timestamp': 1516341168.0, 'added_lines': 1, 'deleted_lines': 1, 'nloc': 181}, {'timestamp': 1516838128.0, 'added_lines': 1, 'deleted_lines': 1, 'nloc': 181}, {'timestamp': 1517105039.0, 'added_lines': 1, 'deleted_lines': 1, 'nloc': 181}, {'timestamp': 1517453697.0, 'added_lines': 2, 'deleted_lines': 2, 'nloc': 181}, {'timestamp': 1516123504.0, 'added_lines': 1, 'deleted_lines': 1, 'nloc': 181}, {'timestamp': 1517518262.0, 'added_lines': 1, 'deleted_lines': 2, 'nloc': 180}, {'timestamp': 1519173780.0, 'added_lines': 1, 'deleted_lines': 1, 'nloc': 180}, {'timestamp': 1521256014.0, 'added_lines': 1, 'deleted_lines': 1, 'nloc': 180}, {'timestamp': 1521314540.0, 'added_lines': 1, 'deleted_lines': 1, 'nloc': 180}, {'timestamp': 1521500314.0, 'added_lines': 1, 'deleted_lines': 1, 'nloc': 180}, {'timestamp': 1524596476.0, 'added_lines': 1, 'deleted_lines': 1, 'nloc': 180}, {'timestamp': 1525408792.0, 'added_lines': 2, 'deleted_lines': 2, 'nloc': 180}, {'timestamp': 1528520460.0, 'added_lines': 3, 'deleted_lines': 3, 'nloc': 180}, {'timestamp': 1529984485.0, 'added_lines': 2, 'deleted_lines': 2, 'nloc': 180}, {'timestamp': 1507288650.0, 'added_lines': 2, 'deleted_lines': 1, 'nloc': 181}, {'timestamp': 1530042936.0, 'added_lines': 1, 'deleted_lines': 1, 'nloc': 181}, {'timestamp': 1531769369.0, 'added_lines': 1, 'deleted_lines': 1, 'nloc': 181}, {'timestamp': 1533066314.0, 'added_lines': 1, 'deleted_lines': 1, 'nloc': 181}, {'timestamp': 1533307603.0, 'added_lines': 1, 'deleted_lines': 1, 'nloc': 181}, {'timestamp': 1533779477.0, 'added_lines': 2, 'deleted_lines': 2, 'nloc': 181}, {'timestamp': 1533946888.0, 'added_lines': 2, 'deleted_lines': 2, 'nloc': 181}, {'timestamp': 1534896611.0, 'added_lines': 2, 'deleted_lines': 2, 'nloc': 181}, {'timestamp': 1534903410.0, 'added_lines': 9, 'deleted_lines': 5, 'nloc': 184}, {'timestamp': 1537229830.0, 'added_lines': 2, 'deleted_lines': 2, 'nloc': 184}, {'timestamp': 1523628870.0, 'added_lines': 1, 'deleted_lines': 1, 'nloc': 184}, {'timestamp': 1535044155.0, 'added_lines': 1, 'deleted_lines': 1, 'nloc': 184}, {'timestamp': 1537193530.0, 'added_lines': 1, 'deleted_lines': 1, 'nloc': 184}, {'timestamp': 1537391809.0, 'added_lines': 1, 'deleted_lines': 1, 'nloc': 184}, {'timestamp': 1537792589.0, 'added_lines': 2, 'deleted_lines': 2, 'nloc': 184}, {'timestamp': 1536691815.0, 'added_lines': 1, 'deleted_lines': 1, 'nloc': 184}, {'timestamp': 1534377738.0, 'added_lines': 2, 'deleted_lines': 0, 'nloc': 186}, {'timestamp': 1539850591.0, 'added_lines': 2, 'deleted_lines': 2, 'nloc': 186}, {'timestamp': 1540451598.0, 'added_lines': 10, 'deleted_lines': 7, 'nloc': 189}, {'timestamp': 1540487471.0, 'added_lines': 1, 'deleted_lines': 1, 'nloc': 189}, {'timestamp': 1540552487.0, 'added_lines': 1, 'deleted_lines': 1, 'nloc': 189}, {'timestamp': 1540572324.0, 'added_lines': 5, 'deleted_lines': 5, 'nloc': 189}, {'timestamp': 1540540339.0, 'added_lines': 2, 'deleted_lines': 2, 'nloc': 189}, {'timestamp': 1540558290.0, 'added_lines': 3, 'deleted_lines': 3, 'nloc': 189}, {'timestamp': 1540597832.0, 'added_lines': 1, 'deleted_lines': 1, 'nloc': 189}, {'timestamp': 1540615030.0, 'added_lines': 1, 'deleted_lines': 1, 'nloc': 189}, {'timestamp': 1540605823.0, 'added_lines': 2, 'deleted_lines': 2, 'nloc': 189}, {'timestamp': 1540606122.0, 'added_lines': 1, 'deleted_lines': 1, 'nloc': 189}, {'timestamp': 1540609052.0, 'added_lines': 1, 'deleted_lines': 1, 'nloc': 189}, {'timestamp': 1540611547.0, 'added_lines': 1, 'deleted_lines': 1, 'nloc': 189}, {'timestamp': 1541204121.0, 'added_lines': 2, 'deleted_lines': 2, 'nloc': 189}, {'timestamp': 1540564653.0, 'added_lines': 1, 'deleted_lines': 1, 'nloc': 189}, {'timestamp': 1540565575.0, 'added_lines': 1, 'deleted_lines': 1, 'nloc': 189}, {'timestamp': 1540568587.0, 'added_lines': 1, 'deleted_lines': 1, 'nloc': 189}, {'timestamp': 1540569270.0, 'added_lines': 1, 'deleted_lines': 1, 'nloc': 189}, {'timestamp': 1540644903.0, 'added_lines': 4, 'deleted_lines': 4, 'nloc': 189}, {'timestamp': 1541472719.0, 'added_lines': 1, 'deleted_lines': 0, 'nloc': 189}, {'timestamp': 1540621603.0, 'added_lines': 1, 'deleted_lines': 1, 'nloc': 189}, {'timestamp': 1540614377.0, 'added_lines': 1, 'deleted_lines': 1, 'nloc': 189}, {'timestamp': 1541661710.0, 'added_lines': 0, 'deleted_lines': 18, 'nloc': 174}, {'timestamp': 1541726812.0, 'added_lines': 1, 'deleted_lines': 1, 'nloc': 174}, {'timestamp': 1541259636.0, 'added_lines': 1, 'deleted_lines': 1, 'nloc': 174}, {'timestamp': 1539856162.0, 'added_lines': 2, 'deleted_lines': 3, 'nloc': 173}, {'timestamp': 1544661332.0, 'added_lines': 1, 'deleted_lines': 1, 'nloc': 173}, {'timestamp': 1540556089.0, 'added_lines': 1, 'deleted_lines': 1, 'nloc': 173}, {'timestamp': 1544616047.0, 'added_lines': 7, 'deleted_lines': 5, 'nloc': 175}, {'timestamp': 1545033123.0, 'added_lines': 1, 'deleted_lines': 1, 'nloc': 175}, {'timestamp': 1547152271.0, 'added_lines': 1, 'deleted_lines': 1, 'nloc': 175}, {'timestamp': 1542878205.0, 'added_lines': 4, 'deleted_lines': 0, 'nloc': 178}, {'timestamp': 1546897390.0, 'added_lines': 1, 'deleted_lines': 1, 'nloc': 178}, {'timestamp': 1546998952.0, 'added_lines': 1, 'deleted_lines': 1, 'nloc': 178}, {'timestamp': 1548866534.0, 'added_lines': 1, 'deleted_lines': 1, 'nloc': 178}, {'timestamp': 1549903582.0, 'added_lines': 1, 'deleted_lines': 1, 'nloc': 178}, {'timestamp': 1550507829.0, 'added_lines': 2, 'deleted_lines': 2, 'nloc': 178}, {'timestamp': 1550610741.0, 'added_lines': 1, 'deleted_lines': 1, 'nloc': 178}, {'timestamp': 1550799433.0, 'added_lines': 1, 'deleted_lines': 1, 'nloc': 178}, {'timestamp': 1550799568.0, 'added_lines': 1, 'deleted_lines': 0, 'nloc': 179}, {'timestamp': 1551138343.0, 'added_lines': 1, 'deleted_lines': 1, 'nloc': 178}, {'timestamp': 1551299964.0, 'added_lines': 1, 'deleted_lines': 1, 'nloc': 178}, {'timestamp': 1551471469.0, 'added_lines': 1, 'deleted_lines': 1, 'nloc': 178}, {'timestamp': 1551480720.0, 'added_lines': 1, 'deleted_lines': 1, 'nloc': 179}, {'timestamp': 1551551196.0, 'added_lines': 3, 'deleted_lines': 3, 'nloc': 179}, {'timestamp': 1554412076.0, 'added_lines': 12, 'deleted_lines': 6, 'nloc': 182}, {'timestamp': 1557554420.0, 'added_lines': 9, 'deleted_lines': 10, 'nloc': 181}, {'timestamp': 1564169853.0, 'added_lines': 1, 'deleted_lines': 1, 'nloc': 181}, {'timestamp': 1583334674.0, 'added_lines': 1, 'deleted_lines': 0, 'nloc': 182}, {'timestamp': 1586379617.0, 'added_lines': 0, 'deleted_lines': 1, 'nloc': 181}, {'timestamp': 1585711581.0, 'added_lines': 1, 'deleted_lines': 1, 'nloc': 181}, {'timestamp': 1597688976.0, 'added_lines': 1, 'deleted_lines': 0, 'nloc': 182}, {'timestamp': 1607477553.0, 'added_lines': 2, 'deleted_lines': 1, 'nloc': 183}, {'timestamp': 1612535168.0, 'added_lines': 1, 'deleted_lines': 1, 'nloc': 183}, {'timestamp': 1616604074.0, 'added_lines': 1, 'deleted_lines': 1, 'nloc': 183}, {'timestamp': 1616605362.0, 'added_lines': 4, 'deleted_lines': 4, 'nloc': 183}, {'timestamp': 1616615390.0, 'added_lines': 1, 'deleted_lines': 1, 'nloc': 183}, {'timestamp': 1617665500.0, 'added_lines': 3, 'deleted_lines': 1, 'nloc': 185}, {'timestamp': 1619738863.0, 'added_lines': 0, 'deleted_lines': 1, 'nloc': 184}, {'timestamp': 1620225146.0, 'added_lines': 1, 'deleted_lines': 0, 'nloc': 185}, {'timestamp': 1629319719.0, 'added_lines': 4, 'deleted_lines': 0, 'nloc': 188}]","{'blocks/blockstore/caching.go': 1, 'blocks/blockstore/util/remove.go': 3, 'cmd/ipfs/daemon.go': 56, 'cmd/ipfs/init.go': 36, 'cmd/ipfs/ipfs.go': 52, 'cmd/ipfs/main.go': 52, 'cmd/ipfs/main_test.go': 4, 'cmd/ipfswatch/main.go': 15, 'cmd/seccat/seccat.go': 14, None: 14, 'commands/channelmarshaler.go': 1, 'commands/cli/cmd_suggestion.go': 1, 'commands/cli/helptext.go': 2, 'commands/cli/helptext_test.go': 2, 'commands/cli/parse.go': 2, 'commands/cli/parse_test.go': 2, 'commands/command.go': 29, 'commands/command_test.go': 20, 'commands/http/client.go': 2, 'commands/http/handler.go': 2, 'commands/http/multifilereader.go': 2, 'commands/http/multifilereader_test.go': 2, 'commands/http/parse.go': 2, 'commands/reqlog.go': 1, 'commands/request.go': 37, 'commands/response.go': 24, 'commands/response_test.go': 20, 'core/bootstrap.go': 15, 'core/commands/active.go': 26, 'core/commands/add.go': 56, 'core/commands/bitswap.go': 55, 'core/commands/block.go': 55, 'core/commands/bootstrap.go': 26, 'core/commands/cat.go': 54, 'core/commands/commands.go': 54, 'core/commands/config.go': 30, 'core/commands/dag/dag.go': 35, 'core/commands/dht.go': 34, 'core/commands/diag.go': 24, 'core/commands/dns.go': 28, 'core/commands/e/error.go': 1, 'core/commands/external.go': 25, 'core/commands/files/files.go': 12, 'core/commands/filestore.go': 56, 'core/commands/get.go': 55, 'core/commands/helptext_test.go': 51, 'core/commands/id.go': 35, 'core/commands/ipns.go': 14, 'core/commands/keystore.go': 39, 'core/commands/log.go': 31, 'core/commands/ls.go': 32, 'core/commands/mount_nofuse.go': 24, 'core/commands/mount_unix.go': 27, 'core/commands/mount_windows.go': 23, 'core/commands/name.go': 10, 'core/commands/object/diff.go': 27, 'core/commands/object/object.go': 47, 'core/commands/object/patch.go': 44, 'core/commands/p2p.go': 31, 'core/commands/pin.go': 32, 'core/commands/ping.go': 32, 'core/commands/publish.go': 15, 'core/commands/pubsub.go': 54, 'core/commands/refs.go': 31, 'core/commands/repo.go': 55, 'core/commands/resolve.go': 33, 'core/commands/shutdown.go': 35, 'core/commands/stat.go': 56, 'core/commands/swarm.go': 36, 'core/commands/sysdiag.go': 28, 'core/commands/tar.go': 30, 'core/commands/unixfs/ls.go': 27, 'core/commands/unixfs/unixfs.go': 24, 'core/commands/version.go': 29, 'core/core_test.go': 7, 'core/corehttp/commands.go': 52, 'core/corehttp/gateway.go': 17, 'core/coreunix/add.go': 25, 'core/coreunix/add_test.go': 24, 'core/coreunix/metadata_test.go': 18, 'exchange/bitswap/bitswap_test.go': 10, 'exchange/bitswap/decision/engine_test.go': 8, 'exchange/bitswap/message/message_test.go': 4, 'exchange/bitswap/message/pb/Makefile': 1, 'exchange/bitswap/testnet/network_test.go': 8, 'exchange/bitswap/testnet/peernet.go': 9, 'exchange/reprovide/reprovide_test.go': 14, 'fuse/ipns/common.go': 14, 'fuse/node/mount_test.go': 14, 'importer/balanced/balanced_test.go': 6, 'importer/chunk/rabin_test.go': 3, 'importer/helpers/dagbuilder.go': 12, 'importer/importer.go': 11, 'merkledag/utils/utils_test.go': 4, 'mfs/repub_test.go': 9, 'namesys/dns.go': 10, 'namesys/interface.go': 10, 'namesys/ipns_select_test.go': 5, 'namesys/proquint.go': 9, 'namesys/republisher/repub_test.go': 17, 'package.json': 52, 'repo/config/identity.go': 3, 'routing/offline/offline_test.go': 6, 'test/integration/addcat_test.go': 19, 'test/integration/bench_cat_test.go': 18, 'test/integration/bitswap_wo_routing_test.go': 16, 'test/integration/three_legged_cat_test.go': 18, 'test/sharness/t0600-issues-and-regressions-online.sh': 1, 'core/bootstrap_test.go': 13, 'core/commands/dht_test.go': 13, 'core/commands/get_test.go': 50, 'core/core.go': 20, 'core/corehttp/gateway_test.go': 17, 'core/corehttp/metrics_test.go': 15, 'core/mock/mock.go': 15, 'exchange/bitswap/decision/bench_test.go': 7, 'exchange/bitswap/decision/peer_request_queue_test.go': 7, 'exchange/bitswap/message/message.go': 7, 'exchange/bitswap/network/interface.go': 7, 'exchange/bitswap/network/ipfs_impl.go': 7, 'exchange/bitswap/testnet/interface.go': 7, 'exchange/bitswap/testnet/virtual.go': 7, 'exchange/bitswap/testutils.go': 8, 'fuse/ipns/ipns_test.go': 13, 'fuse/readonly/ipfs_test.go': 19, 'namesys/publisher_test.go': 13, 'namesys/resolve_test.go': 14, 'p2p/p2p.go': 13, 'p2p/registry.go': 9, 'repo/config/bootstrap_peers.go': 9, 'routing/mock/centralized_client.go': 4, 'routing/mock/centralized_server.go': 4, 'routing/mock/centralized_test.go': 4, 'routing/mock/interface.go': 4, 'routing/none/none_client.go': 4, 'test/integration/bench_test.go': 13, 'assets/assets.go': 15, 'blocks/blockstore/arc_cache.go': 2, 'blocks/blockstore/arc_cache_test.go': 2, 'blocks/blockstore/blockstore.go': 3, 'blocks/blockstore/blockstore_test.go': 2, 'blocks/blockstore/bloom_cache.go': 2, 'blocks/blockstore/bloom_cache_test.go': 2, 'blocks/blocksutil/block_generator.go': 2, 'blockservice/blockservice.go': 6, 'blockservice/blockservice_test.go': 5, 'blockservice/test/blocks_test.go': 5, 'core/builder.go': 18, 'core/commands/ipnsps.go': 9, 'core/coreapi/coreapi.go': 8, 'core/coreapi/interface/interface.go': 2, 'core/coreapi/unixfs.go': 16, 'core/coreapi/unixfs_test.go': 13, 'core/coredag/cbor.go': 7, 'core/coredag/dagpb.go': 10, 'core/coredag/dagtransl.go': 6, 'core/coredag/raw.go': 10, 'core/corehttp/corehttp.go': 11, 'core/corehttp/gateway_handler.go': 19, 'core/corerepo/gc.go': 18, 'core/corerepo/pinning.go': 8, 'core/coreunix/metadata.go': 15, 'core/pathresolver.go': 13, 'exchange/bitswap/bitswap.go': 6, 'exchange/bitswap/decision/engine.go': 6, 'exchange/bitswap/decision/ledger.go': 6, 'exchange/bitswap/decision/peer_request_queue.go': 6, 'exchange/bitswap/get.go': 5, 'exchange/bitswap/notifications/notifications.go': 3, 'exchange/bitswap/notifications/notifications_test.go': 3, 'exchange/bitswap/session.go': 7, 'exchange/bitswap/session_test.go': 5, 'exchange/bitswap/stat.go': 3, 'exchange/bitswap/wantlist/wantlist.go': 3, 'exchange/bitswap/wantlist/wantlist_test.go': 3, 'exchange/bitswap/wantmanager.go': 6, 'exchange/bitswap/workers.go': 6, 'exchange/interface.go': 2, 'exchange/offline/offline.go': 2, 'exchange/offline/offline_test.go': 2, 'exchange/reprovide/providers.go': 12, 'exchange/reprovide/reprovide.go': 12, 'filestore/filestore.go': 13, 'filestore/filestore_test.go': 13, 'filestore/fsrefstore.go': 13, 'filestore/util.go': 12, 'fuse/ipns/ipns_unix.go': 18, 'fuse/readonly/readonly_unix.go': 19, 'importer/balanced/builder.go': 3, 'importer/chunk/splitting_test.go': 2, 'importer/helpers/helpers.go': 4, 'importer/importer_test.go': 5, 'importer/trickle/trickle_test.go': 5, 'importer/trickle/trickledag.go': 3, 'merkledag/batch.go': 2, 'merkledag/coding.go': 3, 'merkledag/merkledag.go': 3, 'merkledag/merkledag_test.go': 5, 'merkledag/node.go': 3, 'merkledag/node_test.go': 3, 'merkledag/raw.go': 3, 'merkledag/traverse/traverse.go': 3, 'merkledag/traverse/traverse_test.go': 3, 'merkledag/utils/diff.go': 3, 'merkledag/utils/diffenum.go': 3, 'merkledag/utils/diffenum_test.go': 3, 'merkledag/utils/utils.go': 5, 'mfs/dir.go': 5, 'mfs/file.go': 7, 'mfs/mfs_test.go': 7, 'mfs/ops.go': 4, 'mfs/system.go': 8, 'namesys/namesys.go': 15, 'namesys/publisher.go': 18, 'namesys/pubsub.go': 5, 'namesys/pubsub_test.go': 5, 'namesys/republisher/repub.go': 13, 'namesys/routing.go': 14, 'path/path.go': 3, 'path/resolver.go': 3, 'path/resolver_test.go': 2, 'pin/gc/gc.go': 13, 'pin/pin.go': 13, 'pin/pin_test.go': 12, 'pin/set.go': 10, 'pin/set_test.go': 12, 'plugin/ipld.go': 6, 'plugin/loader/initializer.go': 5, 'plugin/plugins/git/git.go': 6, 'repo/config/init.go': 7, 'repo/fsrepo/fsrepo.go': 12, 'repo/fsrepo/lock/lock.go': 3, 'repo/fsrepo/serialize/serialize.go': 3, 'repo/mock.go': 9, 'repo/repo.go': 10, 'routing/offline/offline.go': 3, 'tar/format.go': 18, 'test/dependencies/ma-pipe-unidir/main.go': 6, 'thirdparty/ds-help/key.go': 2, 'thirdparty/pollEndpoint/main.go': 11, 'thirdparty/posinfo/posinfo.go': 2, 'unixfs/archive/archive.go': 3, 'unixfs/archive/tar/writer.go': 3, 'unixfs/hamt/hamt.go': 3, 'unixfs/io/dagreader.go': 3, 'unixfs/io/dirbuilder.go': 3, 'unixfs/io/resolve.go': 3, 'unixfs/mod/dagmodifier.go': 5, 'unixfs/mod/dagmodifier_test.go': 3, 'unixfs/test/utils.go': 5, 'commands/legacy/command.go': 34, 'commands/legacy/legacy.go': 34, 'commands/legacy/legacy_test.go': 35, 'commands/legacy/request.go': 35, 'commands/legacy/response.go': 35, 'commands/legacy/responseemitter.go': 4, 'core/commands/env.go': 4, 'core/commands/commands_test.go': 51, 'test/sharness/t0040-add-and-cat.sh': 3, 'TODO.md': 2, 'test/sharness/t0110-gateway.sh': 2, 'test/sharness/t0410-api-add.sh': 1, 'core/coreapi/dag.go': 5, 'core/coreapi/dag_test.go': 3, 'core/coreapi/interface/options/dag.go': 4, 'core/coreapi/key.go': 13, 'core/coreapi/name.go': 13, 'merkledag/test/utils.go': 4, 'namesys/namesys_test.go': 16, 'repo/fsrepo/datastores.go': 10, 'repo/fsrepo/fsrepo_test.go': 7, 'thirdparty/datastore2/datastore_closer.go': 1, 'thirdparty/datastore2/delayed.go': 1, 'thirdparty/datastore2/threadsafe.go': 1, 'unixfs/io/pbdagreader.go': 2, 'cmd/ipfs/util/ulimit.go': 9, 'cmd/seccat/util.go': 9, 'core/corehttp/logs.go': 9, 'fuse/mount/mount.go': 9, 'fuse/node/mount_unix.go': 9, 'importer/chunk/splitting.go': 1, 'namesys/ipns_validate_test.go': 3, 'plugin/loader/load.go': 7, 'core/commands/files.go': 36, 'core/commands/root_test.go': 1, 'test/sharness/t0090-get.sh': 1, 'blocks/blockstoreutil/remove.go': 9, 'blockservice/test/mock.go': 3, 'core/coreapi/pin.go': 11, 'keystore/keystore.go': 8, 'keystore/keystore_test.go': 5, 'keystore/memkeystore.go': 5, 'namesys/validator.go': 2, 'path/resolver/resolver.go': 3, 'thirdparty/verifbs/verifbs.go': 9, 'cmd/ipfs/util/ulimit_freebsd.go': 2, 'cmd/ipfs/util/ulimit_unix.go': 2, 'core/coreapi/block.go': 7, 'core/coreapi/block_test.go': 2, 'core/coreapi/interface/coreapi.go': 3, 'core/coreapi/interface/dag.go': 3, 'core/coreapi/interface/object.go': 3, 'core/coreapi/interface/options/block.go': 2, 'core/coreapi/interface/path.go': 5, 'core/coreapi/interface/unixfs.go': 6, 'core/coreapi/object.go': 13, 'fuse/ipns/link_unix.go': 2, 'fuse/mount/fuse.go': 2, 'fuse/node/mount_darwin.go': 2, 'merkledag/errservice.go': 1, 'merkledag/readonly.go': 1, 'merkledag/readonly_test.go': 1, 'merkledag/rwservice.go': 1, 'merkledag/session.go': 1, 'path/resolver/resolver_test.go': 1, 'thirdparty/verifcid/validate.go': 1, 'thirdparty/verifcid/validate_test.go': 1, 'unixfs/hamt/hamt_stress_test.go': 1, 'unixfs/hamt/hamt_test.go': 1, 'namesys/ipns_resolver_validation_test.go': 9, 'test/sharness/t0170-dht.sh': 1, 'core/commands/urlstore.go': 29, 'filestore/pb/Makefile': 1, 'filestore/pb/dataobj.pb.go': 4, 'filestore/pb/dataobj.proto': 1, 'core/coreapi/interface/key.go': 4, 'core/coreapi/name_test.go': 6, 'core/coreapi/path.go': 12, 'core/coreunix/cat.go': 4, 'core/pathresolver_test.go': 7, 'dagutils/diff.go': 8, 'dagutils/diffenum.go': 7, 'dagutils/diffenum_test.go': 7, 'dagutils/utils.go': 7, 'dagutils/utils_test.go': 7, 'mfs/fd.go': 2, 'namesys/base.go': 8, 'namesys/cache.go': 7, 'pin/internal/pb/header.pb.go': 3, 'thirdparty/cidv0v1/blockstore.go': 6, 'repo/fsrepo/config_test.go': 5, 'repo/fsrepo/misc.go': 5, 'test/bench/bench_cli_ipfs_add/main.go': 6, 'test/bench/offline_add/main.go': 6, 'core/commands/cmdenv/env.go': 22, 'core/commands/name/ipns.go': 22, 'core/commands/name/ipnsps.go': 23, 'core/commands/name/name.go': 22, 'core/commands/name/publish.go': 22, 'test/sharness/lib/test-lib.sh': 1, 'core/coreapi/dht.go': 6, 'core/coreapi/dht_test.go': 2, 'core/coreapi/interface/dht.go': 2, 'p2p/listener.go': 4, 'p2p/local.go': 4, 'p2p/remote.go': 4, 'p2p/stream.go': 4, 'core/coreapi/interface/swarm.go': 2, 'core/coreapi/swarm.go': 6, 'core/commands/cid.go': 17, 'core/coreapi/unixfile.go': 3, 'cmd/ipfs/dnsresolve_test.go': 2, 'core/coreapi/interface/options/unixfs.go': 1, 'core/coreapi/interface/pubsub.go': 1, 'core/coreapi/pubsub.go': 5, 'test/dependencies/iptb/iptb.go': 4, 'commands/context.go': 11, 'core/commands/cmdenv/cidbase.go': 12, 'core/commands/cmdenv/cidbase_test.go': 2, 'test/sharness/t0045-ls.sh': 1, 'test/sharness/t0051-object-data/mixed.json': 1, 'test/sharness/t0051-object.sh': 3, 'test/sharness/t0053-dag.sh': 2, 'test/sharness/t0085-pins.sh': 1, 'test/sharness/t0095-refs.sh': 1, 'test/sharness/t0160-resolve.sh': 1, 'test/sharness/t0210-tar.sh': 1, 'test/sharness/t0250-files-api.sh': 1, 'test/sharness/t0271-filestore-utils.sh': 1, 'test/sharness/t0272-urlstore.sh': 1, 'core/commands/cmdenv/file.go': 3, 'core/coreapi/interface/tests/name.go': 1, 'core/coreapi/interface/tests/unixfs.go': 1, 'core/coreapi/test/api_test.go': 4, 'core/corehttp/ipns_hostname.go': 4, 'namesys/dns_test.go': 5, 'plugin/daemon.go': 4, 'plugin/loader/loader.go': 4, 'core/corehttp/proxy.go': 3, 'plugin/plugins/badgerds/badgerds.go': 3, 'plugin/plugins/flatfs/flatfs.go': 3, 'plugin/plugins/levelds/levelds.go': 2, 'core/corerepo/stat.go': 2, 'core/corehttp/metrics.go': 1, 'core/corehttp/proxy_test.go': 1, 'plugin/tracer.go': 1, 'thirdparty/notifier/notifier.go': 1, 'README.md': 5, 'go.mod': 3, 'go.sum': 3, 'package-list.json': 1, '.gitattributes': 1, 'test/sharness/t0054-dag-car-import-export.sh': 1, '.circleci/config.yml': 1, 'core/commands/pin/pin.go': 3, 'core/commands/pin/remotepin.go': 1, 'docs/config.md': 1, 'test/sharness/t0700-remotepin.sh': 1, 'assets/bindata.go': 1, 'core/commands/stat_dht.go': 1, 'core/commands/multibase.go': 1, 'test/sharness/t0295-multibase.sh': 1}","('cmd/ipfs/daemon.go', 0.49557522123893805, 0.3660130718954248)"
core/commands/shutdown.go,24,126,1,"[{'cyclomatic_complexity': 4, 'nloc': 14, 'token_count': 94, 'name': '', 'long_name': '(req cmds.Request,res cmds.Response)', 'start_line': 13, 'end_line': 28, 'full_parameters': [], 'filename': '/home/dimi/Documents/Informatik_Studium/FSS/SoftEvo/DataCollection/FFS_SoftEvo/go-ipfs/core/commands/shutdown.go', 'top_nesting_level': 0, 'length': 16, 'fan_in': 0, 'fan_out': 0, 'general_fan_out': 0}]",23,114,0,[],-1,-12,-1,37,37,"[{'timestamp': 1491058697.0, 'added_lines': 7, 'deleted_lines': 3, 'nloc': 26}, {'timestamp': 1511223906.0, 'added_lines': 1, 'deleted_lines': 1, 'nloc': 26}, {'timestamp': 1512365669.0, 'added_lines': 1, 'deleted_lines': 1, 'nloc': 26}, {'timestamp': 1511187070.0, 'added_lines': 1, 'deleted_lines': 1, 'nloc': 26}, {'timestamp': 1513436097.0, 'added_lines': 1, 'deleted_lines': 1, 'nloc': 26}, {'timestamp': 1513612261.0, 'added_lines': 1, 'deleted_lines': 1, 'nloc': 26}, {'timestamp': 1515277696.0, 'added_lines': 1, 'deleted_lines': 1, 'nloc': 26}, {'timestamp': 1528520460.0, 'added_lines': 1, 'deleted_lines': 1, 'nloc': 26}, {'timestamp': 1533066314.0, 'added_lines': 5, 'deleted_lines': 8, 'nloc': 25}, {'timestamp': 1533779477.0, 'added_lines': 1, 'deleted_lines': 1, 'nloc': 25}, {'timestamp': 1533946888.0, 'added_lines': 2, 'deleted_lines': 2, 'nloc': 25}, {'timestamp': 1534896611.0, 'added_lines': 2, 'deleted_lines': 2, 'nloc': 25}, {'timestamp': 1534903410.0, 'added_lines': 3, 'deleted_lines': 1, 'nloc': 26}, {'timestamp': 1523628870.0, 'added_lines': 6, 'deleted_lines': 8, 'nloc': 24}, {'timestamp': 1535044155.0, 'added_lines': 1, 'deleted_lines': 1, 'nloc': 24}, {'timestamp': 1537193530.0, 'added_lines': 1, 'deleted_lines': 1, 'nloc': 24}, {'timestamp': 1537391809.0, 'added_lines': 1, 'deleted_lines': 1, 'nloc': 24}, {'timestamp': 1537792589.0, 'added_lines': 1, 'deleted_lines': 1, 'nloc': 24}, {'timestamp': 1539850591.0, 'added_lines': 2, 'deleted_lines': 2, 'nloc': 24}, {'timestamp': 1540552487.0, 'added_lines': 1, 'deleted_lines': 1, 'nloc': 24}, {'timestamp': 1540597832.0, 'added_lines': 1, 'deleted_lines': 1, 'nloc': 24}, {'timestamp': 1541204121.0, 'added_lines': 1, 'deleted_lines': 1, 'nloc': 24}, {'timestamp': 1544661332.0, 'added_lines': 1, 'deleted_lines': 1, 'nloc': 24}, {'timestamp': 1540556089.0, 'added_lines': 1, 'deleted_lines': 1, 'nloc': 24}, {'timestamp': 1547152271.0, 'added_lines': 1, 'deleted_lines': 1, 'nloc': 24}, {'timestamp': 1548866534.0, 'added_lines': 1, 'deleted_lines': 1, 'nloc': 24}, {'timestamp': 1549903582.0, 'added_lines': 1, 'deleted_lines': 1, 'nloc': 24}, {'timestamp': 1550507829.0, 'added_lines': 1, 'deleted_lines': 1, 'nloc': 24}, {'timestamp': 1550610741.0, 'added_lines': 1, 'deleted_lines': 1, 'nloc': 24}, {'timestamp': 1551138343.0, 'added_lines': 1, 'deleted_lines': 1, 'nloc': 24}, {'timestamp': 1551299964.0, 'added_lines': 1, 'deleted_lines': 1, 'nloc': 24}, {'timestamp': 1551471469.0, 'added_lines': 1, 'deleted_lines': 1, 'nloc': 24}, {'timestamp': 1551754781.0, 'added_lines': 1, 'deleted_lines': 1, 'nloc': 24}, {'timestamp': 1551551196.0, 'added_lines': 2, 'deleted_lines': 2, 'nloc': 24}, {'timestamp': 1553871352.0, 'added_lines': 1, 'deleted_lines': 1, 'nloc': 24}, {'timestamp': 1557554420.0, 'added_lines': 3, 'deleted_lines': 4, 'nloc': 23}, {'timestamp': 1616604074.0, 'added_lines': 2, 'deleted_lines': 3, 'nloc': 23}]","{'blocks/blockstore/caching.go': 1, 'blocks/blockstore/util/remove.go': 2, 'cmd/ipfs/daemon.go': 34, 'cmd/ipfs/init.go': 32, 'cmd/ipfs/ipfs.go': 30, 'cmd/ipfs/main.go': 32, 'cmd/ipfs/main_test.go': 4, 'cmd/ipfswatch/main.go': 12, 'cmd/seccat/seccat.go': 10, None: 13, 'commands/channelmarshaler.go': 1, 'commands/cli/cmd_suggestion.go': 1, 'commands/cli/helptext.go': 2, 'commands/cli/helptext_test.go': 2, 'commands/cli/parse.go': 2, 'commands/cli/parse_test.go': 2, 'commands/command.go': 14, 'commands/command_test.go': 7, 'commands/http/client.go': 2, 'commands/http/handler.go': 2, 'commands/http/multifilereader.go': 2, 'commands/http/multifilereader_test.go': 2, 'commands/http/parse.go': 2, 'commands/reqlog.go': 1, 'commands/request.go': 20, 'commands/response.go': 11, 'commands/response_test.go': 7, 'core/bootstrap.go': 10, 'core/commands/active.go': 23, 'core/commands/add.go': 34, 'core/commands/bitswap.go': 34, 'core/commands/block.go': 33, 'core/commands/bootstrap.go': 25, 'core/commands/cat.go': 33, 'core/commands/commands.go': 32, 'core/commands/config.go': 26, 'core/commands/dag/dag.go': 28, 'core/commands/dht.go': 28, 'core/commands/diag.go': 23, 'core/commands/dns.go': 26, 'core/commands/e/error.go': 1, 'core/commands/external.go': 23, 'core/commands/files/files.go': 7, 'core/commands/filestore.go': 33, 'core/commands/get.go': 33, 'core/commands/helptext_test.go': 30, 'core/commands/id.go': 30, 'core/commands/ipns.go': 11, 'core/commands/keystore.go': 34, 'core/commands/log.go': 26, 'core/commands/ls.go': 26, 'core/commands/mount_nofuse.go': 23, 'core/commands/mount_unix.go': 27, 'core/commands/mount_windows.go': 22, 'core/commands/name.go': 10, 'core/commands/object/diff.go': 25, 'core/commands/object/object.go': 33, 'core/commands/object/patch.go': 34, 'core/commands/p2p.go': 28, 'core/commands/pin.go': 26, 'core/commands/ping.go': 28, 'core/commands/publish.go': 11, 'core/commands/pubsub.go': 33, 'core/commands/refs.go': 26, 'core/commands/repo.go': 33, 'core/commands/resolve.go': 30, 'core/commands/root.go': 35, 'core/commands/stat.go': 35, 'core/commands/swarm.go': 29, 'core/commands/sysdiag.go': 25, 'core/commands/tar.go': 28, 'core/commands/unixfs/ls.go': 26, 'core/commands/unixfs/unixfs.go': 23, 'core/commands/version.go': 26, 'core/core_test.go': 6, 'core/corehttp/commands.go': 31, 'core/corehttp/gateway.go': 12, 'core/coreunix/add.go': 20, 'core/coreunix/add_test.go': 20, 'core/coreunix/metadata_test.go': 15, 'exchange/bitswap/bitswap_test.go': 4, 'exchange/bitswap/decision/engine_test.go': 4, 'exchange/bitswap/message/message_test.go': 3, 'exchange/bitswap/message/pb/Makefile': 1, 'exchange/bitswap/testnet/network_test.go': 4, 'exchange/bitswap/testnet/peernet.go': 4, 'exchange/reprovide/reprovide_test.go': 10, 'fuse/ipns/common.go': 13, 'fuse/node/mount_test.go': 10, 'importer/balanced/balanced_test.go': 3, 'importer/chunk/rabin_test.go': 2, 'importer/helpers/dagbuilder.go': 8, 'importer/importer.go': 8, 'merkledag/utils/utils_test.go': 3, 'mfs/repub_test.go': 5, 'namesys/dns.go': 9, 'namesys/interface.go': 9, 'namesys/ipns_select_test.go': 3, 'namesys/proquint.go': 9, 'namesys/republisher/repub_test.go': 11, 'package.json': 30, 'repo/config/identity.go': 2, 'routing/offline/offline_test.go': 3, 'test/integration/addcat_test.go': 14, 'test/integration/bench_cat_test.go': 13, 'test/integration/bitswap_wo_routing_test.go': 11, 'test/integration/three_legged_cat_test.go': 13, 'core/bootstrap_test.go': 9, 'core/commands/dht_test.go': 9, 'core/commands/get_test.go': 31, 'core/core.go': 17, 'core/corehttp/gateway_test.go': 12, 'core/corehttp/metrics_test.go': 10, 'core/mock/mock.go': 10, 'exchange/bitswap/decision/bench_test.go': 3, 'exchange/bitswap/decision/peer_request_queue_test.go': 3, 'exchange/bitswap/message/message.go': 3, 'exchange/bitswap/network/interface.go': 3, 'exchange/bitswap/network/ipfs_impl.go': 3, 'exchange/bitswap/testnet/interface.go': 3, 'exchange/bitswap/testnet/virtual.go': 3, 'exchange/bitswap/testutils.go': 3, 'fuse/ipns/ipns_test.go': 9, 'fuse/readonly/ipfs_test.go': 15, 'namesys/publisher_test.go': 9, 'namesys/resolve_test.go': 10, 'p2p/p2p.go': 9, 'p2p/registry.go': 5, 'repo/config/bootstrap_peers.go': 4, 'routing/mock/centralized_client.go': 2, 'routing/mock/centralized_server.go': 2, 'routing/mock/centralized_test.go': 2, 'routing/mock/interface.go': 2, 'routing/none/none_client.go': 2, 'test/integration/bench_test.go': 9, 'assets/assets.go': 14, 'blocks/blockstore/arc_cache.go': 1, 'blocks/blockstore/arc_cache_test.go': 1, 'blocks/blockstore/blockstore.go': 1, 'blocks/blockstore/blockstore_test.go': 1, 'blocks/blockstore/bloom_cache.go': 1, 'blocks/blockstore/bloom_cache_test.go': 1, 'blocks/blocksutil/block_generator.go': 1, 'blockservice/blockservice.go': 2, 'blockservice/blockservice_test.go': 2, 'blockservice/test/blocks_test.go': 2, 'core/builder.go': 16, 'core/commands/ipnsps.go': 8, 'core/coreapi/coreapi.go': 8, 'core/coreapi/interface/interface.go': 1, 'core/coreapi/unixfs.go': 15, 'core/coreapi/unixfs_test.go': 9, 'core/coredag/cbor.go': 6, 'core/coredag/dagpb.go': 9, 'core/coredag/dagtransl.go': 5, 'core/coredag/raw.go': 9, 'core/corehttp/corehttp.go': 8, 'core/corehttp/gateway_handler.go': 16, 'core/corerepo/gc.go': 14, 'core/corerepo/pinning.go': 7, 'core/coreunix/metadata.go': 14, 'core/pathresolver.go': 9, 'exchange/bitswap/bitswap.go': 2, 'exchange/bitswap/decision/engine.go': 2, 'exchange/bitswap/decision/ledger.go': 2, 'exchange/bitswap/decision/peer_request_queue.go': 2, 'exchange/bitswap/get.go': 2, 'exchange/bitswap/notifications/notifications.go': 2, 'exchange/bitswap/notifications/notifications_test.go': 2, 'exchange/bitswap/session.go': 2, 'exchange/bitswap/session_test.go': 2, 'exchange/bitswap/stat.go': 2, 'exchange/bitswap/wantlist/wantlist.go': 2, 'exchange/bitswap/wantlist/wantlist_test.go': 2, 'exchange/bitswap/wantmanager.go': 2, 'exchange/bitswap/workers.go': 2, 'exchange/interface.go': 1, 'exchange/offline/offline.go': 1, 'exchange/offline/offline_test.go': 1, 'exchange/reprovide/providers.go': 9, 'exchange/reprovide/reprovide.go': 8, 'filestore/filestore.go': 8, 'filestore/filestore_test.go': 9, 'filestore/fsrefstore.go': 8, 'filestore/util.go': 8, 'fuse/ipns/ipns_unix.go': 14, 'fuse/readonly/readonly_unix.go': 14, 'importer/balanced/builder.go': 2, 'importer/chunk/splitting_test.go': 1, 'importer/helpers/helpers.go': 2, 'importer/importer_test.go': 2, 'importer/trickle/trickle_test.go': 2, 'importer/trickle/trickledag.go': 2, 'merkledag/batch.go': 1, 'merkledag/coding.go': 2, 'merkledag/merkledag.go': 2, 'merkledag/merkledag_test.go': 2, 'merkledag/node.go': 2, 'merkledag/node_test.go': 2, 'merkledag/raw.go': 2, 'merkledag/traverse/traverse.go': 2, 'merkledag/traverse/traverse_test.go': 2, 'merkledag/utils/diff.go': 2, 'merkledag/utils/diffenum.go': 2, 'merkledag/utils/diffenum_test.go': 2, 'merkledag/utils/utils.go': 2, 'mfs/dir.go': 4, 'mfs/file.go': 4, 'mfs/mfs_test.go': 4, 'mfs/ops.go': 3, 'mfs/system.go': 4, 'namesys/namesys.go': 10, 'namesys/publisher.go': 14, 'namesys/pubsub.go': 1, 'namesys/pubsub_test.go': 1, 'namesys/republisher/repub.go': 9, 'namesys/routing.go': 10, 'path/path.go': 2, 'path/resolver.go': 1, 'path/resolver_test.go': 1, 'pin/gc/gc.go': 9, 'pin/pin.go': 9, 'pin/pin_test.go': 9, 'pin/set.go': 9, 'pin/set_test.go': 9, 'plugin/ipld.go': 5, 'plugin/loader/initializer.go': 4, 'plugin/plugins/git/git.go': 5, 'repo/config/init.go': 3, 'repo/fsrepo/fsrepo.go': 8, 'repo/fsrepo/lock/lock.go': 1, 'repo/fsrepo/serialize/serialize.go': 2, 'repo/mock.go': 7, 'repo/repo.go': 7, 'routing/offline/offline.go': 1, 'tar/format.go': 14, 'test/dependencies/ma-pipe-unidir/main.go': 4, 'thirdparty/ds-help/key.go': 1, 'thirdparty/pollEndpoint/main.go': 7, 'thirdparty/posinfo/posinfo.go': 1, 'unixfs/archive/archive.go': 2, 'unixfs/archive/tar/writer.go': 2, 'unixfs/hamt/hamt.go': 2, 'unixfs/io/dagreader.go': 2, 'unixfs/io/dirbuilder.go': 2, 'unixfs/io/resolve.go': 2, 'unixfs/mod/dagmodifier.go': 2, 'unixfs/mod/dagmodifier_test.go': 2, 'unixfs/test/utils.go': 2, 'commands/legacy/command.go': 16, 'commands/legacy/legacy.go': 16, 'commands/legacy/legacy_test.go': 17, 'commands/legacy/request.go': 17, 'commands/legacy/response.go': 17, 'commands/legacy/responseemitter.go': 4, 'core/commands/env.go': 4, 'TODO.md': 2, 'core/commands/commands_test.go': 26, 'test/sharness/t0110-gateway.sh': 1, 'test/sharness/t0410-api-add.sh': 1, 'blocks/blockstoreutil/remove.go': 7, 'blockservice/test/mock.go': 1, 'cmd/ipfs/util/ulimit.go': 6, 'cmd/ipfs/util/ulimit_freebsd.go': 2, 'cmd/ipfs/util/ulimit_unix.go': 2, 'cmd/seccat/util.go': 6, 'core/commands/files.go': 27, 'core/coreapi/block.go': 7, 'core/coreapi/block_test.go': 2, 'core/coreapi/dag.go': 4, 'core/coreapi/dag_test.go': 2, 'core/coreapi/interface/coreapi.go': 3, 'core/coreapi/interface/dag.go': 3, 'core/coreapi/interface/object.go': 3, 'core/coreapi/interface/options/block.go': 2, 'core/coreapi/interface/options/dag.go': 3, 'core/coreapi/interface/path.go': 5, 'core/coreapi/interface/unixfs.go': 6, 'core/coreapi/key.go': 9, 'core/coreapi/name.go': 9, 'core/coreapi/object.go': 13, 'core/coreapi/pin.go': 9, 'core/corehttp/logs.go': 6, 'fuse/ipns/link_unix.go': 2, 'fuse/mount/fuse.go': 2, 'fuse/mount/mount.go': 6, 'fuse/node/mount_darwin.go': 2, 'fuse/node/mount_unix.go': 7, 'keystore/keystore.go': 6, 'merkledag/errservice.go': 1, 'merkledag/readonly.go': 1, 'merkledag/readonly_test.go': 1, 'merkledag/rwservice.go': 1, 'merkledag/session.go': 1, 'merkledag/test/utils.go': 1, 'namesys/ipns_validate_test.go': 1, 'namesys/namesys_test.go': 13, 'namesys/validator.go': 1, 'path/resolver/resolver.go': 1, 'path/resolver/resolver_test.go': 1, 'plugin/loader/load.go': 4, 'repo/fsrepo/datastores.go': 6, 'thirdparty/verifbs/verifbs.go': 7, 'thirdparty/verifcid/validate.go': 1, 'thirdparty/verifcid/validate_test.go': 1, 'unixfs/hamt/hamt_stress_test.go': 1, 'unixfs/hamt/hamt_test.go': 1, 'unixfs/io/pbdagreader.go': 1, 'core/commands/urlstore.go': 25, 'core/coreapi/interface/key.go': 4, 'core/coreapi/name_test.go': 6, 'core/coreapi/path.go': 12, 'core/coreunix/cat.go': 4, 'core/pathresolver_test.go': 7, 'dagutils/diff.go': 8, 'dagutils/diffenum.go': 7, 'dagutils/diffenum_test.go': 7, 'dagutils/utils.go': 7, 'dagutils/utils_test.go': 7, 'filestore/pb/dataobj.pb.go': 3, 'keystore/keystore_test.go': 4, 'keystore/memkeystore.go': 4, 'mfs/fd.go': 2, 'namesys/base.go': 8, 'namesys/cache.go': 7, 'namesys/ipns_resolver_validation_test.go': 8, 'pin/internal/pb/header.pb.go': 3, 'thirdparty/cidv0v1/blockstore.go': 6, 'repo/fsrepo/config_test.go': 5, 'repo/fsrepo/fsrepo_test.go': 5, 'repo/fsrepo/misc.go': 5, 'test/bench/bench_cli_ipfs_add/main.go': 6, 'test/bench/offline_add/main.go': 6, 'core/commands/cmdenv/env.go': 21, 'core/commands/name/ipns.go': 22, 'core/commands/name/ipnsps.go': 23, 'core/commands/name/name.go': 22, 'core/commands/name/publish.go': 22, 'test/sharness/lib/test-lib.sh': 1, 'core/coreapi/dht.go': 6, 'core/coreapi/dht_test.go': 2, 'core/coreapi/interface/dht.go': 2, 'p2p/listener.go': 4, 'p2p/local.go': 4, 'p2p/remote.go': 4, 'p2p/stream.go': 4, 'core/commands/cid.go': 16, 'core/coreapi/unixfile.go': 3, 'cmd/ipfs/dnsresolve_test.go': 2, 'core/coreapi/interface/options/unixfs.go': 1, 'core/coreapi/interface/pubsub.go': 1, 'core/coreapi/interface/swarm.go': 1, 'core/coreapi/pubsub.go': 5, 'core/coreapi/swarm.go': 5, 'test/dependencies/iptb/iptb.go': 4, 'commands/context.go': 11, 'core/commands/cmdenv/cidbase.go': 9, 'core/commands/cmdenv/file.go': 3, 'core/coreapi/interface/tests/name.go': 1, 'core/coreapi/interface/tests/unixfs.go': 1, 'core/coreapi/test/api_test.go': 4, 'core/corehttp/ipns_hostname.go': 4, 'namesys/dns_test.go': 4, 'plugin/daemon.go': 4, 'plugin/loader/loader.go': 4, 'core/corehttp/proxy.go': 3, 'plugin/plugins/badgerds/badgerds.go': 3, 'plugin/plugins/flatfs/flatfs.go': 3, 'plugin/plugins/levelds/levelds.go': 2, 'core/corerepo/stat.go': 2, 'core/commands/cmdenv/cidbase_test.go': 1, 'core/corehttp/metrics.go': 1, 'core/corehttp/proxy_test.go': 1, 'plugin/tracer.go': 1, 'thirdparty/notifier/notifier.go': 1, 'core/ncore.go': 1, 'fuse/ipns/mount_unix.go': 1, 'fuse/readonly/mount_unix.go': 1, 'README.md': 2, 'go.mod': 1, 'go.sum': 1, 'package-list.json': 1, 'core/commands/pin/pin.go': 1, 'core/commands/stat_dht.go': 1}","('core/commands/root.go', 0.9459459459459459, 0.30973451327433627)"
core/commands/stat.go,200,1105,5,"[{'cyclomatic_complexity': 7, 'nloc': 24, 'token_count': 110, 'name': '', 'long_name': '()', 'start_line': 147, 'end_line': 170, 'full_parameters': [], 'filename': '/home/dimi/Documents/Informatik_Studium/FSS/SoftEvo/DataCollection/FFS_SoftEvo/go-ipfs/core/commands/stat.go', 'top_nesting_level': 0, 'length': 24, 'fan_in': 0, 'fan_out': 0, 'general_fan_out': 0}, {'cyclomatic_complexity': 13, 'nloc': 56, 'token_count': 337, 'name': '', 'long_name': '(req cmds.Request,res cmds.Response)', 'start_line': 83, 'end_line': 171, 'full_parameters': [], 'filename': '/home/dimi/Documents/Informatik_Studium/FSS/SoftEvo/DataCollection/FFS_SoftEvo/go-ipfs/core/commands/stat.go', 'top_nesting_level': 0, 'length': 89, 'fan_in': 0, 'fan_out': 0, 'general_fan_out': 0}, {'cyclomatic_complexity': 4, 'nloc': 21, 'token_count': 170, 'name': '', 'long_name': '(v interface{})(io.Reader,error)', 'start_line': 186, 'end_line': 208, 'full_parameters': [], 'filename': '/home/dimi/Documents/Informatik_Studium/FSS/SoftEvo/DataCollection/FFS_SoftEvo/go-ipfs/core/commands/stat.go', 'top_nesting_level': 0, 'length': 23, 'fan_in': 0, 'fan_out': 0, 'general_fan_out': 0}, {'cyclomatic_complexity': 3, 'nloc': 17, 'token_count': 104, 'name': '', 'long_name': '(res cmds.Response)(io.Reader,error)', 'start_line': 174, 'end_line': 215, 'full_parameters': [], 'filename': '/home/dimi/Documents/Informatik_Studium/FSS/SoftEvo/DataCollection/FFS_SoftEvo/go-ipfs/core/commands/stat.go', 'top_nesting_level': 0, 'length': 42, 'fan_in': 0, 'fan_out': 0, 'general_fan_out': 0}, {'cyclomatic_complexity': 1, 'nloc': 7, 'token_count': 104, 'name': 'printStats', 'long_name': 'printStats out io . Writer , bs * metrics . Stats', 'start_line': 219, 'end_line': 225, 'full_parameters': ['out io . Writer', ' bs * metrics . Stats'], 'filename': '/home/dimi/Documents/Informatik_Studium/FSS/SoftEvo/DataCollection/FFS_SoftEvo/go-ipfs/core/commands/stat.go', 'top_nesting_level': 0, 'length': 7, 'fan_in': 0, 'fan_out': 0, 'general_fan_out': 0}]",173,940,1,"[{'cyclomatic_complexity': 1, 'nloc': 7, 'token_count': 104, 'name': 'printStats', 'long_name': 'printStats out io . Writer , bs * metrics . Stats', 'start_line': 189, 'end_line': 195, 'full_parameters': ['out io . Writer', ' bs * metrics . Stats'], 'filename': '/home/dimi/Documents/Informatik_Studium/FSS/SoftEvo/DataCollection/FFS_SoftEvo/go-ipfs/core/commands/stat.go', 'top_nesting_level': 0, 'length': 7, 'fan_in': 0, 'fan_out': 0, 'general_fan_out': 0}]",-27,-165,-4,74,74,"[{'timestamp': 1491058697.0, 'added_lines': 70, 'deleted_lines': 84, 'nloc': 185}, {'timestamp': 1508770239.0, 'added_lines': 1, 'deleted_lines': 1, 'nloc': 185}, {'timestamp': 1509016767.0, 'added_lines': 1, 'deleted_lines': 1, 'nloc': 185}, {'timestamp': 1499331469.0, 'added_lines': 1, 'deleted_lines': 1, 'nloc': 185}, {'timestamp': 1511223906.0, 'added_lines': 3, 'deleted_lines': 3, 'nloc': 185}, {'timestamp': 1511245249.0, 'added_lines': 1, 'deleted_lines': 1, 'nloc': 185}, {'timestamp': 1511373659.0, 'added_lines': 1, 'deleted_lines': 1, 'nloc': 185}, {'timestamp': 1512365669.0, 'added_lines': 4, 'deleted_lines': 4, 'nloc': 185}, {'timestamp': 1511187070.0, 'added_lines': 11, 'deleted_lines': 32, 'nloc': 167}, {'timestamp': 1512058290.0, 'added_lines': 0, 'deleted_lines': 1, 'nloc': 166}, {'timestamp': 1512121226.0, 'added_lines': 1, 'deleted_lines': 1, 'nloc': 166}, {'timestamp': 1513436097.0, 'added_lines': 2, 'deleted_lines': 2, 'nloc': 166}, {'timestamp': 1513612261.0, 'added_lines': 2, 'deleted_lines': 2, 'nloc': 166}, {'timestamp': 1513764708.0, 'added_lines': 1, 'deleted_lines': 1, 'nloc': 166}, {'timestamp': 1513765470.0, 'added_lines': 1, 'deleted_lines': 1, 'nloc': 166}, {'timestamp': 1513766201.0, 'added_lines': 1, 'deleted_lines': 1, 'nloc': 166}, {'timestamp': 1513772654.0, 'added_lines': 1, 'deleted_lines': 1, 'nloc': 166}, {'timestamp': 1513773452.0, 'added_lines': 1, 'deleted_lines': 1, 'nloc': 166}, {'timestamp': 1515277696.0, 'added_lines': 1, 'deleted_lines': 1, 'nloc': 166}, {'timestamp': 1515465466.0, 'added_lines': 2, 'deleted_lines': 2, 'nloc': 166}, {'timestamp': 1515713724.0, 'added_lines': 1, 'deleted_lines': 1, 'nloc': 166}, {'timestamp': 1516341168.0, 'added_lines': 1, 'deleted_lines': 1, 'nloc': 166}, {'timestamp': 1516826246.0, 'added_lines': 1, 'deleted_lines': 1, 'nloc': 166}, {'timestamp': 1516838128.0, 'added_lines': 3, 'deleted_lines': 3, 'nloc': 166}, {'timestamp': 1517105039.0, 'added_lines': 1, 'deleted_lines': 1, 'nloc': 166}, {'timestamp': 1517453697.0, 'added_lines': 3, 'deleted_lines': 3, 'nloc': 166}, {'timestamp': 1519173780.0, 'added_lines': 1, 'deleted_lines': 1, 'nloc': 166}, {'timestamp': 1521314540.0, 'added_lines': 1, 'deleted_lines': 1, 'nloc': 166}, {'timestamp': 1521500314.0, 'added_lines': 1, 'deleted_lines': 1, 'nloc': 166}, {'timestamp': 1521643018.0, 'added_lines': 3, 'deleted_lines': 1, 'nloc': 168}, {'timestamp': 1524596476.0, 'added_lines': 1, 'deleted_lines': 1, 'nloc': 168}, {'timestamp': 1525408792.0, 'added_lines': 3, 'deleted_lines': 3, 'nloc': 168}, {'timestamp': 1528268108.0, 'added_lines': 1, 'deleted_lines': 1, 'nloc': 168}, {'timestamp': 1528520460.0, 'added_lines': 4, 'deleted_lines': 4, 'nloc': 168}, {'timestamp': 1529984485.0, 'added_lines': 3, 'deleted_lines': 3, 'nloc': 168}, {'timestamp': 1533779477.0, 'added_lines': 3, 'deleted_lines': 3, 'nloc': 168}, {'timestamp': 1533946888.0, 'added_lines': 2, 'deleted_lines': 2, 'nloc': 168}, {'timestamp': 1534896611.0, 'added_lines': 4, 'deleted_lines': 4, 'nloc': 168}, {'timestamp': 1534903410.0, 'added_lines': 4, 'deleted_lines': 2, 'nloc': 169}, {'timestamp': 1523628870.0, 'added_lines': 32, 'deleted_lines': 44, 'nloc': 161}, {'timestamp': 1535044155.0, 'added_lines': 1, 'deleted_lines': 1, 'nloc': 161}, {'timestamp': 1535388501.0, 'added_lines': 1, 'deleted_lines': 1, 'nloc': 160}, {'timestamp': 1537193530.0, 'added_lines': 1, 'deleted_lines': 1, 'nloc': 160}, {'timestamp': 1537391809.0, 'added_lines': 1, 'deleted_lines': 1, 'nloc': 160}, {'timestamp': 1537792589.0, 'added_lines': 3, 'deleted_lines': 3, 'nloc': 160}, {'timestamp': 1538662493.0, 'added_lines': 15, 'deleted_lines': 8, 'nloc': 166}, {'timestamp': 1539462168.0, 'added_lines': 1, 'deleted_lines': 1, 'nloc': 166}, {'timestamp': 1539850591.0, 'added_lines': 2, 'deleted_lines': 2, 'nloc': 166}, {'timestamp': 1540400358.0, 'added_lines': 2, 'deleted_lines': 2, 'nloc': 166}, {'timestamp': 1540552487.0, 'added_lines': 1, 'deleted_lines': 1, 'nloc': 166}, {'timestamp': 1540597832.0, 'added_lines': 1, 'deleted_lines': 1, 'nloc': 166}, {'timestamp': 1540906996.0, 'added_lines': 10, 'deleted_lines': 4, 'nloc': 172}, {'timestamp': 1541204121.0, 'added_lines': 3, 'deleted_lines': 3, 'nloc': 172}, {'timestamp': 1544225843.0, 'added_lines': 2, 'deleted_lines': 2, 'nloc': 172}, {'timestamp': 1544661332.0, 'added_lines': 1, 'deleted_lines': 1, 'nloc': 172}, {'timestamp': 1540556089.0, 'added_lines': 1, 'deleted_lines': 1, 'nloc': 172}, {'timestamp': 1547152271.0, 'added_lines': 1, 'deleted_lines': 1, 'nloc': 172}, {'timestamp': 1548866534.0, 'added_lines': 1, 'deleted_lines': 1, 'nloc': 172}, {'timestamp': 1549588289.0, 'added_lines': 2, 'deleted_lines': 2, 'nloc': 172}, {'timestamp': 1549903582.0, 'added_lines': 1, 'deleted_lines': 1, 'nloc': 172}, {'timestamp': 1550507829.0, 'added_lines': 3, 'deleted_lines': 3, 'nloc': 172}, {'timestamp': 1550610741.0, 'added_lines': 2, 'deleted_lines': 2, 'nloc': 172}, {'timestamp': 1551138343.0, 'added_lines': 1, 'deleted_lines': 1, 'nloc': 172}, {'timestamp': 1551229859.0, 'added_lines': 2, 'deleted_lines': 2, 'nloc': 172}, {'timestamp': 1551299964.0, 'added_lines': 1, 'deleted_lines': 1, 'nloc': 172}, {'timestamp': 1551471469.0, 'added_lines': 1, 'deleted_lines': 1, 'nloc': 172}, {'timestamp': 1551754781.0, 'added_lines': 1, 'deleted_lines': 1, 'nloc': 172}, {'timestamp': 1551551196.0, 'added_lines': 6, 'deleted_lines': 6, 'nloc': 172}, {'timestamp': 1557554420.0, 'added_lines': 9, 'deleted_lines': 10, 'nloc': 171}, {'timestamp': 1559060517.0, 'added_lines': 3, 'deleted_lines': 3, 'nloc': 171}, {'timestamp': 1576349311.0, 'added_lines': 1, 'deleted_lines': 1, 'nloc': 171}, {'timestamp': 1587954625.0, 'added_lines': 1, 'deleted_lines': 0, 'nloc': 172}, {'timestamp': 1616604074.0, 'added_lines': 1, 'deleted_lines': 1, 'nloc': 172}, {'timestamp': 1620878179.0, 'added_lines': 1, 'deleted_lines': 0, 'nloc': 173}]","{'blocks/blockstore/caching.go': 1, 'blocks/blockstore/util/remove.go': 3, 'cmd/ipfs/daemon.go': 60, 'cmd/ipfs/init.go': 41, 'cmd/ipfs/ipfs.go': 51, 'cmd/ipfs/main.go': 59, 'cmd/ipfs/main_test.go': 4, 'cmd/ipfswatch/main.go': 20, 'cmd/seccat/seccat.go': 20, None: 13, 'commands/channelmarshaler.go': 1, 'commands/cli/cmd_suggestion.go': 1, 'commands/cli/helptext.go': 3, 'commands/cli/helptext_test.go': 2, 'commands/cli/parse.go': 2, 'commands/cli/parse_test.go': 2, 'commands/command.go': 29, 'commands/command_test.go': 20, 'commands/http/client.go': 2, 'commands/http/handler.go': 2, 'commands/http/multifilereader.go': 2, 'commands/http/multifilereader_test.go': 2, 'commands/http/parse.go': 2, 'commands/reqlog.go': 1, 'commands/request.go': 39, 'commands/response.go': 24, 'commands/response_test.go': 20, 'core/bootstrap.go': 20, 'core/commands/active.go': 25, 'core/commands/add.go': 58, 'core/commands/bitswap.go': 63, 'core/commands/block.go': 58, 'core/commands/bootstrap.go': 30, 'core/commands/cat.go': 56, 'core/commands/commands.go': 54, 'core/commands/config.go': 33, 'core/commands/dag/dag.go': 37, 'core/commands/dht.go': 43, 'core/commands/diag.go': 23, 'core/commands/dns.go': 31, 'core/commands/e/error.go': 1, 'core/commands/external.go': 23, 'core/commands/files/files.go': 12, 'core/commands/filestore.go': 55, 'core/commands/get.go': 60, 'core/commands/helptext_test.go': 51, 'core/commands/id.go': 44, 'core/commands/ipns.go': 15, 'core/commands/keystore.go': 40, 'core/commands/log.go': 29, 'core/commands/ls.go': 35, 'core/commands/mount_nofuse.go': 23, 'core/commands/mount_unix.go': 31, 'core/commands/mount_windows.go': 22, 'core/commands/name.go': 10, 'core/commands/object/diff.go': 26, 'core/commands/object/object.go': 45, 'core/commands/object/patch.go': 42, 'core/commands/p2p.go': 37, 'core/commands/pin.go': 37, 'core/commands/ping.go': 41, 'core/commands/publish.go': 16, 'core/commands/pubsub.go': 58, 'core/commands/refs.go': 34, 'core/commands/repo.go': 60, 'core/commands/resolve.go': 36, 'core/commands/root.go': 56, 'core/commands/shutdown.go': 35, 'core/commands/swarm.go': 42, 'core/commands/sysdiag.go': 30, 'core/commands/tar.go': 33, 'core/commands/unixfs/ls.go': 30, 'core/commands/unixfs/unixfs.go': 23, 'core/commands/version.go': 29, 'core/core_test.go': 11, 'core/corehttp/commands.go': 56, 'core/corehttp/gateway.go': 22, 'core/coreunix/add.go': 28, 'core/coreunix/add_test.go': 27, 'core/coreunix/metadata_test.go': 22, 'exchange/bitswap/bitswap_test.go': 11, 'exchange/bitswap/decision/engine_test.go': 8, 'exchange/bitswap/message/message_test.go': 4, 'exchange/bitswap/message/pb/Makefile': 1, 'exchange/bitswap/testnet/network_test.go': 9, 'exchange/bitswap/testnet/peernet.go': 10, 'exchange/reprovide/reprovide_test.go': 19, 'fuse/ipns/common.go': 19, 'fuse/node/mount_test.go': 20, 'importer/balanced/balanced_test.go': 6, 'importer/chunk/rabin_test.go': 3, 'importer/helpers/dagbuilder.go': 11, 'importer/importer.go': 11, 'merkledag/utils/utils_test.go': 4, 'mfs/repub_test.go': 9, 'namesys/dns.go': 13, 'namesys/interface.go': 15, 'namesys/ipns_select_test.go': 5, 'namesys/proquint.go': 13, 'namesys/republisher/repub_test.go': 23, 'package.json': 56, 'repo/config/identity.go': 3, 'routing/offline/offline_test.go': 6, 'test/integration/addcat_test.go': 25, 'test/integration/bench_cat_test.go': 24, 'test/integration/bitswap_wo_routing_test.go': 21, 'test/integration/three_legged_cat_test.go': 24, 'test/sharness/t0600-issues-and-regressions-online.sh': 1, 'core/bootstrap_test.go': 18, 'core/commands/dht_test.go': 18, 'core/commands/get_test.go': 50, 'core/core.go': 27, 'core/corehttp/gateway_test.go': 23, 'core/corehttp/metrics_test.go': 21, 'core/mock/mock.go': 21, 'exchange/bitswap/decision/bench_test.go': 7, 'exchange/bitswap/decision/peer_request_queue_test.go': 7, 'exchange/bitswap/message/message.go': 8, 'exchange/bitswap/network/interface.go': 8, 'exchange/bitswap/network/ipfs_impl.go': 8, 'exchange/bitswap/testnet/interface.go': 7, 'exchange/bitswap/testnet/virtual.go': 8, 'exchange/bitswap/testutils.go': 9, 'fuse/ipns/ipns_test.go': 19, 'fuse/readonly/ipfs_test.go': 24, 'namesys/publisher_test.go': 19, 'namesys/resolve_test.go': 20, 'p2p/p2p.go': 19, 'p2p/registry.go': 10, 'repo/config/bootstrap_peers.go': 10, 'routing/mock/centralized_client.go': 4, 'routing/mock/centralized_server.go': 4, 'routing/mock/centralized_test.go': 4, 'routing/mock/interface.go': 4, 'routing/none/none_client.go': 4, 'test/integration/bench_test.go': 18, 'assets/assets.go': 18, 'blocks/blockstore/arc_cache.go': 2, 'blocks/blockstore/arc_cache_test.go': 2, 'blocks/blockstore/blockstore.go': 3, 'blocks/blockstore/blockstore_test.go': 2, 'blocks/blockstore/bloom_cache.go': 2, 'blocks/blockstore/bloom_cache_test.go': 2, 'blocks/blocksutil/block_generator.go': 2, 'blockservice/blockservice.go': 6, 'blockservice/blockservice_test.go': 5, 'blockservice/test/blocks_test.go': 5, 'core/builder.go': 24, 'core/commands/ipnsps.go': 10, 'core/coreapi/coreapi.go': 14, 'core/coreapi/interface/interface.go': 2, 'core/coreapi/unixfs.go': 20, 'core/coreapi/unixfs_test.go': 15, 'core/coredag/cbor.go': 7, 'core/coredag/dagpb.go': 14, 'core/coredag/dagtransl.go': 6, 'core/coredag/raw.go': 14, 'core/corehttp/corehttp.go': 14, 'core/corehttp/gateway_handler.go': 26, 'core/corerepo/gc.go': 22, 'core/corerepo/pinning.go': 8, 'core/coreunix/metadata.go': 19, 'core/pathresolver.go': 17, 'exchange/bitswap/bitswap.go': 6, 'exchange/bitswap/decision/engine.go': 6, 'exchange/bitswap/decision/ledger.go': 6, 'exchange/bitswap/decision/peer_request_queue.go': 6, 'exchange/bitswap/get.go': 5, 'exchange/bitswap/notifications/notifications.go': 3, 'exchange/bitswap/notifications/notifications_test.go': 3, 'exchange/bitswap/session.go': 7, 'exchange/bitswap/session_test.go': 5, 'exchange/bitswap/stat.go': 3, 'exchange/bitswap/wantlist/wantlist.go': 3, 'exchange/bitswap/wantlist/wantlist_test.go': 3, 'exchange/bitswap/wantmanager.go': 6, 'exchange/bitswap/workers.go': 6, 'exchange/interface.go': 2, 'exchange/offline/offline.go': 2, 'exchange/offline/offline_test.go': 2, 'exchange/reprovide/providers.go': 16, 'exchange/reprovide/reprovide.go': 17, 'filestore/filestore.go': 12, 'filestore/filestore_test.go': 16, 'filestore/fsrefstore.go': 11, 'filestore/util.go': 11, 'fuse/ipns/ipns_unix.go': 23, 'fuse/readonly/readonly_unix.go': 23, 'importer/balanced/builder.go': 3, 'importer/chunk/splitting_test.go': 2, 'importer/helpers/helpers.go': 3, 'importer/importer_test.go': 5, 'importer/trickle/trickle_test.go': 5, 'importer/trickle/trickledag.go': 3, 'merkledag/batch.go': 2, 'merkledag/coding.go': 3, 'merkledag/merkledag.go': 3, 'merkledag/merkledag_test.go': 5, 'merkledag/node.go': 3, 'merkledag/node_test.go': 3, 'merkledag/raw.go': 3, 'merkledag/traverse/traverse.go': 3, 'merkledag/traverse/traverse_test.go': 3, 'merkledag/utils/diff.go': 3, 'merkledag/utils/diffenum.go': 3, 'merkledag/utils/diffenum_test.go': 3, 'merkledag/utils/utils.go': 5, 'mfs/dir.go': 5, 'mfs/file.go': 7, 'mfs/mfs_test.go': 7, 'mfs/ops.go': 4, 'mfs/system.go': 8, 'namesys/namesys.go': 22, 'namesys/publisher.go': 24, 'namesys/pubsub.go': 5, 'namesys/pubsub_test.go': 5, 'namesys/republisher/repub.go': 18, 'namesys/routing.go': 21, 'path/path.go': 3, 'path/resolver.go': 3, 'path/resolver_test.go': 2, 'pin/gc/gc.go': 17, 'pin/pin.go': 17, 'pin/pin_test.go': 16, 'pin/set.go': 14, 'pin/set_test.go': 16, 'plugin/ipld.go': 6, 'plugin/loader/initializer.go': 5, 'plugin/plugins/git/git.go': 6, 'repo/config/init.go': 7, 'repo/fsrepo/fsrepo.go': 16, 'repo/fsrepo/lock/lock.go': 3, 'repo/fsrepo/serialize/serialize.go': 3, 'repo/mock.go': 13, 'repo/repo.go': 14, 'routing/offline/offline.go': 3, 'tar/format.go': 22, 'test/dependencies/ma-pipe-unidir/main.go': 9, 'thirdparty/ds-help/key.go': 2, 'thirdparty/pollEndpoint/main.go': 14, 'thirdparty/posinfo/posinfo.go': 2, 'unixfs/archive/archive.go': 3, 'unixfs/archive/tar/writer.go': 3, 'unixfs/hamt/hamt.go': 3, 'unixfs/io/dagreader.go': 3, 'unixfs/io/dirbuilder.go': 3, 'unixfs/io/resolve.go': 3, 'unixfs/mod/dagmodifier.go': 5, 'unixfs/mod/dagmodifier_test.go': 3, 'unixfs/test/utils.go': 5, 'commands/legacy/command.go': 34, 'commands/legacy/legacy.go': 34, 'commands/legacy/legacy_test.go': 35, 'commands/legacy/request.go': 35, 'commands/legacy/response.go': 35, 'commands/legacy/responseemitter.go': 4, 'core/commands/env.go': 4, 'core/commands/commands_test.go': 46, 'test/sharness/t0040-add-and-cat.sh': 1, 'TODO.md': 2, 'test/sharness/t0110-gateway.sh': 1, 'test/sharness/t0410-api-add.sh': 1, 'core/coreapi/dag.go': 5, 'core/coreapi/dag_test.go': 3, 'core/coreapi/interface/options/dag.go': 4, 'core/coreapi/key.go': 18, 'core/coreapi/name.go': 19, 'merkledag/test/utils.go': 4, 'namesys/namesys_test.go': 22, 'repo/fsrepo/datastores.go': 10, 'repo/fsrepo/fsrepo_test.go': 11, 'thirdparty/datastore2/datastore_closer.go': 1, 'thirdparty/datastore2/delayed.go': 1, 'thirdparty/datastore2/threadsafe.go': 1, 'unixfs/io/pbdagreader.go': 2, 'cmd/ipfs/util/ulimit.go': 9, 'cmd/seccat/util.go': 9, 'core/corehttp/logs.go': 9, 'fuse/mount/mount.go': 9, 'fuse/node/mount_unix.go': 10, 'importer/chunk/splitting.go': 1, 'namesys/ipns_validate_test.go': 4, 'plugin/loader/load.go': 7, 'core/commands/files.go': 38, 'core/commands/root_test.go': 1, 'test/sharness/t0090-get.sh': 1, 'blocks/blockstoreutil/remove.go': 9, 'blockservice/test/mock.go': 4, 'core/coreapi/pin.go': 15, 'keystore/keystore.go': 9, 'keystore/keystore_test.go': 6, 'keystore/memkeystore.go': 6, 'namesys/validator.go': 3, 'path/resolver/resolver.go': 3, 'thirdparty/verifbs/verifbs.go': 9, 'cmd/ipfs/util/ulimit_freebsd.go': 2, 'cmd/ipfs/util/ulimit_unix.go': 2, 'core/coreapi/block.go': 8, 'core/coreapi/block_test.go': 2, 'core/coreapi/interface/coreapi.go': 3, 'core/coreapi/interface/dag.go': 3, 'core/coreapi/interface/object.go': 3, 'core/coreapi/interface/options/block.go': 2, 'core/coreapi/interface/path.go': 8, 'core/coreapi/interface/unixfs.go': 7, 'core/coreapi/object.go': 17, 'fuse/ipns/link_unix.go': 2, 'fuse/mount/fuse.go': 2, 'fuse/node/mount_darwin.go': 2, 'merkledag/errservice.go': 1, 'merkledag/readonly.go': 1, 'merkledag/readonly_test.go': 1, 'merkledag/rwservice.go': 1, 'merkledag/session.go': 1, 'path/resolver/resolver_test.go': 1, 'thirdparty/verifcid/validate.go': 1, 'thirdparty/verifcid/validate_test.go': 1, 'unixfs/hamt/hamt_stress_test.go': 1, 'unixfs/hamt/hamt_test.go': 1, 'namesys/ipns_resolver_validation_test.go': 14, 'test/sharness/t0170-dht.sh': 1, 'core/commands/urlstore.go': 29, 'core/coreapi/interface/key.go': 7, 'core/coreapi/name_test.go': 8, 'core/coreapi/path.go': 16, 'core/coreunix/cat.go': 4, 'core/pathresolver_test.go': 11, 'dagutils/diff.go': 12, 'dagutils/diffenum.go': 11, 'dagutils/diffenum_test.go': 11, 'dagutils/utils.go': 11, 'dagutils/utils_test.go': 11, 'filestore/pb/dataobj.pb.go': 3, 'mfs/fd.go': 2, 'namesys/base.go': 12, 'namesys/cache.go': 11, 'pin/internal/pb/header.pb.go': 3, 'thirdparty/cidv0v1/blockstore.go': 6, 'repo/fsrepo/config_test.go': 9, 'repo/fsrepo/misc.go': 9, 'test/bench/bench_cli_ipfs_add/main.go': 10, 'test/bench/offline_add/main.go': 10, 'core/commands/cmdenv/env.go': 25, 'core/commands/name/ipns.go': 26, 'core/commands/name/ipnsps.go': 29, 'core/commands/name/name.go': 22, 'core/commands/name/publish.go': 23, 'test/sharness/lib/test-lib.sh': 1, 'core/coreapi/dht.go': 11, 'core/coreapi/dht_test.go': 4, 'core/coreapi/interface/dht.go': 5, 'p2p/listener.go': 9, 'p2p/local.go': 9, 'p2p/remote.go': 9, 'p2p/stream.go': 9, 'core/commands/cid.go': 17, 'core/coreapi/unixfile.go': 5, 'cmd/ipfs/dnsresolve_test.go': 4, 'core/coreapi/interface/options/unixfs.go': 4, 'core/coreapi/interface/pubsub.go': 4, 'core/coreapi/interface/swarm.go': 4, 'core/coreapi/pubsub.go': 10, 'core/coreapi/swarm.go': 10, 'test/dependencies/iptb/iptb.go': 7, 'commands/context.go': 14, 'core/corehttp/proxy.go': 7, 'core/commands/cmdenv/cidbase.go': 9, 'core/commands/cmdenv/file.go': 3, 'core/coreapi/interface/tests/name.go': 2, 'core/coreapi/interface/tests/unixfs.go': 2, 'core/coreapi/test/api_test.go': 7, 'core/corehttp/ipns_hostname.go': 5, 'namesys/dns_test.go': 5, 'plugin/daemon.go': 5, 'plugin/loader/loader.go': 5, 'plugin/plugins/badgerds/badgerds.go': 3, 'plugin/plugins/flatfs/flatfs.go': 3, 'plugin/plugins/levelds/levelds.go': 2, 'core/corerepo/stat.go': 2, 'core/commands/cmdenv/cidbase_test.go': 1, 'core/corehttp/metrics.go': 1, 'core/corehttp/proxy_test.go': 2, 'plugin/tracer.go': 1, 'thirdparty/notifier/notifier.go': 1, 'README.md': 2, 'go.mod': 3, 'go.sum': 3, 'package-list.json': 1, 'core/bootstrap/bootstrap.go': 1, 'core/bootstrap/bootstrap_test.go': 1, 'core/node/builder.go': 1, 'core/node/core.go': 1, 'core/node/groups.go': 3, 'core/node/identity.go': 1, 'core/node/ipns.go': 1, 'core/node/libp2p/addrs.go': 1, 'core/node/libp2p/discovery.go': 1, 'core/node/libp2p/host.go': 1, 'core/node/libp2p/hostopt.go': 1, 'core/node/libp2p/libp2p.go': 1, 'core/node/libp2p/nat.go': 1, 'core/node/libp2p/pnet.go': 1, 'core/node/libp2p/pubsub.go': 1, 'core/node/libp2p/routing.go': 1, 'core/node/libp2p/routingopt.go': 1, 'core/node/libp2p/smux.go': 1, 'core/node/libp2p/transport.go': 1, 'core/node/provider.go': 2, 'provider/simple/provider.go': 1, 'provider/simple/provider_test.go': 1, 'provider/simple/reprovide.go': 1, 'provider/simple/reprovide_test.go': 1, 'core/commands/stat_dht.go': 2, 'core/commands/pin/pin.go': 1, 'core/commands/stat_provide.go': 1}","('core/commands/bitswap.go', 0.8513513513513513, 0.6363636363636364)"
core/commands/swarm.go,681,4437,23,"[{'cyclomatic_complexity': 12, 'nloc': 51, 'token_count': 350, 'name': '', 'long_name': '(req cmds.Request,res cmds.Response)', 'start_line': 62, 'end_line': 122, 'full_parameters': [], 'filename': '/home/dimi/Documents/Informatik_Studium/FSS/SoftEvo/DataCollection/FFS_SoftEvo/go-ipfs/core/commands/swarm.go', 'top_nesting_level': 0, 'length': 61, 'fan_in': 0, 'fan_out': 0, 'general_fan_out': 0}, {'cyclomatic_complexity': 7, 'nloc': 27, 'token_count': 197, 'name': '', 'long_name': '(res cmds.Response)(io.Reader,error)', 'start_line': 124, 'end_line': 154, 'full_parameters': [], 'filename': '/home/dimi/Documents/Informatik_Studium/FSS/SoftEvo/DataCollection/FFS_SoftEvo/go-ipfs/core/commands/swarm.go', 'top_nesting_level': 0, 'length': 31, 'fan_in': 0, 'fan_out': 0, 'general_fan_out': 0}, {'cyclomatic_complexity': 1, 'nloc': 3, 'token_count': 34, 'name': 'Less', 'long_name': '(ci*connInfo)Less i , j int', 'start_line': 171, 'end_line': 173, 'full_parameters': ['i', ' j int'], 'filename': '/home/dimi/Documents/Informatik_Studium/FSS/SoftEvo/DataCollection/FFS_SoftEvo/go-ipfs/core/commands/swarm.go', 'top_nesting_level': 0, 'length': 3, 'fan_in': 0, 'fan_out': 0, 'general_fan_out': 0}, {'cyclomatic_complexity': 1, 'nloc': 3, 'token_count': 19, 'name': 'Len', 'long_name': '(ci*connInfo)Len', 'start_line': 175, 'end_line': 177, 'full_parameters': [], 'filename': '/home/dimi/Documents/Informatik_Studium/FSS/SoftEvo/DataCollection/FFS_SoftEvo/go-ipfs/core/commands/swarm.go', 'top_nesting_level': 0, 'length': 3, 'fan_in': 0, 'fan_out': 0, 'general_fan_out': 0}, {'cyclomatic_complexity': 1, 'nloc': 3, 'token_count': 42, 'name': 'Swap', 'long_name': '(ci*connInfo)Swap i , j int', 'start_line': 179, 'end_line': 181, 'full_parameters': ['i', ' j int'], 'filename': '/home/dimi/Documents/Informatik_Studium/FSS/SoftEvo/DataCollection/FFS_SoftEvo/go-ipfs/core/commands/swarm.go', 'top_nesting_level': 0, 'length': 3, 'fan_in': 0, 'fan_out': 0, 'general_fan_out': 0}, {'cyclomatic_complexity': 1, 'nloc': 3, 'token_count': 33, 'name': 'Less', 'long_name': '(ci connInfos)Less i , j int', 'start_line': 187, 'end_line': 189, 'full_parameters': ['i', ' j int'], 'filename': '/home/dimi/Documents/Informatik_Studium/FSS/SoftEvo/DataCollection/FFS_SoftEvo/go-ipfs/core/commands/swarm.go', 'top_nesting_level': 0, 'length': 3, 'fan_in': 0, 'fan_out': 0, 'general_fan_out': 0}, {'cyclomatic_complexity': 1, 'nloc': 3, 'token_count': 18, 'name': 'Len', 'long_name': '(ci connInfos)Len', 'start_line': 191, 'end_line': 193, 'full_parameters': [], 'filename': '/home/dimi/Documents/Informatik_Studium/FSS/SoftEvo/DataCollection/FFS_SoftEvo/go-ipfs/core/commands/swarm.go', 'top_nesting_level': 0, 'length': 3, 'fan_in': 0, 'fan_out': 0, 'general_fan_out': 0}, {'cyclomatic_complexity': 1, 'nloc': 3, 'token_count': 41, 'name': 'Swap', 'long_name': '(ci connInfos)Swap i , j int', 'start_line': 195, 'end_line': 197, 'full_parameters': ['i', ' j int'], 'filename': '/home/dimi/Documents/Informatik_Studium/FSS/SoftEvo/DataCollection/FFS_SoftEvo/go-ipfs/core/commands/swarm.go', 'top_nesting_level': 0, 'length': 3, 'fan_in': 0, 'fan_out': 0, 'general_fan_out': 0}, {'cyclomatic_complexity': 5, 'nloc': 21, 'token_count': 166, 'name': '', 'long_name': '(req cmds.Request,res cmds.Response)', 'start_line': 210, 'end_line': 234, 'full_parameters': [], 'filename': '/home/dimi/Documents/Informatik_Studium/FSS/SoftEvo/DataCollection/FFS_SoftEvo/go-ipfs/core/commands/swarm.go', 'top_nesting_level': 0, 'length': 25, 'fan_in': 0, 'fan_out': 0, 'general_fan_out': 0}, {'cyclomatic_complexity': 5, 'nloc': 20, 'token_count': 155, 'name': '', 'long_name': '(res cmds.Response)(io.Reader,error)', 'start_line': 236, 'end_line': 258, 'full_parameters': [], 'filename': '/home/dimi/Documents/Informatik_Studium/FSS/SoftEvo/DataCollection/FFS_SoftEvo/go-ipfs/core/commands/swarm.go', 'top_nesting_level': 0, 'length': 23, 'fan_in': 0, 'fan_out': 0, 'general_fan_out': 0}, {'cyclomatic_complexity': 5, 'nloc': 23, 'token_count': 160, 'name': '', 'long_name': '(req cmds.Request,res cmds.Response)', 'start_line': 273, 'end_line': 300, 'full_parameters': [], 'filename': '/home/dimi/Documents/Informatik_Studium/FSS/SoftEvo/DataCollection/FFS_SoftEvo/go-ipfs/core/commands/swarm.go', 'top_nesting_level': 0, 'length': 28, 'fan_in': 0, 'fan_out': 0, 'general_fan_out': 0}, {'cyclomatic_complexity': 5, 'nloc': 22, 'token_count': 142, 'name': '', 'long_name': '(req cmds.Request,res cmds.Response)', 'start_line': 314, 'end_line': 340, 'full_parameters': [], 'filename': '/home/dimi/Documents/Informatik_Studium/FSS/SoftEvo/DataCollection/FFS_SoftEvo/go-ipfs/core/commands/swarm.go', 'top_nesting_level': 0, 'length': 27, 'fan_in': 0, 'fan_out': 0, 'general_fan_out': 0}, {'cyclomatic_complexity': 7, 'nloc': 36, 'token_count': 253, 'name': '', 'long_name': '(req cmds.Request,res cmds.Response)', 'start_line': 361, 'end_line': 406, 'full_parameters': [], 'filename': '/home/dimi/Documents/Informatik_Studium/FSS/SoftEvo/DataCollection/FFS_SoftEvo/go-ipfs/core/commands/swarm.go', 'top_nesting_level': 0, 'length': 46, 'fan_in': 0, 'fan_out': 0, 'general_fan_out': 0}, {'cyclomatic_complexity': 9, 'nloc': 41, 'token_count': 259, 'name': '', 'long_name': '(req cmds.Request,res cmds.Response)', 'start_line': 429, 'end_line': 476, 'full_parameters': [], 'filename': '/home/dimi/Documents/Informatik_Studium/FSS/SoftEvo/DataCollection/FFS_SoftEvo/go-ipfs/core/commands/swarm.go', 'top_nesting_level': 0, 'length': 48, 'fan_in': 0, 'fan_out': 0, 'general_fan_out': 0}, {'cyclomatic_complexity': 3, 'nloc': 12, 'token_count': 80, 'name': 'stringListMarshaler', 'long_name': 'stringListMarshaler res cmds . Response', 'start_line': 483, 'end_line': 495, 'full_parameters': ['res cmds . Response'], 'filename': '/home/dimi/Documents/Informatik_Studium/FSS/SoftEvo/DataCollection/FFS_SoftEvo/go-ipfs/core/commands/swarm.go', 'top_nesting_level': 0, 'length': 13, 'fan_in': 0, 'fan_out': 0, 'general_fan_out': 0}, {'cyclomatic_complexity': 3, 'nloc': 10, 'token_count': 80, 'name': 'parseAddresses', 'long_name': 'parseAddresses addrs [ ] string', 'start_line': 499, 'end_line': 508, 'full_parameters': ['addrs [ ] string'], 'filename': '/home/dimi/Documents/Informatik_Studium/FSS/SoftEvo/DataCollection/FFS_SoftEvo/go-ipfs/core/commands/swarm.go', 'top_nesting_level': 0, 'length': 10, 'fan_in': 0, 'fan_out': 0, 'general_fan_out': 0}, {'cyclomatic_complexity': 3, 'nloc': 13, 'token_count': 87, 'name': 'peersWithAddresses', 'long_name': 'peersWithAddresses addrs [ ] string', 'start_line': 512, 'end_line': 525, 'full_parameters': ['addrs [ ] string'], 'filename': '/home/dimi/Documents/Informatik_Studium/FSS/SoftEvo/DataCollection/FFS_SoftEvo/go-ipfs/core/commands/swarm.go', 'top_nesting_level': 0, 'length': 14, 'fan_in': 0, 'fan_out': 0, 'general_fan_out': 0}, {'cyclomatic_complexity': 6, 'nloc': 26, 'token_count': 167, 'name': '', 'long_name': '(req cmds.Request,res cmds.Response)', 'start_line': 550, 'end_line': 578, 'full_parameters': [], 'filename': '/home/dimi/Documents/Informatik_Studium/FSS/SoftEvo/DataCollection/FFS_SoftEvo/go-ipfs/core/commands/swarm.go', 'top_nesting_level': 0, 'length': 29, 'fan_in': 0, 'fan_out': 0, 'general_fan_out': 0}, {'cyclomatic_complexity': 10, 'nloc': 45, 'token_count': 287, 'name': '', 'long_name': '(req cmds.Request,res cmds.Response)', 'start_line': 597, 'end_line': 650, 'full_parameters': [], 'filename': '/home/dimi/Documents/Informatik_Studium/FSS/SoftEvo/DataCollection/FFS_SoftEvo/go-ipfs/core/commands/swarm.go', 'top_nesting_level': 0, 'length': 54, 'fan_in': 0, 'fan_out': 0, 'general_fan_out': 0}, {'cyclomatic_complexity': 13, 'nloc': 54, 'token_count': 346, 'name': '', 'long_name': '(req cmds.Request,res cmds.Response)', 'start_line': 669, 'end_line': 733, 'full_parameters': [], 'filename': '/home/dimi/Documents/Informatik_Studium/FSS/SoftEvo/DataCollection/FFS_SoftEvo/go-ipfs/core/commands/swarm.go', 'top_nesting_level': 0, 'length': 65, 'fan_in': 0, 'fan_out': 0, 'general_fan_out': 0}, {'cyclomatic_complexity': 6, 'nloc': 25, 'token_count': 197, 'name': 'filtersAdd', 'long_name': 'filtersAdd r repo . Repo , cfg * config . Config , filters [ ] string', 'start_line': 740, 'end_line': 774, 'full_parameters': ['r repo . Repo', ' cfg * config . Config', ' filters [ ] string'], 'filename': '/home/dimi/Documents/Informatik_Studium/FSS/SoftEvo/DataCollection/FFS_SoftEvo/go-ipfs/core/commands/swarm.go', 'top_nesting_level': 0, 'length': 35, 'fan_in': 0, 'fan_out': 0, 'general_fan_out': 0}, {'cyclomatic_complexity': 2, 'nloc': 8, 'token_count': 60, 'name': 'filtersRemoveAll', 'long_name': 'filtersRemoveAll r repo . Repo , cfg * config . Config', 'start_line': 776, 'end_line': 785, 'full_parameters': ['r repo . Repo', ' cfg * config . Config'], 'filename': '/home/dimi/Documents/Informatik_Studium/FSS/SoftEvo/DataCollection/FFS_SoftEvo/go-ipfs/core/commands/swarm.go', 'top_nesting_level': 0, 'length': 10, 'fan_in': 0, 'fan_out': 0, 'general_fan_out': 0}, {'cyclomatic_complexity': 6, 'nloc': 23, 'token_count': 151, 'name': 'filtersRemove', 'long_name': 'filtersRemove r repo . Repo , cfg * config . Config , toRemoveFilters [ ] string', 'start_line': 787, 'end_line': 814, 'full_parameters': ['r repo . Repo', ' cfg * config . Config', ' toRemoveFilters [ ] string'], 'filename': '/home/dimi/Documents/Informatik_Studium/FSS/SoftEvo/DataCollection/FFS_SoftEvo/go-ipfs/core/commands/swarm.go', 'top_nesting_level': 0, 'length': 28, 'fan_in': 0, 'fan_out': 0, 'general_fan_out': 0}]",779,4937,0,[],98,500,-23,94,94,"[{'timestamp': 1508424715.0, 'added_lines': 1, 'deleted_lines': 1, 'nloc': 681}, {'timestamp': 1508854441.0, 'added_lines': 1, 'deleted_lines': 1, 'nloc': 681}, {'timestamp': 1491058697.0, 'added_lines': 91, 'deleted_lines': 76, 'nloc': 694}, {'timestamp': 1499331469.0, 'added_lines': 1, 'deleted_lines': 1, 'nloc': 694}, {'timestamp': 1511223906.0, 'added_lines': 3, 'deleted_lines': 3, 'nloc': 694}, {'timestamp': 1512365669.0, 'added_lines': 5, 'deleted_lines': 5, 'nloc': 694}, {'timestamp': 1511187070.0, 'added_lines': 1, 'deleted_lines': 1, 'nloc': 694}, {'timestamp': 1513436097.0, 'added_lines': 1, 'deleted_lines': 1, 'nloc': 694}, {'timestamp': 1513612261.0, 'added_lines': 1, 'deleted_lines': 1, 'nloc': 694}, {'timestamp': 1515277696.0, 'added_lines': 1, 'deleted_lines': 1, 'nloc': 694}, {'timestamp': 1516838128.0, 'added_lines': 4, 'deleted_lines': 4, 'nloc': 694}, {'timestamp': 1517105039.0, 'added_lines': 2, 'deleted_lines': 2, 'nloc': 694}, {'timestamp': 1517453697.0, 'added_lines': 3, 'deleted_lines': 3, 'nloc': 694}, {'timestamp': 1525408792.0, 'added_lines': 3, 'deleted_lines': 3, 'nloc': 694}, {'timestamp': 1528131220.0, 'added_lines': 2, 'deleted_lines': 2, 'nloc': 694}, {'timestamp': 1520489177.0, 'added_lines': 20, 'deleted_lines': 20, 'nloc': 685}, {'timestamp': 1528268108.0, 'added_lines': 3, 'deleted_lines': 3, 'nloc': 685}, {'timestamp': 1528520460.0, 'added_lines': 5, 'deleted_lines': 5, 'nloc': 685}, {'timestamp': 1528839449.0, 'added_lines': 16, 'deleted_lines': 4, 'nloc': 697}, {'timestamp': 1528840216.0, 'added_lines': 26, 'deleted_lines': 13, 'nloc': 709}, {'timestamp': 1529984485.0, 'added_lines': 6, 'deleted_lines': 6, 'nloc': 709}, {'timestamp': 1532146078.0, 'added_lines': 2, 'deleted_lines': 2, 'nloc': 709}, {'timestamp': 1533779477.0, 'added_lines': 5, 'deleted_lines': 5, 'nloc': 709}, {'timestamp': 1532357069.0, 'added_lines': 1, 'deleted_lines': 1, 'nloc': 709}, {'timestamp': 1532365899.0, 'added_lines': 1, 'deleted_lines': 1, 'nloc': 709}, {'timestamp': 1532388583.0, 'added_lines': 1, 'deleted_lines': 1, 'nloc': 709}, {'timestamp': 1533809170.0, 'added_lines': 1, 'deleted_lines': 1, 'nloc': 709}, {'timestamp': 1533946888.0, 'added_lines': 1, 'deleted_lines': 1, 'nloc': 709}, {'timestamp': 1534072974.0, 'added_lines': 1, 'deleted_lines': 1, 'nloc': 709}, {'timestamp': 1534896611.0, 'added_lines': 7, 'deleted_lines': 7, 'nloc': 709}, {'timestamp': 1534903410.0, 'added_lines': 9, 'deleted_lines': 9, 'nloc': 709}, {'timestamp': 1535255498.0, 'added_lines': 1, 'deleted_lines': 1, 'nloc': 709}, {'timestamp': 1535601896.0, 'added_lines': 4, 'deleted_lines': 4, 'nloc': 709}, {'timestamp': 1536388808.0, 'added_lines': 5, 'deleted_lines': 5, 'nloc': 709}, {'timestamp': 1536852174.0, 'added_lines': 29, 'deleted_lines': 9, 'nloc': 725}, {'timestamp': 1536885988.0, 'added_lines': 9, 'deleted_lines': 6, 'nloc': 728}, {'timestamp': 1537792589.0, 'added_lines': 6, 'deleted_lines': 6, 'nloc': 728}, {'timestamp': 1536691815.0, 'added_lines': 122, 'deleted_lines': 200, 'nloc': 663}, {'timestamp': 1537195559.0, 'added_lines': 9, 'deleted_lines': 54, 'nloc': 627}, {'timestamp': 1537206795.0, 'added_lines': 40, 'deleted_lines': 44, 'nloc': 631}, {'timestamp': 1538476310.0, 'added_lines': 2, 'deleted_lines': 2, 'nloc': 631}, {'timestamp': 1538544957.0, 'added_lines': 5, 'deleted_lines': 5, 'nloc': 631}, {'timestamp': 1538547366.0, 'added_lines': 1, 'deleted_lines': 1, 'nloc': 631}, {'timestamp': 1538695953.0, 'added_lines': 1, 'deleted_lines': 1, 'nloc': 631}, {'timestamp': 1538662493.0, 'added_lines': 15, 'deleted_lines': 8, 'nloc': 637}, {'timestamp': 1538773916.0, 'added_lines': 3, 'deleted_lines': 3, 'nloc': 637}, {'timestamp': 1539176817.0, 'added_lines': 3, 'deleted_lines': 3, 'nloc': 637}, {'timestamp': 1539357340.0, 'added_lines': 1, 'deleted_lines': 1, 'nloc': 637}, {'timestamp': 1539850591.0, 'added_lines': 2, 'deleted_lines': 2, 'nloc': 637}, {'timestamp': 1540400358.0, 'added_lines': 7, 'deleted_lines': 7, 'nloc': 637}, {'timestamp': 1540418491.0, 'added_lines': 1, 'deleted_lines': 1, 'nloc': 637}, {'timestamp': 1540484152.0, 'added_lines': 1, 'deleted_lines': 7, 'nloc': 631}, {'timestamp': 1540489644.0, 'added_lines': 1, 'deleted_lines': 1, 'nloc': 637}, {'timestamp': 1540552487.0, 'added_lines': 1, 'deleted_lines': 1, 'nloc': 631}, {'timestamp': 1540597832.0, 'added_lines': 1, 'deleted_lines': 1, 'nloc': 631}, {'timestamp': 1541204121.0, 'added_lines': 8, 'deleted_lines': 8, 'nloc': 631}, {'timestamp': 1541822268.0, 'added_lines': 21, 'deleted_lines': 31, 'nloc': 622}, {'timestamp': 1541903826.0, 'added_lines': 3, 'deleted_lines': 3, 'nloc': 622}, {'timestamp': 1543282933.0, 'added_lines': 1, 'deleted_lines': 1, 'nloc': 622}, {'timestamp': 1544225843.0, 'added_lines': 6, 'deleted_lines': 6, 'nloc': 622}, {'timestamp': 1544661332.0, 'added_lines': 1, 'deleted_lines': 1, 'nloc': 622}, {'timestamp': 1540556089.0, 'added_lines': 1, 'deleted_lines': 1, 'nloc': 622}, {'timestamp': 1544451987.0, 'added_lines': 6, 'deleted_lines': 6, 'nloc': 622}, {'timestamp': 1545323704.0, 'added_lines': 1, 'deleted_lines': 1, 'nloc': 622}, {'timestamp': 1546553605.0, 'added_lines': 1, 'deleted_lines': 1, 'nloc': 622}, {'timestamp': 1547003974.0, 'added_lines': 6, 'deleted_lines': 6, 'nloc': 622}, {'timestamp': 1547152271.0, 'added_lines': 1, 'deleted_lines': 1, 'nloc': 622}, {'timestamp': 1548866534.0, 'added_lines': 1, 'deleted_lines': 1, 'nloc': 622}, {'timestamp': 1549588289.0, 'added_lines': 6, 'deleted_lines': 6, 'nloc': 622}, {'timestamp': 1549903582.0, 'added_lines': 1, 'deleted_lines': 1, 'nloc': 622}, {'timestamp': 1550507829.0, 'added_lines': 7, 'deleted_lines': 7, 'nloc': 622}, {'timestamp': 1550610741.0, 'added_lines': 1, 'deleted_lines': 1, 'nloc': 622}, {'timestamp': 1551138343.0, 'added_lines': 1, 'deleted_lines': 1, 'nloc': 622}, {'timestamp': 1551229859.0, 'added_lines': 7, 'deleted_lines': 7, 'nloc': 622}, {'timestamp': 1551299964.0, 'added_lines': 2, 'deleted_lines': 2, 'nloc': 622}, {'timestamp': 1551471469.0, 'added_lines': 1, 'deleted_lines': 1, 'nloc': 622}, {'timestamp': 1551551196.0, 'added_lines': 10, 'deleted_lines': 10, 'nloc': 622}, {'timestamp': 1538716375.0, 'added_lines': 78, 'deleted_lines': 1, 'nloc': 685}, {'timestamp': 1540473555.0, 'added_lines': 21, 'deleted_lines': 4, 'nloc': 699}, {'timestamp': 1552960507.0, 'added_lines': 7, 'deleted_lines': 6, 'nloc': 699}, {'timestamp': 1552960738.0, 'added_lines': 8, 'deleted_lines': 15, 'nloc': 693}, {'timestamp': 1552961015.0, 'added_lines': 5, 'deleted_lines': 5, 'nloc': 693}, {'timestamp': 1552961090.0, 'added_lines': 1, 'deleted_lines': 1, 'nloc': 693}, {'timestamp': 1553697989.0, 'added_lines': 3, 'deleted_lines': 3, 'nloc': 693}, {'timestamp': 1557554420.0, 'added_lines': 25, 'deleted_lines': 26, 'nloc': 692}, {'timestamp': 1558459378.0, 'added_lines': 10, 'deleted_lines': 9, 'nloc': 693}, {'timestamp': 1559060517.0, 'added_lines': 5, 'deleted_lines': 6, 'nloc': 692}, {'timestamp': 1559347612.0, 'added_lines': 28, 'deleted_lines': 62, 'nloc': 657}, {'timestamp': 1569016931.0, 'added_lines': 0, 'deleted_lines': 4, 'nloc': 653}, {'timestamp': 1576348716.0, 'added_lines': 2, 'deleted_lines': 2, 'nloc': 653}, {'timestamp': 1580917597.0, 'added_lines': 2, 'deleted_lines': 1, 'nloc': 654}, {'timestamp': 1589955086.0, 'added_lines': 5, 'deleted_lines': 24, 'nloc': 640}, {'timestamp': 1618224384.0, 'added_lines': 16, 'deleted_lines': 6, 'nloc': 648}, {'timestamp': 1631717176.0, 'added_lines': 144, 'deleted_lines': 0, 'nloc': 779}]","{'core/commands/dht.go': 53, 'core/commands/id.go': 53, 'core/commands/pubsub.go': 46, 'core/core.go': 55, 'core/corehttp/gateway.go': 37, 'core/corehttp/gateway_test.go': 47, 'core/corehttp/metrics_test.go': 35, 'core/mock/mock.go': 45, 'exchange/bitswap/bitswap_test.go': 13, 'exchange/bitswap/testnet/peernet.go': 13, 'exchange/bitswap/testutils.go': 12, 'namesys/republisher/repub_test.go': 36, 'package.json': 63, 'test/integration/addcat_test.go': 39, 'test/integration/bench_cat_test.go': 38, 'test/integration/bitswap_wo_routing_test.go': 35, 'test/integration/three_legged_cat_test.go': 38, 'thirdparty/ipfsaddr/ipfsaddr.go': 1, 'repo/config/bootstrap_peers.go': 14, None: 15, 'blocks/blockstore/caching.go': 1, 'blocks/blockstore/util/remove.go': 3, 'cmd/ipfs/daemon.go': 41, 'cmd/ipfs/init.go': 50, 'cmd/ipfs/ipfs.go': 31, 'cmd/ipfs/main.go': 53, 'cmd/ipfs/main_test.go': 4, 'cmd/ipfswatch/main.go': 32, 'cmd/seccat/seccat.go': 30, 'commands/channelmarshaler.go': 1, 'commands/cli/cmd_suggestion.go': 1, 'commands/cli/helptext.go': 2, 'commands/cli/helptext_test.go': 2, 'commands/cli/parse.go': 2, 'commands/cli/parse_test.go': 2, 'commands/command.go': 19, 'commands/command_test.go': 10, 'commands/http/client.go': 2, 'commands/http/handler.go': 2, 'commands/http/multifilereader.go': 2, 'commands/http/multifilereader_test.go': 2, 'commands/http/parse.go': 2, 'commands/reqlog.go': 2, 'commands/request.go': 34, 'commands/response.go': 14, 'commands/response_test.go': 10, 'core/bootstrap.go': 39, 'core/commands/active.go': 25, 'core/commands/add.go': 42, 'core/commands/bitswap.go': 51, 'core/commands/block.go': 39, 'core/commands/bootstrap.go': 46, 'core/commands/cat.go': 36, 'core/commands/commands.go': 35, 'core/commands/config.go': 47, 'core/commands/dag/dag.go': 44, 'core/commands/diag.go': 23, 'core/commands/dns.go': 31, 'core/commands/e/error.go': 1, 'core/commands/external.go': 23, 'core/commands/files/files.go': 10, 'core/commands/filestore.go': 35, 'core/commands/get.go': 50, 'core/commands/helptext_test.go': 31, 'core/commands/ipns.go': 16, 'core/commands/keystore.go': 37, 'core/commands/log.go': 30, 'core/commands/ls.go': 46, 'core/commands/mount_nofuse.go': 23, 'core/commands/mount_unix.go': 45, 'core/commands/mount_windows.go': 22, 'core/commands/name.go': 10, 'core/commands/object/diff.go': 26, 'core/commands/object/object.go': 47, 'core/commands/object/patch.go': 35, 'core/commands/p2p.go': 43, 'core/commands/pin.go': 47, 'core/commands/ping.go': 45, 'core/commands/publish.go': 15, 'core/commands/refs.go': 43, 'core/commands/repo.go': 60, 'core/commands/resolve.go': 46, 'core/commands/root.go': 36, 'core/commands/shutdown.go': 29, 'core/commands/stat.go': 42, 'core/commands/sysdiag.go': 32, 'core/commands/tar.go': 41, 'core/commands/unixfs/ls.go': 41, 'core/commands/unixfs/unixfs.go': 23, 'core/commands/version.go': 29, 'core/core_test.go': 27, 'core/corehttp/commands.go': 57, 'core/coreunix/add.go': 39, 'core/coreunix/add_test.go': 49, 'core/coreunix/metadata_test.go': 34, 'exchange/bitswap/decision/engine_test.go': 9, 'exchange/bitswap/message/message_test.go': 4, 'exchange/bitswap/message/pb/Makefile': 1, 'exchange/bitswap/testnet/network_test.go': 10, 'exchange/reprovide/reprovide_test.go': 29, 'fuse/ipns/common.go': 29, 'fuse/node/mount_test.go': 28, 'importer/balanced/balanced_test.go': 6, 'importer/chunk/rabin_test.go': 3, 'importer/helpers/dagbuilder.go': 11, 'importer/importer.go': 11, 'merkledag/utils/utils_test.go': 4, 'mfs/repub_test.go': 9, 'namesys/dns.go': 23, 'namesys/interface.go': 25, 'namesys/ipns_select_test.go': 5, 'namesys/proquint.go': 23, 'repo/config/identity.go': 3, 'routing/offline/offline_test.go': 5, 'core/bootstrap_test.go': 35, 'core/commands/dht_test.go': 24, 'core/commands/get_test.go': 32, 'exchange/bitswap/decision/bench_test.go': 7, 'exchange/bitswap/decision/peer_request_queue_test.go': 7, 'exchange/bitswap/message/message.go': 8, 'exchange/bitswap/network/interface.go': 8, 'exchange/bitswap/network/ipfs_impl.go': 10, 'exchange/bitswap/testnet/interface.go': 7, 'exchange/bitswap/testnet/virtual.go': 9, 'fuse/ipns/ipns_test.go': 28, 'fuse/readonly/ipfs_test.go': 35, 'namesys/publisher_test.go': 27, 'namesys/resolve_test.go': 31, 'p2p/p2p.go': 27, 'p2p/registry.go': 12, 'routing/mock/centralized_client.go': 4, 'routing/mock/centralized_server.go': 4, 'routing/mock/centralized_test.go': 4, 'routing/mock/interface.go': 4, 'routing/none/none_client.go': 4, 'test/integration/bench_test.go': 19, 'assets/assets.go': 28, 'blocks/blockstore/arc_cache.go': 2, 'blocks/blockstore/arc_cache_test.go': 2, 'blocks/blockstore/blockstore.go': 3, 'blocks/blockstore/blockstore_test.go': 2, 'blocks/blockstore/bloom_cache.go': 2, 'blocks/blockstore/bloom_cache_test.go': 2, 'blocks/blocksutil/block_generator.go': 2, 'blockservice/blockservice.go': 7, 'blockservice/blockservice_test.go': 6, 'blockservice/test/blocks_test.go': 6, 'core/builder.go': 47, 'core/commands/ipnsps.go': 9, 'core/coreapi/coreapi.go': 18, 'core/coreapi/interface/interface.go': 2, 'core/coreapi/unixfs.go': 31, 'core/coreapi/unixfs_test.go': 34, 'core/coredag/cbor.go': 8, 'core/coredag/dagpb.go': 24, 'core/coredag/dagtransl.go': 6, 'core/coredag/raw.go': 24, 'core/corehttp/corehttp.go': 16, 'core/corehttp/gateway_handler.go': 35, 'core/corerepo/gc.go': 33, 'core/corerepo/pinning.go': 10, 'core/coreunix/metadata.go': 29, 'core/pathresolver.go': 27, 'exchange/bitswap/bitswap.go': 7, 'exchange/bitswap/decision/engine.go': 7, 'exchange/bitswap/decision/ledger.go': 6, 'exchange/bitswap/decision/peer_request_queue.go': 6, 'exchange/bitswap/get.go': 6, 'exchange/bitswap/notifications/notifications.go': 3, 'exchange/bitswap/notifications/notifications_test.go': 3, 'exchange/bitswap/session.go': 7, 'exchange/bitswap/session_test.go': 5, 'exchange/bitswap/stat.go': 3, 'exchange/bitswap/wantlist/wantlist.go': 3, 'exchange/bitswap/wantlist/wantlist_test.go': 3, 'exchange/bitswap/wantmanager.go': 7, 'exchange/bitswap/workers.go': 6, 'exchange/interface.go': 2, 'exchange/offline/offline.go': 2, 'exchange/offline/offline_test.go': 2, 'exchange/reprovide/providers.go': 27, 'exchange/reprovide/reprovide.go': 23, 'filestore/filestore.go': 17, 'filestore/filestore_test.go': 27, 'filestore/fsrefstore.go': 16, 'filestore/util.go': 16, 'fuse/ipns/ipns_unix.go': 33, 'fuse/readonly/readonly_unix.go': 33, 'importer/balanced/builder.go': 3, 'importer/chunk/splitting_test.go': 2, 'importer/helpers/helpers.go': 3, 'importer/importer_test.go': 5, 'importer/trickle/trickle_test.go': 5, 'importer/trickle/trickledag.go': 3, 'merkledag/batch.go': 2, 'merkledag/coding.go': 3, 'merkledag/merkledag.go': 3, 'merkledag/merkledag_test.go': 6, 'merkledag/node.go': 3, 'merkledag/node_test.go': 3, 'merkledag/raw.go': 3, 'merkledag/traverse/traverse.go': 3, 'merkledag/traverse/traverse_test.go': 3, 'merkledag/utils/diff.go': 3, 'merkledag/utils/diffenum.go': 3, 'merkledag/utils/diffenum_test.go': 3, 'merkledag/utils/utils.go': 6, 'mfs/dir.go': 5, 'mfs/file.go': 7, 'mfs/mfs_test.go': 8, 'mfs/ops.go': 4, 'mfs/system.go': 8, 'namesys/namesys.go': 32, 'namesys/publisher.go': 34, 'namesys/pubsub.go': 5, 'namesys/pubsub_test.go': 5, 'namesys/republisher/repub.go': 28, 'namesys/routing.go': 33, 'path/path.go': 3, 'path/resolver.go': 3, 'path/resolver_test.go': 2, 'pin/gc/gc.go': 28, 'pin/pin.go': 27, 'pin/pin_test.go': 28, 'pin/set.go': 24, 'pin/set_test.go': 27, 'plugin/ipld.go': 6, 'plugin/loader/initializer.go': 5, 'plugin/plugins/git/git.go': 6, 'repo/config/init.go': 7, 'repo/fsrepo/fsrepo.go': 34, 'repo/fsrepo/lock/lock.go': 3, 'repo/fsrepo/serialize/serialize.go': 3, 'repo/mock.go': 28, 'repo/repo.go': 31, 'routing/offline/offline.go': 3, 'tar/format.go': 32, 'test/dependencies/ma-pipe-unidir/main.go': 11, 'thirdparty/ds-help/key.go': 2, 'thirdparty/pollEndpoint/main.go': 15, 'thirdparty/posinfo/posinfo.go': 2, 'unixfs/archive/archive.go': 3, 'unixfs/archive/tar/writer.go': 3, 'unixfs/hamt/hamt.go': 3, 'unixfs/io/dagreader.go': 3, 'unixfs/io/dirbuilder.go': 3, 'unixfs/io/resolve.go': 3, 'unixfs/mod/dagmodifier.go': 5, 'unixfs/mod/dagmodifier_test.go': 3, 'unixfs/test/utils.go': 5, 'commands/legacy/command.go': 17, 'commands/legacy/legacy.go': 17, 'commands/legacy/legacy_test.go': 18, 'commands/legacy/request.go': 18, 'commands/legacy/response.go': 18, 'commands/legacy/responseemitter.go': 4, 'core/commands/env.go': 9, 'TODO.md': 2, 'core/commands/commands_test.go': 28, 'test/sharness/t0110-gateway.sh': 1, 'test/sharness/t0410-api-add.sh': 1, 'core/coreapi/dag.go': 5, 'core/coreapi/dag_test.go': 3, 'core/coreapi/interface/options/dag.go': 4, 'core/coreapi/key.go': 29, 'core/coreapi/name.go': 31, 'merkledag/test/utils.go': 5, 'namesys/namesys_test.go': 34, 'repo/fsrepo/datastores.go': 15, 'repo/fsrepo/fsrepo_test.go': 27, 'thirdparty/datastore2/datastore_closer.go': 1, 'thirdparty/datastore2/delayed.go': 1, 'thirdparty/datastore2/threadsafe.go': 1, 'unixfs/io/pbdagreader.go': 2, 'cmd/ipfs/util/ulimit.go': 9, 'cmd/seccat/util.go': 10, 'core/corehttp/logs.go': 9, 'fuse/mount/mount.go': 9, 'fuse/node/mount_unix.go': 10, 'importer/chunk/splitting.go': 1, 'namesys/ipns_validate_test.go': 5, 'plugin/loader/load.go': 7, 'blocks/blockstoreutil/remove.go': 14, 'blockservice/test/mock.go': 5, 'core/commands/files.go': 42, 'core/coreapi/pin.go': 26, 'keystore/keystore.go': 9, 'keystore/keystore_test.go': 7, 'keystore/memkeystore.go': 6, 'namesys/validator.go': 3, 'path/resolver/resolver.go': 3, 'thirdparty/verifbs/verifbs.go': 14, 'cmd/ipfs/util/ulimit_freebsd.go': 2, 'cmd/ipfs/util/ulimit_unix.go': 2, 'core/coreapi/block.go': 8, 'core/coreapi/block_test.go': 2, 'core/coreapi/interface/coreapi.go': 3, 'core/coreapi/interface/dag.go': 3, 'core/coreapi/interface/object.go': 3, 'core/coreapi/interface/options/block.go': 2, 'core/coreapi/interface/path.go': 18, 'core/coreapi/interface/unixfs.go': 7, 'core/coreapi/object.go': 27, 'fuse/ipns/link_unix.go': 2, 'fuse/mount/fuse.go': 3, 'fuse/node/mount_darwin.go': 2, 'merkledag/errservice.go': 1, 'merkledag/readonly.go': 1, 'merkledag/readonly_test.go': 1, 'merkledag/rwservice.go': 1, 'merkledag/session.go': 1, 'path/resolver/resolver_test.go': 1, 'thirdparty/verifcid/validate.go': 1, 'thirdparty/verifcid/validate_test.go': 1, 'unixfs/hamt/hamt_stress_test.go': 1, 'unixfs/hamt/hamt_test.go': 1, 'namesys/ipns_resolver_validation_test.go': 24, 'test/sharness/t0170-dht.sh': 1, 'core/corehttp/metrics.go': 2, 'core/commands/urlstore.go': 35, 'core/coreapi/interface/key.go': 8, 'core/coreapi/name_test.go': 17, 'core/coreapi/path.go': 26, 'core/coreunix/cat.go': 6, 'core/pathresolver_test.go': 21, 'dagutils/diff.go': 23, 'dagutils/diffenum.go': 21, 'dagutils/diffenum_test.go': 21, 'dagutils/utils.go': 22, 'dagutils/utils_test.go': 21, 'filestore/pb/dataobj.pb.go': 3, 'mfs/fd.go': 2, 'namesys/base.go': 22, 'namesys/cache.go': 21, 'pin/internal/pb/header.pb.go': 3, 'thirdparty/cidv0v1/blockstore.go': 10, 'repo/fsrepo/misc.go': 24, 'cmd/ipfs/Rules.mk': 1, 'core/corehttp/option_test.go': 2, 'docs/releases.md': 1, 'docs/windows.md': 1, 'repo/fsrepo/config_test.go': 23, 'repo/version.go': 1, 'test/bench/bench_cli_ipfs_add/main.go': 25, 'test/bench/offline_add/main.go': 25, 'core/commands/cmdenv/env.go': 32, 'core/commands/name/ipns.go': 34, 'core/commands/name/ipnsps.go': 24, 'core/commands/name/name.go': 18, 'core/commands/name/publish.go': 24, 'core/coreapi/dht.go': 19, 'core/coreapi/dht_test.go': 4, 'core/coreapi/interface/dht.go': 10, 'p2p/listener.go': 14, 'p2p/local.go': 14, 'p2p/remote.go': 15, 'p2p/stream.go': 15, 'core/coreapi/interface/swarm.go': 13, 'core/coreapi/swarm.go': 24, 'test/sharness/lib/test-lib.sh': 1, 'core/commands/cid.go': 19, 'core/coreapi/interface/options/unixfs.go': 11, 'core/coreapi/pubsub.go': 18, 'core/coreapi/unixfile.go': 11, 'cmd/ipfs/dnsresolve_test.go': 5, 'core/coreapi/interface/pubsub.go': 4, 'test/sharness/t0180-pubsub.sh': 1, 'test/dependencies/iptb/iptb.go': 12, 'plugin/plugins/badgerds/badgerds.go': 4, 'plugin/plugins/flatfs/flatfs.go': 4, 'plugin/plugins/levelds/levelds.go': 3, 'commands/context.go': 17, 'core/corehttp/proxy.go': 8, 'core/coreapi/test/api_test.go': 9, 'core/coreapi/interface/tests/name.go': 3, 'core/coreapi/interface/tests/unixfs.go': 3, 'core/commands/cmdenv/cidbase.go': 9, 'core/commands/cmdenv/file.go': 3, 'core/corehttp/ipns_hostname.go': 5, 'namesys/dns_test.go': 5, 'plugin/daemon.go': 5, 'plugin/loader/loader.go': 6, 'core/corerepo/stat.go': 2, 'core/commands/cmdenv/cidbase_test.go': 1, 'core/corehttp/proxy_test.go': 2, 'plugin/tracer.go': 1, 'thirdparty/notifier/notifier.go': 1, 'core/corehttp/mutex_profile.go': 1, 'provider/queue.go': 1, 'provider/queue_test.go': 1, 'README.md': 1, 'go.mod': 4, 'go.sum': 4, 'package-list.json': 1, 'core/node/libp2p/addrs.go': 3, 'namesys/resolve/pathresolver_test.go': 1, 'plugin/plugins/gen_main.sh': 1, 'core/bootstrap/bootstrap.go': 2, 'core/bootstrap/bootstrap_test.go': 2, 'core/node/builder.go': 1, 'core/node/core.go': 1, 'core/node/groups.go': 2, 'core/node/identity.go': 1, 'core/node/ipns.go': 2, 'core/node/libp2p/discovery.go': 1, 'core/node/libp2p/host.go': 1, 'core/node/libp2p/hostopt.go': 1, 'core/node/libp2p/libp2p.go': 1, 'core/node/libp2p/nat.go': 1, 'core/node/libp2p/pnet.go': 1, 'core/node/libp2p/pubsub.go': 1, 'core/node/libp2p/routing.go': 1, 'core/node/libp2p/routingopt.go': 1, 'core/node/libp2p/smux.go': 1, 'core/node/libp2p/transport.go': 1, 'core/node/provider.go': 1, 'provider/simple/provider.go': 1, 'provider/simple/provider_test.go': 1, 'provider/simple/reprovide.go': 1, 'provider/simple/reprovide_test.go': 1, 'docs/examples/go-ipfs-as-a-library/main.go': 1, 'docs/experimental-features.md': 1, 'docs/file-transfer.md': 1, 'docs/transports.md': 1, 'core/node/dns.go': 1, 'core/node/libp2p/dns.go': 1, 'peering/peering.go': 1, 'peering/peering_test.go': 1, 'test/sharness/t0140-swarm.sh': 1}","('core/commands/repo.go', 0.6382978723404256, 0.5607476635514018)"
core/commands/sysdiag.go,118,691,7,"[{'cyclomatic_complexity': 7, 'nloc': 36, 'token_count': 199, 'name': '', 'long_name': '(req cmds.Request,res cmds.Response)', 'start_line': 22, 'end_line': 62, 'full_parameters': [], 'filename': '/home/dimi/Documents/Informatik_Studium/FSS/SoftEvo/DataCollection/FFS_SoftEvo/go-ipfs/core/commands/sysdiag.go', 'top_nesting_level': 0, 'length': 41, 'fan_in': 0, 'fan_out': 0, 'general_fan_out': 0}, {'cyclomatic_complexity': 1, 'nloc': 12, 'token_count': 100, 'name': 'runtimeInfo', 'long_name': 'runtimeInfo out map [ string ] interface { }', 'start_line': 65, 'end_line': 77, 'full_parameters': ['out map [ string ] interface { }'], 'filename': '/home/dimi/Documents/Informatik_Studium/FSS/SoftEvo/DataCollection/FFS_SoftEvo/go-ipfs/core/commands/sysdiag.go', 'top_nesting_level': 0, 'length': 13, 'fan_in': 0, 'fan_out': 0, 'general_fan_out': 0}, {'cyclomatic_complexity': 1, 'nloc': 7, 'token_count': 57, 'name': 'envVarInfo', 'long_name': 'envVarInfo out map [ string ] interface { }', 'start_line': 79, 'end_line': 86, 'full_parameters': ['out map [ string ] interface { }'], 'filename': '/home/dimi/Documents/Informatik_Studium/FSS/SoftEvo/DataCollection/FFS_SoftEvo/go-ipfs/core/commands/sysdiag.go', 'top_nesting_level': 0, 'length': 8, 'fan_in': 0, 'fan_out': 0, 'general_fan_out': 0}, {'cyclomatic_complexity': 2, 'nloc': 7, 'token_count': 38, 'name': 'ipfsPath', 'long_name': 'ipfsPath', 'start_line': 88, 'end_line': 94, 'full_parameters': [], 'filename': '/home/dimi/Documents/Informatik_Studium/FSS/SoftEvo/DataCollection/FFS_SoftEvo/go-ipfs/core/commands/sysdiag.go', 'top_nesting_level': 0, 'length': 7, 'fan_in': 0, 'fan_out': 0, 'general_fan_out': 0}, {'cyclomatic_complexity': 2, 'nloc': 12, 'token_count': 79, 'name': 'diskSpaceInfo', 'long_name': 'diskSpaceInfo out map [ string ] interface { }', 'start_line': 96, 'end_line': 109, 'full_parameters': ['out map [ string ] interface { }'], 'filename': '/home/dimi/Documents/Informatik_Studium/FSS/SoftEvo/DataCollection/FFS_SoftEvo/go-ipfs/core/commands/sysdiag.go', 'top_nesting_level': 0, 'length': 14, 'fan_in': 0, 'fan_out': 0, 'general_fan_out': 0}, {'cyclomatic_complexity': 2, 'nloc': 11, 'token_count': 68, 'name': 'memInfo', 'long_name': 'memInfo out map [ string ] interface { }', 'start_line': 111, 'end_line': 123, 'full_parameters': ['out map [ string ] interface { }'], 'filename': '/home/dimi/Documents/Informatik_Studium/FSS/SoftEvo/DataCollection/FFS_SoftEvo/go-ipfs/core/commands/sysdiag.go', 'top_nesting_level': 0, 'length': 13, 'fan_in': 0, 'fan_out': 0, 'general_fan_out': 0}, {'cyclomatic_complexity': 3, 'nloc': 15, 'token_count': 93, 'name': 'netInfo', 'long_name': 'netInfo online bool , out map [ string ] interface { }', 'start_line': 125, 'end_line': 141, 'full_parameters': ['online bool', ' out map [ string ] interface { }'], 'filename': '/home/dimi/Documents/Informatik_Studium/FSS/SoftEvo/DataCollection/FFS_SoftEvo/go-ipfs/core/commands/sysdiag.go', 'top_nesting_level': 0, 'length': 17, 'fan_in': 0, 'fan_out': 0, 'general_fan_out': 0}]",121,697,7,"[{'cyclomatic_complexity': 1, 'nloc': 1, 'token_count': 17, 'name': 'getInfo', 'long_name': 'getInfo nd * core . IpfsNode', 'start_line': 38, 'end_line': 38, 'full_parameters': ['nd * core . IpfsNode'], 'filename': '/home/dimi/Documents/Informatik_Studium/FSS/SoftEvo/DataCollection/FFS_SoftEvo/go-ipfs/core/commands/sysdiag.go', 'top_nesting_level': 0, 'length': 1, 'fan_in': 0, 'fan_out': 0, 'general_fan_out': 0}, {'cyclomatic_complexity': 1, 'nloc': 12, 'token_count': 100, 'name': 'runtimeInfo', 'long_name': 'runtimeInfo out map [ string ] interface { }', 'start_line': 70, 'end_line': 82, 'full_parameters': ['out map [ string ] interface { }'], 'filename': '/home/dimi/Documents/Informatik_Studium/FSS/SoftEvo/DataCollection/FFS_SoftEvo/go-ipfs/core/commands/sysdiag.go', 'top_nesting_level': 0, 'length': 13, 'fan_in': 0, 'fan_out': 0, 'general_fan_out': 0}, {'cyclomatic_complexity': 1, 'nloc': 7, 'token_count': 57, 'name': 'envVarInfo', 'long_name': 'envVarInfo out map [ string ] interface { }', 'start_line': 84, 'end_line': 91, 'full_parameters': ['out map [ string ] interface { }'], 'filename': '/home/dimi/Documents/Informatik_Studium/FSS/SoftEvo/DataCollection/FFS_SoftEvo/go-ipfs/core/commands/sysdiag.go', 'top_nesting_level': 0, 'length': 8, 'fan_in': 0, 'fan_out': 0, 'general_fan_out': 0}, {'cyclomatic_complexity': 2, 'nloc': 7, 'token_count': 38, 'name': 'ipfsPath', 'long_name': 'ipfsPath', 'start_line': 93, 'end_line': 99, 'full_parameters': [], 'filename': '/home/dimi/Documents/Informatik_Studium/FSS/SoftEvo/DataCollection/FFS_SoftEvo/go-ipfs/core/commands/sysdiag.go', 'top_nesting_level': 0, 'length': 7, 'fan_in': 0, 'fan_out': 0, 'general_fan_out': 0}, {'cyclomatic_complexity': 2, 'nloc': 12, 'token_count': 79, 'name': 'diskSpaceInfo', 'long_name': 'diskSpaceInfo out map [ string ] interface { }', 'start_line': 101, 'end_line': 114, 'full_parameters': ['out map [ string ] interface { }'], 'filename': '/home/dimi/Documents/Informatik_Studium/FSS/SoftEvo/DataCollection/FFS_SoftEvo/go-ipfs/core/commands/sysdiag.go', 'top_nesting_level': 0, 'length': 14, 'fan_in': 0, 'fan_out': 0, 'general_fan_out': 0}, {'cyclomatic_complexity': 2, 'nloc': 11, 'token_count': 68, 'name': 'memInfo', 'long_name': 'memInfo out map [ string ] interface { }', 'start_line': 116, 'end_line': 128, 'full_parameters': ['out map [ string ] interface { }'], 'filename': '/home/dimi/Documents/Informatik_Studium/FSS/SoftEvo/DataCollection/FFS_SoftEvo/go-ipfs/core/commands/sysdiag.go', 'top_nesting_level': 0, 'length': 13, 'fan_in': 0, 'fan_out': 0, 'general_fan_out': 0}, {'cyclomatic_complexity': 3, 'nloc': 15, 'token_count': 93, 'name': 'netInfo', 'long_name': 'netInfo online bool , out map [ string ] interface { }', 'start_line': 130, 'end_line': 146, 'full_parameters': ['online bool', ' out map [ string ] interface { }'], 'filename': '/home/dimi/Documents/Informatik_Studium/FSS/SoftEvo/DataCollection/FFS_SoftEvo/go-ipfs/core/commands/sysdiag.go', 'top_nesting_level': 0, 'length': 17, 'fan_in': 0, 'fan_out': 0, 'general_fan_out': 0}]",3,6,0,39,39,"[{'timestamp': 1491058697.0, 'added_lines': 8, 'deleted_lines': 7, 'nloc': 119}, {'timestamp': 1511223906.0, 'added_lines': 1, 'deleted_lines': 1, 'nloc': 119}, {'timestamp': 1512365669.0, 'added_lines': 2, 'deleted_lines': 2, 'nloc': 119}, {'timestamp': 1511187070.0, 'added_lines': 1, 'deleted_lines': 1, 'nloc': 119}, {'timestamp': 1513436097.0, 'added_lines': 1, 'deleted_lines': 1, 'nloc': 119}, {'timestamp': 1513612261.0, 'added_lines': 1, 'deleted_lines': 1, 'nloc': 119}, {'timestamp': 1515277696.0, 'added_lines': 1, 'deleted_lines': 1, 'nloc': 119}, {'timestamp': 1516838128.0, 'added_lines': 1, 'deleted_lines': 1, 'nloc': 119}, {'timestamp': 1528268108.0, 'added_lines': 1, 'deleted_lines': 1, 'nloc': 119}, {'timestamp': 1528520460.0, 'added_lines': 2, 'deleted_lines': 2, 'nloc': 119}, {'timestamp': 1529984485.0, 'added_lines': 1, 'deleted_lines': 1, 'nloc': 119}, {'timestamp': 1532357069.0, 'added_lines': 1, 'deleted_lines': 1, 'nloc': 119}, {'timestamp': 1532365899.0, 'added_lines': 3, 'deleted_lines': 3, 'nloc': 119}, {'timestamp': 1532507240.0, 'added_lines': 3, 'deleted_lines': 3, 'nloc': 119}, {'timestamp': 1533946888.0, 'added_lines': 1, 'deleted_lines': 1, 'nloc': 119}, {'timestamp': 1534896611.0, 'added_lines': 1, 'deleted_lines': 1, 'nloc': 119}, {'timestamp': 1539850591.0, 'added_lines': 1, 'deleted_lines': 1, 'nloc': 119}, {'timestamp': 1540400358.0, 'added_lines': 1, 'deleted_lines': 1, 'nloc': 119}, {'timestamp': 1541204121.0, 'added_lines': 1, 'deleted_lines': 1, 'nloc': 119}, {'timestamp': 1540564653.0, 'added_lines': 12, 'deleted_lines': 17, 'nloc': 114}, {'timestamp': 1540565575.0, 'added_lines': 1, 'deleted_lines': 1, 'nloc': 114}, {'timestamp': 1540951823.0, 'added_lines': 3, 'deleted_lines': 3, 'nloc': 114}, {'timestamp': 1544661332.0, 'added_lines': 1, 'deleted_lines': 1, 'nloc': 114}, {'timestamp': 1540556089.0, 'added_lines': 1, 'deleted_lines': 1, 'nloc': 114}, {'timestamp': 1547003974.0, 'added_lines': 1, 'deleted_lines': 1, 'nloc': 114}, {'timestamp': 1547152271.0, 'added_lines': 1, 'deleted_lines': 1, 'nloc': 114}, {'timestamp': 1548866534.0, 'added_lines': 1, 'deleted_lines': 1, 'nloc': 114}, {'timestamp': 1549903582.0, 'added_lines': 1, 'deleted_lines': 1, 'nloc': 114}, {'timestamp': 1550507829.0, 'added_lines': 1, 'deleted_lines': 1, 'nloc': 114}, {'timestamp': 1550610741.0, 'added_lines': 2, 'deleted_lines': 2, 'nloc': 114}, {'timestamp': 1551138343.0, 'added_lines': 1, 'deleted_lines': 1, 'nloc': 114}, {'timestamp': 1551229859.0, 'added_lines': 1, 'deleted_lines': 1, 'nloc': 114}, {'timestamp': 1551299964.0, 'added_lines': 1, 'deleted_lines': 1, 'nloc': 114}, {'timestamp': 1551471469.0, 'added_lines': 1, 'deleted_lines': 1, 'nloc': 114}, {'timestamp': 1551754781.0, 'added_lines': 1, 'deleted_lines': 1, 'nloc': 114}, {'timestamp': 1551551196.0, 'added_lines': 4, 'deleted_lines': 4, 'nloc': 114}, {'timestamp': 1557554420.0, 'added_lines': 1, 'deleted_lines': 2, 'nloc': 113}, {'timestamp': 1597895573.0, 'added_lines': 1, 'deleted_lines': 1, 'nloc': 113}, {'timestamp': 1626901942.0, 'added_lines': 33, 'deleted_lines': 23, 'nloc': 121}]","{'blocks/blockstore/caching.go': 1, 'blocks/blockstore/util/remove.go': 3, 'cmd/ipfs/daemon.go': 32, 'cmd/ipfs/init.go': 30, 'cmd/ipfs/ipfs.go': 24, 'cmd/ipfs/main.go': 33, 'cmd/ipfs/main_test.go': 4, 'cmd/ipfswatch/main.go': 16, 'cmd/seccat/seccat.go': 14, None: 13, 'commands/channelmarshaler.go': 1, 'commands/cli/cmd_suggestion.go': 1, 'commands/cli/helptext.go': 2, 'commands/cli/helptext_test.go': 2, 'commands/cli/parse.go': 2, 'commands/cli/parse_test.go': 2, 'commands/command.go': 14, 'commands/command_test.go': 8, 'commands/http/client.go': 2, 'commands/http/handler.go': 2, 'commands/http/multifilereader.go': 2, 'commands/http/multifilereader_test.go': 2, 'commands/http/parse.go': 2, 'commands/reqlog.go': 1, 'commands/request.go': 17, 'commands/response.go': 12, 'commands/response_test.go': 8, 'core/bootstrap.go': 16, 'core/commands/active.go': 26, 'core/commands/add.go': 27, 'core/commands/bitswap.go': 30, 'core/commands/block.go': 27, 'core/commands/bootstrap.go': 29, 'core/commands/cat.go': 27, 'core/commands/commands.go': 26, 'core/commands/config.go': 31, 'core/commands/dag/dag.go': 28, 'core/commands/dht.go': 31, 'core/commands/diag.go': 26, 'core/commands/dns.go': 25, 'core/commands/e/error.go': 1, 'core/commands/external.go': 23, 'core/commands/files/files.go': 8, 'core/commands/filestore.go': 26, 'core/commands/get.go': 29, 'core/commands/helptext_test.go': 24, 'core/commands/id.go': 31, 'core/commands/ipns.go': 12, 'core/commands/keystore.go': 27, 'core/commands/log.go': 26, 'core/commands/ls.go': 29, 'core/commands/mount_nofuse.go': 24, 'core/commands/mount_unix.go': 31, 'core/commands/mount_windows.go': 23, 'core/commands/name.go': 10, 'core/commands/object/diff.go': 25, 'core/commands/object/object.go': 29, 'core/commands/object/patch.go': 26, 'core/commands/p2p.go': 30, 'core/commands/pin.go': 29, 'core/commands/ping.go': 31, 'core/commands/publish.go': 12, 'core/commands/pubsub.go': 28, 'core/commands/refs.go': 28, 'core/commands/repo.go': 31, 'core/commands/resolve.go': 27, 'core/commands/root.go': 28, 'core/commands/shutdown.go': 25, 'core/commands/stat.go': 30, 'core/commands/swarm.go': 32, 'core/commands/tar.go': 27, 'core/commands/unixfs/ls.go': 27, 'core/commands/unixfs/unixfs.go': 23, 'core/commands/version.go': 27, 'core/core_test.go': 9, 'core/corehttp/commands.go': 31, 'core/corehttp/gateway.go': 19, 'core/coreunix/add.go': 23, 'core/coreunix/add_test.go': 24, 'core/coreunix/metadata_test.go': 18, 'exchange/bitswap/bitswap_test.go': 7, 'exchange/bitswap/decision/engine_test.go': 6, 'exchange/bitswap/message/message_test.go': 4, 'exchange/bitswap/message/pb/Makefile': 1, 'exchange/bitswap/testnet/network_test.go': 7, 'exchange/bitswap/testnet/peernet.go': 7, 'exchange/reprovide/reprovide_test.go': 14, 'fuse/ipns/common.go': 14, 'fuse/node/mount_test.go': 14, 'importer/balanced/balanced_test.go': 5, 'importer/chunk/rabin_test.go': 3, 'importer/helpers/dagbuilder.go': 10, 'importer/importer.go': 10, 'merkledag/utils/utils_test.go': 4, 'mfs/repub_test.go': 6, 'namesys/dns.go': 10, 'namesys/interface.go': 10, 'namesys/ipns_select_test.go': 4, 'namesys/proquint.go': 10, 'namesys/republisher/repub_test.go': 15, 'package.json': 30, 'repo/config/identity.go': 1, 'routing/offline/offline_test.go': 4, 'test/integration/addcat_test.go': 18, 'test/integration/bench_cat_test.go': 17, 'test/integration/bitswap_wo_routing_test.go': 15, 'test/integration/three_legged_cat_test.go': 17, 'core/bootstrap_test.go': 14, 'core/commands/dht_test.go': 12, 'core/commands/get_test.go': 25, 'core/core.go': 23, 'core/corehttp/gateway_test.go': 18, 'core/corehttp/metrics_test.go': 14, 'core/mock/mock.go': 15, 'exchange/bitswap/decision/bench_test.go': 5, 'exchange/bitswap/decision/peer_request_queue_test.go': 5, 'exchange/bitswap/message/message.go': 6, 'exchange/bitswap/network/interface.go': 6, 'exchange/bitswap/network/ipfs_impl.go': 6, 'exchange/bitswap/testnet/interface.go': 5, 'exchange/bitswap/testnet/virtual.go': 6, 'exchange/bitswap/testutils.go': 6, 'fuse/ipns/ipns_test.go': 13, 'fuse/readonly/ipfs_test.go': 18, 'namesys/publisher_test.go': 13, 'namesys/resolve_test.go': 14, 'p2p/p2p.go': 13, 'p2p/registry.go': 7, 'repo/config/bootstrap_peers.go': 6, 'routing/mock/centralized_client.go': 3, 'routing/mock/centralized_server.go': 3, 'routing/mock/centralized_test.go': 3, 'routing/mock/interface.go': 3, 'routing/none/none_client.go': 3, 'test/integration/bench_test.go': 12, 'assets/assets.go': 16, 'blocks/blockstore/arc_cache.go': 2, 'blocks/blockstore/arc_cache_test.go': 2, 'blocks/blockstore/blockstore.go': 2, 'blocks/blockstore/blockstore_test.go': 2, 'blocks/blockstore/bloom_cache.go': 2, 'blocks/blockstore/bloom_cache_test.go': 2, 'blocks/blocksutil/block_generator.go': 2, 'blockservice/blockservice.go': 4, 'blockservice/blockservice_test.go': 4, 'blockservice/test/blocks_test.go': 4, 'core/builder.go': 21, 'core/commands/ipnsps.go': 8, 'core/coreapi/coreapi.go': 12, 'core/coreapi/interface/interface.go': 2, 'core/coreapi/unixfs.go': 17, 'core/coreapi/unixfs_test.go': 11, 'core/coredag/cbor.go': 6, 'core/coredag/dagpb.go': 11, 'core/coredag/dagtransl.go': 6, 'core/coredag/raw.go': 11, 'core/corehttp/corehttp.go': 12, 'core/corehttp/gateway_handler.go': 20, 'core/corerepo/gc.go': 17, 'core/corerepo/pinning.go': 6, 'core/coreunix/metadata.go': 16, 'core/pathresolver.go': 12, 'exchange/bitswap/bitswap.go': 4, 'exchange/bitswap/decision/engine.go': 4, 'exchange/bitswap/decision/ledger.go': 4, 'exchange/bitswap/decision/peer_request_queue.go': 4, 'exchange/bitswap/get.go': 4, 'exchange/bitswap/notifications/notifications.go': 3, 'exchange/bitswap/notifications/notifications_test.go': 3, 'exchange/bitswap/session.go': 4, 'exchange/bitswap/session_test.go': 4, 'exchange/bitswap/stat.go': 3, 'exchange/bitswap/wantlist/wantlist.go': 3, 'exchange/bitswap/wantlist/wantlist_test.go': 3, 'exchange/bitswap/wantmanager.go': 4, 'exchange/bitswap/workers.go': 4, 'exchange/interface.go': 2, 'exchange/offline/offline.go': 2, 'exchange/offline/offline_test.go': 2, 'exchange/reprovide/providers.go': 12, 'exchange/reprovide/reprovide.go': 12, 'filestore/filestore.go': 8, 'filestore/filestore_test.go': 12, 'filestore/fsrefstore.go': 8, 'filestore/util.go': 8, 'fuse/ipns/ipns_unix.go': 17, 'fuse/readonly/readonly_unix.go': 17, 'importer/balanced/builder.go': 3, 'importer/chunk/splitting_test.go': 2, 'importer/helpers/helpers.go': 3, 'importer/importer_test.go': 4, 'importer/trickle/trickle_test.go': 4, 'importer/trickle/trickledag.go': 3, 'merkledag/batch.go': 2, 'merkledag/coding.go': 3, 'merkledag/merkledag.go': 3, 'merkledag/merkledag_test.go': 4, 'merkledag/node.go': 3, 'merkledag/node_test.go': 3, 'merkledag/raw.go': 3, 'merkledag/traverse/traverse.go': 3, 'merkledag/traverse/traverse_test.go': 3, 'merkledag/utils/diff.go': 3, 'merkledag/utils/diffenum.go': 3, 'merkledag/utils/diffenum_test.go': 3, 'merkledag/utils/utils.go': 4, 'mfs/dir.go': 4, 'mfs/file.go': 5, 'mfs/mfs_test.go': 5, 'mfs/ops.go': 3, 'mfs/system.go': 5, 'namesys/namesys.go': 14, 'namesys/publisher.go': 18, 'namesys/pubsub.go': 2, 'namesys/pubsub_test.go': 2, 'namesys/republisher/repub.go': 12, 'namesys/routing.go': 14, 'path/path.go': 3, 'path/resolver.go': 2, 'path/resolver_test.go': 2, 'pin/gc/gc.go': 12, 'pin/pin.go': 12, 'pin/pin_test.go': 12, 'pin/set.go': 11, 'pin/set_test.go': 12, 'plugin/ipld.go': 6, 'plugin/loader/initializer.go': 5, 'plugin/plugins/git/git.go': 6, 'repo/config/init.go': 4, 'repo/fsrepo/fsrepo.go': 13, 'repo/fsrepo/lock/lock.go': 2, 'repo/fsrepo/serialize/serialize.go': 3, 'repo/mock.go': 13, 'repo/repo.go': 13, 'routing/offline/offline.go': 2, 'tar/format.go': 17, 'test/dependencies/ma-pipe-unidir/main.go': 10, 'thirdparty/ds-help/key.go': 2, 'thirdparty/pollEndpoint/main.go': 11, 'thirdparty/posinfo/posinfo.go': 2, 'unixfs/archive/archive.go': 3, 'unixfs/archive/tar/writer.go': 3, 'unixfs/hamt/hamt.go': 3, 'unixfs/io/dagreader.go': 3, 'unixfs/io/dirbuilder.go': 3, 'unixfs/io/resolve.go': 3, 'unixfs/mod/dagmodifier.go': 4, 'unixfs/mod/dagmodifier_test.go': 3, 'unixfs/test/utils.go': 4, 'commands/legacy/command.go': 10, 'commands/legacy/legacy.go': 10, 'commands/legacy/legacy_test.go': 11, 'commands/legacy/request.go': 11, 'commands/legacy/response.go': 11, 'commands/legacy/responseemitter.go': 4, 'core/commands/env.go': 5, 'TODO.md': 2, 'core/commands/commands_test.go': 20, 'test/sharness/t0110-gateway.sh': 1, 'test/sharness/t0410-api-add.sh': 1, 'core/coreapi/dag.go': 5, 'core/coreapi/dag_test.go': 3, 'core/coreapi/interface/options/dag.go': 4, 'core/coreapi/key.go': 12, 'core/coreapi/name.go': 13, 'merkledag/test/utils.go': 3, 'namesys/namesys_test.go': 17, 'repo/fsrepo/datastores.go': 6, 'repo/fsrepo/fsrepo_test.go': 9, 'thirdparty/datastore2/datastore_closer.go': 1, 'thirdparty/datastore2/delayed.go': 1, 'thirdparty/datastore2/threadsafe.go': 1, 'unixfs/io/pbdagreader.go': 2, 'blockservice/test/mock.go': 3, 'namesys/ipns_validate_test.go': 2, 'namesys/validator.go': 2, 'blocks/blockstoreutil/remove.go': 6, 'cmd/ipfs/util/ulimit.go': 5, 'cmd/ipfs/util/ulimit_freebsd.go': 2, 'cmd/ipfs/util/ulimit_unix.go': 2, 'cmd/seccat/util.go': 5, 'core/commands/files.go': 21, 'core/coreapi/block.go': 8, 'core/coreapi/block_test.go': 2, 'core/coreapi/interface/coreapi.go': 3, 'core/coreapi/interface/dag.go': 3, 'core/coreapi/interface/object.go': 3, 'core/coreapi/interface/options/block.go': 2, 'core/coreapi/interface/path.go': 5, 'core/coreapi/interface/unixfs.go': 6, 'core/coreapi/object.go': 14, 'core/coreapi/pin.go': 11, 'core/corehttp/logs.go': 5, 'fuse/ipns/link_unix.go': 2, 'fuse/mount/fuse.go': 2, 'fuse/mount/mount.go': 5, 'fuse/node/mount_darwin.go': 2, 'fuse/node/mount_unix.go': 6, 'keystore/keystore.go': 5, 'merkledag/errservice.go': 1, 'merkledag/readonly.go': 1, 'merkledag/readonly_test.go': 1, 'merkledag/rwservice.go': 1, 'merkledag/session.go': 1, 'path/resolver/resolver.go': 2, 'path/resolver/resolver_test.go': 1, 'plugin/loader/load.go': 3, 'thirdparty/verifbs/verifbs.go': 6, 'thirdparty/verifcid/validate.go': 1, 'thirdparty/verifcid/validate_test.go': 1, 'unixfs/hamt/hamt_stress_test.go': 1, 'unixfs/hamt/hamt_test.go': 1, 'namesys/ipns_resolver_validation_test.go': 10, 'test/sharness/t0170-dht.sh': 1, 'repo/fsrepo/misc.go': 9, 'cmd/ipfs/Rules.mk': 1, 'core/corehttp/option_test.go': 2, 'docs/releases.md': 2, 'docs/windows.md': 2, 'repo/fsrepo/config_test.go': 8, 'repo/version.go': 1, 'test/bench/bench_cli_ipfs_add/main.go': 9, 'test/bench/offline_add/main.go': 9, 'version.go': 1, 'core/commands/urlstore.go': 19, 'core/coreapi/path.go': 13, 'core/coreunix/cat.go': 2, 'mfs/fd.go': 1, 'core/coreapi/interface/key.go': 3, 'core/coreapi/name_test.go': 5, 'core/pathresolver_test.go': 8, 'dagutils/diff.go': 9, 'dagutils/diffenum.go': 8, 'dagutils/diffenum_test.go': 8, 'dagutils/utils.go': 8, 'dagutils/utils_test.go': 8, 'namesys/base.go': 9, 'namesys/cache.go': 8, 'thirdparty/cidv0v1/blockstore.go': 4, 'core/commands/cid.go': 14, 'core/commands/cmdenv/env.go': 16, 'core/commands/name/ipns.go': 17, 'core/commands/name/ipnsps.go': 16, 'core/commands/name/name.go': 14, 'core/commands/name/publish.go': 15, 'core/coreapi/unixfile.go': 5, 'cmd/ipfs/dnsresolve_test.go': 5, 'core/coreapi/dht.go': 8, 'core/coreapi/dht_test.go': 2, 'core/coreapi/interface/dht.go': 3, 'core/coreapi/interface/options/unixfs.go': 3, 'core/coreapi/interface/pubsub.go': 2, 'core/coreapi/interface/swarm.go': 3, 'core/coreapi/pubsub.go': 8, 'core/coreapi/swarm.go': 8, 'p2p/listener.go': 6, 'p2p/local.go': 7, 'p2p/remote.go': 7, 'p2p/stream.go': 7, 'keystore/keystore_test.go': 3, 'keystore/memkeystore.go': 3, 'test/dependencies/iptb/iptb.go': 6, 'commands/context.go': 13, 'core/coreapi/interface/tests/name.go': 2, 'core/coreapi/interface/tests/unixfs.go': 2, 'core/coreapi/test/api_test.go': 6, 'core/corehttp/proxy.go': 5, 'core/commands/cmdenv/cidbase.go': 9, 'core/commands/cmdenv/file.go': 3, 'core/corehttp/ipns_hostname.go': 5, 'namesys/dns_test.go': 5, 'plugin/daemon.go': 5, 'plugin/loader/loader.go': 5, 'filestore/pb/dataobj.pb.go': 2, 'pin/internal/pb/header.pb.go': 2, 'plugin/plugins/badgerds/badgerds.go': 3, 'plugin/plugins/flatfs/flatfs.go': 3, 'plugin/plugins/levelds/levelds.go': 2, 'core/corerepo/stat.go': 2, 'core/commands/cmdenv/cidbase_test.go': 1, 'core/corehttp/metrics.go': 1, 'core/corehttp/proxy_test.go': 1, 'plugin/tracer.go': 1, 'thirdparty/notifier/notifier.go': 1, 'README.md': 1, 'go.mod': 2, 'go.sum': 2, 'package-list.json': 1, 'core/commands/profile.go': 1, 'docs/debug-guide.md': 1, 'test/sharness/t0152-profile.sh': 1}","('cmd/ipfs/main.go', 0.8461538461538461, 0.3142857142857143)"
core/commands/tar.go,101,601,3,"[{'cyclomatic_complexity': 4, 'nloc': 23, 'token_count': 144, 'name': '', 'long_name': '(req cmds.Request,res cmds.Response)', 'start_line': 38, 'end_line': 64, 'full_parameters': [], 'filename': '/home/dimi/Documents/Informatik_Studium/FSS/SoftEvo/DataCollection/FFS_SoftEvo/go-ipfs/core/commands/tar.go', 'top_nesting_level': 0, 'length': 27, 'fan_in': 0, 'fan_out': 0, 'general_fan_out': 0}, {'cyclomatic_complexity': 1, 'nloc': 4, 'token_count': 43, 'name': '', 'long_name': '(res cmds.Response)(io.Reader,error)', 'start_line': 67, 'end_line': 70, 'full_parameters': [], 'filename': '/home/dimi/Documents/Informatik_Studium/FSS/SoftEvo/DataCollection/FFS_SoftEvo/go-ipfs/core/commands/tar.go', 'top_nesting_level': 0, 'length': 4, 'fan_in': 0, 'fan_out': 0, 'general_fan_out': 0}, {'cyclomatic_complexity': 6, 'nloc': 28, 'token_count': 192, 'name': '', 'long_name': '(req cmds.Request,res cmds.Response)', 'start_line': 85, 'end_line': 117, 'full_parameters': [], 'filename': '/home/dimi/Documents/Informatik_Studium/FSS/SoftEvo/DataCollection/FFS_SoftEvo/go-ipfs/core/commands/tar.go', 'top_nesting_level': 0, 'length': 33, 'fan_in': 0, 'fan_out': 0, 'general_fan_out': 0}]",92,534,0,[],-9,-67,-3,76,76,"[{'timestamp': 1491058697.0, 'added_lines': 27, 'deleted_lines': 16, 'nloc': 110}, {'timestamp': 1511223906.0, 'added_lines': 1, 'deleted_lines': 1, 'nloc': 110}, {'timestamp': 1512365669.0, 'added_lines': 1, 'deleted_lines': 1, 'nloc': 110}, {'timestamp': 1511187070.0, 'added_lines': 1, 'deleted_lines': 1, 'nloc': 110}, {'timestamp': 1513436097.0, 'added_lines': 1, 'deleted_lines': 1, 'nloc': 110}, {'timestamp': 1513612261.0, 'added_lines': 1, 'deleted_lines': 1, 'nloc': 110}, {'timestamp': 1515277696.0, 'added_lines': 1, 'deleted_lines': 1, 'nloc': 110}, {'timestamp': 1516911711.0, 'added_lines': 1, 'deleted_lines': 1, 'nloc': 110}, {'timestamp': 1528520460.0, 'added_lines': 1, 'deleted_lines': 1, 'nloc': 110}, {'timestamp': 1532764253.0, 'added_lines': 1, 'deleted_lines': 1, 'nloc': 110}, {'timestamp': 1532847462.0, 'added_lines': 1, 'deleted_lines': 1, 'nloc': 110}, {'timestamp': 1533500571.0, 'added_lines': 2, 'deleted_lines': 2, 'nloc': 110}, {'timestamp': 1533618653.0, 'added_lines': 2, 'deleted_lines': 2, 'nloc': 110}, {'timestamp': 1533779477.0, 'added_lines': 2, 'deleted_lines': 2, 'nloc': 110}, {'timestamp': 1533946888.0, 'added_lines': 1, 'deleted_lines': 1, 'nloc': 110}, {'timestamp': 1534115707.0, 'added_lines': 2, 'deleted_lines': 2, 'nloc': 110}, {'timestamp': 1534195762.0, 'added_lines': 2, 'deleted_lines': 2, 'nloc': 110}, {'timestamp': 1534347022.0, 'added_lines': 2, 'deleted_lines': 2, 'nloc': 110}, {'timestamp': 1534896611.0, 'added_lines': 3, 'deleted_lines': 3, 'nloc': 110}, {'timestamp': 1535601896.0, 'added_lines': 2, 'deleted_lines': 2, 'nloc': 110}, {'timestamp': 1536388808.0, 'added_lines': 2, 'deleted_lines': 2, 'nloc': 110}, {'timestamp': 1536718784.0, 'added_lines': 2, 'deleted_lines': 2, 'nloc': 110}, {'timestamp': 1536723292.0, 'added_lines': 2, 'deleted_lines': 2, 'nloc': 110}, {'timestamp': 1537790637.0, 'added_lines': 2, 'deleted_lines': 2, 'nloc': 110}, {'timestamp': 1537792589.0, 'added_lines': 2, 'deleted_lines': 2, 'nloc': 110}, {'timestamp': 1538607626.0, 'added_lines': 4, 'deleted_lines': 4, 'nloc': 110}, {'timestamp': 1538544957.0, 'added_lines': 2, 'deleted_lines': 2, 'nloc': 110}, {'timestamp': 1538694687.0, 'added_lines': 2, 'deleted_lines': 2, 'nloc': 110}, {'timestamp': 1538695953.0, 'added_lines': 2, 'deleted_lines': 2, 'nloc': 110}, {'timestamp': 1538773916.0, 'added_lines': 2, 'deleted_lines': 2, 'nloc': 110}, {'timestamp': 1539176817.0, 'added_lines': 2, 'deleted_lines': 2, 'nloc': 110}, {'timestamp': 1539357340.0, 'added_lines': 2, 'deleted_lines': 2, 'nloc': 110}, {'timestamp': 1539850591.0, 'added_lines': 1, 'deleted_lines': 1, 'nloc': 110}, {'timestamp': 1540400358.0, 'added_lines': 2, 'deleted_lines': 2, 'nloc': 110}, {'timestamp': 1540410565.0, 'added_lines': 2, 'deleted_lines': 2, 'nloc': 110}, {'timestamp': 1540418491.0, 'added_lines': 2, 'deleted_lines': 2, 'nloc': 110}, {'timestamp': 1540558290.0, 'added_lines': 30, 'deleted_lines': 46, 'nloc': 95}, {'timestamp': 1540597832.0, 'added_lines': 1, 'deleted_lines': 1, 'nloc': 95}, {'timestamp': 1540603818.0, 'added_lines': 2, 'deleted_lines': 2, 'nloc': 95}, {'timestamp': 1540906996.0, 'added_lines': 1, 'deleted_lines': 1, 'nloc': 95}, {'timestamp': 1540916861.0, 'added_lines': 1, 'deleted_lines': 1, 'nloc': 95}, {'timestamp': 1541189794.0, 'added_lines': 2, 'deleted_lines': 2, 'nloc': 95}, {'timestamp': 1541204121.0, 'added_lines': 3, 'deleted_lines': 3, 'nloc': 95}, {'timestamp': 1541903826.0, 'added_lines': 2, 'deleted_lines': 2, 'nloc': 95}, {'timestamp': 1543443696.0, 'added_lines': 2, 'deleted_lines': 2, 'nloc': 95}, {'timestamp': 1544225843.0, 'added_lines': 2, 'deleted_lines': 2, 'nloc': 95}, {'timestamp': 1544661332.0, 'added_lines': 1, 'deleted_lines': 1, 'nloc': 95}, {'timestamp': 1540556089.0, 'added_lines': 1, 'deleted_lines': 1, 'nloc': 95}, {'timestamp': 1540562190.0, 'added_lines': 2, 'deleted_lines': 3, 'nloc': 94}, {'timestamp': 1542594282.0, 'added_lines': 8, 'deleted_lines': 5, 'nloc': 97}, {'timestamp': 1543031503.0, 'added_lines': 1, 'deleted_lines': 1, 'nloc': 97}, {'timestamp': 1543868676.0, 'added_lines': 3, 'deleted_lines': 2, 'nloc': 98}, {'timestamp': 1544737281.0, 'added_lines': 3, 'deleted_lines': 3, 'nloc': 98}, {'timestamp': 1544785510.0, 'added_lines': 8, 'deleted_lines': 11, 'nloc': 95}, {'timestamp': 1545139435.0, 'added_lines': 3, 'deleted_lines': 4, 'nloc': 94}, {'timestamp': 1547003974.0, 'added_lines': 2, 'deleted_lines': 2, 'nloc': 94}, {'timestamp': 1547152271.0, 'added_lines': 1, 'deleted_lines': 1, 'nloc': 94}, {'timestamp': 1542878205.0, 'added_lines': 6, 'deleted_lines': 1, 'nloc': 98}, {'timestamp': 1547499910.0, 'added_lines': 2, 'deleted_lines': 2, 'nloc': 98}, {'timestamp': 1548866534.0, 'added_lines': 1, 'deleted_lines': 1, 'nloc': 98}, {'timestamp': 1549588289.0, 'added_lines': 2, 'deleted_lines': 2, 'nloc': 98}, {'timestamp': 1549903582.0, 'added_lines': 1, 'deleted_lines': 1, 'nloc': 98}, {'timestamp': 1550185115.0, 'added_lines': 2, 'deleted_lines': 2, 'nloc': 98}, {'timestamp': 1550507829.0, 'added_lines': 3, 'deleted_lines': 3, 'nloc': 98}, {'timestamp': 1550610741.0, 'added_lines': 1, 'deleted_lines': 1, 'nloc': 98}, {'timestamp': 1550711994.0, 'added_lines': 2, 'deleted_lines': 2, 'nloc': 98}, {'timestamp': 1550723346.0, 'added_lines': 2, 'deleted_lines': 2, 'nloc': 98}, {'timestamp': 1551138343.0, 'added_lines': 1, 'deleted_lines': 1, 'nloc': 98}, {'timestamp': 1551229859.0, 'added_lines': 2, 'deleted_lines': 2, 'nloc': 98}, {'timestamp': 1551299964.0, 'added_lines': 3, 'deleted_lines': 3, 'nloc': 98}, {'timestamp': 1551471469.0, 'added_lines': 1, 'deleted_lines': 1, 'nloc': 98}, {'timestamp': 1551551196.0, 'added_lines': 4, 'deleted_lines': 4, 'nloc': 98}, {'timestamp': 1554256305.0, 'added_lines': 2, 'deleted_lines': 2, 'nloc': 98}, {'timestamp': 1557554420.0, 'added_lines': 7, 'deleted_lines': 8, 'nloc': 97}, {'timestamp': 1566440663.0, 'added_lines': 6, 'deleted_lines': 12, 'nloc': 92}, {'timestamp': 1616604074.0, 'added_lines': 2, 'deleted_lines': 2, 'nloc': 92}]","{'blocks/blockstore/caching.go': 1, 'blocks/blockstore/util/remove.go': 2, 'cmd/ipfs/daemon.go': 30, 'cmd/ipfs/init.go': 40, 'cmd/ipfs/ipfs.go': 25, 'cmd/ipfs/main.go': 34, 'cmd/ipfs/main_test.go': 4, 'cmd/ipfswatch/main.go': 20, 'cmd/seccat/seccat.go': 22, None: 36, 'commands/channelmarshaler.go': 1, 'commands/cli/cmd_suggestion.go': 1, 'commands/cli/helptext.go': 2, 'commands/cli/helptext_test.go': 2, 'commands/cli/parse.go': 2, 'commands/cli/parse_test.go': 2, 'commands/command.go': 14, 'commands/command_test.go': 7, 'commands/http/client.go': 2, 'commands/http/handler.go': 2, 'commands/http/multifilereader.go': 2, 'commands/http/multifilereader_test.go': 2, 'commands/http/parse.go': 2, 'commands/reqlog.go': 1, 'commands/request.go': 19, 'commands/response.go': 11, 'commands/response_test.go': 7, 'core/bootstrap.go': 21, 'core/commands/active.go': 23, 'core/commands/add.go': 51, 'core/commands/bitswap.go': 56, 'core/commands/block.go': 40, 'core/commands/bootstrap.go': 33, 'core/commands/cat.go': 32, 'core/commands/commands.go': 27, 'core/commands/config.go': 39, 'core/commands/dag/dag.go': 70, 'core/commands/dht.go': 61, 'core/commands/diag.go': 23, 'core/commands/dns.go': 31, 'core/commands/e/error.go': 1, 'core/commands/external.go': 23, 'core/commands/files/files.go': 8, 'core/commands/filestore.go': 32, 'core/commands/get.go': 60, 'core/commands/helptext_test.go': 25, 'core/commands/id.go': 45, 'core/commands/ipns.go': 14, 'core/commands/keystore.go': 32, 'core/commands/log.go': 26, 'core/commands/ls.go': 60, 'core/commands/mount_nofuse.go': 23, 'core/commands/mount_unix.go': 33, 'core/commands/mount_windows.go': 22, 'core/commands/name.go': 10, 'core/commands/object/diff.go': 30, 'core/commands/object/object.go': 69, 'core/commands/object/patch.go': 41, 'core/commands/p2p.go': 35, 'core/commands/pin.go': 61, 'core/commands/ping.go': 38, 'core/commands/publish.go': 17, 'core/commands/pubsub.go': 41, 'core/commands/refs.go': 62, 'core/commands/repo.go': 44, 'core/commands/resolve.go': 61, 'core/commands/root.go': 30, 'core/commands/shutdown.go': 28, 'core/commands/stat.go': 33, 'core/commands/swarm.go': 41, 'core/commands/sysdiag.go': 27, 'core/commands/unixfs/ls.go': 59, 'core/commands/unixfs/unixfs.go': 23, 'core/commands/version.go': 28, 'core/core_test.go': 17, 'core/corehttp/commands.go': 59, 'core/corehttp/gateway.go': 30, 'core/coreunix/add.go': 61, 'core/coreunix/add_test.go': 59, 'core/coreunix/metadata_test.go': 48, 'exchange/bitswap/bitswap_test.go': 4, 'exchange/bitswap/decision/engine_test.go': 4, 'exchange/bitswap/message/message_test.go': 3, 'exchange/bitswap/message/pb/Makefile': 1, 'exchange/bitswap/testnet/network_test.go': 4, 'exchange/bitswap/testnet/peernet.go': 4, 'exchange/reprovide/reprovide_test.go': 29, 'fuse/ipns/common.go': 46, 'fuse/node/mount_test.go': 27, 'importer/balanced/balanced_test.go': 5, 'importer/chunk/rabin_test.go': 2, 'importer/helpers/dagbuilder.go': 10, 'importer/importer.go': 9, 'merkledag/utils/utils_test.go': 4, 'mfs/repub_test.go': 7, 'namesys/dns.go': 42, 'namesys/interface.go': 42, 'namesys/ipns_select_test.go': 3, 'namesys/proquint.go': 42, 'namesys/republisher/repub_test.go': 44, 'package.json': 59, 'repo/config/identity.go': 2, 'routing/offline/offline_test.go': 3, 'test/integration/addcat_test.go': 32, 'test/integration/bench_cat_test.go': 31, 'test/integration/bitswap_wo_routing_test.go': 31, 'test/integration/three_legged_cat_test.go': 31, 'core/bootstrap_test.go': 20, 'core/commands/dht_test.go': 19, 'core/commands/get_test.go': 26, 'core/core.go': 50, 'core/corehttp/gateway_test.go': 47, 'core/corehttp/metrics_test.go': 27, 'core/mock/mock.go': 28, 'exchange/bitswap/decision/bench_test.go': 3, 'exchange/bitswap/decision/peer_request_queue_test.go': 3, 'exchange/bitswap/message/message.go': 3, 'exchange/bitswap/network/interface.go': 3, 'exchange/bitswap/network/ipfs_impl.go': 3, 'exchange/bitswap/testnet/interface.go': 3, 'exchange/bitswap/testnet/virtual.go': 3, 'exchange/bitswap/testutils.go': 3, 'fuse/ipns/ipns_test.go': 26, 'fuse/readonly/ipfs_test.go': 49, 'namesys/publisher_test.go': 27, 'namesys/resolve_test.go': 43, 'p2p/p2p.go': 20, 'p2p/registry.go': 7, 'repo/config/bootstrap_peers.go': 4, 'routing/mock/centralized_client.go': 2, 'routing/mock/centralized_server.go': 2, 'routing/mock/centralized_test.go': 2, 'routing/mock/interface.go': 2, 'routing/none/none_client.go': 2, 'test/integration/bench_test.go': 14, 'assets/assets.go': 44, 'blocks/blockstore/arc_cache.go': 1, 'blocks/blockstore/arc_cache_test.go': 1, 'blocks/blockstore/blockstore.go': 1, 'blocks/blockstore/blockstore_test.go': 1, 'blocks/blockstore/bloom_cache.go': 1, 'blocks/blockstore/bloom_cache_test.go': 1, 'blocks/blocksutil/block_generator.go': 1, 'blockservice/blockservice.go': 3, 'blockservice/blockservice_test.go': 2, 'blockservice/test/blocks_test.go': 3, 'core/builder.go': 48, 'core/commands/ipnsps.go': 8, 'core/coreapi/coreapi.go': 22, 'core/coreapi/interface/interface.go': 1, 'core/coreapi/unixfs.go': 50, 'core/coreapi/unixfs_test.go': 42, 'core/coredag/cbor.go': 15, 'core/coredag/dagpb.go': 41, 'core/coredag/dagtransl.go': 11, 'core/coredag/raw.go': 41, 'core/corehttp/corehttp.go': 10, 'core/corehttp/gateway_handler.go': 54, 'core/corerepo/gc.go': 44, 'core/corerepo/pinning.go': 18, 'core/coreunix/metadata.go': 47, 'core/pathresolver.go': 42, 'exchange/bitswap/bitswap.go': 2, 'exchange/bitswap/decision/engine.go': 2, 'exchange/bitswap/decision/ledger.go': 2, 'exchange/bitswap/decision/peer_request_queue.go': 2, 'exchange/bitswap/get.go': 2, 'exchange/bitswap/notifications/notifications.go': 2, 'exchange/bitswap/notifications/notifications_test.go': 2, 'exchange/bitswap/session.go': 2, 'exchange/bitswap/session_test.go': 2, 'exchange/bitswap/stat.go': 2, 'exchange/bitswap/wantlist/wantlist.go': 2, 'exchange/bitswap/wantlist/wantlist_test.go': 2, 'exchange/bitswap/wantmanager.go': 2, 'exchange/bitswap/workers.go': 2, 'exchange/interface.go': 1, 'exchange/offline/offline.go': 1, 'exchange/offline/offline_test.go': 1, 'exchange/reprovide/providers.go': 42, 'exchange/reprovide/reprovide.go': 23, 'filestore/filestore.go': 21, 'filestore/filestore_test.go': 41, 'filestore/fsrefstore.go': 21, 'filestore/util.go': 20, 'fuse/ipns/ipns_unix.go': 49, 'fuse/readonly/readonly_unix.go': 49, 'importer/balanced/builder.go': 2, 'importer/chunk/splitting_test.go': 1, 'importer/helpers/helpers.go': 4, 'importer/importer_test.go': 4, 'importer/trickle/trickle_test.go': 4, 'importer/trickle/trickledag.go': 3, 'merkledag/batch.go': 1, 'merkledag/coding.go': 2, 'merkledag/merkledag.go': 3, 'merkledag/merkledag_test.go': 3, 'merkledag/node.go': 3, 'merkledag/node_test.go': 3, 'merkledag/raw.go': 2, 'merkledag/traverse/traverse.go': 2, 'merkledag/traverse/traverse_test.go': 3, 'merkledag/utils/diff.go': 3, 'merkledag/utils/diffenum.go': 2, 'merkledag/utils/diffenum_test.go': 3, 'merkledag/utils/utils.go': 3, 'mfs/dir.go': 11, 'mfs/file.go': 11, 'mfs/mfs_test.go': 12, 'mfs/ops.go': 9, 'mfs/system.go': 11, 'namesys/namesys.go': 43, 'namesys/publisher.go': 47, 'namesys/pubsub.go': 1, 'namesys/pubsub_test.go': 1, 'namesys/republisher/repub.go': 42, 'namesys/routing.go': 43, 'path/path.go': 2, 'path/resolver.go': 2, 'path/resolver_test.go': 2, 'pin/gc/gc.go': 42, 'pin/pin.go': 42, 'pin/pin_test.go': 42, 'pin/set.go': 42, 'pin/set_test.go': 41, 'plugin/ipld.go': 11, 'plugin/loader/initializer.go': 8, 'plugin/plugins/git/git.go': 11, 'repo/config/init.go': 3, 'repo/fsrepo/fsrepo.go': 19, 'repo/fsrepo/lock/lock.go': 1, 'repo/fsrepo/serialize/serialize.go': 2, 'repo/mock.go': 15, 'repo/repo.go': 18, 'routing/offline/offline.go': 1, 'tar/format.go': 49, 'test/dependencies/ma-pipe-unidir/main.go': 7, 'thirdparty/ds-help/key.go': 1, 'thirdparty/pollEndpoint/main.go': 10, 'thirdparty/posinfo/posinfo.go': 1, 'unixfs/archive/archive.go': 3, 'unixfs/archive/tar/writer.go': 4, 'unixfs/hamt/hamt.go': 4, 'unixfs/io/dagreader.go': 4, 'unixfs/io/dirbuilder.go': 3, 'unixfs/io/resolve.go': 4, 'unixfs/mod/dagmodifier.go': 4, 'unixfs/mod/dagmodifier_test.go': 2, 'unixfs/test/utils.go': 4, 'commands/legacy/command.go': 11, 'commands/legacy/legacy.go': 11, 'commands/legacy/legacy_test.go': 12, 'commands/legacy/request.go': 12, 'commands/legacy/response.go': 12, 'commands/legacy/responseemitter.go': 4, 'core/commands/env.go': 4, 'TODO.md': 2, 'core/commands/commands_test.go': 21, 'test/sharness/t0110-gateway.sh': 1, 'test/sharness/t0410-api-add.sh': 1, 'core/coreapi/dag.go': 11, 'merkledag/test/utils.go': 2, 'mfs/fd.go': 8, 'unixfs/hamt/hamt_stress_test.go': 3, 'unixfs/hamt/hamt_test.go': 3, 'unixfs/io/dagreader_test.go': 2, 'unixfs/io/dirbuilder_test.go': 1, 'unixfs/io/pbdagreader.go': 3, 'blocks/blockstoreutil/remove.go': 18, 'blockservice/test/mock.go': 1, 'cmd/ipfs/util/ulimit.go': 6, 'cmd/ipfs/util/ulimit_freebsd.go': 2, 'cmd/ipfs/util/ulimit_unix.go': 2, 'cmd/seccat/util.go': 6, 'core/commands/files.go': 62, 'core/coreapi/block.go': 14, 'core/coreapi/block_test.go': 2, 'core/coreapi/dag_test.go': 2, 'core/coreapi/interface/coreapi.go': 8, 'core/coreapi/interface/dag.go': 8, 'core/coreapi/interface/object.go': 8, 'core/coreapi/interface/options/block.go': 3, 'core/coreapi/interface/options/dag.go': 6, 'core/coreapi/interface/path.go': 35, 'core/coreapi/interface/unixfs.go': 16, 'core/coreapi/key.go': 42, 'core/coreapi/name.go': 42, 'core/coreapi/object.go': 45, 'core/coreapi/pin.go': 41, 'core/corehttp/logs.go': 6, 'fuse/ipns/link_unix.go': 2, 'fuse/mount/fuse.go': 2, 'fuse/mount/mount.go': 6, 'fuse/node/mount_darwin.go': 2, 'fuse/node/mount_unix.go': 6, 'keystore/keystore.go': 6, 'merkledag/errservice.go': 1, 'merkledag/readonly.go': 1, 'merkledag/readonly_test.go': 1, 'merkledag/rwservice.go': 1, 'merkledag/session.go': 1, 'namesys/ipns_validate_test.go': 1, 'namesys/namesys_test.go': 46, 'namesys/validator.go': 1, 'path/resolver/resolver.go': 2, 'path/resolver/resolver_test.go': 2, 'plugin/loader/load.go': 4, 'repo/fsrepo/datastores.go': 11, 'thirdparty/verifbs/verifbs.go': 18, 'thirdparty/verifcid/validate.go': 1, 'thirdparty/verifcid/validate_test.go': 1, 'Rules.mk': 1, 'dagutils/diff.go': 40, 'dagutils/diffenum.go': 39, 'dagutils/diffenum_test.go': 39, 'dagutils/utils.go': 41, 'dagutils/utils_test.go': 41, 'unixfs/io/directory.go': 1, 'unixfs/io/directory_test.go': 1, 'unixfs/unixfs.go': 1, 'core/coreapi/name_test.go': 35, 'core/coreapi/path.go': 46, 'core/coreunix/cat.go': 15, 'core/pathresolver_test.go': 40, 'namesys/base.go': 41, 'namesys/cache.go': 40, 'namesys/ipns_resolver_validation_test.go': 41, 'core/commands/urlstore.go': 51, 'core/coreapi/interface/key.go': 7, 'filestore/pb/dataobj.pb.go': 3, 'keystore/keystore_test.go': 4, 'keystore/memkeystore.go': 4, 'pin/internal/pb/header.pb.go': 3, 'thirdparty/cidv0v1/blockstore.go': 16, 'repo/fsrepo/fsrepo_test.go': 16, 'repo/fsrepo/config_test.go': 13, 'repo/fsrepo/misc.go': 13, 'test/bench/bench_cli_ipfs_add/main.go': 14, 'test/bench/offline_add/main.go': 14, 'core/commands/cmdenv/env.go': 26, 'core/commands/name/ipns.go': 43, 'core/commands/name/publish.go': 26, 'core/coreapi/dht.go': 30, 'core/coreapi/dht_test.go': 5, 'test/sharness/t0275-cid-security.sh': 1, 'core/commands/name/ipnsps.go': 21, 'core/commands/name/name.go': 16, 'core/coreapi/interface/dht.go': 10, 'p2p/listener.go': 13, 'p2p/local.go': 13, 'p2p/remote.go': 13, 'p2p/stream.go': 13, 'core/coreapi/interface/options/unixfs.go': 16, 'core/coreapi/interface/swarm.go': 9, 'core/coreapi/swarm.go': 20, 'core/coreapi/pubsub.go': 18, 'core/coreapi/unixfile.go': 20, 'core/commands/cid.go': 16, 'cmd/ipfs/dnsresolve_test.go': 5, 'core/coreapi/interface/pubsub.go': 4, 'test/dependencies/iptb/iptb.go': 12, 'plugin/plugins/badgerds/badgerds.go': 4, 'plugin/plugins/flatfs/flatfs.go': 4, 'plugin/plugins/levelds/levelds.go': 3, 'commands/context.go': 18, 'core/corehttp/proxy.go': 9, 'core/commands/cmdenv/file.go': 4, 'core/coreapi/interface/tests/name.go': 4, 'core/coreapi/interface/tests/unixfs.go': 4, 'core/coreapi/test/api_test.go': 10, 'core/commands/cmdenv/cidbase.go': 11, 'core/commands/cmdenv/cidbase_test.go': 3, 'test/sharness/t0040-add-and-cat.sh': 1, 'test/sharness/t0045-ls.sh': 1, 'test/sharness/t0051-object-data/mixed.json': 1, 'test/sharness/t0051-object.sh': 1, 'test/sharness/t0053-dag.sh': 1, 'test/sharness/t0085-pins.sh': 1, 'test/sharness/t0095-refs.sh': 1, 'test/sharness/t0160-resolve.sh': 1, 'test/sharness/t0210-tar.sh': 1, 'test/sharness/t0250-files-api.sh': 1, 'test/sharness/t0271-filestore-utils.sh': 1, 'test/sharness/t0272-urlstore.sh': 1, 'plugin/loader/loader.go': 9, 'core/corehttp/ipns_hostname.go': 8, 'namesys/dns_test.go': 8, 'plugin/daemon.go': 8, 'core/corerepo/stat.go': 2, 'core/corehttp/metrics.go': 1, 'core/corehttp/proxy_test.go': 1, 'plugin/tracer.go': 1, 'thirdparty/notifier/notifier.go': 1, 'namesys/resolve/pathresolver_test.go': 1, 'namesys/resolve/resolve.go': 1, 'README.md': 2, 'go.mod': 1, 'go.sum': 1, 'package-list.json': 1, 'core/commands/pin/pin.go': 1, 'core/commands/stat_dht.go': 1}","('core/commands/dag/dag.go', 0.9210526315789473, 0.5833333333333334)"
core/commands/version.go,77,475,2,"[{'cyclomatic_complexity': 1, 'nloc': 9, 'token_count': 66, 'name': '', 'long_name': '(req cmds.Request,res cmds.Response)', 'start_line': 34, 'end_line': 42, 'full_parameters': [], 'filename': '/home/dimi/Documents/Informatik_Studium/FSS/SoftEvo/DataCollection/FFS_SoftEvo/go-ipfs/core/commands/version.go', 'top_nesting_level': 0, 'length': 9, 'fan_in': 0, 'fan_out': 0, 'general_fan_out': 0}, {'cyclomatic_complexity': 9, 'nloc': 36, 'token_count': 264, 'name': '', 'long_name': '(res cmds.Response)(io.Reader,error)', 'start_line': 44, 'end_line': 85, 'full_parameters': [], 'filename': '/home/dimi/Documents/Informatik_Studium/FSS/SoftEvo/DataCollection/FFS_SoftEvo/go-ipfs/core/commands/version.go', 'top_nesting_level': 0, 'length': 42, 'fan_in': 0, 'fan_out': 0, 'general_fan_out': 0}]",135,784,2,"[{'cyclomatic_complexity': 1, 'nloc': 9, 'token_count': 56, 'name': 'getVersionInfo', 'long_name': 'getVersionInfo', 'start_line': 31, 'end_line': 39, 'full_parameters': [], 'filename': '/home/dimi/Documents/Informatik_Studium/FSS/SoftEvo/DataCollection/FFS_SoftEvo/go-ipfs/core/commands/version.go', 'top_nesting_level': 0, 'length': 9, 'fan_in': 0, 'fan_out': 0, 'general_fan_out': 0}, {'cyclomatic_complexity': 2, 'nloc': 9, 'token_count': 66, 'name': '', 'long_name': '(mod*debug.Module)(dep Dependency)', 'start_line': 123, 'end_line': 131, 'full_parameters': [], 'filename': '/home/dimi/Documents/Informatik_Studium/FSS/SoftEvo/DataCollection/FFS_SoftEvo/go-ipfs/core/commands/version.go', 'top_nesting_level': 0, 'length': 9, 'fan_in': 0, 'fan_out': 0, 'general_fan_out': 0}]",58,309,0,41,41,"[{'timestamp': 1491058697.0, 'added_lines': 22, 'deleted_lines': 12, 'nloc': 86}, {'timestamp': 1499331469.0, 'added_lines': 4, 'deleted_lines': 4, 'nloc': 86}, {'timestamp': 1511223906.0, 'added_lines': 1, 'deleted_lines': 1, 'nloc': 86}, {'timestamp': 1512365669.0, 'added_lines': 1, 'deleted_lines': 1, 'nloc': 86}, {'timestamp': 1511187070.0, 'added_lines': 1, 'deleted_lines': 1, 'nloc': 86}, {'timestamp': 1513436097.0, 'added_lines': 1, 'deleted_lines': 1, 'nloc': 86}, {'timestamp': 1513612261.0, 'added_lines': 1, 'deleted_lines': 1, 'nloc': 86}, {'timestamp': 1515277696.0, 'added_lines': 1, 'deleted_lines': 1, 'nloc': 86}, {'timestamp': 1528520460.0, 'added_lines': 1, 'deleted_lines': 1, 'nloc': 86}, {'timestamp': 1532357069.0, 'added_lines': 2, 'deleted_lines': 1, 'nloc': 86}, {'timestamp': 1532365899.0, 'added_lines': 3, 'deleted_lines': 3, 'nloc': 86}, {'timestamp': 1532507240.0, 'added_lines': 3, 'deleted_lines': 3, 'nloc': 86}, {'timestamp': 1533946888.0, 'added_lines': 1, 'deleted_lines': 1, 'nloc': 86}, {'timestamp': 1534896611.0, 'added_lines': 1, 'deleted_lines': 1, 'nloc': 86}, {'timestamp': 1538662493.0, 'added_lines': 15, 'deleted_lines': 8, 'nloc': 92}, {'timestamp': 1539850591.0, 'added_lines': 1, 'deleted_lines': 1, 'nloc': 92}, {'timestamp': 1540540339.0, 'added_lines': 18, 'deleted_lines': 39, 'nloc': 74}, {'timestamp': 1540558290.0, 'added_lines': 1, 'deleted_lines': 1, 'nloc': 74}, {'timestamp': 1540597832.0, 'added_lines': 1, 'deleted_lines': 1, 'nloc': 74}, {'timestamp': 1540906996.0, 'added_lines': 1, 'deleted_lines': 1, 'nloc': 74}, {'timestamp': 1541157833.0, 'added_lines': 12, 'deleted_lines': 12, 'nloc': 74}, {'timestamp': 1541204121.0, 'added_lines': 1, 'deleted_lines': 1, 'nloc': 74}, {'timestamp': 1544661332.0, 'added_lines': 1, 'deleted_lines': 1, 'nloc': 74}, {'timestamp': 1540556089.0, 'added_lines': 1, 'deleted_lines': 1, 'nloc': 74}, {'timestamp': 1547152271.0, 'added_lines': 1, 'deleted_lines': 1, 'nloc': 74}, {'timestamp': 1548866534.0, 'added_lines': 1, 'deleted_lines': 1, 'nloc': 74}, {'timestamp': 1549903582.0, 'added_lines': 1, 'deleted_lines': 1, 'nloc': 74}, {'timestamp': 1550507829.0, 'added_lines': 1, 'deleted_lines': 1, 'nloc': 74}, {'timestamp': 1550610741.0, 'added_lines': 1, 'deleted_lines': 1, 'nloc': 74}, {'timestamp': 1551138343.0, 'added_lines': 1, 'deleted_lines': 1, 'nloc': 74}, {'timestamp': 1551299964.0, 'added_lines': 1, 'deleted_lines': 1, 'nloc': 74}, {'timestamp': 1551471469.0, 'added_lines': 1, 'deleted_lines': 1, 'nloc': 74}, {'timestamp': 1551551196.0, 'added_lines': 2, 'deleted_lines': 2, 'nloc': 74}, {'timestamp': 1553170374.0, 'added_lines': 53, 'deleted_lines': 1, 'nloc': 123}, {'timestamp': 1553202382.0, 'added_lines': 7, 'deleted_lines': 3, 'nloc': 127}, {'timestamp': 1553714498.0, 'added_lines': 4, 'deleted_lines': 2, 'nloc': 128}, {'timestamp': 1557554420.0, 'added_lines': 7, 'deleted_lines': 8, 'nloc': 127}, {'timestamp': 1566973868.0, 'added_lines': 12, 'deleted_lines': 8, 'nloc': 131}, {'timestamp': 1595277534.0, 'added_lines': 2, 'deleted_lines': 0, 'nloc': 132}, {'timestamp': 1616604074.0, 'added_lines': 3, 'deleted_lines': 3, 'nloc': 132}, {'timestamp': 1626906900.0, 'added_lines': 11, 'deleted_lines': 7, 'nloc': 135}]","{'blocks/blockstore/caching.go': 1, 'blocks/blockstore/util/remove.go': 2, 'cmd/ipfs/daemon.go': 28, 'cmd/ipfs/init.go': 29, 'cmd/ipfs/ipfs.go': 24, 'cmd/ipfs/main.go': 27, 'cmd/ipfs/main_test.go': 4, 'cmd/ipfswatch/main.go': 13, 'cmd/seccat/seccat.go': 8, None: 13, 'commands/channelmarshaler.go': 1, 'commands/cli/cmd_suggestion.go': 1, 'commands/cli/helptext.go': 2, 'commands/cli/helptext_test.go': 2, 'commands/cli/parse.go': 2, 'commands/cli/parse_test.go': 2, 'commands/command.go': 12, 'commands/command_test.go': 7, 'commands/http/client.go': 2, 'commands/http/handler.go': 2, 'commands/http/multifilereader.go': 2, 'commands/http/multifilereader_test.go': 2, 'commands/http/parse.go': 2, 'commands/reqlog.go': 1, 'commands/request.go': 15, 'commands/response.go': 11, 'commands/response_test.go': 7, 'core/bootstrap.go': 10, 'core/commands/active.go': 26, 'core/commands/add.go': 26, 'core/commands/bitswap.go': 26, 'core/commands/block.go': 27, 'core/commands/bootstrap.go': 27, 'core/commands/cat.go': 26, 'core/commands/commands.go': 27, 'core/commands/config.go': 30, 'core/commands/dag/dag.go': 28, 'core/commands/dht.go': 26, 'core/commands/diag.go': 23, 'core/commands/dns.go': 29, 'core/commands/e/error.go': 1, 'core/commands/external.go': 24, 'core/commands/files/files.go': 8, 'core/commands/filestore.go': 26, 'core/commands/get.go': 27, 'core/commands/helptext_test.go': 23, 'core/commands/id.go': 27, 'core/commands/ipns.go': 11, 'core/commands/keystore.go': 28, 'core/commands/log.go': 25, 'core/commands/ls.go': 26, 'core/commands/mount_nofuse.go': 23, 'core/commands/mount_unix.go': 26, 'core/commands/mount_windows.go': 22, 'core/commands/name.go': 10, 'core/commands/object/diff.go': 25, 'core/commands/object/object.go': 27, 'core/commands/object/patch.go': 27, 'core/commands/p2p.go': 27, 'core/commands/pin.go': 26, 'core/commands/ping.go': 25, 'core/commands/publish.go': 10, 'core/commands/pubsub.go': 27, 'core/commands/refs.go': 26, 'core/commands/repo.go': 30, 'core/commands/resolve.go': 27, 'core/commands/root.go': 29, 'core/commands/shutdown.go': 26, 'core/commands/stat.go': 29, 'core/commands/swarm.go': 29, 'core/commands/sysdiag.go': 27, 'core/commands/tar.go': 28, 'core/commands/unixfs/ls.go': 24, 'core/commands/unixfs/unixfs.go': 23, 'core/core_test.go': 6, 'core/corehttp/commands.go': 27, 'core/corehttp/gateway.go': 13, 'core/coreunix/add.go': 18, 'core/coreunix/add_test.go': 19, 'core/coreunix/metadata_test.go': 13, 'exchange/bitswap/bitswap_test.go': 4, 'exchange/bitswap/decision/engine_test.go': 4, 'exchange/bitswap/message/message_test.go': 3, 'exchange/bitswap/message/pb/Makefile': 1, 'exchange/bitswap/testnet/network_test.go': 4, 'exchange/bitswap/testnet/peernet.go': 4, 'exchange/reprovide/reprovide_test.go': 8, 'fuse/ipns/common.go': 11, 'fuse/node/mount_test.go': 8, 'importer/balanced/balanced_test.go': 3, 'importer/chunk/rabin_test.go': 2, 'importer/helpers/dagbuilder.go': 8, 'importer/importer.go': 8, 'merkledag/utils/utils_test.go': 3, 'mfs/repub_test.go': 4, 'namesys/dns.go': 7, 'namesys/interface.go': 7, 'namesys/ipns_select_test.go': 3, 'namesys/proquint.go': 7, 'namesys/republisher/repub_test.go': 9, 'package.json': 25, 'repo/config/identity.go': 1, 'routing/offline/offline_test.go': 3, 'test/integration/addcat_test.go': 12, 'test/integration/bench_cat_test.go': 11, 'test/integration/bitswap_wo_routing_test.go': 9, 'test/integration/three_legged_cat_test.go': 11, 'core/bootstrap_test.go': 8, 'core/commands/dht_test.go': 7, 'core/commands/get_test.go': 24, 'core/core.go': 17, 'core/corehttp/gateway_test.go': 12, 'core/corehttp/metrics_test.go': 8, 'core/mock/mock.go': 9, 'exchange/bitswap/decision/bench_test.go': 3, 'exchange/bitswap/decision/peer_request_queue_test.go': 3, 'exchange/bitswap/message/message.go': 3, 'exchange/bitswap/network/interface.go': 3, 'exchange/bitswap/network/ipfs_impl.go': 3, 'exchange/bitswap/testnet/interface.go': 3, 'exchange/bitswap/testnet/virtual.go': 3, 'exchange/bitswap/testutils.go': 3, 'fuse/ipns/ipns_test.go': 7, 'fuse/readonly/ipfs_test.go': 13, 'namesys/publisher_test.go': 7, 'namesys/resolve_test.go': 8, 'p2p/p2p.go': 7, 'p2p/registry.go': 4, 'repo/config/bootstrap_peers.go': 3, 'routing/mock/centralized_client.go': 2, 'routing/mock/centralized_server.go': 2, 'routing/mock/centralized_test.go': 2, 'routing/mock/interface.go': 2, 'routing/none/none_client.go': 2, 'test/integration/bench_test.go': 7, 'assets/assets.go': 12, 'blocks/blockstore/arc_cache.go': 1, 'blocks/blockstore/arc_cache_test.go': 1, 'blocks/blockstore/blockstore.go': 1, 'blocks/blockstore/blockstore_test.go': 1, 'blocks/blockstore/bloom_cache.go': 1, 'blocks/blockstore/bloom_cache_test.go': 1, 'blocks/blocksutil/block_generator.go': 1, 'blockservice/blockservice.go': 2, 'blockservice/blockservice_test.go': 2, 'blockservice/test/blocks_test.go': 2, 'core/builder.go': 14, 'core/commands/ipnsps.go': 7, 'core/coreapi/coreapi.go': 7, 'core/coreapi/interface/interface.go': 1, 'core/coreapi/unixfs.go': 13, 'core/coreapi/unixfs_test.go': 8, 'core/coredag/cbor.go': 5, 'core/coredag/dagpb.go': 7, 'core/coredag/dagtransl.go': 5, 'core/coredag/raw.go': 7, 'core/corehttp/corehttp.go': 5, 'core/corehttp/gateway_handler.go': 13, 'core/corerepo/gc.go': 12, 'core/corerepo/pinning.go': 5, 'core/coreunix/metadata.go': 12, 'core/pathresolver.go': 7, 'exchange/bitswap/bitswap.go': 2, 'exchange/bitswap/decision/engine.go': 2, 'exchange/bitswap/decision/ledger.go': 2, 'exchange/bitswap/decision/peer_request_queue.go': 2, 'exchange/bitswap/get.go': 2, 'exchange/bitswap/notifications/notifications.go': 2, 'exchange/bitswap/notifications/notifications_test.go': 2, 'exchange/bitswap/session.go': 2, 'exchange/bitswap/session_test.go': 2, 'exchange/bitswap/stat.go': 2, 'exchange/bitswap/wantlist/wantlist.go': 2, 'exchange/bitswap/wantlist/wantlist_test.go': 2, 'exchange/bitswap/wantmanager.go': 2, 'exchange/bitswap/workers.go': 2, 'exchange/interface.go': 1, 'exchange/offline/offline.go': 1, 'exchange/offline/offline_test.go': 1, 'exchange/reprovide/providers.go': 7, 'exchange/reprovide/reprovide.go': 6, 'filestore/filestore.go': 6, 'filestore/filestore_test.go': 7, 'filestore/fsrefstore.go': 6, 'filestore/util.go': 6, 'fuse/ipns/ipns_unix.go': 12, 'fuse/readonly/readonly_unix.go': 12, 'importer/balanced/builder.go': 2, 'importer/chunk/splitting_test.go': 1, 'importer/helpers/helpers.go': 2, 'importer/importer_test.go': 2, 'importer/trickle/trickle_test.go': 2, 'importer/trickle/trickledag.go': 2, 'merkledag/batch.go': 1, 'merkledag/coding.go': 2, 'merkledag/merkledag.go': 2, 'merkledag/merkledag_test.go': 2, 'merkledag/node.go': 2, 'merkledag/node_test.go': 2, 'merkledag/raw.go': 2, 'merkledag/traverse/traverse.go': 2, 'merkledag/traverse/traverse_test.go': 2, 'merkledag/utils/diff.go': 2, 'merkledag/utils/diffenum.go': 2, 'merkledag/utils/diffenum_test.go': 2, 'merkledag/utils/utils.go': 2, 'mfs/dir.go': 3, 'mfs/file.go': 3, 'mfs/mfs_test.go': 3, 'mfs/ops.go': 2, 'mfs/system.go': 3, 'namesys/namesys.go': 8, 'namesys/publisher.go': 12, 'namesys/pubsub.go': 1, 'namesys/pubsub_test.go': 1, 'namesys/republisher/repub.go': 7, 'namesys/routing.go': 8, 'path/path.go': 2, 'path/resolver.go': 1, 'path/resolver_test.go': 1, 'pin/gc/gc.go': 7, 'pin/pin.go': 7, 'pin/pin_test.go': 7, 'pin/set.go': 7, 'pin/set_test.go': 7, 'plugin/ipld.go': 5, 'plugin/loader/initializer.go': 4, 'plugin/plugins/git/git.go': 5, 'repo/config/init.go': 2, 'repo/fsrepo/fsrepo.go': 8, 'repo/fsrepo/lock/lock.go': 1, 'repo/fsrepo/serialize/serialize.go': 2, 'repo/mock.go': 8, 'repo/repo.go': 8, 'routing/offline/offline.go': 1, 'tar/format.go': 12, 'test/dependencies/ma-pipe-unidir/main.go': 4, 'thirdparty/ds-help/key.go': 1, 'thirdparty/pollEndpoint/main.go': 5, 'thirdparty/posinfo/posinfo.go': 1, 'unixfs/archive/archive.go': 2, 'unixfs/archive/tar/writer.go': 2, 'unixfs/hamt/hamt.go': 2, 'unixfs/io/dagreader.go': 2, 'unixfs/io/dirbuilder.go': 2, 'unixfs/io/resolve.go': 2, 'unixfs/mod/dagmodifier.go': 2, 'unixfs/mod/dagmodifier_test.go': 2, 'unixfs/test/utils.go': 2, 'commands/legacy/command.go': 9, 'commands/legacy/legacy.go': 9, 'commands/legacy/legacy_test.go': 10, 'commands/legacy/request.go': 10, 'commands/legacy/response.go': 10, 'commands/legacy/responseemitter.go': 4, 'core/commands/env.go': 5, 'TODO.md': 2, 'core/commands/commands_test.go': 20, 'test/sharness/t0110-gateway.sh': 1, 'test/sharness/t0410-api-add.sh': 1, 'blocks/blockstoreutil/remove.go': 5, 'blockservice/test/mock.go': 1, 'cmd/ipfs/util/ulimit.go': 4, 'cmd/ipfs/util/ulimit_freebsd.go': 2, 'cmd/ipfs/util/ulimit_unix.go': 2, 'cmd/seccat/util.go': 4, 'core/commands/files.go': 20, 'core/coreapi/block.go': 7, 'core/coreapi/block_test.go': 2, 'core/coreapi/dag.go': 4, 'core/coreapi/dag_test.go': 2, 'core/coreapi/interface/coreapi.go': 3, 'core/coreapi/interface/dag.go': 3, 'core/coreapi/interface/object.go': 3, 'core/coreapi/interface/options/block.go': 2, 'core/coreapi/interface/options/dag.go': 3, 'core/coreapi/interface/path.go': 3, 'core/coreapi/interface/unixfs.go': 6, 'core/coreapi/key.go': 7, 'core/coreapi/name.go': 7, 'core/coreapi/object.go': 11, 'core/coreapi/pin.go': 7, 'core/corehttp/logs.go': 4, 'fuse/ipns/link_unix.go': 2, 'fuse/mount/fuse.go': 2, 'fuse/mount/mount.go': 4, 'fuse/node/mount_darwin.go': 2, 'fuse/node/mount_unix.go': 4, 'keystore/keystore.go': 4, 'merkledag/errservice.go': 1, 'merkledag/readonly.go': 1, 'merkledag/readonly_test.go': 1, 'merkledag/rwservice.go': 1, 'merkledag/session.go': 1, 'merkledag/test/utils.go': 1, 'namesys/ipns_validate_test.go': 1, 'namesys/namesys_test.go': 11, 'namesys/validator.go': 1, 'path/resolver/resolver.go': 1, 'path/resolver/resolver_test.go': 1, 'plugin/loader/load.go': 2, 'repo/fsrepo/datastores.go': 4, 'thirdparty/verifbs/verifbs.go': 5, 'thirdparty/verifcid/validate.go': 1, 'thirdparty/verifcid/validate_test.go': 1, 'unixfs/hamt/hamt_stress_test.go': 1, 'unixfs/hamt/hamt_test.go': 1, 'unixfs/io/pbdagreader.go': 1, 'repo/fsrepo/misc.go': 6, 'cmd/ipfs/Rules.mk': 1, 'core/corehttp/option_test.go': 2, 'docs/releases.md': 2, 'docs/windows.md': 2, 'repo/fsrepo/config_test.go': 5, 'repo/fsrepo/fsrepo_test.go': 5, 'repo/version.go': 1, 'test/bench/bench_cli_ipfs_add/main.go': 6, 'test/bench/offline_add/main.go': 6, 'version.go': 1, 'core/commands/urlstore.go': 17, 'core/coreapi/path.go': 10, 'core/coreunix/cat.go': 2, 'mfs/fd.go': 1, 'core/coreapi/interface/key.go': 2, 'core/coreapi/name_test.go': 4, 'core/pathresolver_test.go': 5, 'dagutils/diff.go': 6, 'dagutils/diffenum.go': 5, 'dagutils/diffenum_test.go': 5, 'dagutils/utils.go': 5, 'dagutils/utils_test.go': 5, 'namesys/base.go': 6, 'namesys/cache.go': 5, 'namesys/ipns_resolver_validation_test.go': 6, 'thirdparty/cidv0v1/blockstore.go': 4, 'core/commands/cid.go': 17, 'core/commands/cmdenv/env.go': 14, 'core/commands/name/ipns.go': 15, 'core/commands/name/ipnsps.go': 16, 'core/commands/name/name.go': 15, 'core/commands/name/publish.go': 15, 'core/coreapi/unixfile.go': 3, 'cmd/ipfs/dnsresolve_test.go': 2, 'core/coreapi/dht.go': 5, 'core/coreapi/dht_test.go': 1, 'core/coreapi/interface/dht.go': 1, 'core/coreapi/interface/options/unixfs.go': 1, 'core/coreapi/interface/pubsub.go': 1, 'core/coreapi/interface/swarm.go': 1, 'core/coreapi/pubsub.go': 5, 'core/coreapi/swarm.go': 5, 'keystore/keystore_test.go': 3, 'keystore/memkeystore.go': 3, 'p2p/listener.go': 3, 'p2p/local.go': 3, 'p2p/remote.go': 3, 'p2p/stream.go': 3, 'test/dependencies/iptb/iptb.go': 4, 'commands/context.go': 11, 'core/commands/cmdenv/cidbase.go': 9, 'core/commands/cmdenv/file.go': 3, 'core/coreapi/interface/tests/name.go': 1, 'core/coreapi/interface/tests/unixfs.go': 1, 'core/coreapi/test/api_test.go': 4, 'core/corehttp/ipns_hostname.go': 4, 'namesys/dns_test.go': 4, 'plugin/daemon.go': 4, 'plugin/loader/loader.go': 4, 'core/corehttp/proxy.go': 3, 'filestore/pb/dataobj.pb.go': 2, 'pin/internal/pb/header.pb.go': 2, 'plugin/plugins/badgerds/badgerds.go': 3, 'plugin/plugins/flatfs/flatfs.go': 3, 'plugin/plugins/levelds/levelds.go': 2, 'core/corerepo/stat.go': 2, 'core/commands/cmdenv/cidbase_test.go': 1, 'core/corehttp/metrics.go': 1, 'core/corehttp/proxy_test.go': 1, 'plugin/tracer.go': 1, 'thirdparty/notifier/notifier.go': 1, 'test/sharness/t0010-basic-commands.sh': 1, 'test/sharness/t0060-daemon.sh': 1, 'README.md': 2, 'go.mod': 2, 'go.sum': 2, 'package-list.json': 1, 'cmd/ipfs/rotate.go': 1, 'core/commands/extra.go': 1, 'core/commands/pin/pin.go': 1, 'core/commands/stat_dht.go': 1, 'core/commands/profile.go': 1}","('core/commands/config.go', 0.7317073170731707, 0.37037037037037035)"
core/commands/dag/dag.go,210,1319,5,"[{'cyclomatic_complexity': 14, 'nloc': 63, 'token_count': 416, 'name': '', 'long_name': '(req cmds.Request,res cmds.Response)', 'start_line': 64, 'end_line': 139, 'full_parameters': [], 'filename': '/home/dimi/Documents/Informatik_Studium/FSS/SoftEvo/DataCollection/FFS_SoftEvo/go-ipfs/core/commands/dag/dag.go', 'top_nesting_level': 0, 'length': 76, 'fan_in': 0, 'fan_out': 0, 'general_fan_out': 0}, {'cyclomatic_complexity': 2, 'nloc': 7, 'token_count': 59, 'name': '', 'long_name': '(res cmds.Response)(io.Reader,error)', 'start_line': 142, 'end_line': 149, 'full_parameters': [], 'filename': '/home/dimi/Documents/Informatik_Studium/FSS/SoftEvo/DataCollection/FFS_SoftEvo/go-ipfs/core/commands/dag/dag.go', 'top_nesting_level': 0, 'length': 8, 'fan_in': 0, 'fan_out': 0, 'general_fan_out': 0}, {'cyclomatic_complexity': 6, 'nloc': 27, 'token_count': 169, 'name': '', 'long_name': '(req cmds.Request,res cmds.Response)', 'start_line': 163, 'end_line': 193, 'full_parameters': [], 'filename': '/home/dimi/Documents/Informatik_Studium/FSS/SoftEvo/DataCollection/FFS_SoftEvo/go-ipfs/core/commands/dag/dag.go', 'top_nesting_level': 0, 'length': 31, 'fan_in': 0, 'fan_out': 0, 'general_fan_out': 0}, {'cyclomatic_complexity': 4, 'nloc': 21, 'token_count': 141, 'name': '', 'long_name': '(req cmds.Request,res cmds.Response)', 'start_line': 207, 'end_line': 230, 'full_parameters': [], 'filename': '/home/dimi/Documents/Informatik_Studium/FSS/SoftEvo/DataCollection/FFS_SoftEvo/go-ipfs/core/commands/dag/dag.go', 'top_nesting_level': 0, 'length': 24, 'fan_in': 0, 'fan_out': 0, 'general_fan_out': 0}, {'cyclomatic_complexity': 2, 'nloc': 10, 'token_count': 80, 'name': '', 'long_name': '(res cmds.Response)(io.Reader,error)', 'start_line': 232, 'end_line': 243, 'full_parameters': [], 'filename': '/home/dimi/Documents/Informatik_Studium/FSS/SoftEvo/DataCollection/FFS_SoftEvo/go-ipfs/core/commands/dag/dag.go', 'top_nesting_level': 0, 'length': 12, 'fan_in': 0, 'fan_out': 0, 'general_fan_out': 0}]",271,1598,0,[],61,279,-5,120,120,"[{'timestamp': 1491058697.0, 'added_lines': 57, 'deleted_lines': 44, 'nloc': 245}, {'timestamp': 1499331469.0, 'added_lines': 1, 'deleted_lines': 1, 'nloc': 245}, {'timestamp': 1511223906.0, 'added_lines': 2, 'deleted_lines': 2, 'nloc': 245}, {'timestamp': 1511245249.0, 'added_lines': 3, 'deleted_lines': 3, 'nloc': 245}, {'timestamp': 1512365669.0, 'added_lines': 4, 'deleted_lines': 4, 'nloc': 245}, {'timestamp': 1511187070.0, 'added_lines': 2, 'deleted_lines': 2, 'nloc': 245}, {'timestamp': 1512671605.0, 'added_lines': 3, 'deleted_lines': 0, 'nloc': 247}, {'timestamp': 1513436097.0, 'added_lines': 2, 'deleted_lines': 2, 'nloc': 247}, {'timestamp': 1513612261.0, 'added_lines': 2, 'deleted_lines': 2, 'nloc': 247}, {'timestamp': 1515277696.0, 'added_lines': 2, 'deleted_lines': 2, 'nloc': 247}, {'timestamp': 1516838128.0, 'added_lines': 2, 'deleted_lines': 2, 'nloc': 247}, {'timestamp': 1516911711.0, 'added_lines': 3, 'deleted_lines': 2, 'nloc': 248}, {'timestamp': 1517255734.0, 'added_lines': 2, 'deleted_lines': 2, 'nloc': 248}, {'timestamp': 1517453697.0, 'added_lines': 1, 'deleted_lines': 1, 'nloc': 248}, {'timestamp': 1521421769.0, 'added_lines': 0, 'deleted_lines': 3, 'nloc': 246}, {'timestamp': 1521427288.0, 'added_lines': 1, 'deleted_lines': 1, 'nloc': 248}, {'timestamp': 1526121342.0, 'added_lines': 6, 'deleted_lines': 1, 'nloc': 250}, {'timestamp': 1528520460.0, 'added_lines': 5, 'deleted_lines': 5, 'nloc': 250}, {'timestamp': 1531779409.0, 'added_lines': 2, 'deleted_lines': 2, 'nloc': 250}, {'timestamp': 1532847462.0, 'added_lines': 1, 'deleted_lines': 1, 'nloc': 250}, {'timestamp': 1533500571.0, 'added_lines': 1, 'deleted_lines': 1, 'nloc': 250}, {'timestamp': 1533618653.0, 'added_lines': 1, 'deleted_lines': 1, 'nloc': 250}, {'timestamp': 1533618690.0, 'added_lines': 8, 'deleted_lines': 3, 'nloc': 255}, {'timestamp': 1533779477.0, 'added_lines': 1, 'deleted_lines': 1, 'nloc': 255}, {'timestamp': 1533946888.0, 'added_lines': 2, 'deleted_lines': 2, 'nloc': 255}, {'timestamp': 1534115707.0, 'added_lines': 3, 'deleted_lines': 3, 'nloc': 255}, {'timestamp': 1534195762.0, 'added_lines': 1, 'deleted_lines': 1, 'nloc': 255}, {'timestamp': 1534347022.0, 'added_lines': 3, 'deleted_lines': 3, 'nloc': 255}, {'timestamp': 1534896611.0, 'added_lines': 5, 'deleted_lines': 5, 'nloc': 255}, {'timestamp': 1535601896.0, 'added_lines': 1, 'deleted_lines': 1, 'nloc': 255}, {'timestamp': 1536388808.0, 'added_lines': 1, 'deleted_lines': 1, 'nloc': 255}, {'timestamp': 1536718784.0, 'added_lines': 6, 'deleted_lines': 6, 'nloc': 255}, {'timestamp': 1536723292.0, 'added_lines': 1, 'deleted_lines': 1, 'nloc': 255}, {'timestamp': 1537790637.0, 'added_lines': 1, 'deleted_lines': 1, 'nloc': 255}, {'timestamp': 1537792589.0, 'added_lines': 1, 'deleted_lines': 1, 'nloc': 255}, {'timestamp': 1538544957.0, 'added_lines': 1, 'deleted_lines': 1, 'nloc': 255}, {'timestamp': 1538694687.0, 'added_lines': 1, 'deleted_lines': 1, 'nloc': 255}, {'timestamp': 1538695953.0, 'added_lines': 1, 'deleted_lines': 1, 'nloc': 255}, {'timestamp': 1538773916.0, 'added_lines': 1, 'deleted_lines': 1, 'nloc': 255}, {'timestamp': 1539176817.0, 'added_lines': 1, 'deleted_lines': 1, 'nloc': 255}, {'timestamp': 1539357340.0, 'added_lines': 1, 'deleted_lines': 1, 'nloc': 255}, {'timestamp': 1539850591.0, 'added_lines': 4, 'deleted_lines': 3, 'nloc': 255}, {'timestamp': 1540400358.0, 'added_lines': 1, 'deleted_lines': 1, 'nloc': 255}, {'timestamp': 1540410565.0, 'added_lines': 1, 'deleted_lines': 1, 'nloc': 255}, {'timestamp': 1540418491.0, 'added_lines': 1, 'deleted_lines': 1, 'nloc': 255}, {'timestamp': 1540572324.0, 'added_lines': 62, 'deleted_lines': 91, 'nloc': 231}, {'timestamp': 1540597832.0, 'added_lines': 1, 'deleted_lines': 1, 'nloc': 231}, {'timestamp': 1540583852.0, 'added_lines': 37, 'deleted_lines': 60, 'nloc': 214}, {'timestamp': 1540583905.0, 'added_lines': 0, 'deleted_lines': 15, 'nloc': 203}, {'timestamp': 1540584128.0, 'added_lines': 4, 'deleted_lines': 3, 'nloc': 204}, {'timestamp': 1540603818.0, 'added_lines': 2, 'deleted_lines': 2, 'nloc': 204}, {'timestamp': 1540568776.0, 'added_lines': 1, 'deleted_lines': 1, 'nloc': 204}, {'timestamp': 1540906996.0, 'added_lines': 2, 'deleted_lines': 2, 'nloc': 204}, {'timestamp': 1540916861.0, 'added_lines': 1, 'deleted_lines': 1, 'nloc': 204}, {'timestamp': 1541189794.0, 'added_lines': 1, 'deleted_lines': 1, 'nloc': 204}, {'timestamp': 1541204121.0, 'added_lines': 5, 'deleted_lines': 5, 'nloc': 204}, {'timestamp': 1541903826.0, 'added_lines': 1, 'deleted_lines': 1, 'nloc': 204}, {'timestamp': 1543443696.0, 'added_lines': 1, 'deleted_lines': 1, 'nloc': 204}, {'timestamp': 1544225843.0, 'added_lines': 1, 'deleted_lines': 1, 'nloc': 204}, {'timestamp': 1544661332.0, 'added_lines': 1, 'deleted_lines': 1, 'nloc': 204}, {'timestamp': 1540556089.0, 'added_lines': 1, 'deleted_lines': 1, 'nloc': 204}, {'timestamp': 1540562190.0, 'added_lines': 1, 'deleted_lines': 1, 'nloc': 204}, {'timestamp': 1542594282.0, 'added_lines': 8, 'deleted_lines': 9, 'nloc': 205}, {'timestamp': 1543031503.0, 'added_lines': 1, 'deleted_lines': 1, 'nloc': 205}, {'timestamp': 1543514086.0, 'added_lines': 1, 'deleted_lines': 1, 'nloc': 205}, {'timestamp': 1543868676.0, 'added_lines': 3, 'deleted_lines': 2, 'nloc': 206}, {'timestamp': 1544737281.0, 'added_lines': 3, 'deleted_lines': 3, 'nloc': 206}, {'timestamp': 1544785510.0, 'added_lines': 3, 'deleted_lines': 2, 'nloc': 207}, {'timestamp': 1547003974.0, 'added_lines': 1, 'deleted_lines': 1, 'nloc': 207}, {'timestamp': 1547152271.0, 'added_lines': 1, 'deleted_lines': 1, 'nloc': 207}, {'timestamp': 1542878205.0, 'added_lines': 13, 'deleted_lines': 2, 'nloc': 218}, {'timestamp': 1548089993.0, 'added_lines': 19, 'deleted_lines': 6, 'nloc': 229}, {'timestamp': 1548187279.0, 'added_lines': 18, 'deleted_lines': 28, 'nloc': 220}, {'timestamp': 1547499910.0, 'added_lines': 2, 'deleted_lines': 2, 'nloc': 220}, {'timestamp': 1548866534.0, 'added_lines': 2, 'deleted_lines': 2, 'nloc': 220}, {'timestamp': 1549588289.0, 'added_lines': 1, 'deleted_lines': 1, 'nloc': 220}, {'timestamp': 1549672857.0, 'added_lines': 1, 'deleted_lines': 1, 'nloc': 220}, {'timestamp': 1549673846.0, 'added_lines': 1, 'deleted_lines': 1, 'nloc': 220}, {'timestamp': 1549903582.0, 'added_lines': 3, 'deleted_lines': 3, 'nloc': 220}, {'timestamp': 1550185115.0, 'added_lines': 2, 'deleted_lines': 2, 'nloc': 220}, {'timestamp': 1550507829.0, 'added_lines': 3, 'deleted_lines': 3, 'nloc': 220}, {'timestamp': 1550576884.0, 'added_lines': 1, 'deleted_lines': 1, 'nloc': 220}, {'timestamp': 1550610741.0, 'added_lines': 1, 'deleted_lines': 1, 'nloc': 220}, {'timestamp': 1550711994.0, 'added_lines': 2, 'deleted_lines': 2, 'nloc': 220}, {'timestamp': 1550723346.0, 'added_lines': 5, 'deleted_lines': 5, 'nloc': 220}, {'timestamp': 1551138343.0, 'added_lines': 1, 'deleted_lines': 1, 'nloc': 220}, {'timestamp': 1551229859.0, 'added_lines': 2, 'deleted_lines': 2, 'nloc': 220}, {'timestamp': 1551299964.0, 'added_lines': 3, 'deleted_lines': 3, 'nloc': 220}, {'timestamp': 1551471469.0, 'added_lines': 1, 'deleted_lines': 1, 'nloc': 220}, {'timestamp': 1551551196.0, 'added_lines': 9, 'deleted_lines': 9, 'nloc': 220}, {'timestamp': 1553529899.0, 'added_lines': 2, 'deleted_lines': 12, 'nloc': 212}, {'timestamp': 1553608614.0, 'added_lines': 3, 'deleted_lines': 4, 'nloc': 211}, {'timestamp': 1553609463.0, 'added_lines': 2, 'deleted_lines': 2, 'nloc': 211}, {'timestamp': 1553615181.0, 'added_lines': 2, 'deleted_lines': 1, 'nloc': 212}, {'timestamp': 1557554420.0, 'added_lines': 15, 'deleted_lines': 16, 'nloc': 211}, {'timestamp': 1583334674.0, 'added_lines': 108, 'deleted_lines': 1, 'nloc': 275}, {'timestamp': 1585237100.0, 'added_lines': 1, 'deleted_lines': 1, 'nloc': 275}, {'timestamp': 1585288577.0, 'added_lines': 6, 'deleted_lines': 18, 'nloc': 268}, {'timestamp': 1585288668.0, 'added_lines': 1, 'deleted_lines': 1, 'nloc': 268}, {'timestamp': 1585288977.0, 'added_lines': 0, 'deleted_lines': 1, 'nloc': 267}, {'timestamp': 1585292251.0, 'added_lines': 10, 'deleted_lines': 1, 'nloc': 273}, {'timestamp': 1585333448.0, 'added_lines': 7, 'deleted_lines': 18, 'nloc': 277}, {'timestamp': 1585333599.0, 'added_lines': 1, 'deleted_lines': 1, 'nloc': 277}, {'timestamp': 1585333951.0, 'added_lines': 2, 'deleted_lines': 1, 'nloc': 277}, {'timestamp': 1585335236.0, 'added_lines': 1, 'deleted_lines': 0, 'nloc': 278}, {'timestamp': 1585236904.0, 'added_lines': 69, 'deleted_lines': 0, 'nloc': 331}, {'timestamp': 1583334674.0, 'added_lines': 277, 'deleted_lines': 1, 'nloc': 527}, {'timestamp': 1586381179.0, 'added_lines': 7, 'deleted_lines': 19, 'nloc': 518}, {'timestamp': 1587221101.0, 'added_lines': 3, 'deleted_lines': 3, 'nloc': 501}, {'timestamp': 1597688976.0, 'added_lines': 116, 'deleted_lines': 0, 'nloc': 604}, {'timestamp': 1600726105.0, 'added_lines': 1, 'deleted_lines': 1, 'nloc': 604}, {'timestamp': 1604542440.0, 'added_lines': 11, 'deleted_lines': 4, 'nloc': 611}, {'timestamp': 1605099892.0, 'added_lines': 1, 'deleted_lines': 1, 'nloc': 604}, {'timestamp': 1615407290.0, 'added_lines': 17, 'deleted_lines': 518, 'nloc': 246}, {'timestamp': 1616604074.0, 'added_lines': 10, 'deleted_lines': 10, 'nloc': 246}, {'timestamp': 1629221569.0, 'added_lines': 6, 'deleted_lines': 3, 'nloc': 249}, {'timestamp': 1632407037.0, 'added_lines': 31, 'deleted_lines': 5, 'nloc': 271}, {'timestamp': 1631733374.0, 'added_lines': 2, 'deleted_lines': 2, 'nloc': 271}, {'timestamp': 1632766984.0, 'added_lines': 2, 'deleted_lines': 2, 'nloc': 271}, {'timestamp': 1631733783.0, 'added_lines': 1, 'deleted_lines': 1, 'nloc': 271}]","{'blocks/blockstore/caching.go': 1, 'blocks/blockstore/util/remove.go': 3, 'cmd/ipfs/daemon.go': 35, 'cmd/ipfs/init.go': 43, 'cmd/ipfs/ipfs.go': 27, 'cmd/ipfs/main.go': 39, 'cmd/ipfs/main_test.go': 4, 'cmd/ipfswatch/main.go': 21, 'cmd/seccat/seccat.go': 26, None: 20, 'commands/channelmarshaler.go': 1, 'commands/cli/cmd_suggestion.go': 1, 'commands/cli/helptext.go': 3, 'commands/cli/helptext_test.go': 2, 'commands/cli/parse.go': 2, 'commands/cli/parse_test.go': 2, 'commands/command.go': 16, 'commands/command_test.go': 9, 'commands/http/client.go': 2, 'commands/http/handler.go': 2, 'commands/http/multifilereader.go': 2, 'commands/http/multifilereader_test.go': 2, 'commands/http/parse.go': 2, 'commands/reqlog.go': 1, 'commands/request.go': 24, 'commands/response.go': 13, 'commands/response_test.go': 9, 'core/bootstrap.go': 23, 'core/commands/active.go': 24, 'core/commands/add.go': 58, 'core/commands/bitswap.go': 59, 'core/commands/block.go': 52, 'core/commands/bootstrap.go': 33, 'core/commands/cat.go': 40, 'core/commands/commands.go': 31, 'core/commands/config.go': 40, 'core/commands/dht.go': 66, 'core/commands/diag.go': 23, 'core/commands/dns.go': 33, 'core/commands/e/error.go': 1, 'core/commands/external.go': 23, 'core/commands/files/files.go': 14, 'core/commands/filestore.go': 36, 'core/commands/get.go': 72, 'core/commands/helptext_test.go': 27, 'core/commands/id.go': 47, 'core/commands/ipns.go': 16, 'core/commands/keystore.go': 37, 'core/commands/log.go': 27, 'core/commands/ls.go': 70, 'core/commands/mount_nofuse.go': 23, 'core/commands/mount_unix.go': 34, 'core/commands/mount_windows.go': 22, 'core/commands/name.go': 10, 'core/commands/object/diff.go': 36, 'core/commands/object/object.go': 80, 'core/commands/object/patch.go': 49, 'core/commands/p2p.go': 37, 'core/commands/pin.go': 72, 'core/commands/ping.go': 41, 'core/commands/publish.go': 20, 'core/commands/pubsub.go': 47, 'core/commands/refs.go': 67, 'core/commands/repo.go': 48, 'core/commands/resolve.go': 69, 'core/commands/root.go': 35, 'core/commands/shutdown.go': 28, 'core/commands/stat.go': 37, 'core/commands/swarm.go': 44, 'core/commands/sysdiag.go': 28, 'core/commands/tar.go': 70, 'core/commands/unixfs/ls.go': 64, 'core/commands/unixfs/unixfs.go': 23, 'core/commands/version.go': 28, 'core/core_test.go': 17, 'core/corehttp/commands.go': 61, 'core/corehttp/gateway.go': 35, 'core/coreunix/add.go': 68, 'core/coreunix/add_test.go': 62, 'core/coreunix/metadata_test.go': 50, 'exchange/bitswap/bitswap_test.go': 7, 'exchange/bitswap/decision/engine_test.go': 7, 'exchange/bitswap/message/message_test.go': 5, 'exchange/bitswap/message/pb/Makefile': 1, 'exchange/bitswap/testnet/network_test.go': 7, 'exchange/bitswap/testnet/peernet.go': 7, 'exchange/reprovide/reprovide_test.go': 32, 'fuse/ipns/common.go': 46, 'fuse/node/mount_test.go': 31, 'importer/balanced/balanced_test.go': 7, 'importer/chunk/rabin_test.go': 3, 'importer/helpers/dagbuilder.go': 13, 'importer/importer.go': 13, 'merkledag/utils/utils_test.go': 7, 'mfs/repub_test.go': 10, 'namesys/dns.go': 45, 'namesys/interface.go': 45, 'namesys/ipns_select_test.go': 4, 'namesys/proquint.go': 45, 'namesys/republisher/repub_test.go': 47, 'package.json': 62, 'repo/config/identity.go': 2, 'routing/offline/offline_test.go': 5, 'test/integration/addcat_test.go': 34, 'test/integration/bench_cat_test.go': 33, 'test/integration/bitswap_wo_routing_test.go': 34, 'test/integration/three_legged_cat_test.go': 33, 'core/bootstrap_test.go': 22, 'core/commands/dht_test.go': 21, 'core/commands/get_test.go': 28, 'core/core.go': 55, 'core/corehttp/gateway_test.go': 52, 'core/corehttp/metrics_test.go': 29, 'core/mock/mock.go': 30, 'exchange/bitswap/decision/bench_test.go': 6, 'exchange/bitswap/decision/peer_request_queue_test.go': 6, 'exchange/bitswap/message/message.go': 6, 'exchange/bitswap/network/interface.go': 6, 'exchange/bitswap/network/ipfs_impl.go': 6, 'exchange/bitswap/testnet/interface.go': 5, 'exchange/bitswap/testnet/virtual.go': 6, 'exchange/bitswap/testutils.go': 7, 'fuse/ipns/ipns_test.go': 31, 'fuse/readonly/ipfs_test.go': 59, 'namesys/publisher_test.go': 30, 'namesys/resolve_test.go': 47, 'p2p/p2p.go': 22, 'p2p/registry.go': 9, 'repo/config/bootstrap_peers.go': 6, 'routing/mock/centralized_client.go': 4, 'routing/mock/centralized_server.go': 4, 'routing/mock/centralized_test.go': 4, 'routing/mock/interface.go': 4, 'routing/none/none_client.go': 4, 'test/integration/bench_test.go': 16, 'assets/assets.go': 50, 'blocks/blockstore/arc_cache.go': 2, 'blocks/blockstore/arc_cache_test.go': 2, 'blocks/blockstore/blockstore.go': 3, 'blocks/blockstore/blockstore_test.go': 2, 'blocks/blockstore/bloom_cache.go': 2, 'blocks/blockstore/bloom_cache_test.go': 2, 'blocks/blocksutil/block_generator.go': 2, 'blockservice/blockservice.go': 6, 'blockservice/blockservice_test.go': 4, 'blockservice/test/blocks_test.go': 5, 'core/builder.go': 51, 'core/commands/ipnsps.go': 8, 'core/coreapi/coreapi.go': 30, 'core/coreapi/interface/interface.go': 2, 'core/coreapi/unixfs.go': 57, 'core/coreapi/unixfs_test.go': 42, 'core/coredag/cbor.go': 18, 'core/coredag/dagpb.go': 43, 'core/coredag/dagtransl.go': 15, 'core/coredag/raw.go': 43, 'core/corehttp/corehttp.go': 13, 'core/corehttp/gateway_handler.go': 63, 'core/corerepo/gc.go': 47, 'core/corerepo/pinning.go': 21, 'core/coreunix/metadata.go': 48, 'core/pathresolver.go': 47, 'exchange/bitswap/bitswap.go': 7, 'exchange/bitswap/decision/engine.go': 5, 'exchange/bitswap/decision/ledger.go': 6, 'exchange/bitswap/decision/peer_request_queue.go': 5, 'exchange/bitswap/get.go': 4, 'exchange/bitswap/notifications/notifications.go': 4, 'exchange/bitswap/notifications/notifications_test.go': 4, 'exchange/bitswap/session.go': 5, 'exchange/bitswap/session_test.go': 4, 'exchange/bitswap/stat.go': 4, 'exchange/bitswap/wantlist/wantlist.go': 4, 'exchange/bitswap/wantlist/wantlist_test.go': 4, 'exchange/bitswap/wantmanager.go': 5, 'exchange/bitswap/workers.go': 5, 'exchange/interface.go': 2, 'exchange/offline/offline.go': 2, 'exchange/offline/offline_test.go': 2, 'exchange/reprovide/providers.go': 44, 'exchange/reprovide/reprovide.go': 26, 'filestore/filestore.go': 24, 'filestore/filestore_test.go': 42, 'filestore/fsrefstore.go': 23, 'filestore/util.go': 22, 'fuse/ipns/ipns_unix.go': 51, 'fuse/readonly/readonly_unix.go': 54, 'importer/balanced/builder.go': 5, 'importer/chunk/splitting_test.go': 2, 'importer/helpers/helpers.go': 7, 'importer/importer_test.go': 6, 'importer/trickle/trickle_test.go': 6, 'importer/trickle/trickledag.go': 6, 'merkledag/batch.go': 2, 'merkledag/coding.go': 5, 'merkledag/merkledag.go': 7, 'merkledag/merkledag_test.go': 6, 'merkledag/node.go': 6, 'merkledag/node_test.go': 6, 'merkledag/raw.go': 6, 'merkledag/traverse/traverse.go': 5, 'merkledag/traverse/traverse_test.go': 6, 'merkledag/utils/diff.go': 6, 'merkledag/utils/diffenum.go': 5, 'merkledag/utils/diffenum_test.go': 6, 'merkledag/utils/utils.go': 6, 'mfs/dir.go': 13, 'mfs/file.go': 13, 'mfs/mfs_test.go': 14, 'mfs/ops.go': 12, 'mfs/system.go': 14, 'namesys/namesys.go': 50, 'namesys/publisher.go': 51, 'namesys/pubsub.go': 4, 'namesys/pubsub_test.go': 3, 'namesys/republisher/repub.go': 44, 'namesys/routing.go': 49, 'path/path.go': 5, 'path/resolver.go': 5, 'path/resolver_test.go': 4, 'pin/gc/gc.go': 45, 'pin/pin.go': 46, 'pin/pin_test.go': 43, 'pin/set.go': 45, 'pin/set_test.go': 42, 'plugin/ipld.go': 15, 'plugin/loader/initializer.go': 11, 'plugin/plugins/git/git.go': 14, 'repo/config/init.go': 6, 'repo/fsrepo/fsrepo.go': 22, 'repo/fsrepo/lock/lock.go': 3, 'repo/fsrepo/serialize/serialize.go': 3, 'repo/mock.go': 16, 'repo/repo.go': 19, 'routing/offline/offline.go': 3, 'tar/format.go': 52, 'test/dependencies/ma-pipe-unidir/main.go': 8, 'thirdparty/ds-help/key.go': 2, 'thirdparty/pollEndpoint/main.go': 12, 'thirdparty/posinfo/posinfo.go': 3, 'unixfs/archive/archive.go': 7, 'unixfs/archive/tar/writer.go': 7, 'unixfs/hamt/hamt.go': 6, 'unixfs/io/dagreader.go': 6, 'unixfs/io/dirbuilder.go': 5, 'unixfs/io/resolve.go': 6, 'unixfs/mod/dagmodifier.go': 7, 'unixfs/mod/dagmodifier_test.go': 3, 'unixfs/test/utils.go': 6, 'commands/legacy/command.go': 13, 'commands/legacy/legacy.go': 13, 'commands/legacy/legacy_test.go': 14, 'commands/legacy/request.go': 15, 'commands/legacy/response.go': 14, 'commands/legacy/responseemitter.go': 4, 'core/commands/env.go': 4, 'TODO.md': 2, 'core/commands/commands_test.go': 26, 'test/sharness/t0110-gateway.sh': 2, 'test/sharness/t0410-api-add.sh': 2, 'core/coreapi/dag.go': 14, 'core/coreapi/dag_test.go': 3, 'core/coreapi/interface/options/dag.go': 8, 'core/coreapi/key.go': 50, 'core/coreapi/name.go': 51, 'merkledag/test/utils.go': 5, 'namesys/namesys_test.go': 51, 'repo/fsrepo/datastores.go': 13, 'repo/fsrepo/fsrepo_test.go': 17, 'thirdparty/datastore2/datastore_closer.go': 1, 'thirdparty/datastore2/delayed.go': 1, 'thirdparty/datastore2/threadsafe.go': 1, 'unixfs/io/pbdagreader.go': 5, 'mfs/fd.go': 8, 'unixfs/hamt/hamt_stress_test.go': 4, 'unixfs/hamt/hamt_test.go': 4, 'unixfs/io/dagreader_test.go': 1, 'unixfs/io/dirbuilder_test.go': 1, 'cmd/ipfs/util/ulimit.go': 8, 'cmd/seccat/util.go': 7, 'core/corehttp/logs.go': 7, 'fuse/mount/mount.go': 7, 'fuse/node/mount_unix.go': 8, 'importer/chunk/splitting.go': 1, 'namesys/ipns_validate_test.go': 2, 'plugin/loader/load.go': 5, 'path/path_test.go': 1, 'test/api-startup/main.go': 1, 'CHANGELOG.md': 3, 'README.md': 4, 'bin/dist_get': 1, 'cmd/ipfs/util/ulimit_freebsd.go': 3, 'contribute.md': 1, 'core/coreapi/interface/options/pin.go': 1, 'docs/experimental-features.md': 1, 'docs/file-transfer.md': 1, 'docs/releases.md': 1, 'exchange/bitswap/README.md': 1, 'plugin/plugin.go': 1, 'repo/fsrepo/migrations/mfsr_test.go': 1, 'repo/fsrepo/migrations/migrations.go': 2, 'test/sharness/README.md': 2, 'thirdparty/dir/dir.go': 1, 'blocks/blockstoreutil/remove.go': 20, 'blockservice/test/mock.go': 2, 'cmd/ipfs/util/ulimit_unix.go': 2, 'core/commands/files.go': 69, 'core/coreapi/block.go': 20, 'core/coreapi/block_test.go': 2, 'core/coreapi/interface/coreapi.go': 10, 'core/coreapi/interface/dag.go': 10, 'core/coreapi/interface/object.go': 9, 'core/coreapi/interface/options/block.go': 3, 'core/coreapi/interface/path.go': 35, 'core/coreapi/interface/unixfs.go': 15, 'core/coreapi/object.go': 50, 'core/coreapi/pin.go': 46, 'fuse/ipns/link_unix.go': 3, 'fuse/mount/fuse.go': 3, 'fuse/node/mount_darwin.go': 3, 'keystore/keystore.go': 7, 'merkledag/errservice.go': 2, 'merkledag/readonly.go': 2, 'merkledag/readonly_test.go': 2, 'merkledag/rwservice.go': 2, 'merkledag/session.go': 2, 'namesys/validator.go': 1, 'path/resolver/resolver.go': 2, 'path/resolver/resolver_test.go': 2, 'thirdparty/verifbs/verifbs.go': 19, 'thirdparty/verifcid/validate.go': 2, 'thirdparty/verifcid/validate_test.go': 2, 'core/commands/urlstore.go': 52, 'namesys/ipns_resolver_validation_test.go': 45, 'unixfs/io/directory.go': 1, 'core/coreapi/name_test.go': 35, 'core/coreapi/path.go': 53, 'core/coreunix/cat.go': 15, 'core/pathresolver_test.go': 40, 'dagutils/utils.go': 40, 'dagutils/utils_test.go': 40, 'namesys/base.go': 44, 'namesys/cache.go': 40, 'dagutils/diff.go': 42, 'dagutils/diffenum.go': 38, 'dagutils/diffenum_test.go': 38, 'core/coreapi/interface/key.go': 7, 'filestore/pb/dataobj.pb.go': 3, 'keystore/keystore_test.go': 5, 'keystore/memkeystore.go': 5, 'pin/internal/pb/header.pb.go': 3, 'thirdparty/cidv0v1/blockstore.go': 16, 'repo/fsrepo/config_test.go': 13, 'repo/fsrepo/misc.go': 13, 'test/bench/bench_cli_ipfs_add/main.go': 14, 'test/bench/offline_add/main.go': 14, 'core/commands/cmdenv/env.go': 29, 'core/commands/name/ipns.go': 46, 'core/commands/name/publish.go': 32, 'core/coreapi/dht.go': 34, 'core/coreapi/dht_test.go': 5, 'test/sharness/t0275-cid-security.sh': 1, 'core/commands/name/ipnsps.go': 21, 'core/commands/name/name.go': 16, 'core/coreapi/interface/dht.go': 10, 'p2p/listener.go': 13, 'p2p/local.go': 13, 'p2p/remote.go': 13, 'p2p/stream.go': 13, 'core/coreapi/interface/swarm.go': 9, 'core/coreapi/swarm.go': 23, 'core/coreapi/interface/options/unixfs.go': 15, 'core/coreapi/pubsub.go': 21, 'core/coreapi/unixfile.go': 20, 'core/commands/cid.go': 17, 'cmd/ipfs/dnsresolve_test.go': 5, 'core/coreapi/interface/pubsub.go': 4, 'test/dependencies/iptb/iptb.go': 12, 'plugin/plugins/badgerds/badgerds.go': 4, 'plugin/plugins/flatfs/flatfs.go': 4, 'plugin/plugins/levelds/levelds.go': 3, 'commands/context.go': 21, 'core/corehttp/proxy.go': 9, 'core/commands/cmdenv/file.go': 4, 'core/coreapi/interface/tests/name.go': 4, 'core/coreapi/interface/tests/unixfs.go': 4, 'core/coreapi/test/api_test.go': 13, 'core/commands/cmdenv/cidbase.go': 12, 'core/commands/cmdenv/cidbase_test.go': 4, 'test/sharness/t0040-add-and-cat.sh': 2, 'test/sharness/t0045-ls.sh': 1, 'test/sharness/t0051-object-data/mixed.json': 1, 'test/sharness/t0051-object.sh': 2, 'test/sharness/t0053-dag.sh': 6, 'test/sharness/t0085-pins.sh': 1, 'test/sharness/t0095-refs.sh': 1, 'test/sharness/t0160-resolve.sh': 1, 'test/sharness/t0210-tar.sh': 1, 'test/sharness/t0250-files-api.sh': 2, 'test/sharness/t0271-filestore-utils.sh': 1, 'test/sharness/t0272-urlstore.sh': 2, 'plugin/loader/loader.go': 13, 'core/corehttp/ipns_hostname.go': 11, 'namesys/dns_test.go': 10, 'plugin/daemon.go': 10, 'core/corerepo/stat.go': 2, 'core/corehttp/metrics.go': 1, 'core/corehttp/proxy_test.go': 1, 'plugin/tracer.go': 1, 'thirdparty/notifier/notifier.go': 2, 'go.mod': 7, 'go.sum': 7, 'package-list.json': 1, '.gitattributes': 2, 'test/sharness/t0054-dag-car-import-export.sh': 4, '.gitignore': 1, 'test/sharness/t0054-dag-car-import-export-data/README.md': 1, 'test/sharness/t0054-dag-car-import-export-data/test_dataset_car_v0.tar.xz': 1, 'Dockerfile': 1, 'bin/check_go_version': 1, 'coverage/Rules.mk': 1, 'docs/config.md': 1, 'docs/debug-guide.md': 1, 'docs/environment-variables.md': 1, 'gc/gc.go': 1, 'keystore/memkeystore_test.go': 1, 'misc/completion/ipfs-completion.bash': 1, 'plugin/plugins/gen_main.sh': 1, 'repo/onlyone.go': 1, 'test/3nodetest/run-test-on-img.sh': 1, 'test/ipfs-test-lib.sh': 1, 'test/sharness/lib/iptb-lib.sh': 1, 'test/sharness/t0010-basic-commands.sh': 1, 'test/sharness/t0020-init.sh': 1, 'test/sharness/t0030-mount.sh': 1, 'test/sharness/t0031-mount-publish.sh': 1, 'test/sharness/t0050-block.sh': 1, 'test/sharness/t0060-daemon.sh': 1, 'test/sharness/t0062-daemon-api.sh': 1, 'test/sharness/t0080-repo.sh': 1, 'test/sharness/t0087-repo-robust-gc.sh': 1, 'test/sharness/t0090-get.sh': 1, 'test/sharness/t0114-gateway-subdomains.sh': 1, 'test/sharness/t0131-multinode-client-routing.sh': 1, 'test/sharness/t0140-swarm.sh': 1, 'test/sharness/t0183-namesys-pubsub.sh': 1, 'test/sharness/t0270-filestore.sh': 1, 'test/sharness/t0600-issues-and-regressions-online.sh': 1, 'test/sharness_test_coverage_helper.sh': 1, 'thirdparty/README.md': 1, 'cmd/ipfs/util/ulimit_test.go': 1, 'cmd/ipfswatch/ipfswatch_test.go': 1, 'cmd/seccat/seccat_plan9.go': 1, 'cmd/seccat/seccat_posix.go': 1, 'fuse/node/mount_notsupp.go': 1, 'core/commands/dag/export.go': 1, 'core/commands/dag/get.go': 3, 'core/commands/dag/import.go': 2, 'core/commands/dag/put.go': 3, 'core/commands/dag/resolve.go': 1, 'core/commands/dag/stat.go': 1, 'core/commands/pin/pin.go': 1, 'core/commands/stat_dht.go': 1, 'core/node/core.go': 1, 'core/node/groups.go': 1, 'core/node/provider.go': 1, 'test/sharness/t0055-dag-put-json-new-line.sh': 3, 'test/sharness/t0280-plugin-git.sh': 2, 'test/sharness/lib/test-lib.sh': 1, 'test/sharness/t0041-ping.sh': 1}","('core/commands/object/object.go', 0.6666666666666666, 0.6956521739130435)"
core/commands/object/diff.go,112,695,2,"[{'cyclomatic_complexity': 7, 'nloc': 36, 'token_count': 244, 'name': '', 'long_name': '(req cmds.Request,res cmds.Response)', 'start_line': 52, 'end_line': 95, 'full_parameters': [], 'filename': '/home/dimi/Documents/Informatik_Studium/FSS/SoftEvo/DataCollection/FFS_SoftEvo/go-ipfs/core/commands/object/diff.go', 'top_nesting_level': 0, 'length': 44, 'fan_in': 0, 'fan_out': 0, 'general_fan_out': 0}, {'cyclomatic_complexity': 9, 'nloc': 27, 'token_count': 224, 'name': '', 'long_name': '(res cmds.Response)(io.Reader,error)', 'start_line': 98, 'end_line': 124, 'full_parameters': [], 'filename': '/home/dimi/Documents/Informatik_Studium/FSS/SoftEvo/DataCollection/FFS_SoftEvo/go-ipfs/core/commands/object/diff.go', 'top_nesting_level': 0, 'length': 27, 'fan_in': 0, 'fan_out': 0, 'general_fan_out': 0}]",102,641,0,[],-10,-54,-2,45,45,"[{'timestamp': 1491058697.0, 'added_lines': 24, 'deleted_lines': 13, 'nloc': 121}, {'timestamp': 1511223906.0, 'added_lines': 1, 'deleted_lines': 1, 'nloc': 121}, {'timestamp': 1512365669.0, 'added_lines': 1, 'deleted_lines': 1, 'nloc': 121}, {'timestamp': 1511187070.0, 'added_lines': 1, 'deleted_lines': 1, 'nloc': 121}, {'timestamp': 1513436097.0, 'added_lines': 1, 'deleted_lines': 1, 'nloc': 121}, {'timestamp': 1513612261.0, 'added_lines': 1, 'deleted_lines': 1, 'nloc': 121}, {'timestamp': 1515277696.0, 'added_lines': 1, 'deleted_lines': 1, 'nloc': 121}, {'timestamp': 1528520460.0, 'added_lines': 1, 'deleted_lines': 1, 'nloc': 121}, {'timestamp': 1532722333.0, 'added_lines': 1, 'deleted_lines': 1, 'nloc': 121}, {'timestamp': 1532847462.0, 'added_lines': 1, 'deleted_lines': 1, 'nloc': 121}, {'timestamp': 1517607361.0, 'added_lines': 19, 'deleted_lines': 21, 'nloc': 118}, {'timestamp': 1533946888.0, 'added_lines': 1, 'deleted_lines': 1, 'nloc': 118}, {'timestamp': 1534896611.0, 'added_lines': 1, 'deleted_lines': 1, 'nloc': 118}, {'timestamp': 1536937702.0, 'added_lines': 4, 'deleted_lines': 0, 'nloc': 122}, {'timestamp': 1539850591.0, 'added_lines': 1, 'deleted_lines': 1, 'nloc': 122}, {'timestamp': 1540581988.0, 'added_lines': 1, 'deleted_lines': 1, 'nloc': 122}, {'timestamp': 1540605823.0, 'added_lines': 29, 'deleted_lines': 39, 'nloc': 111}, {'timestamp': 1540606122.0, 'added_lines': 1, 'deleted_lines': 1, 'nloc': 111}, {'timestamp': 1540869553.0, 'added_lines': 1, 'deleted_lines': 1, 'nloc': 111}, {'timestamp': 1541204121.0, 'added_lines': 1, 'deleted_lines': 1, 'nloc': 111}, {'timestamp': 1544661332.0, 'added_lines': 1, 'deleted_lines': 1, 'nloc': 111}, {'timestamp': 1540556089.0, 'added_lines': 1, 'deleted_lines': 1, 'nloc': 111}, {'timestamp': 1544451987.0, 'added_lines': 1, 'deleted_lines': 1, 'nloc': 111}, {'timestamp': 1547152271.0, 'added_lines': 1, 'deleted_lines': 1, 'nloc': 111}, {'timestamp': 1548866534.0, 'added_lines': 1, 'deleted_lines': 1, 'nloc': 111}, {'timestamp': 1549672857.0, 'added_lines': 1, 'deleted_lines': 1, 'nloc': 111}, {'timestamp': 1549673846.0, 'added_lines': 1, 'deleted_lines': 1, 'nloc': 111}, {'timestamp': 1549903582.0, 'added_lines': 2, 'deleted_lines': 2, 'nloc': 111}, {'timestamp': 1550185115.0, 'added_lines': 1, 'deleted_lines': 1, 'nloc': 111}, {'timestamp': 1550507829.0, 'added_lines': 2, 'deleted_lines': 2, 'nloc': 111}, {'timestamp': 1550576884.0, 'added_lines': 1, 'deleted_lines': 1, 'nloc': 111}, {'timestamp': 1550610741.0, 'added_lines': 1, 'deleted_lines': 1, 'nloc': 111}, {'timestamp': 1550711994.0, 'added_lines': 1, 'deleted_lines': 1, 'nloc': 111}, {'timestamp': 1550723346.0, 'added_lines': 1, 'deleted_lines': 1, 'nloc': 111}, {'timestamp': 1551138343.0, 'added_lines': 1, 'deleted_lines': 1, 'nloc': 111}, {'timestamp': 1551229859.0, 'added_lines': 1, 'deleted_lines': 1, 'nloc': 111}, {'timestamp': 1551299964.0, 'added_lines': 2, 'deleted_lines': 2, 'nloc': 111}, {'timestamp': 1551471469.0, 'added_lines': 1, 'deleted_lines': 1, 'nloc': 111}, {'timestamp': 1551551196.0, 'added_lines': 3, 'deleted_lines': 3, 'nloc': 111}, {'timestamp': 1553529899.0, 'added_lines': 2, 'deleted_lines': 12, 'nloc': 103}, {'timestamp': 1553608614.0, 'added_lines': 3, 'deleted_lines': 3, 'nloc': 103}, {'timestamp': 1553609463.0, 'added_lines': 2, 'deleted_lines': 2, 'nloc': 103}, {'timestamp': 1557554420.0, 'added_lines': 6, 'deleted_lines': 7, 'nloc': 102}, {'timestamp': 1574264289.0, 'added_lines': 4, 'deleted_lines': 4, 'nloc': 102}, {'timestamp': 1616604074.0, 'added_lines': 1, 'deleted_lines': 1, 'nloc': 102}]","{'blocks/blockstore/caching.go': 1, 'blocks/blockstore/util/remove.go': 2, 'cmd/ipfs/daemon.go': 25, 'cmd/ipfs/init.go': 25, 'cmd/ipfs/ipfs.go': 22, 'cmd/ipfs/main.go': 24, 'cmd/ipfs/main_test.go': 4, 'cmd/ipfswatch/main.go': 12, 'cmd/seccat/seccat.go': 9, None: 30, 'commands/channelmarshaler.go': 1, 'commands/cli/cmd_suggestion.go': 1, 'commands/cli/helptext.go': 2, 'commands/cli/helptext_test.go': 2, 'commands/cli/parse.go': 2, 'commands/cli/parse_test.go': 2, 'commands/command.go': 12, 'commands/command_test.go': 7, 'commands/http/client.go': 2, 'commands/http/handler.go': 2, 'commands/http/multifilereader.go': 2, 'commands/http/multifilereader_test.go': 2, 'commands/http/parse.go': 2, 'commands/reqlog.go': 1, 'commands/request.go': 12, 'commands/response.go': 11, 'commands/response_test.go': 7, 'core/bootstrap.go': 9, 'core/commands/active.go': 23, 'core/commands/add.go': 33, 'core/commands/bitswap.go': 28, 'core/commands/block.go': 35, 'core/commands/bootstrap.go': 25, 'core/commands/cat.go': 34, 'core/commands/commands.go': 24, 'core/commands/config.go': 26, 'core/commands/dag/dag.go': 36, 'core/commands/dht.go': 29, 'core/commands/diag.go': 23, 'core/commands/dns.go': 30, 'core/commands/e/error.go': 1, 'core/commands/external.go': 23, 'core/commands/files/files.go': 7, 'core/commands/filestore.go': 25, 'core/commands/get.go': 35, 'core/commands/helptext_test.go': 22, 'core/commands/id.go': 28, 'core/commands/ipns.go': 10, 'core/commands/keystore.go': 33, 'core/commands/log.go': 24, 'core/commands/ls.go': 36, 'core/commands/mount_nofuse.go': 23, 'core/commands/mount_unix.go': 25, 'core/commands/mount_windows.go': 22, 'core/commands/name.go': 10, 'core/commands/object/object.go': 41, 'core/commands/object/patch.go': 41, 'core/commands/p2p.go': 26, 'core/commands/pin.go': 37, 'core/commands/ping.go': 27, 'core/commands/publish.go': 11, 'core/commands/pubsub.go': 32, 'core/commands/refs.go': 29, 'core/commands/repo.go': 26, 'core/commands/resolve.go': 35, 'core/commands/root.go': 27, 'core/commands/shutdown.go': 25, 'core/commands/stat.go': 26, 'core/commands/swarm.go': 26, 'core/commands/sysdiag.go': 25, 'core/commands/tar.go': 30, 'core/commands/unixfs/ls.go': 36, 'core/commands/unixfs/unixfs.go': 23, 'core/commands/version.go': 25, 'core/core_test.go': 6, 'core/corehttp/commands.go': 28, 'core/corehttp/gateway.go': 17, 'core/coreunix/add.go': 27, 'core/coreunix/add_test.go': 26, 'core/coreunix/metadata_test.go': 17, 'exchange/bitswap/bitswap_test.go': 4, 'exchange/bitswap/decision/engine_test.go': 4, 'exchange/bitswap/message/message_test.go': 3, 'exchange/bitswap/message/pb/Makefile': 1, 'exchange/bitswap/testnet/network_test.go': 4, 'exchange/bitswap/testnet/peernet.go': 4, 'exchange/reprovide/reprovide_test.go': 10, 'fuse/ipns/common.go': 16, 'fuse/node/mount_test.go': 9, 'importer/balanced/balanced_test.go': 3, 'importer/chunk/rabin_test.go': 2, 'importer/helpers/dagbuilder.go': 8, 'importer/importer.go': 8, 'merkledag/utils/utils_test.go': 3, 'mfs/repub_test.go': 4, 'namesys/dns.go': 15, 'namesys/interface.go': 15, 'namesys/ipns_select_test.go': 3, 'namesys/proquint.go': 15, 'namesys/republisher/repub_test.go': 14, 'package.json': 28, 'repo/config/identity.go': 1, 'routing/offline/offline_test.go': 3, 'test/integration/addcat_test.go': 15, 'test/integration/bench_cat_test.go': 14, 'test/integration/bitswap_wo_routing_test.go': 12, 'test/integration/three_legged_cat_test.go': 14, 'core/bootstrap_test.go': 8, 'core/commands/dht_test.go': 8, 'core/commands/get_test.go': 23, 'core/core.go': 19, 'core/corehttp/gateway_test.go': 19, 'core/corehttp/metrics_test.go': 11, 'core/mock/mock.go': 11, 'exchange/bitswap/decision/bench_test.go': 3, 'exchange/bitswap/decision/peer_request_queue_test.go': 3, 'exchange/bitswap/message/message.go': 3, 'exchange/bitswap/network/interface.go': 3, 'exchange/bitswap/network/ipfs_impl.go': 3, 'exchange/bitswap/testnet/interface.go': 3, 'exchange/bitswap/testnet/virtual.go': 3, 'exchange/bitswap/testutils.go': 3, 'fuse/ipns/ipns_test.go': 8, 'fuse/readonly/ipfs_test.go': 23, 'namesys/publisher_test.go': 9, 'namesys/resolve_test.go': 14, 'p2p/p2p.go': 8, 'p2p/registry.go': 4, 'repo/config/bootstrap_peers.go': 3, 'routing/mock/centralized_client.go': 2, 'routing/mock/centralized_server.go': 2, 'routing/mock/centralized_test.go': 2, 'routing/mock/interface.go': 2, 'routing/none/none_client.go': 2, 'test/integration/bench_test.go': 8, 'assets/assets.go': 20, 'blocks/blockstore/arc_cache.go': 1, 'blocks/blockstore/arc_cache_test.go': 1, 'blocks/blockstore/blockstore.go': 1, 'blocks/blockstore/blockstore_test.go': 1, 'blocks/blockstore/bloom_cache.go': 1, 'blocks/blockstore/bloom_cache_test.go': 1, 'blocks/blocksutil/block_generator.go': 1, 'blockservice/blockservice.go': 2, 'blockservice/blockservice_test.go': 2, 'blockservice/test/blocks_test.go': 2, 'core/builder.go': 17, 'core/commands/ipnsps.go': 7, 'core/coreapi/coreapi.go': 16, 'core/coreapi/interface/interface.go': 1, 'core/coreapi/unixfs.go': 23, 'core/coreapi/unixfs_test.go': 8, 'core/coredag/cbor.go': 7, 'core/coredag/dagpb.go': 11, 'core/coredag/dagtransl.go': 6, 'core/coredag/raw.go': 11, 'core/corehttp/corehttp.go': 6, 'core/corehttp/gateway_handler.go': 25, 'core/corerepo/gc.go': 17, 'core/corerepo/pinning.go': 6, 'core/coreunix/metadata.go': 16, 'core/pathresolver.go': 12, 'exchange/bitswap/bitswap.go': 2, 'exchange/bitswap/decision/engine.go': 2, 'exchange/bitswap/decision/ledger.go': 2, 'exchange/bitswap/decision/peer_request_queue.go': 2, 'exchange/bitswap/get.go': 2, 'exchange/bitswap/notifications/notifications.go': 2, 'exchange/bitswap/notifications/notifications_test.go': 2, 'exchange/bitswap/session.go': 2, 'exchange/bitswap/session_test.go': 2, 'exchange/bitswap/stat.go': 2, 'exchange/bitswap/wantlist/wantlist.go': 2, 'exchange/bitswap/wantlist/wantlist_test.go': 2, 'exchange/bitswap/wantmanager.go': 2, 'exchange/bitswap/workers.go': 2, 'exchange/interface.go': 1, 'exchange/offline/offline.go': 1, 'exchange/offline/offline_test.go': 1, 'exchange/reprovide/providers.go': 11, 'exchange/reprovide/reprovide.go': 8, 'filestore/filestore.go': 7, 'filestore/filestore_test.go': 11, 'filestore/fsrefstore.go': 7, 'filestore/util.go': 7, 'fuse/ipns/ipns_unix.go': 17, 'fuse/readonly/readonly_unix.go': 17, 'importer/balanced/builder.go': 2, 'importer/chunk/splitting_test.go': 1, 'importer/helpers/helpers.go': 2, 'importer/importer_test.go': 2, 'importer/trickle/trickle_test.go': 2, 'importer/trickle/trickledag.go': 2, 'merkledag/batch.go': 1, 'merkledag/coding.go': 2, 'merkledag/merkledag.go': 2, 'merkledag/merkledag_test.go': 2, 'merkledag/node.go': 2, 'merkledag/node_test.go': 2, 'merkledag/raw.go': 2, 'merkledag/traverse/traverse.go': 2, 'merkledag/traverse/traverse_test.go': 2, 'merkledag/utils/diff.go': 2, 'merkledag/utils/diffenum.go': 2, 'merkledag/utils/diffenum_test.go': 2, 'merkledag/utils/utils.go': 2, 'mfs/dir.go': 3, 'mfs/file.go': 3, 'mfs/mfs_test.go': 4, 'mfs/ops.go': 3, 'mfs/system.go': 3, 'namesys/namesys.go': 16, 'namesys/publisher.go': 19, 'namesys/pubsub.go': 1, 'namesys/pubsub_test.go': 1, 'namesys/republisher/repub.go': 12, 'namesys/routing.go': 16, 'path/path.go': 2, 'path/resolver.go': 1, 'path/resolver_test.go': 1, 'pin/gc/gc.go': 11, 'pin/pin.go': 12, 'pin/pin_test.go': 11, 'pin/set.go': 11, 'pin/set_test.go': 11, 'plugin/ipld.go': 6, 'plugin/loader/initializer.go': 4, 'plugin/plugins/git/git.go': 6, 'repo/config/init.go': 2, 'repo/fsrepo/fsrepo.go': 7, 'repo/fsrepo/lock/lock.go': 1, 'repo/fsrepo/serialize/serialize.go': 2, 'repo/mock.go': 7, 'repo/repo.go': 7, 'routing/offline/offline.go': 1, 'tar/format.go': 19, 'test/dependencies/ma-pipe-unidir/main.go': 5, 'thirdparty/ds-help/key.go': 1, 'thirdparty/pollEndpoint/main.go': 6, 'thirdparty/posinfo/posinfo.go': 1, 'unixfs/archive/archive.go': 2, 'unixfs/archive/tar/writer.go': 2, 'unixfs/hamt/hamt.go': 2, 'unixfs/io/dagreader.go': 2, 'unixfs/io/dirbuilder.go': 2, 'unixfs/io/resolve.go': 2, 'unixfs/mod/dagmodifier.go': 2, 'unixfs/mod/dagmodifier_test.go': 2, 'unixfs/test/utils.go': 2, 'commands/legacy/command.go': 8, 'commands/legacy/legacy.go': 8, 'commands/legacy/legacy_test.go': 9, 'commands/legacy/request.go': 9, 'commands/legacy/response.go': 9, 'commands/legacy/responseemitter.go': 4, 'core/commands/env.go': 4, 'TODO.md': 2, 'core/commands/commands_test.go': 18, 'test/sharness/t0110-gateway.sh': 1, 'test/sharness/t0410-api-add.sh': 1, 'blocks/blockstoreutil/remove.go': 7, 'blockservice/test/mock.go': 1, 'cmd/ipfs/util/ulimit.go': 4, 'cmd/ipfs/util/ulimit_freebsd.go': 2, 'cmd/ipfs/util/ulimit_unix.go': 2, 'cmd/seccat/util.go': 4, 'core/commands/files.go': 30, 'core/coreapi/block.go': 17, 'core/coreapi/block_test.go': 2, 'core/coreapi/dag.go': 6, 'core/coreapi/dag_test.go': 2, 'core/coreapi/interface/coreapi.go': 3, 'core/coreapi/interface/dag.go': 3, 'core/coreapi/interface/object.go': 4, 'core/coreapi/interface/options/block.go': 2, 'core/coreapi/interface/options/dag.go': 3, 'core/coreapi/interface/path.go': 4, 'core/coreapi/interface/unixfs.go': 6, 'core/coreapi/key.go': 18, 'core/coreapi/name.go': 18, 'core/coreapi/object.go': 23, 'core/coreapi/pin.go': 17, 'core/corehttp/logs.go': 4, 'fuse/ipns/link_unix.go': 2, 'fuse/mount/fuse.go': 2, 'fuse/mount/mount.go': 4, 'fuse/node/mount_darwin.go': 2, 'fuse/node/mount_unix.go': 4, 'keystore/keystore.go': 4, 'merkledag/errservice.go': 1, 'merkledag/readonly.go': 1, 'merkledag/readonly_test.go': 1, 'merkledag/rwservice.go': 1, 'merkledag/session.go': 1, 'merkledag/test/utils.go': 1, 'namesys/ipns_validate_test.go': 1, 'namesys/namesys_test.go': 19, 'namesys/validator.go': 1, 'path/resolver/resolver.go': 1, 'path/resolver/resolver_test.go': 1, 'plugin/loader/load.go': 2, 'repo/fsrepo/datastores.go': 4, 'thirdparty/verifbs/verifbs.go': 6, 'thirdparty/verifcid/validate.go': 1, 'thirdparty/verifcid/validate_test.go': 1, 'unixfs/hamt/hamt_stress_test.go': 1, 'unixfs/hamt/hamt_test.go': 2, 'unixfs/io/pbdagreader.go': 1, 'dagutils/diff.go': 14, 'dagutils/diffenum.go': 10, 'dagutils/diffenum_test.go': 10, 'dagutils/utils.go': 11, 'dagutils/utils_test.go': 11, 'core/coreapi/name_test.go': 5, 'core/coreapi/path.go': 21, 'core/coreunix/cat.go': 3, 'core/pathresolver_test.go': 10, 'namesys/base.go': 14, 'namesys/cache.go': 10, 'namesys/ipns_resolver_validation_test.go': 14, 'core/coreapi/interface/options/object.go': 1, 'core/commands/urlstore.go': 20, 'mfs/fd.go': 1, 'core/coreapi/interface/key.go': 2, 'repo/fsrepo/config_test.go': 5, 'repo/fsrepo/fsrepo_test.go': 5, 'repo/fsrepo/misc.go': 5, 'test/bench/bench_cli_ipfs_add/main.go': 6, 'test/bench/offline_add/main.go': 6, 'thirdparty/cidv0v1/blockstore.go': 5, 'core/commands/cid.go': 15, 'core/commands/cmdenv/env.go': 21, 'core/commands/name/ipns.go': 22, 'core/commands/name/ipnsps.go': 16, 'core/commands/name/name.go': 14, 'core/commands/name/publish.go': 25, 'core/coreapi/unixfile.go': 3, 'cmd/ipfs/dnsresolve_test.go': 3, 'core/coreapi/dht.go': 13, 'core/coreapi/dht_test.go': 1, 'core/coreapi/interface/dht.go': 1, 'core/coreapi/interface/options/unixfs.go': 2, 'core/coreapi/interface/pubsub.go': 1, 'core/coreapi/interface/swarm.go': 1, 'core/coreapi/pubsub.go': 12, 'core/coreapi/swarm.go': 12, 'keystore/keystore_test.go': 3, 'keystore/memkeystore.go': 3, 'p2p/listener.go': 4, 'p2p/local.go': 4, 'p2p/remote.go': 4, 'p2p/stream.go': 4, 'test/dependencies/iptb/iptb.go': 8, 'commands/context.go': 18, 'core/commands/cmdenv/cidbase.go': 10, 'core/commands/cmdenv/file.go': 3, 'core/coreapi/interface/tests/name.go': 1, 'core/coreapi/interface/tests/unixfs.go': 1, 'core/coreapi/test/api_test.go': 11, 'core/corehttp/ipns_hostname.go': 11, 'namesys/dns_test.go': 10, 'plugin/daemon.go': 10, 'plugin/loader/loader.go': 11, 'core/corehttp/proxy.go': 6, 'filestore/pb/dataobj.pb.go': 2, 'pin/internal/pb/header.pb.go': 2, 'plugin/plugins/badgerds/badgerds.go': 3, 'plugin/plugins/flatfs/flatfs.go': 3, 'plugin/plugins/levelds/levelds.go': 2, 'core/corerepo/stat.go': 2, 'core/commands/cmdenv/cidbase_test.go': 2, 'core/corehttp/metrics.go': 1, 'core/corehttp/proxy_test.go': 1, 'plugin/tracer.go': 1, 'thirdparty/notifier/notifier.go': 1, 'README.md': 2, 'go.mod': 2, 'go.sum': 2, 'package-list.json': 1, 'Rules.mk': 1, 'core/node/core.go': 1, 'core/node/provider.go': 1, 'gc/gc.go': 1, 'core/commands/pin/pin.go': 1, 'core/commands/stat_dht.go': 1}","('core/commands/object/object.go', 0.9111111111111111, 0.3565217391304348)"
core/commands/object/object.go,528,3373,18,"[{'cyclomatic_complexity': 5, 'nloc': 23, 'token_count': 164, 'name': '', 'long_name': '(req cmds.Request,res cmds.Response)', 'start_line': 85, 'end_line': 111, 'full_parameters': [], 'filename': '/home/dimi/Documents/Informatik_Studium/FSS/SoftEvo/DataCollection/FFS_SoftEvo/go-ipfs/core/commands/object/object.go', 'top_nesting_level': 0, 'length': 27, 'fan_in': 0, 'fan_out': 0, 'general_fan_out': 0}, {'cyclomatic_complexity': 5, 'nloc': 23, 'token_count': 165, 'name': '', 'long_name': '(req cmds.Request,res cmds.Response)', 'start_line': 130, 'end_line': 156, 'full_parameters': [], 'filename': '/home/dimi/Documents/Informatik_Studium/FSS/SoftEvo/DataCollection/FFS_SoftEvo/go-ipfs/core/commands/object/object.go', 'top_nesting_level': 0, 'length': 27, 'fan_in': 0, 'fan_out': 0, 'general_fan_out': 0}, {'cyclomatic_complexity': 3, 'nloc': 14, 'token_count': 126, 'name': '', 'long_name': '(res cmds.Response)(io.Reader,error)', 'start_line': 158, 'end_line': 171, 'full_parameters': [], 'filename': '/home/dimi/Documents/Informatik_Studium/FSS/SoftEvo/DataCollection/FFS_SoftEvo/go-ipfs/core/commands/object/object.go', 'top_nesting_level': 0, 'length': 14, 'fan_in': 0, 'fan_out': 0, 'general_fan_out': 0}, {'cyclomatic_complexity': 5, 'nloc': 30, 'token_count': 216, 'name': '', 'long_name': '(req cmds.Request,res cmds.Response)', 'start_line': 199, 'end_line': 234, 'full_parameters': [], 'filename': '/home/dimi/Documents/Informatik_Studium/FSS/SoftEvo/DataCollection/FFS_SoftEvo/go-ipfs/core/commands/object/object.go', 'top_nesting_level': 0, 'length': 36, 'fan_in': 0, 'fan_out': 0, 'general_fan_out': 0}, {'cyclomatic_complexity': 3, 'nloc': 12, 'token_count': 76, 'name': '', 'long_name': '(res cmds.Response)(io.Reader,error)', 'start_line': 237, 'end_line': 250, 'full_parameters': [], 'filename': '/home/dimi/Documents/Informatik_Studium/FSS/SoftEvo/DataCollection/FFS_SoftEvo/go-ipfs/core/commands/object/object.go', 'top_nesting_level': 0, 'length': 14, 'fan_in': 0, 'fan_out': 0, 'general_fan_out': 0}, {'cyclomatic_complexity': 4, 'nloc': 19, 'token_count': 132, 'name': '', 'long_name': '(req cmds.Request,res cmds.Response)', 'start_line': 272, 'end_line': 294, 'full_parameters': [], 'filename': '/home/dimi/Documents/Informatik_Studium/FSS/SoftEvo/DataCollection/FFS_SoftEvo/go-ipfs/core/commands/object/object.go', 'top_nesting_level': 0, 'length': 23, 'fan_in': 0, 'fan_out': 0, 'general_fan_out': 0}, {'cyclomatic_complexity': 1, 'nloc': 3, 'token_count': 22, 'name': '', 'long_name': '(s string,n int)', 'start_line': 301, 'end_line': 303, 'full_parameters': [], 'filename': '/home/dimi/Documents/Informatik_Studium/FSS/SoftEvo/DataCollection/FFS_SoftEvo/go-ipfs/core/commands/object/object.go', 'top_nesting_level': 0, 'length': 3, 'fan_in': 0, 'fan_out': 0, 'general_fan_out': 0}, {'cyclomatic_complexity': 1, 'nloc': 11, 'token_count': 85, 'name': '', 'long_name': '(res cmds.Response)(io.Reader,error)', 'start_line': 297, 'end_line': 311, 'full_parameters': [], 'filename': '/home/dimi/Documents/Informatik_Studium/FSS/SoftEvo/DataCollection/FFS_SoftEvo/go-ipfs/core/commands/object/object.go', 'top_nesting_level': 0, 'length': 15, 'fan_in': 0, 'fan_out': 0, 'general_fan_out': 0}, {'cyclomatic_complexity': 12, 'nloc': 48, 'token_count': 298, 'name': '', 'long_name': '(req cmds.Request,res cmds.Response)', 'start_line': 361, 'end_line': 416, 'full_parameters': [], 'filename': '/home/dimi/Documents/Informatik_Studium/FSS/SoftEvo/DataCollection/FFS_SoftEvo/go-ipfs/core/commands/object/object.go', 'top_nesting_level': 0, 'length': 56, 'fan_in': 0, 'fan_out': 0, 'general_fan_out': 0}, {'cyclomatic_complexity': 1, 'nloc': 4, 'token_count': 43, 'name': '', 'long_name': '(res cmds.Response)(io.Reader,error)', 'start_line': 418, 'end_line': 421, 'full_parameters': [], 'filename': '/home/dimi/Documents/Informatik_Studium/FSS/SoftEvo/DataCollection/FFS_SoftEvo/go-ipfs/core/commands/object/object.go', 'top_nesting_level': 0, 'length': 4, 'fan_in': 0, 'fan_out': 0, 'general_fan_out': 0}, {'cyclomatic_complexity': 5, 'nloc': 23, 'token_count': 148, 'name': '', 'long_name': '(req cmds.Request,res cmds.Response)', 'start_line': 445, 'end_line': 469, 'full_parameters': [], 'filename': '/home/dimi/Documents/Informatik_Studium/FSS/SoftEvo/DataCollection/FFS_SoftEvo/go-ipfs/core/commands/object/object.go', 'top_nesting_level': 0, 'length': 25, 'fan_in': 0, 'fan_out': 0, 'general_fan_out': 0}, {'cyclomatic_complexity': 1, 'nloc': 4, 'token_count': 41, 'name': '', 'long_name': '(res cmds.Response)(io.Reader,error)', 'start_line': 471, 'end_line': 474, 'full_parameters': [], 'filename': '/home/dimi/Documents/Informatik_Studium/FSS/SoftEvo/DataCollection/FFS_SoftEvo/go-ipfs/core/commands/object/object.go', 'top_nesting_level': 0, 'length': 4, 'fan_in': 0, 'fan_out': 0, 'general_fan_out': 0}, {'cyclomatic_complexity': 2, 'nloc': 8, 'token_count': 44, 'name': 'nodeFromTemplate', 'long_name': 'nodeFromTemplate template string', 'start_line': 479, 'end_line': 486, 'full_parameters': ['template string'], 'filename': '/home/dimi/Documents/Informatik_Studium/FSS/SoftEvo/DataCollection/FFS_SoftEvo/go-ipfs/core/commands/object/object.go', 'top_nesting_level': 0, 'length': 8, 'fan_in': 0, 'fan_out': 0, 'general_fan_out': 0}, {'cyclomatic_complexity': 14, 'nloc': 50, 'token_count': 264, 'name': 'objectPut', 'long_name': 'objectPut n * core . IpfsNode , input io . Reader , encoding string , dataFieldEncoding string', 'start_line': 492, 'end_line': 558, 'full_parameters': ['n * core . IpfsNode', ' input io . Reader', ' encoding string', ' dataFieldEncoding string'], 'filename': '/home/dimi/Documents/Informatik_Studium/FSS/SoftEvo/DataCollection/FFS_SoftEvo/go-ipfs/core/commands/object/object.go', 'top_nesting_level': 0, 'length': 67, 'fan_in': 0, 'fan_out': 0, 'general_fan_out': 0}, {'cyclomatic_complexity': 2, 'nloc': 7, 'token_count': 32, 'name': 'getObjectEnc', 'long_name': 'getObjectEnc o interface { }', 'start_line': 571, 'end_line': 579, 'full_parameters': ['o interface { }'], 'filename': '/home/dimi/Documents/Informatik_Studium/FSS/SoftEvo/DataCollection/FFS_SoftEvo/go-ipfs/core/commands/object/object.go', 'top_nesting_level': 0, 'length': 9, 'fan_in': 0, 'fan_out': 0, 'general_fan_out': 0}, {'cyclomatic_complexity': 2, 'nloc': 15, 'token_count': 104, 'name': 'getOutput', 'long_name': 'getOutput dagnode node . Node', 'start_line': 581, 'end_line': 597, 'full_parameters': ['dagnode node . Node'], 'filename': '/home/dimi/Documents/Informatik_Studium/FSS/SoftEvo/DataCollection/FFS_SoftEvo/go-ipfs/core/commands/object/object.go', 'top_nesting_level': 0, 'length': 17, 'fan_in': 0, 'fan_out': 0, 'general_fan_out': 0}, {'cyclomatic_complexity': 5, 'nloc': 25, 'token_count': 171, 'name': 'deserializeNode', 'long_name': 'deserializeNode nd * Node , dataFieldEncoding string', 'start_line': 600, 'end_line': 626, 'full_parameters': ['nd * Node', ' dataFieldEncoding string'], 'filename': '/home/dimi/Documents/Informatik_Studium/FSS/SoftEvo/DataCollection/FFS_SoftEvo/go-ipfs/core/commands/object/object.go', 'top_nesting_level': 0, 'length': 27, 'fan_in': 0, 'fan_out': 0, 'general_fan_out': 0}, {'cyclomatic_complexity': 2, 'nloc': 3, 'token_count': 27, 'name': 'NodeEmpty', 'long_name': 'NodeEmpty node * Node', 'start_line': 628, 'end_line': 630, 'full_parameters': ['node * Node'], 'filename': '/home/dimi/Documents/Informatik_Studium/FSS/SoftEvo/DataCollection/FFS_SoftEvo/go-ipfs/core/commands/object/object.go', 'top_nesting_level': 0, 'length': 3, 'fan_in': 0, 'fan_out': 0, 'general_fan_out': 0}]",461,3052,3,"[{'cyclomatic_complexity': 1, 'nloc': 3, 'token_count': 22, 'name': '', 'long_name': '(s string,n int)', 'start_line': 353, 'end_line': 355, 'full_parameters': [], 'filename': '/home/dimi/Documents/Informatik_Studium/FSS/SoftEvo/DataCollection/FFS_SoftEvo/go-ipfs/core/commands/object/object.go', 'top_nesting_level': 0, 'length': 3, 'fan_in': 0, 'fan_out': 0, 'general_fan_out': 0}, {'cyclomatic_complexity': 6, 'nloc': 29, 'token_count': 175, 'name': 'deserializeNode', 'long_name': 'deserializeNode nd * Node , dataFieldEncoding string', 'start_line': 507, 'end_line': 537, 'full_parameters': ['nd * Node', ' dataFieldEncoding string'], 'filename': '/home/dimi/Documents/Informatik_Studium/FSS/SoftEvo/DataCollection/FFS_SoftEvo/go-ipfs/core/commands/object/object.go', 'top_nesting_level': 0, 'length': 31, 'fan_in': 0, 'fan_out': 0, 'general_fan_out': 0}, {'cyclomatic_complexity': 3, 'nloc': 9, 'token_count': 50, 'name': 'encodeData', 'long_name': 'encodeData data [ ] byte , encoding string', 'start_line': 539, 'end_line': 548, 'full_parameters': ['data [ ] byte', ' encoding string'], 'filename': '/home/dimi/Documents/Informatik_Studium/FSS/SoftEvo/DataCollection/FFS_SoftEvo/go-ipfs/core/commands/object/object.go', 'top_nesting_level': 0, 'length': 10, 'fan_in': 0, 'fan_out': 0, 'general_fan_out': 0}]",-67,-321,-15,115,115,"[{'timestamp': 1491058697.0, 'added_lines': 116, 'deleted_lines': 57, 'nloc': 575}, {'timestamp': 1499331469.0, 'added_lines': 2, 'deleted_lines': 2, 'nloc': 575}, {'timestamp': 1511223906.0, 'added_lines': 1, 'deleted_lines': 1, 'nloc': 575}, {'timestamp': 1511245249.0, 'added_lines': 2, 'deleted_lines': 2, 'nloc': 575}, {'timestamp': 1511289579.0, 'added_lines': 10, 'deleted_lines': 2, 'nloc': 581}, {'timestamp': 1512365669.0, 'added_lines': 3, 'deleted_lines': 3, 'nloc': 581}, {'timestamp': 1511187070.0, 'added_lines': 1, 'deleted_lines': 1, 'nloc': 581}, {'timestamp': 1513436097.0, 'added_lines': 1, 'deleted_lines': 1, 'nloc': 581}, {'timestamp': 1513612261.0, 'added_lines': 1, 'deleted_lines': 1, 'nloc': 581}, {'timestamp': 1515277696.0, 'added_lines': 1, 'deleted_lines': 1, 'nloc': 581}, {'timestamp': 1516838128.0, 'added_lines': 2, 'deleted_lines': 2, 'nloc': 581}, {'timestamp': 1516911711.0, 'added_lines': 6, 'deleted_lines': 5, 'nloc': 582}, {'timestamp': 1517255734.0, 'added_lines': 6, 'deleted_lines': 6, 'nloc': 582}, {'timestamp': 1517352024.0, 'added_lines': 7, 'deleted_lines': 3, 'nloc': 586}, {'timestamp': 1521256014.0, 'added_lines': 32, 'deleted_lines': 30, 'nloc': 588}, {'timestamp': 1521314540.0, 'added_lines': 1, 'deleted_lines': 1, 'nloc': 588}, {'timestamp': 1521500314.0, 'added_lines': 1, 'deleted_lines': 1, 'nloc': 588}, {'timestamp': 1521421769.0, 'added_lines': 1, 'deleted_lines': 1, 'nloc': 588}, {'timestamp': 1521399286.0, 'added_lines': 1, 'deleted_lines': 1, 'nloc': 588}, {'timestamp': 1524596476.0, 'added_lines': 1, 'deleted_lines': 1, 'nloc': 588}, {'timestamp': 1525408792.0, 'added_lines': 1, 'deleted_lines': 1, 'nloc': 588}, {'timestamp': 1528520460.0, 'added_lines': 4, 'deleted_lines': 4, 'nloc': 588}, {'timestamp': 1529406761.0, 'added_lines': 36, 'deleted_lines': 2, 'nloc': 694}, {'timestamp': 1529984485.0, 'added_lines': 1, 'deleted_lines': 1, 'nloc': 588}, {'timestamp': 1531779409.0, 'added_lines': 2, 'deleted_lines': 2, 'nloc': 694}, {'timestamp': 1532764253.0, 'added_lines': 1, 'deleted_lines': 1, 'nloc': 694}, {'timestamp': 1532847462.0, 'added_lines': 1, 'deleted_lines': 1, 'nloc': 694}, {'timestamp': 1532986515.0, 'added_lines': 1, 'deleted_lines': 1, 'nloc': 694}, {'timestamp': 1517607361.0, 'added_lines': 79, 'deleted_lines': 196, 'nloc': 573}, {'timestamp': 1533500571.0, 'added_lines': 1, 'deleted_lines': 1, 'nloc': 573}, {'timestamp': 1533618653.0, 'added_lines': 1, 'deleted_lines': 1, 'nloc': 573}, {'timestamp': 1533779477.0, 'added_lines': 2, 'deleted_lines': 2, 'nloc': 573}, {'timestamp': 1533946888.0, 'added_lines': 2, 'deleted_lines': 2, 'nloc': 573}, {'timestamp': 1534115707.0, 'added_lines': 3, 'deleted_lines': 3, 'nloc': 573}, {'timestamp': 1534195762.0, 'added_lines': 1, 'deleted_lines': 1, 'nloc': 573}, {'timestamp': 1534347022.0, 'added_lines': 3, 'deleted_lines': 3, 'nloc': 573}, {'timestamp': 1534896611.0, 'added_lines': 5, 'deleted_lines': 5, 'nloc': 573}, {'timestamp': 1535601896.0, 'added_lines': 1, 'deleted_lines': 1, 'nloc': 573}, {'timestamp': 1536127655.0, 'added_lines': 8, 'deleted_lines': 5, 'nloc': 576}, {'timestamp': 1536138351.0, 'added_lines': 1, 'deleted_lines': 5, 'nloc': 573}, {'timestamp': 1536388808.0, 'added_lines': 1, 'deleted_lines': 1, 'nloc': 573}, {'timestamp': 1536718784.0, 'added_lines': 3, 'deleted_lines': 3, 'nloc': 573}, {'timestamp': 1536723292.0, 'added_lines': 1, 'deleted_lines': 1, 'nloc': 573}, {'timestamp': 1536861463.0, 'added_lines': 1, 'deleted_lines': 1, 'nloc': 573}, {'timestamp': 1536862229.0, 'added_lines': 2, 'deleted_lines': 2, 'nloc': 573}, {'timestamp': 1523628870.0, 'added_lines': 2, 'deleted_lines': 2, 'nloc': 573}, {'timestamp': 1535044155.0, 'added_lines': 1, 'deleted_lines': 1, 'nloc': 573}, {'timestamp': 1537193530.0, 'added_lines': 1, 'deleted_lines': 1, 'nloc': 573}, {'timestamp': 1537391809.0, 'added_lines': 1, 'deleted_lines': 1, 'nloc': 573}, {'timestamp': 1537790637.0, 'added_lines': 1, 'deleted_lines': 1, 'nloc': 573}, {'timestamp': 1537792589.0, 'added_lines': 2, 'deleted_lines': 2, 'nloc': 573}, {'timestamp': 1538544957.0, 'added_lines': 1, 'deleted_lines': 1, 'nloc': 573}, {'timestamp': 1538694687.0, 'added_lines': 1, 'deleted_lines': 1, 'nloc': 573}, {'timestamp': 1538695953.0, 'added_lines': 1, 'deleted_lines': 1, 'nloc': 573}, {'timestamp': 1538773916.0, 'added_lines': 1, 'deleted_lines': 1, 'nloc': 573}, {'timestamp': 1539176817.0, 'added_lines': 1, 'deleted_lines': 1, 'nloc': 573}, {'timestamp': 1539357340.0, 'added_lines': 1, 'deleted_lines': 1, 'nloc': 573}, {'timestamp': 1539850591.0, 'added_lines': 2, 'deleted_lines': 2, 'nloc': 573}, {'timestamp': 1540400358.0, 'added_lines': 1, 'deleted_lines': 1, 'nloc': 573}, {'timestamp': 1540410565.0, 'added_lines': 1, 'deleted_lines': 1, 'nloc': 573}, {'timestamp': 1540418491.0, 'added_lines': 1, 'deleted_lines': 1, 'nloc': 573}, {'timestamp': 1540552487.0, 'added_lines': 1, 'deleted_lines': 1, 'nloc': 573}, {'timestamp': 1540597832.0, 'added_lines': 1, 'deleted_lines': 1, 'nloc': 573}, {'timestamp': 1540603818.0, 'added_lines': 2, 'deleted_lines': 2, 'nloc': 573}, {'timestamp': 1540605823.0, 'added_lines': 122, 'deleted_lines': 218, 'nloc': 487}, {'timestamp': 1540606122.0, 'added_lines': 6, 'deleted_lines': 0, 'nloc': 490}, {'timestamp': 1540869553.0, 'added_lines': 5, 'deleted_lines': 5, 'nloc': 490}, {'timestamp': 1541189794.0, 'added_lines': 1, 'deleted_lines': 1, 'nloc': 490}, {'timestamp': 1541204121.0, 'added_lines': 4, 'deleted_lines': 4, 'nloc': 490}, {'timestamp': 1541903826.0, 'added_lines': 1, 'deleted_lines': 1, 'nloc': 490}, {'timestamp': 1543443696.0, 'added_lines': 1, 'deleted_lines': 1, 'nloc': 490}, {'timestamp': 1544225843.0, 'added_lines': 1, 'deleted_lines': 1, 'nloc': 490}, {'timestamp': 1544661332.0, 'added_lines': 1, 'deleted_lines': 1, 'nloc': 490}, {'timestamp': 1540556089.0, 'added_lines': 1, 'deleted_lines': 1, 'nloc': 490}, {'timestamp': 1540562190.0, 'added_lines': 1, 'deleted_lines': 1, 'nloc': 490}, {'timestamp': 1542594282.0, 'added_lines': 7, 'deleted_lines': 4, 'nloc': 493}, {'timestamp': 1543031503.0, 'added_lines': 1, 'deleted_lines': 1, 'nloc': 493}, {'timestamp': 1543868676.0, 'added_lines': 3, 'deleted_lines': 2, 'nloc': 494}, {'timestamp': 1544737281.0, 'added_lines': 3, 'deleted_lines': 3, 'nloc': 494}, {'timestamp': 1544785510.0, 'added_lines': 8, 'deleted_lines': 12, 'nloc': 490}, {'timestamp': 1544451987.0, 'added_lines': 6, 'deleted_lines': 6, 'nloc': 490}, {'timestamp': 1547003974.0, 'added_lines': 1, 'deleted_lines': 1, 'nloc': 490}, {'timestamp': 1547152271.0, 'added_lines': 1, 'deleted_lines': 1, 'nloc': 490}, {'timestamp': 1542878205.0, 'added_lines': 31, 'deleted_lines': 6, 'nloc': 513}, {'timestamp': 1547888702.0, 'added_lines': 21, 'deleted_lines': 12, 'nloc': 498}, {'timestamp': 1547499910.0, 'added_lines': 2, 'deleted_lines': 2, 'nloc': 521}, {'timestamp': 1548866534.0, 'added_lines': 1, 'deleted_lines': 1, 'nloc': 521}, {'timestamp': 1549588289.0, 'added_lines': 1, 'deleted_lines': 1, 'nloc': 521}, {'timestamp': 1549672857.0, 'added_lines': 2, 'deleted_lines': 2, 'nloc': 521}, {'timestamp': 1549673846.0, 'added_lines': 2, 'deleted_lines': 2, 'nloc': 521}, {'timestamp': 1549903582.0, 'added_lines': 3, 'deleted_lines': 3, 'nloc': 521}, {'timestamp': 1550185115.0, 'added_lines': 3, 'deleted_lines': 3, 'nloc': 521}, {'timestamp': 1550507829.0, 'added_lines': 4, 'deleted_lines': 4, 'nloc': 521}, {'timestamp': 1550576884.0, 'added_lines': 2, 'deleted_lines': 2, 'nloc': 521}, {'timestamp': 1550610741.0, 'added_lines': 1, 'deleted_lines': 1, 'nloc': 521}, {'timestamp': 1550711994.0, 'added_lines': 3, 'deleted_lines': 3, 'nloc': 521}, {'timestamp': 1550723346.0, 'added_lines': 5, 'deleted_lines': 5, 'nloc': 521}, {'timestamp': 1551138343.0, 'added_lines': 1, 'deleted_lines': 1, 'nloc': 521}, {'timestamp': 1551229859.0, 'added_lines': 3, 'deleted_lines': 3, 'nloc': 521}, {'timestamp': 1551299964.0, 'added_lines': 4, 'deleted_lines': 4, 'nloc': 521}, {'timestamp': 1551471469.0, 'added_lines': 1, 'deleted_lines': 1, 'nloc': 521}, {'timestamp': 1551551196.0, 'added_lines': 7, 'deleted_lines': 7, 'nloc': 521}, {'timestamp': 1554557096.0, 'added_lines': 3, 'deleted_lines': 1, 'nloc': 523}, {'timestamp': 1553529899.0, 'added_lines': 4, 'deleted_lines': 18, 'nloc': 509}, {'timestamp': 1553608614.0, 'added_lines': 5, 'deleted_lines': 5, 'nloc': 509}, {'timestamp': 1553609463.0, 'added_lines': 4, 'deleted_lines': 4, 'nloc': 509}, {'timestamp': 1555807678.0, 'added_lines': 11, 'deleted_lines': 1, 'nloc': 519}, {'timestamp': 1557554420.0, 'added_lines': 30, 'deleted_lines': 31, 'nloc': 518}, {'timestamp': 1557947056.0, 'added_lines': 2, 'deleted_lines': 3, 'nloc': 517}, {'timestamp': 1577243561.0, 'added_lines': 2, 'deleted_lines': 2, 'nloc': 517}, {'timestamp': 1608253728.0, 'added_lines': 1, 'deleted_lines': 1, 'nloc': 517}, {'timestamp': 1616604074.0, 'added_lines': 2, 'deleted_lines': 2, 'nloc': 517}, {'timestamp': 1616605362.0, 'added_lines': 3, 'deleted_lines': 3, 'nloc': 517}, {'timestamp': 1616615390.0, 'added_lines': 21, 'deleted_lines': 21, 'nloc': 517}, {'timestamp': 1619738863.0, 'added_lines': 45, 'deleted_lines': 55, 'nloc': 461}]","{'blocks/blockstore/caching.go': 1, 'blocks/blockstore/util/remove.go': 3, 'cmd/ipfs/daemon.go': 44, 'cmd/ipfs/init.go': 51, 'cmd/ipfs/ipfs.go': 36, 'cmd/ipfs/main.go': 46, 'cmd/ipfs/main_test.go': 4, 'cmd/ipfswatch/main.go': 20, 'cmd/seccat/seccat.go': 26, None: 38, 'commands/channelmarshaler.go': 1, 'commands/cli/cmd_suggestion.go': 1, 'commands/cli/helptext.go': 3, 'commands/cli/helptext_test.go': 2, 'commands/cli/parse.go': 2, 'commands/cli/parse_test.go': 2, 'commands/command.go': 17, 'commands/command_test.go': 8, 'commands/http/client.go': 2, 'commands/http/handler.go': 2, 'commands/http/multifilereader.go': 2, 'commands/http/multifilereader_test.go': 2, 'commands/http/parse.go': 2, 'commands/reqlog.go': 1, 'commands/request.go': 31, 'commands/response.go': 12, 'commands/response_test.go': 8, 'core/bootstrap.go': 24, 'core/commands/active.go': 24, 'core/commands/add.go': 68, 'core/commands/bitswap.go': 68, 'core/commands/block.go': 61, 'core/commands/bootstrap.go': 33, 'core/commands/cat.go': 50, 'core/commands/commands.go': 39, 'core/commands/config.go': 41, 'core/commands/dag/dag.go': 80, 'core/commands/dht.go': 68, 'core/commands/diag.go': 23, 'core/commands/dns.go': 33, 'core/commands/e/error.go': 1, 'core/commands/external.go': 23, 'core/commands/files/files.go': 12, 'core/commands/filestore.go': 45, 'core/commands/get.go': 80, 'core/commands/helptext_test.go': 36, 'core/commands/id.go': 50, 'core/commands/ipns.go': 18, 'core/commands/keystore.go': 45, 'core/commands/log.go': 28, 'core/commands/ls.go': 76, 'core/commands/mount_nofuse.go': 23, 'core/commands/mount_unix.go': 35, 'core/commands/mount_windows.go': 22, 'core/commands/name.go': 10, 'core/commands/object/diff.go': 41, 'core/commands/object/patch.go': 65, 'core/commands/p2p.go': 38, 'core/commands/pin.go': 78, 'core/commands/ping.go': 42, 'core/commands/publish.go': 22, 'core/commands/pubsub.go': 58, 'core/commands/refs.go': 65, 'core/commands/repo.go': 57, 'core/commands/resolve.go': 69, 'core/commands/root.go': 47, 'core/commands/shutdown.go': 33, 'core/commands/stat.go': 45, 'core/commands/swarm.go': 47, 'core/commands/sysdiag.go': 29, 'core/commands/tar.go': 69, 'core/commands/unixfs/ls.go': 68, 'core/commands/unixfs/unixfs.go': 23, 'core/commands/version.go': 27, 'core/core_test.go': 18, 'core/corehttp/commands.go': 69, 'core/corehttp/gateway.go': 36, 'core/coreunix/add.go': 69, 'core/coreunix/add_test.go': 64, 'core/coreunix/metadata_test.go': 54, 'exchange/bitswap/bitswap_test.go': 8, 'exchange/bitswap/decision/engine_test.go': 8, 'exchange/bitswap/message/message_test.go': 5, 'exchange/bitswap/message/pb/Makefile': 1, 'exchange/bitswap/testnet/network_test.go': 8, 'exchange/bitswap/testnet/peernet.go': 8, 'exchange/reprovide/reprovide_test.go': 33, 'fuse/ipns/common.go': 47, 'fuse/node/mount_test.go': 31, 'importer/balanced/balanced_test.go': 11, 'importer/chunk/rabin_test.go': 3, 'importer/helpers/dagbuilder.go': 15, 'importer/importer.go': 15, 'merkledag/utils/utils_test.go': 7, 'mfs/repub_test.go': 11, 'namesys/dns.go': 44, 'namesys/interface.go': 46, 'namesys/ipns_select_test.go': 5, 'namesys/proquint.go': 44, 'namesys/republisher/repub_test.go': 46, 'package.json': 72, 'repo/config/identity.go': 3, 'routing/offline/offline_test.go': 4, 'test/integration/addcat_test.go': 35, 'test/integration/bench_cat_test.go': 34, 'test/integration/bitswap_wo_routing_test.go': 35, 'test/integration/three_legged_cat_test.go': 34, 'core/bootstrap_test.go': 23, 'core/commands/dht_test.go': 22, 'core/commands/get_test.go': 37, 'core/core.go': 57, 'core/corehttp/gateway_test.go': 53, 'core/corehttp/metrics_test.go': 30, 'core/mock/mock.go': 31, 'exchange/bitswap/decision/bench_test.go': 7, 'exchange/bitswap/decision/peer_request_queue_test.go': 7, 'exchange/bitswap/message/message.go': 7, 'exchange/bitswap/network/interface.go': 7, 'exchange/bitswap/network/ipfs_impl.go': 7, 'exchange/bitswap/testnet/interface.go': 6, 'exchange/bitswap/testnet/virtual.go': 8, 'exchange/bitswap/testutils.go': 8, 'fuse/ipns/ipns_test.go': 30, 'fuse/readonly/ipfs_test.go': 62, 'namesys/publisher_test.go': 31, 'namesys/resolve_test.go': 48, 'p2p/p2p.go': 23, 'p2p/registry.go': 10, 'repo/config/bootstrap_peers.go': 7, 'routing/mock/centralized_client.go': 3, 'routing/mock/centralized_server.go': 3, 'routing/mock/centralized_test.go': 3, 'routing/mock/interface.go': 3, 'routing/none/none_client.go': 3, 'test/integration/bench_test.go': 17, 'test/sharness/t0051-object.sh': 5, 'assets/assets.go': 51, 'blocks/blockstore/arc_cache.go': 2, 'blocks/blockstore/arc_cache_test.go': 2, 'blocks/blockstore/blockstore.go': 2, 'blocks/blockstore/blockstore_test.go': 2, 'blocks/blockstore/bloom_cache.go': 2, 'blocks/blockstore/bloom_cache_test.go': 2, 'blocks/blocksutil/block_generator.go': 2, 'blockservice/blockservice.go': 7, 'blockservice/blockservice_test.go': 6, 'blockservice/test/blocks_test.go': 7, 'core/builder.go': 52, 'core/commands/ipnsps.go': 9, 'core/coreapi/coreapi.go': 28, 'core/coreapi/interface/interface.go': 2, 'core/coreapi/unixfs.go': 58, 'core/coreapi/unixfs_test.go': 46, 'core/coredag/cbor.go': 18, 'core/coredag/dagpb.go': 44, 'core/coredag/dagtransl.go': 14, 'core/coredag/raw.go': 44, 'core/corehttp/corehttp.go': 13, 'core/corehttp/gateway_handler.go': 64, 'core/corerepo/gc.go': 48, 'core/corerepo/pinning.go': 21, 'core/coreunix/metadata.go': 50, 'core/pathresolver.go': 46, 'exchange/bitswap/bitswap.go': 7, 'exchange/bitswap/decision/engine.go': 6, 'exchange/bitswap/decision/ledger.go': 6, 'exchange/bitswap/decision/peer_request_queue.go': 6, 'exchange/bitswap/get.go': 6, 'exchange/bitswap/notifications/notifications.go': 4, 'exchange/bitswap/notifications/notifications_test.go': 4, 'exchange/bitswap/session.go': 6, 'exchange/bitswap/session_test.go': 6, 'exchange/bitswap/stat.go': 4, 'exchange/bitswap/wantlist/wantlist.go': 4, 'exchange/bitswap/wantlist/wantlist_test.go': 4, 'exchange/bitswap/wantmanager.go': 6, 'exchange/bitswap/workers.go': 6, 'exchange/interface.go': 2, 'exchange/offline/offline.go': 2, 'exchange/offline/offline_test.go': 2, 'exchange/reprovide/providers.go': 47, 'exchange/reprovide/reprovide.go': 28, 'filestore/filestore.go': 25, 'filestore/filestore_test.go': 45, 'filestore/fsrefstore.go': 25, 'filestore/util.go': 24, 'fuse/ipns/ipns_unix.go': 53, 'fuse/readonly/readonly_unix.go': 55, 'importer/balanced/builder.go': 5, 'importer/chunk/splitting_test.go': 2, 'importer/helpers/helpers.go': 8, 'importer/importer_test.go': 9, 'importer/trickle/trickle_test.go': 10, 'importer/trickle/trickledag.go': 7, 'merkledag/batch.go': 2, 'merkledag/coding.go': 6, 'merkledag/merkledag.go': 8, 'merkledag/merkledag_test.go': 9, 'merkledag/node.go': 6, 'merkledag/node_test.go': 6, 'merkledag/raw.go': 5, 'merkledag/traverse/traverse.go': 5, 'merkledag/traverse/traverse_test.go': 6, 'merkledag/utils/diff.go': 6, 'merkledag/utils/diffenum.go': 5, 'merkledag/utils/diffenum_test.go': 6, 'merkledag/utils/utils.go': 8, 'mfs/dir.go': 15, 'mfs/file.go': 17, 'mfs/mfs_test.go': 19, 'mfs/ops.go': 12, 'mfs/system.go': 17, 'namesys/namesys.go': 49, 'namesys/publisher.go': 52, 'namesys/pubsub.go': 4, 'namesys/pubsub_test.go': 3, 'namesys/republisher/repub.go': 44, 'namesys/routing.go': 49, 'path/path.go': 5, 'path/resolver.go': 4, 'path/resolver_test.go': 4, 'pin/gc/gc.go': 47, 'pin/pin.go': 48, 'pin/pin_test.go': 46, 'pin/set.go': 45, 'pin/set_test.go': 45, 'plugin/ipld.go': 14, 'plugin/loader/initializer.go': 11, 'plugin/plugins/git/git.go': 13, 'repo/config/init.go': 7, 'repo/fsrepo/fsrepo.go': 23, 'repo/fsrepo/lock/lock.go': 2, 'repo/fsrepo/serialize/serialize.go': 4, 'repo/mock.go': 17, 'repo/repo.go': 21, 'routing/offline/offline.go': 2, 'tar/format.go': 54, 'test/dependencies/ma-pipe-unidir/main.go': 9, 'thirdparty/ds-help/key.go': 2, 'thirdparty/pollEndpoint/main.go': 14, 'thirdparty/posinfo/posinfo.go': 3, 'unixfs/archive/archive.go': 8, 'unixfs/archive/tar/writer.go': 9, 'unixfs/hamt/hamt.go': 8, 'unixfs/io/dagreader.go': 8, 'unixfs/io/dirbuilder.go': 5, 'unixfs/io/resolve.go': 8, 'unixfs/mod/dagmodifier.go': 10, 'unixfs/mod/dagmodifier_test.go': 4, 'unixfs/test/utils.go': 11, 'commands/legacy/command.go': 22, 'commands/legacy/legacy.go': 22, 'commands/legacy/legacy_test.go': 23, 'commands/legacy/request.go': 24, 'commands/legacy/response.go': 23, 'commands/legacy/responseemitter.go': 4, 'core/commands/env.go': 5, 'TODO.md': 2, 'core/commands/commands_test.go': 32, 'test/sharness/t0110-gateway.sh': 1, 'test/sharness/t0410-api-add.sh': 1, 'core/coreapi/dag.go': 13, 'core/coreapi/dag_test.go': 3, 'core/coreapi/interface/options/dag.go': 8, 'core/coreapi/key.go': 50, 'core/coreapi/name.go': 51, 'merkledag/test/utils.go': 7, 'namesys/namesys_test.go': 54, 'repo/fsrepo/datastores.go': 14, 'repo/fsrepo/fsrepo_test.go': 18, 'thirdparty/datastore2/datastore_closer.go': 1, 'thirdparty/datastore2/delayed.go': 1, 'thirdparty/datastore2/threadsafe.go': 1, 'unixfs/io/pbdagreader.go': 8, 'mfs/fd.go': 9, 'unixfs/hamt/hamt_stress_test.go': 6, 'unixfs/hamt/hamt_test.go': 6, 'unixfs/io/dagreader_test.go': 3, 'unixfs/io/dirbuilder_test.go': 1, 'core/coreapi/object.go': 56, 'core/commands/files.go': 81, 'core/commands/root_test.go': 1, 'test/sharness/t0090-get.sh': 1, 'path/path_test.go': 1, 'test/api-startup/main.go': 1, 'fuse/mount/fuse.go': 3, 'fuse/mount/mount.go': 9, 'keystore/keystore_test.go': 6, 'namesys/dns_test.go': 11, 'repo/config/config.go': 1, 'unixfs/unixfs.go': 3, 'blocks/blockstoreutil/remove.go': 21, 'blockservice/test/mock.go': 4, 'cmd/ipfs/util/ulimit.go': 8, 'cmd/seccat/util.go': 8, 'core/coreapi/pin.go': 49, 'core/corehttp/logs.go': 8, 'fuse/node/mount_unix.go': 8, 'keystore/keystore.go': 8, 'keystore/memkeystore.go': 5, 'namesys/ipns_validate_test.go': 2, 'namesys/validator.go': 2, 'path/resolver/resolver.go': 5, 'plugin/loader/load.go': 6, 'thirdparty/verifbs/verifbs.go': 21, 'cmd/ipfs/util/ulimit_freebsd.go': 2, 'cmd/ipfs/util/ulimit_unix.go': 2, 'core/coreapi/block.go': 20, 'core/coreapi/block_test.go': 2, 'core/coreapi/interface/coreapi.go': 9, 'core/coreapi/interface/dag.go': 9, 'core/coreapi/interface/object.go': 10, 'core/coreapi/interface/options/block.go': 3, 'core/coreapi/interface/path.go': 34, 'core/coreapi/interface/unixfs.go': 15, 'fuse/ipns/link_unix.go': 2, 'fuse/node/mount_darwin.go': 2, 'merkledag/errservice.go': 2, 'merkledag/readonly.go': 2, 'merkledag/readonly_test.go': 2, 'merkledag/rwservice.go': 2, 'merkledag/session.go': 2, 'path/resolver/resolver_test.go': 3, 'thirdparty/verifcid/validate.go': 2, 'thirdparty/verifcid/validate_test.go': 2, 'namesys/ipns_resolver_validation_test.go': 45, 'test/sharness/t0170-dht.sh': 1, 'core/commands/urlstore.go': 58, 'unixfs/io/directory.go': 3, 'Rules.mk': 1, 'dagutils/diff.go': 43, 'dagutils/diffenum.go': 39, 'dagutils/diffenum_test.go': 39, 'dagutils/utils.go': 40, 'dagutils/utils_test.go': 40, 'unixfs/io/directory_test.go': 2, 'core/coreapi/name_test.go': 34, 'core/coreapi/path.go': 51, 'core/coreunix/cat.go': 16, 'core/pathresolver_test.go': 39, 'namesys/base.go': 43, 'namesys/cache.go': 39, 'unixfs/importer/balanced/balanced_test.go': 1, 'unixfs/importer/balanced/builder.go': 1, 'unixfs/importer/helpers/dagbuilder.go': 1, 'unixfs/importer/helpers/helpers.go': 1, 'unixfs/importer/importer.go': 1, 'unixfs/importer/importer_test.go': 1, 'unixfs/importer/trickle/trickle_test.go': 1, 'unixfs/importer/trickle/trickledag.go': 1, 'unixfs/unixfs_test.go': 1, 'core/coreapi/interface/options/object.go': 1, 'core/coreapi/interface/key.go': 7, 'filestore/pb/dataobj.pb.go': 3, 'pin/internal/pb/header.pb.go': 3, 'thirdparty/cidv0v1/blockstore.go': 16, 'repo/fsrepo/config_test.go': 13, 'repo/fsrepo/misc.go': 13, 'test/bench/bench_cli_ipfs_add/main.go': 14, 'test/bench/offline_add/main.go': 14, 'core/commands/cmdenv/env.go': 36, 'core/commands/name/ipns.go': 51, 'core/commands/name/publish.go': 39, 'core/coreapi/dht.go': 34, 'core/coreapi/dht_test.go': 5, 'test/sharness/t0275-cid-security.sh': 1, 'core/commands/name/ipnsps.go': 26, 'core/commands/name/name.go': 21, 'test/sharness/lib/test-lib.sh': 1, 'core/coreapi/interface/dht.go': 10, 'p2p/listener.go': 13, 'p2p/local.go': 13, 'p2p/remote.go': 13, 'p2p/stream.go': 13, 'core/coreapi/interface/swarm.go': 9, 'core/coreapi/swarm.go': 23, 'core/coreapi/interface/options/unixfs.go': 16, 'core/coreapi/pubsub.go': 21, 'core/coreapi/unixfile.go': 20, 'core/commands/cid.go': 17, 'cmd/ipfs/dnsresolve_test.go': 5, 'core/coreapi/interface/pubsub.go': 4, 'test/dependencies/iptb/iptb.go': 12, 'plugin/plugins/badgerds/badgerds.go': 4, 'plugin/plugins/flatfs/flatfs.go': 4, 'plugin/plugins/levelds/levelds.go': 3, 'commands/context.go': 21, 'core/corehttp/proxy.go': 9, 'core/commands/cmdenv/file.go': 4, 'core/coreapi/interface/tests/name.go': 4, 'core/coreapi/interface/tests/unixfs.go': 4, 'core/coreapi/test/api_test.go': 13, 'core/commands/cmdenv/cidbase.go': 11, 'core/commands/cmdenv/cidbase_test.go': 3, 'test/sharness/t0040-add-and-cat.sh': 2, 'test/sharness/t0045-ls.sh': 1, 'test/sharness/t0051-object-data/mixed.json': 1, 'test/sharness/t0053-dag.sh': 1, 'test/sharness/t0085-pins.sh': 1, 'test/sharness/t0095-refs.sh': 1, 'test/sharness/t0160-resolve.sh': 1, 'test/sharness/t0210-tar.sh': 1, 'test/sharness/t0250-files-api.sh': 1, 'test/sharness/t0271-filestore-utils.sh': 1, 'test/sharness/t0272-urlstore.sh': 2, 'plugin/loader/loader.go': 12, 'core/corehttp/ipns_hostname.go': 11, 'plugin/daemon.go': 10, 'core/corerepo/stat.go': 2, 'core/corehttp/metrics.go': 1, 'core/corehttp/proxy_test.go': 1, 'plugin/tracer.go': 1, 'thirdparty/notifier/notifier.go': 1, 'README.md': 5, 'go.mod': 1, 'go.sum': 1, 'package-list.json': 1, 'mk/util.mk': 1, 'test/sharness/README.md': 1, 'test/sharness/t0175-reprovider.sh': 1, 'test/sharness/t0184-http-proxy-over-p2p.sh': 1, 'core/commands/pin/remotepin.go': 1, 'core/commands/pin/pin.go': 1, 'core/commands/stat_dht.go': 1}","('core/commands/dag/dag.go', 0.6956521739130435, 0.6666666666666666)"
core/commands/object/patch.go,292,1957,5,"[{'cyclomatic_complexity': 2, 'nloc': 7, 'token_count': 57, 'name': 'objectMarshaler', 'long_name': 'objectMarshaler res cmds . Response', 'start_line': 35, 'end_line': 42, 'full_parameters': ['res cmds . Response'], 'filename': '/home/dimi/Documents/Informatik_Studium/FSS/SoftEvo/DataCollection/FFS_SoftEvo/go-ipfs/core/commands/object/patch.go', 'top_nesting_level': 0, 'length': 8, 'fan_in': 0, 'fan_out': 0, 'general_fan_out': 0}, {'cyclomatic_complexity': 8, 'nloc': 39, 'token_count': 267, 'name': '', 'long_name': '(req cmds.Request,res cmds.Response)', 'start_line': 63, 'end_line': 109, 'full_parameters': [], 'filename': '/home/dimi/Documents/Informatik_Studium/FSS/SoftEvo/DataCollection/FFS_SoftEvo/go-ipfs/core/commands/object/patch.go', 'top_nesting_level': 0, 'length': 47, 'fan_in': 0, 'fan_out': 0, 'general_fan_out': 0}, {'cyclomatic_complexity': 8, 'nloc': 39, 'token_count': 257, 'name': '', 'long_name': '(req cmds.Request,res cmds.Response)', 'start_line': 131, 'end_line': 177, 'full_parameters': [], 'filename': '/home/dimi/Documents/Informatik_Studium/FSS/SoftEvo/DataCollection/FFS_SoftEvo/go-ipfs/core/commands/object/patch.go', 'top_nesting_level': 0, 'length': 47, 'fan_in': 0, 'fan_out': 0, 'general_fan_out': 0}, {'cyclomatic_complexity': 7, 'nloc': 36, 'token_count': 254, 'name': '', 'long_name': '(req cmds.Request,res cmds.Response)', 'start_line': 195, 'end_line': 239, 'full_parameters': [], 'filename': '/home/dimi/Documents/Informatik_Studium/FSS/SoftEvo/DataCollection/FFS_SoftEvo/go-ipfs/core/commands/object/patch.go', 'top_nesting_level': 0, 'length': 45, 'fan_in': 0, 'fan_out': 0, 'general_fan_out': 0}, {'cyclomatic_complexity': 6, 'nloc': 28, 'token_count': 187, 'name': '*', 'long_name': '()*', 'start_line': 308, 'end_line': 342, 'full_parameters': [], 'filename': '/home/dimi/Documents/Informatik_Studium/FSS/SoftEvo/DataCollection/FFS_SoftEvo/go-ipfs/core/commands/object/patch.go', 'top_nesting_level': 0, 'length': 35, 'fan_in': 0, 'fan_out': 0, 'general_fan_out': 0}]",203,1581,0,[],-89,-376,-5,73,73,"[{'timestamp': 1491058697.0, 'added_lines': 61, 'deleted_lines': 54, 'nloc': 297}, {'timestamp': 1499331469.0, 'added_lines': 1, 'deleted_lines': 1, 'nloc': 297}, {'timestamp': 1511223906.0, 'added_lines': 1, 'deleted_lines': 1, 'nloc': 297}, {'timestamp': 1512590374.0, 'added_lines': 1, 'deleted_lines': 7, 'nloc': 292}, {'timestamp': 1512365669.0, 'added_lines': 1, 'deleted_lines': 1, 'nloc': 292}, {'timestamp': 1511187070.0, 'added_lines': 1, 'deleted_lines': 1, 'nloc': 292}, {'timestamp': 1512671605.0, 'added_lines': 5, 'deleted_lines': 2, 'nloc': 294}, {'timestamp': 1513436097.0, 'added_lines': 1, 'deleted_lines': 1, 'nloc': 294}, {'timestamp': 1513612261.0, 'added_lines': 1, 'deleted_lines': 1, 'nloc': 294}, {'timestamp': 1515277696.0, 'added_lines': 1, 'deleted_lines': 1, 'nloc': 294}, {'timestamp': 1516911711.0, 'added_lines': 6, 'deleted_lines': 6, 'nloc': 294}, {'timestamp': 1517453697.0, 'added_lines': 1, 'deleted_lines': 1, 'nloc': 294}, {'timestamp': 1521256014.0, 'added_lines': 50, 'deleted_lines': 33, 'nloc': 307}, {'timestamp': 1521314540.0, 'added_lines': 1, 'deleted_lines': 1, 'nloc': 307}, {'timestamp': 1521500314.0, 'added_lines': 1, 'deleted_lines': 1, 'nloc': 307}, {'timestamp': 1524596476.0, 'added_lines': 1, 'deleted_lines': 1, 'nloc': 307}, {'timestamp': 1525408792.0, 'added_lines': 2, 'deleted_lines': 2, 'nloc': 307}, {'timestamp': 1528520460.0, 'added_lines': 3, 'deleted_lines': 3, 'nloc': 307}, {'timestamp': 1529984485.0, 'added_lines': 2, 'deleted_lines': 2, 'nloc': 307}, {'timestamp': 1532722333.0, 'added_lines': 1, 'deleted_lines': 1, 'nloc': 307}, {'timestamp': 1532764253.0, 'added_lines': 1, 'deleted_lines': 1, 'nloc': 307}, {'timestamp': 1532847462.0, 'added_lines': 1, 'deleted_lines': 1, 'nloc': 307}, {'timestamp': 1532986515.0, 'added_lines': 1, 'deleted_lines': 1, 'nloc': 307}, {'timestamp': 1517607361.0, 'added_lines': 28, 'deleted_lines': 132, 'nloc': 223}, {'timestamp': 1532551757.0, 'added_lines': 1, 'deleted_lines': 1, 'nloc': 223}, {'timestamp': 1533779477.0, 'added_lines': 1, 'deleted_lines': 1, 'nloc': 223}, {'timestamp': 1533946888.0, 'added_lines': 2, 'deleted_lines': 2, 'nloc': 223}, {'timestamp': 1534896611.0, 'added_lines': 2, 'deleted_lines': 2, 'nloc': 223}, {'timestamp': 1534903410.0, 'added_lines': 2, 'deleted_lines': 13, 'nloc': 217}, {'timestamp': 1523628870.0, 'added_lines': 8, 'deleted_lines': 12, 'nloc': 213}, {'timestamp': 1535044155.0, 'added_lines': 1, 'deleted_lines': 1, 'nloc': 213}, {'timestamp': 1537193530.0, 'added_lines': 1, 'deleted_lines': 1, 'nloc': 213}, {'timestamp': 1537391809.0, 'added_lines': 1, 'deleted_lines': 1, 'nloc': 213}, {'timestamp': 1537792589.0, 'added_lines': 1, 'deleted_lines': 1, 'nloc': 213}, {'timestamp': 1539850591.0, 'added_lines': 2, 'deleted_lines': 2, 'nloc': 213}, {'timestamp': 1540400723.0, 'added_lines': 5, 'deleted_lines': 5, 'nloc': 213}, {'timestamp': 1540552487.0, 'added_lines': 1, 'deleted_lines': 1, 'nloc': 213}, {'timestamp': 1540597832.0, 'added_lines': 1, 'deleted_lines': 1, 'nloc': 213}, {'timestamp': 1540605823.0, 'added_lines': 55, 'deleted_lines': 72, 'nloc': 199}, {'timestamp': 1540869553.0, 'added_lines': 5, 'deleted_lines': 5, 'nloc': 199}, {'timestamp': 1541204121.0, 'added_lines': 1, 'deleted_lines': 1, 'nloc': 199}, {'timestamp': 1544661332.0, 'added_lines': 1, 'deleted_lines': 1, 'nloc': 199}, {'timestamp': 1540556089.0, 'added_lines': 1, 'deleted_lines': 1, 'nloc': 199}, {'timestamp': 1540562190.0, 'added_lines': 2, 'deleted_lines': 2, 'nloc': 199}, {'timestamp': 1542594282.0, 'added_lines': 17, 'deleted_lines': 11, 'nloc': 205}, {'timestamp': 1543031503.0, 'added_lines': 2, 'deleted_lines': 2, 'nloc': 205}, {'timestamp': 1543868676.0, 'added_lines': 5, 'deleted_lines': 4, 'nloc': 206}, {'timestamp': 1544737281.0, 'added_lines': 5, 'deleted_lines': 5, 'nloc': 206}, {'timestamp': 1544785510.0, 'added_lines': 8, 'deleted_lines': 15, 'nloc': 199}, {'timestamp': 1544451987.0, 'added_lines': 4, 'deleted_lines': 4, 'nloc': 199}, {'timestamp': 1547152271.0, 'added_lines': 1, 'deleted_lines': 1, 'nloc': 199}, {'timestamp': 1547887967.0, 'added_lines': 6, 'deleted_lines': 2, 'nloc': 202}, {'timestamp': 1548866534.0, 'added_lines': 1, 'deleted_lines': 1, 'nloc': 202}, {'timestamp': 1549672857.0, 'added_lines': 2, 'deleted_lines': 2, 'nloc': 202}, {'timestamp': 1549673846.0, 'added_lines': 2, 'deleted_lines': 2, 'nloc': 202}, {'timestamp': 1549903582.0, 'added_lines': 3, 'deleted_lines': 3, 'nloc': 202}, {'timestamp': 1550185115.0, 'added_lines': 2, 'deleted_lines': 2, 'nloc': 202}, {'timestamp': 1550507829.0, 'added_lines': 3, 'deleted_lines': 3, 'nloc': 202}, {'timestamp': 1550576884.0, 'added_lines': 2, 'deleted_lines': 2, 'nloc': 202}, {'timestamp': 1550610741.0, 'added_lines': 1, 'deleted_lines': 1, 'nloc': 202}, {'timestamp': 1550711994.0, 'added_lines': 2, 'deleted_lines': 2, 'nloc': 202}, {'timestamp': 1550723346.0, 'added_lines': 2, 'deleted_lines': 2, 'nloc': 202}, {'timestamp': 1551138343.0, 'added_lines': 1, 'deleted_lines': 1, 'nloc': 202}, {'timestamp': 1551229859.0, 'added_lines': 2, 'deleted_lines': 2, 'nloc': 202}, {'timestamp': 1551299964.0, 'added_lines': 3, 'deleted_lines': 3, 'nloc': 202}, {'timestamp': 1551471469.0, 'added_lines': 1, 'deleted_lines': 1, 'nloc': 202}, {'timestamp': 1551551196.0, 'added_lines': 4, 'deleted_lines': 4, 'nloc': 202}, {'timestamp': 1553529899.0, 'added_lines': 5, 'deleted_lines': 22, 'nloc': 187}, {'timestamp': 1553608614.0, 'added_lines': 6, 'deleted_lines': 6, 'nloc': 187}, {'timestamp': 1553609463.0, 'added_lines': 5, 'deleted_lines': 5, 'nloc': 187}, {'timestamp': 1557554420.0, 'added_lines': 21, 'deleted_lines': 22, 'nloc': 186}, {'timestamp': 1616604074.0, 'added_lines': 2, 'deleted_lines': 2, 'nloc': 186}, {'timestamp': 1619738863.0, 'added_lines': 39, 'deleted_lines': 13, 'nloc': 203}]","{'blocks/blockstore/caching.go': 1, 'blocks/blockstore/util/remove.go': 2, 'cmd/ipfs/daemon.go': 40, 'cmd/ipfs/init.go': 42, 'cmd/ipfs/ipfs.go': 36, 'cmd/ipfs/main.go': 39, 'cmd/ipfs/main_test.go': 4, 'cmd/ipfswatch/main.go': 13, 'cmd/seccat/seccat.go': 14, None: 36, 'commands/channelmarshaler.go': 1, 'commands/cli/cmd_suggestion.go': 1, 'commands/cli/helptext.go': 2, 'commands/cli/helptext_test.go': 2, 'commands/cli/parse.go': 2, 'commands/cli/parse_test.go': 2, 'commands/command.go': 17, 'commands/command_test.go': 8, 'commands/http/client.go': 2, 'commands/http/handler.go': 2, 'commands/http/multifilereader.go': 2, 'commands/http/multifilereader_test.go': 2, 'commands/http/parse.go': 2, 'commands/reqlog.go': 1, 'commands/request.go': 28, 'commands/response.go': 12, 'commands/response_test.go': 8, 'core/bootstrap.go': 14, 'core/commands/active.go': 24, 'core/commands/add.go': 53, 'core/commands/bitswap.go': 43, 'core/commands/block.go': 58, 'core/commands/bootstrap.go': 26, 'core/commands/cat.go': 50, 'core/commands/commands.go': 39, 'core/commands/config.go': 33, 'core/commands/dag/dag.go': 49, 'core/commands/dht.go': 38, 'core/commands/diag.go': 23, 'core/commands/dns.go': 33, 'core/commands/e/error.go': 1, 'core/commands/external.go': 23, 'core/commands/files/files.go': 11, 'core/commands/filestore.go': 40, 'core/commands/get.go': 54, 'core/commands/helptext_test.go': 36, 'core/commands/id.go': 35, 'core/commands/ipns.go': 14, 'core/commands/keystore.go': 45, 'core/commands/log.go': 29, 'core/commands/ls.go': 44, 'core/commands/mount_nofuse.go': 23, 'core/commands/mount_unix.go': 27, 'core/commands/mount_windows.go': 22, 'core/commands/name.go': 10, 'core/commands/object/diff.go': 41, 'core/commands/object/object.go': 65, 'core/commands/p2p.go': 30, 'core/commands/pin.go': 44, 'core/commands/ping.go': 33, 'core/commands/publish.go': 15, 'core/commands/pubsub.go': 48, 'core/commands/refs.go': 33, 'core/commands/repo.go': 42, 'core/commands/resolve.go': 42, 'core/commands/root.go': 44, 'core/commands/shutdown.go': 34, 'core/commands/stat.go': 42, 'core/commands/swarm.go': 35, 'core/commands/sysdiag.go': 26, 'core/commands/tar.go': 41, 'core/commands/unixfs/ls.go': 40, 'core/commands/unixfs/unixfs.go': 23, 'core/commands/version.go': 27, 'core/core_test.go': 8, 'core/corehttp/commands.go': 42, 'core/corehttp/gateway.go': 22, 'core/coreunix/add.go': 39, 'core/coreunix/add_test.go': 35, 'core/coreunix/metadata_test.go': 24, 'exchange/bitswap/bitswap_test.go': 7, 'exchange/bitswap/decision/engine_test.go': 7, 'exchange/bitswap/message/message_test.go': 3, 'exchange/bitswap/message/pb/Makefile': 1, 'exchange/bitswap/testnet/network_test.go': 7, 'exchange/bitswap/testnet/peernet.go': 7, 'exchange/reprovide/reprovide_test.go': 15, 'fuse/ipns/common.go': 20, 'fuse/node/mount_test.go': 14, 'importer/balanced/balanced_test.go': 7, 'importer/chunk/rabin_test.go': 2, 'importer/helpers/dagbuilder.go': 12, 'importer/importer.go': 11, 'merkledag/utils/utils_test.go': 4, 'mfs/repub_test.go': 8, 'namesys/dns.go': 17, 'namesys/interface.go': 18, 'namesys/ipns_select_test.go': 4, 'namesys/proquint.go': 17, 'namesys/republisher/repub_test.go': 19, 'package.json': 44, 'repo/config/identity.go': 3, 'routing/offline/offline_test.go': 4, 'test/integration/addcat_test.go': 21, 'test/integration/bench_cat_test.go': 20, 'test/integration/bitswap_wo_routing_test.go': 17, 'test/integration/three_legged_cat_test.go': 20, 'core/bootstrap_test.go': 13, 'core/commands/dht_test.go': 13, 'core/commands/get_test.go': 37, 'core/core.go': 26, 'core/corehttp/gateway_test.go': 26, 'core/corehttp/metrics_test.go': 16, 'core/mock/mock.go': 16, 'exchange/bitswap/decision/bench_test.go': 6, 'exchange/bitswap/decision/peer_request_queue_test.go': 6, 'exchange/bitswap/message/message.go': 6, 'exchange/bitswap/network/interface.go': 6, 'exchange/bitswap/network/ipfs_impl.go': 6, 'exchange/bitswap/testnet/interface.go': 6, 'exchange/bitswap/testnet/virtual.go': 6, 'exchange/bitswap/testutils.go': 6, 'fuse/ipns/ipns_test.go': 13, 'fuse/readonly/ipfs_test.go': 32, 'namesys/publisher_test.go': 14, 'namesys/resolve_test.go': 19, 'p2p/p2p.go': 13, 'p2p/registry.go': 8, 'repo/config/bootstrap_peers.go': 7, 'routing/mock/centralized_client.go': 3, 'routing/mock/centralized_server.go': 3, 'routing/mock/centralized_test.go': 3, 'routing/mock/interface.go': 3, 'routing/none/none_client.go': 3, 'test/integration/bench_test.go': 13, 'merkledag/utils/utils.go': 6, 'test/sharness/t0051-object.sh': 1, 'assets/assets.go': 23, 'blocks/blockstore/arc_cache.go': 1, 'blocks/blockstore/arc_cache_test.go': 1, 'blocks/blockstore/blockstore.go': 2, 'blocks/blockstore/blockstore_test.go': 1, 'blocks/blockstore/bloom_cache.go': 1, 'blocks/blockstore/bloom_cache_test.go': 1, 'blocks/blocksutil/block_generator.go': 1, 'blockservice/blockservice.go': 6, 'blockservice/blockservice_test.go': 4, 'blockservice/test/blocks_test.go': 5, 'core/builder.go': 24, 'core/commands/ipnsps.go': 9, 'core/coreapi/coreapi.go': 15, 'core/coreapi/interface/interface.go': 1, 'core/coreapi/unixfs.go': 28, 'core/coreapi/unixfs_test.go': 21, 'core/coredag/cbor.go': 8, 'core/coredag/dagpb.go': 14, 'core/coredag/dagtransl.go': 6, 'core/coredag/raw.go': 14, 'core/corehttp/corehttp.go': 11, 'core/corehttp/gateway_handler.go': 36, 'core/corerepo/gc.go': 22, 'core/corerepo/pinning.go': 9, 'core/coreunix/metadata.go': 21, 'core/pathresolver.go': 17, 'exchange/bitswap/bitswap.go': 5, 'exchange/bitswap/decision/engine.go': 5, 'exchange/bitswap/decision/ledger.go': 5, 'exchange/bitswap/decision/peer_request_queue.go': 5, 'exchange/bitswap/get.go': 4, 'exchange/bitswap/notifications/notifications.go': 2, 'exchange/bitswap/notifications/notifications_test.go': 2, 'exchange/bitswap/session.go': 5, 'exchange/bitswap/session_test.go': 4, 'exchange/bitswap/stat.go': 2, 'exchange/bitswap/wantlist/wantlist.go': 2, 'exchange/bitswap/wantlist/wantlist_test.go': 2, 'exchange/bitswap/wantmanager.go': 5, 'exchange/bitswap/workers.go': 5, 'exchange/interface.go': 1, 'exchange/offline/offline.go': 1, 'exchange/offline/offline_test.go': 1, 'exchange/reprovide/providers.go': 17, 'exchange/reprovide/reprovide.go': 13, 'filestore/filestore.go': 12, 'filestore/filestore_test.go': 16, 'filestore/fsrefstore.go': 11, 'filestore/util.go': 11, 'fuse/ipns/ipns_unix.go': 24, 'fuse/readonly/readonly_unix.go': 25, 'importer/balanced/builder.go': 2, 'importer/chunk/splitting_test.go': 1, 'importer/helpers/helpers.go': 4, 'importer/importer_test.go': 6, 'importer/trickle/trickle_test.go': 6, 'importer/trickle/trickledag.go': 3, 'merkledag/batch.go': 1, 'merkledag/coding.go': 2, 'merkledag/merkledag.go': 3, 'merkledag/merkledag_test.go': 5, 'merkledag/node.go': 3, 'merkledag/node_test.go': 3, 'merkledag/raw.go': 2, 'merkledag/traverse/traverse.go': 2, 'merkledag/traverse/traverse_test.go': 3, 'merkledag/utils/diff.go': 3, 'merkledag/utils/diffenum.go': 2, 'merkledag/utils/diffenum_test.go': 3, 'mfs/dir.go': 7, 'mfs/file.go': 9, 'mfs/mfs_test.go': 10, 'mfs/ops.go': 4, 'mfs/system.go': 10, 'namesys/namesys.go': 21, 'namesys/publisher.go': 24, 'namesys/pubsub.go': 3, 'namesys/pubsub_test.go': 3, 'namesys/republisher/repub.go': 17, 'namesys/routing.go': 21, 'path/path.go': 2, 'path/resolver.go': 3, 'path/resolver_test.go': 2, 'pin/gc/gc.go': 18, 'pin/pin.go': 19, 'pin/pin_test.go': 17, 'pin/set.go': 15, 'pin/set_test.go': 16, 'plugin/ipld.go': 6, 'plugin/loader/initializer.go': 4, 'plugin/plugins/git/git.go': 6, 'repo/config/init.go': 7, 'repo/fsrepo/fsrepo.go': 12, 'repo/fsrepo/lock/lock.go': 2, 'repo/fsrepo/serialize/serialize.go': 2, 'repo/mock.go': 9, 'repo/repo.go': 10, 'routing/offline/offline.go': 2, 'tar/format.go': 26, 'test/dependencies/ma-pipe-unidir/main.go': 6, 'thirdparty/ds-help/key.go': 1, 'thirdparty/pollEndpoint/main.go': 11, 'thirdparty/posinfo/posinfo.go': 1, 'unixfs/archive/archive.go': 4, 'unixfs/archive/tar/writer.go': 5, 'unixfs/hamt/hamt.go': 5, 'unixfs/io/dagreader.go': 5, 'unixfs/io/dirbuilder.go': 3, 'unixfs/io/resolve.go': 5, 'unixfs/mod/dagmodifier.go': 7, 'unixfs/mod/dagmodifier_test.go': 3, 'unixfs/test/utils.go': 7, 'commands/legacy/command.go': 22, 'commands/legacy/legacy.go': 22, 'commands/legacy/legacy_test.go': 23, 'commands/legacy/request.go': 24, 'commands/legacy/response.go': 23, 'commands/legacy/responseemitter.go': 4, 'core/commands/env.go': 6, 'TODO.md': 2, 'core/commands/commands_test.go': 32, 'test/sharness/t0110-gateway.sh': 1, 'test/sharness/t0410-api-add.sh': 1, 'core/coreapi/dag.go': 6, 'merkledag/test/utils.go': 4, 'mfs/fd.go': 4, 'unixfs/hamt/hamt_stress_test.go': 4, 'unixfs/hamt/hamt_test.go': 5, 'unixfs/io/dagreader_test.go': 3, 'unixfs/io/dirbuilder_test.go': 1, 'unixfs/io/pbdagreader.go': 4, 'cmd/ipfs/util/ulimit.go': 9, 'cmd/seccat/util.go': 9, 'core/coreapi/key.go': 23, 'core/coreapi/name.go': 23, 'core/corehttp/logs.go': 9, 'fuse/mount/mount.go': 9, 'fuse/node/mount_unix.go': 9, 'importer/chunk/splitting.go': 1, 'namesys/ipns_validate_test.go': 3, 'plugin/loader/load.go': 7, 'repo/fsrepo/datastores.go': 9, 'core/commands/files.go': 53, 'core/commands/root_test.go': 1, 'test/sharness/t0090-get.sh': 1, 'blocks/blockstoreutil/remove.go': 10, 'blockservice/test/mock.go': 3, 'core/coreapi/pin.go': 21, 'keystore/keystore.go': 8, 'keystore/keystore_test.go': 5, 'keystore/memkeystore.go': 5, 'namesys/namesys_test.go': 24, 'namesys/validator.go': 2, 'path/resolver/resolver.go': 4, 'repo/fsrepo/fsrepo_test.go': 7, 'thirdparty/verifbs/verifbs.go': 10, 'cmd/ipfs/util/ulimit_freebsd.go': 2, 'cmd/ipfs/util/ulimit_unix.go': 2, 'core/coreapi/block.go': 16, 'core/coreapi/block_test.go': 2, 'core/coreapi/dag_test.go': 2, 'core/coreapi/interface/coreapi.go': 3, 'core/coreapi/interface/dag.go': 3, 'core/coreapi/interface/object.go': 5, 'core/coreapi/interface/options/block.go': 2, 'core/coreapi/interface/options/dag.go': 3, 'core/coreapi/interface/path.go': 6, 'core/coreapi/interface/unixfs.go': 8, 'core/coreapi/object.go': 26, 'fuse/ipns/link_unix.go': 2, 'fuse/mount/fuse.go': 2, 'fuse/node/mount_darwin.go': 2, 'merkledag/errservice.go': 1, 'merkledag/readonly.go': 1, 'merkledag/readonly_test.go': 1, 'merkledag/rwservice.go': 1, 'merkledag/session.go': 1, 'path/resolver/resolver_test.go': 2, 'thirdparty/verifcid/validate.go': 1, 'thirdparty/verifcid/validate_test.go': 1, 'namesys/ipns_resolver_validation_test.go': 17, 'test/sharness/t0170-dht.sh': 1, 'dagutils/diff.go': 18, 'dagutils/diffenum.go': 13, 'dagutils/diffenum_test.go': 13, 'dagutils/utils.go': 14, 'dagutils/utils_test.go': 14, 'Rules.mk': 1, 'unixfs/io/directory.go': 2, 'unixfs/io/directory_test.go': 2, 'unixfs/unixfs.go': 2, 'core/coreapi/name_test.go': 10, 'core/coreapi/path.go': 24, 'core/coreunix/cat.go': 6, 'core/pathresolver_test.go': 12, 'namesys/base.go': 16, 'namesys/cache.go': 12, 'core/commands/urlstore.go': 30, 'unixfs/importer/balanced/balanced_test.go': 1, 'unixfs/importer/balanced/builder.go': 1, 'unixfs/importer/helpers/dagbuilder.go': 1, 'unixfs/importer/helpers/helpers.go': 1, 'unixfs/importer/importer.go': 1, 'unixfs/importer/importer_test.go': 1, 'unixfs/importer/trickle/trickle_test.go': 1, 'unixfs/importer/trickle/trickledag.go': 1, 'unixfs/unixfs_test.go': 1, 'core/coreapi/interface/options/object.go': 1, 'core/coreapi/interface/key.go': 4, 'filestore/pb/dataobj.pb.go': 3, 'pin/internal/pb/header.pb.go': 3, 'thirdparty/cidv0v1/blockstore.go': 7, 'repo/fsrepo/config_test.go': 6, 'repo/fsrepo/misc.go': 6, 'test/bench/bench_cli_ipfs_add/main.go': 7, 'test/bench/offline_add/main.go': 7, 'core/commands/cmdenv/env.go': 29, 'core/commands/name/ipns.go': 30, 'core/commands/name/ipnsps.go': 24, 'core/commands/name/name.go': 22, 'core/commands/name/publish.go': 33, 'test/sharness/lib/test-lib.sh': 1, 'core/coreapi/dht.go': 14, 'core/coreapi/dht_test.go': 2, 'core/coreapi/interface/dht.go': 2, 'p2p/listener.go': 5, 'p2p/local.go': 5, 'p2p/remote.go': 5, 'p2p/stream.go': 5, 'core/commands/cid.go': 17, 'core/coreapi/unixfile.go': 7, 'cmd/ipfs/dnsresolve_test.go': 3, 'core/coreapi/interface/options/unixfs.go': 2, 'core/coreapi/interface/pubsub.go': 1, 'core/coreapi/interface/swarm.go': 1, 'core/coreapi/pubsub.go': 12, 'core/coreapi/swarm.go': 12, 'test/dependencies/iptb/iptb.go': 8, 'commands/context.go': 18, 'core/commands/cmdenv/file.go': 4, 'core/commands/cmdenv/cidbase.go': 10, 'core/coreapi/interface/tests/name.go': 1, 'core/coreapi/interface/tests/unixfs.go': 1, 'core/coreapi/test/api_test.go': 11, 'core/corehttp/ipns_hostname.go': 11, 'namesys/dns_test.go': 10, 'plugin/daemon.go': 10, 'plugin/loader/loader.go': 11, 'core/corehttp/proxy.go': 6, 'plugin/plugins/badgerds/badgerds.go': 3, 'plugin/plugins/flatfs/flatfs.go': 3, 'plugin/plugins/levelds/levelds.go': 2, 'core/corerepo/stat.go': 2, 'core/commands/cmdenv/cidbase_test.go': 2, 'core/corehttp/metrics.go': 1, 'core/corehttp/proxy_test.go': 1, 'plugin/tracer.go': 1, 'thirdparty/notifier/notifier.go': 1, 'README.md': 3, 'go.mod': 1, 'go.sum': 1, 'package-list.json': 1, 'core/commands/pin/pin.go': 1, 'core/commands/stat_dht.go': 1}","('core/commands/object/object.go', 0.8904109589041096, 0.5652173913043478)"
core/commands/unixfs/ls.go,200,1212,2,"[{'cyclomatic_complexity': 15, 'nloc': 89, 'token_count': 558, 'name': '', 'long_name': '(req cmds.Request,res cmds.Response)', 'start_line': 75, 'end_line': 179, 'full_parameters': [], 'filename': '/home/dimi/Documents/Informatik_Studium/FSS/SoftEvo/DataCollection/FFS_SoftEvo/go-ipfs/core/commands/unixfs/ls.go', 'top_nesting_level': 0, 'length': 105, 'fan_in': 0, 'fan_out': 0, 'general_fan_out': 0}, {'cyclomatic_complexity': 13, 'nloc': 47, 'token_count': 313, 'name': '', 'long_name': '(res cmds.Response)(io.Reader,error)', 'start_line': 181, 'end_line': 234, 'full_parameters': [], 'filename': '/home/dimi/Documents/Informatik_Studium/FSS/SoftEvo/DataCollection/FFS_SoftEvo/go-ipfs/core/commands/unixfs/ls.go', 'top_nesting_level': 0, 'length': 54, 'fan_in': 0, 'fan_out': 0, 'general_fan_out': 0}]",191,1160,0,[],-9,-52,-2,79,79,"[{'timestamp': 1491058697.0, 'added_lines': 22, 'deleted_lines': 13, 'nloc': 209}, {'timestamp': 1511223906.0, 'added_lines': 1, 'deleted_lines': 1, 'nloc': 209}, {'timestamp': 1512365669.0, 'added_lines': 1, 'deleted_lines': 1, 'nloc': 209}, {'timestamp': 1511187070.0, 'added_lines': 1, 'deleted_lines': 1, 'nloc': 209}, {'timestamp': 1513436097.0, 'added_lines': 1, 'deleted_lines': 1, 'nloc': 209}, {'timestamp': 1513612261.0, 'added_lines': 1, 'deleted_lines': 1, 'nloc': 209}, {'timestamp': 1515277696.0, 'added_lines': 1, 'deleted_lines': 1, 'nloc': 209}, {'timestamp': 1518736190.0, 'added_lines': 4, 'deleted_lines': 2, 'nloc': 210}, {'timestamp': 1521846182.0, 'added_lines': 4, 'deleted_lines': 0, 'nloc': 213}, {'timestamp': 1528520460.0, 'added_lines': 1, 'deleted_lines': 1, 'nloc': 213}, {'timestamp': 1532764253.0, 'added_lines': 1, 'deleted_lines': 1, 'nloc': 213}, {'timestamp': 1532847462.0, 'added_lines': 2, 'deleted_lines': 2, 'nloc': 213}, {'timestamp': 1532986515.0, 'added_lines': 3, 'deleted_lines': 3, 'nloc': 213}, {'timestamp': 1533500571.0, 'added_lines': 6, 'deleted_lines': 6, 'nloc': 213}, {'timestamp': 1533618653.0, 'added_lines': 6, 'deleted_lines': 6, 'nloc': 213}, {'timestamp': 1533779477.0, 'added_lines': 6, 'deleted_lines': 6, 'nloc': 213}, {'timestamp': 1533946888.0, 'added_lines': 4, 'deleted_lines': 4, 'nloc': 213}, {'timestamp': 1534115707.0, 'added_lines': 6, 'deleted_lines': 6, 'nloc': 213}, {'timestamp': 1534195762.0, 'added_lines': 6, 'deleted_lines': 6, 'nloc': 213}, {'timestamp': 1534347022.0, 'added_lines': 6, 'deleted_lines': 6, 'nloc': 213}, {'timestamp': 1534896611.0, 'added_lines': 7, 'deleted_lines': 7, 'nloc': 213}, {'timestamp': 1535601896.0, 'added_lines': 6, 'deleted_lines': 6, 'nloc': 213}, {'timestamp': 1536388808.0, 'added_lines': 6, 'deleted_lines': 6, 'nloc': 213}, {'timestamp': 1536718784.0, 'added_lines': 6, 'deleted_lines': 6, 'nloc': 213}, {'timestamp': 1536723292.0, 'added_lines': 6, 'deleted_lines': 6, 'nloc': 213}, {'timestamp': 1537507299.0, 'added_lines': 6, 'deleted_lines': 6, 'nloc': 213}, {'timestamp': 1537790637.0, 'added_lines': 6, 'deleted_lines': 6, 'nloc': 213}, {'timestamp': 1537792589.0, 'added_lines': 6, 'deleted_lines': 6, 'nloc': 213}, {'timestamp': 1537957978.0, 'added_lines': 5, 'deleted_lines': 6, 'nloc': 212}, {'timestamp': 1537393245.0, 'added_lines': 16, 'deleted_lines': 12, 'nloc': 215}, {'timestamp': 1538544957.0, 'added_lines': 2, 'deleted_lines': 2, 'nloc': 215}, {'timestamp': 1538694687.0, 'added_lines': 2, 'deleted_lines': 2, 'nloc': 215}, {'timestamp': 1538695953.0, 'added_lines': 2, 'deleted_lines': 2, 'nloc': 215}, {'timestamp': 1538773916.0, 'added_lines': 2, 'deleted_lines': 2, 'nloc': 215}, {'timestamp': 1539176817.0, 'added_lines': 2, 'deleted_lines': 2, 'nloc': 215}, {'timestamp': 1539357340.0, 'added_lines': 2, 'deleted_lines': 2, 'nloc': 215}, {'timestamp': 1539850591.0, 'added_lines': 2, 'deleted_lines': 2, 'nloc': 215}, {'timestamp': 1540400358.0, 'added_lines': 2, 'deleted_lines': 2, 'nloc': 215}, {'timestamp': 1540410565.0, 'added_lines': 2, 'deleted_lines': 2, 'nloc': 215}, {'timestamp': 1540418491.0, 'added_lines': 2, 'deleted_lines': 2, 'nloc': 215}, {'timestamp': 1540603818.0, 'added_lines': 2, 'deleted_lines': 2, 'nloc': 215}, {'timestamp': 1541106379.0, 'added_lines': 1, 'deleted_lines': 1, 'nloc': 215}, {'timestamp': 1541189794.0, 'added_lines': 2, 'deleted_lines': 2, 'nloc': 215}, {'timestamp': 1541204121.0, 'added_lines': 2, 'deleted_lines': 2, 'nloc': 215}, {'timestamp': 1541726812.0, 'added_lines': 42, 'deleted_lines': 61, 'nloc': 196}, {'timestamp': 1541903826.0, 'added_lines': 2, 'deleted_lines': 2, 'nloc': 196}, {'timestamp': 1543443696.0, 'added_lines': 2, 'deleted_lines': 2, 'nloc': 196}, {'timestamp': 1544225843.0, 'added_lines': 2, 'deleted_lines': 2, 'nloc': 196}, {'timestamp': 1544661332.0, 'added_lines': 1, 'deleted_lines': 1, 'nloc': 196}, {'timestamp': 1540556089.0, 'added_lines': 2, 'deleted_lines': 2, 'nloc': 196}, {'timestamp': 1544451987.0, 'added_lines': 1, 'deleted_lines': 1, 'nloc': 196}, {'timestamp': 1547003974.0, 'added_lines': 2, 'deleted_lines': 2, 'nloc': 196}, {'timestamp': 1547152271.0, 'added_lines': 1, 'deleted_lines': 1, 'nloc': 196}, {'timestamp': 1547499910.0, 'added_lines': 2, 'deleted_lines': 2, 'nloc': 196}, {'timestamp': 1548866534.0, 'added_lines': 2, 'deleted_lines': 2, 'nloc': 196}, {'timestamp': 1549588289.0, 'added_lines': 2, 'deleted_lines': 2, 'nloc': 196}, {'timestamp': 1549672857.0, 'added_lines': 1, 'deleted_lines': 1, 'nloc': 196}, {'timestamp': 1549673846.0, 'added_lines': 1, 'deleted_lines': 1, 'nloc': 196}, {'timestamp': 1549903582.0, 'added_lines': 3, 'deleted_lines': 3, 'nloc': 196}, {'timestamp': 1550185115.0, 'added_lines': 3, 'deleted_lines': 3, 'nloc': 196}, {'timestamp': 1550507829.0, 'added_lines': 4, 'deleted_lines': 4, 'nloc': 196}, {'timestamp': 1550576884.0, 'added_lines': 1, 'deleted_lines': 1, 'nloc': 196}, {'timestamp': 1550610741.0, 'added_lines': 1, 'deleted_lines': 1, 'nloc': 196}, {'timestamp': 1550711994.0, 'added_lines': 3, 'deleted_lines': 3, 'nloc': 196}, {'timestamp': 1550723346.0, 'added_lines': 3, 'deleted_lines': 3, 'nloc': 196}, {'timestamp': 1551138343.0, 'added_lines': 1, 'deleted_lines': 1, 'nloc': 196}, {'timestamp': 1551229859.0, 'added_lines': 3, 'deleted_lines': 3, 'nloc': 196}, {'timestamp': 1551299964.0, 'added_lines': 4, 'deleted_lines': 4, 'nloc': 196}, {'timestamp': 1551471469.0, 'added_lines': 1, 'deleted_lines': 1, 'nloc': 196}, {'timestamp': 1551551196.0, 'added_lines': 5, 'deleted_lines': 5, 'nloc': 196}, {'timestamp': 1553529899.0, 'added_lines': 1, 'deleted_lines': 6, 'nloc': 192}, {'timestamp': 1553608614.0, 'added_lines': 2, 'deleted_lines': 2, 'nloc': 192}, {'timestamp': 1553609463.0, 'added_lines': 1, 'deleted_lines': 1, 'nloc': 192}, {'timestamp': 1557554420.0, 'added_lines': 3, 'deleted_lines': 4, 'nloc': 191}, {'timestamp': 1604732058.0, 'added_lines': 5, 'deleted_lines': 1, 'nloc': 193}, {'timestamp': 1606205568.0, 'added_lines': 1, 'deleted_lines': 1, 'nloc': 193}, {'timestamp': 1606206089.0, 'added_lines': 2, 'deleted_lines': 8, 'nloc': 189}, {'timestamp': 1606206642.0, 'added_lines': 2, 'deleted_lines': 0, 'nloc': 191}, {'timestamp': 1608253728.0, 'added_lines': 2, 'deleted_lines': 2, 'nloc': 191}]","{'blocks/blockstore/caching.go': 1, 'blocks/blockstore/util/remove.go': 2, 'cmd/ipfs/daemon.go': 29, 'cmd/ipfs/init.go': 34, 'cmd/ipfs/ipfs.go': 24, 'cmd/ipfs/main.go': 33, 'cmd/ipfs/main_test.go': 4, 'cmd/ipfswatch/main.go': 20, 'cmd/seccat/seccat.go': 22, None: 36, 'commands/channelmarshaler.go': 1, 'commands/cli/cmd_suggestion.go': 1, 'commands/cli/helptext.go': 2, 'commands/cli/helptext_test.go': 2, 'commands/cli/parse.go': 2, 'commands/cli/parse_test.go': 2, 'commands/command.go': 14, 'commands/command_test.go': 7, 'commands/http/client.go': 2, 'commands/http/handler.go': 2, 'commands/http/multifilereader.go': 2, 'commands/http/multifilereader_test.go': 2, 'commands/http/parse.go': 2, 'commands/reqlog.go': 1, 'commands/request.go': 18, 'commands/response.go': 11, 'commands/response_test.go': 7, 'core/bootstrap.go': 21, 'core/commands/active.go': 23, 'core/commands/add.go': 50, 'core/commands/bitswap.go': 54, 'core/commands/block.go': 39, 'core/commands/bootstrap.go': 33, 'core/commands/cat.go': 37, 'core/commands/commands.go': 26, 'core/commands/config.go': 33, 'core/commands/dag/dag.go': 64, 'core/commands/dht.go': 59, 'core/commands/diag.go': 23, 'core/commands/dns.go': 31, 'core/commands/e/error.go': 1, 'core/commands/external.go': 23, 'core/commands/files/files.go': 7, 'core/commands/filestore.go': 30, 'core/commands/get.go': 66, 'core/commands/helptext_test.go': 24, 'core/commands/id.go': 43, 'core/commands/ipns.go': 14, 'core/commands/keystore.go': 35, 'core/commands/log.go': 26, 'core/commands/ls.go': 72, 'core/commands/mount_nofuse.go': 23, 'core/commands/mount_unix.go': 34, 'core/commands/mount_windows.go': 22, 'core/commands/name.go': 10, 'core/commands/object/diff.go': 36, 'core/commands/object/object.go': 68, 'core/commands/object/patch.go': 40, 'core/commands/p2p.go': 34, 'core/commands/pin.go': 69, 'core/commands/ping.go': 38, 'core/commands/publish.go': 17, 'core/commands/pubsub.go': 43, 'core/commands/refs.go': 58, 'core/commands/repo.go': 43, 'core/commands/resolve.go': 64, 'core/commands/root.go': 27, 'core/commands/shutdown.go': 26, 'core/commands/stat.go': 30, 'core/commands/swarm.go': 41, 'core/commands/sysdiag.go': 27, 'core/commands/tar.go': 59, 'core/commands/unixfs/unixfs.go': 24, 'core/commands/version.go': 24, 'core/core_test.go': 17, 'core/corehttp/commands.go': 57, 'core/corehttp/gateway.go': 33, 'core/coreunix/add.go': 58, 'core/coreunix/add_test.go': 55, 'core/coreunix/metadata_test.go': 49, 'exchange/bitswap/bitswap_test.go': 4, 'exchange/bitswap/decision/engine_test.go': 4, 'exchange/bitswap/message/message_test.go': 3, 'exchange/bitswap/message/pb/Makefile': 1, 'exchange/bitswap/testnet/network_test.go': 4, 'exchange/bitswap/testnet/peernet.go': 4, 'exchange/reprovide/reprovide_test.go': 29, 'fuse/ipns/common.go': 47, 'fuse/node/mount_test.go': 27, 'importer/balanced/balanced_test.go': 4, 'importer/chunk/rabin_test.go': 2, 'importer/helpers/dagbuilder.go': 9, 'importer/importer.go': 8, 'merkledag/utils/utils_test.go': 3, 'mfs/repub_test.go': 7, 'namesys/dns.go': 44, 'namesys/interface.go': 44, 'namesys/ipns_select_test.go': 3, 'namesys/proquint.go': 44, 'namesys/republisher/repub_test.go': 43, 'package.json': 60, 'repo/config/identity.go': 2, 'routing/offline/offline_test.go': 3, 'test/integration/addcat_test.go': 32, 'test/integration/bench_cat_test.go': 31, 'test/integration/bitswap_wo_routing_test.go': 31, 'test/integration/three_legged_cat_test.go': 31, 'core/bootstrap_test.go': 20, 'core/commands/dht_test.go': 19, 'core/commands/get_test.go': 25, 'core/core.go': 51, 'core/corehttp/gateway_test.go': 49, 'core/corehttp/metrics_test.go': 27, 'core/mock/mock.go': 28, 'exchange/bitswap/decision/bench_test.go': 3, 'exchange/bitswap/decision/peer_request_queue_test.go': 3, 'exchange/bitswap/message/message.go': 3, 'exchange/bitswap/network/interface.go': 3, 'exchange/bitswap/network/ipfs_impl.go': 3, 'exchange/bitswap/testnet/interface.go': 3, 'exchange/bitswap/testnet/virtual.go': 3, 'exchange/bitswap/testutils.go': 3, 'fuse/ipns/ipns_test.go': 26, 'fuse/readonly/ipfs_test.go': 56, 'namesys/publisher_test.go': 27, 'namesys/resolve_test.go': 43, 'p2p/p2p.go': 20, 'p2p/registry.go': 7, 'repo/config/bootstrap_peers.go': 4, 'routing/mock/centralized_client.go': 2, 'routing/mock/centralized_server.go': 2, 'routing/mock/centralized_test.go': 2, 'routing/mock/interface.go': 2, 'routing/none/none_client.go': 2, 'test/integration/bench_test.go': 14, 'assets/assets.go': 50, 'blocks/blockstore/arc_cache.go': 1, 'blocks/blockstore/arc_cache_test.go': 1, 'blocks/blockstore/blockstore.go': 1, 'blocks/blockstore/blockstore_test.go': 1, 'blocks/blockstore/bloom_cache.go': 1, 'blocks/blockstore/bloom_cache_test.go': 1, 'blocks/blocksutil/block_generator.go': 1, 'blockservice/blockservice.go': 2, 'blockservice/blockservice_test.go': 2, 'blockservice/test/blocks_test.go': 2, 'core/builder.go': 50, 'core/commands/ipnsps.go': 8, 'core/coreapi/coreapi.go': 27, 'core/coreapi/interface/interface.go': 1, 'core/coreapi/unixfs.go': 54, 'core/coreapi/unixfs_test.go': 37, 'core/coredag/cbor.go': 15, 'core/coredag/dagpb.go': 41, 'core/coredag/dagtransl.go': 11, 'core/coredag/raw.go': 41, 'core/corehttp/corehttp.go': 10, 'core/corehttp/gateway_handler.go': 57, 'core/corerepo/gc.go': 43, 'core/corerepo/pinning.go': 21, 'core/coreunix/metadata.go': 48, 'core/pathresolver.go': 43, 'exchange/bitswap/bitswap.go': 2, 'exchange/bitswap/decision/engine.go': 2, 'exchange/bitswap/decision/ledger.go': 2, 'exchange/bitswap/decision/peer_request_queue.go': 2, 'exchange/bitswap/get.go': 2, 'exchange/bitswap/notifications/notifications.go': 2, 'exchange/bitswap/notifications/notifications_test.go': 2, 'exchange/bitswap/session.go': 2, 'exchange/bitswap/session_test.go': 2, 'exchange/bitswap/stat.go': 2, 'exchange/bitswap/wantlist/wantlist.go': 2, 'exchange/bitswap/wantlist/wantlist_test.go': 2, 'exchange/bitswap/wantmanager.go': 2, 'exchange/bitswap/workers.go': 2, 'exchange/interface.go': 1, 'exchange/offline/offline.go': 1, 'exchange/offline/offline_test.go': 1, 'exchange/reprovide/providers.go': 41, 'exchange/reprovide/reprovide.go': 23, 'filestore/filestore.go': 21, 'filestore/filestore_test.go': 41, 'filestore/fsrefstore.go': 21, 'filestore/util.go': 19, 'fuse/ipns/ipns_unix.go': 49, 'fuse/readonly/readonly_unix.go': 50, 'importer/balanced/builder.go': 2, 'importer/chunk/splitting_test.go': 1, 'importer/helpers/helpers.go': 3, 'importer/importer_test.go': 3, 'importer/trickle/trickle_test.go': 3, 'importer/trickle/trickledag.go': 3, 'merkledag/batch.go': 1, 'merkledag/coding.go': 2, 'merkledag/merkledag.go': 2, 'merkledag/merkledag_test.go': 2, 'merkledag/node.go': 2, 'merkledag/node_test.go': 2, 'merkledag/raw.go': 2, 'merkledag/traverse/traverse.go': 2, 'merkledag/traverse/traverse_test.go': 2, 'merkledag/utils/diff.go': 2, 'merkledag/utils/diffenum.go': 2, 'merkledag/utils/diffenum_test.go': 2, 'merkledag/utils/utils.go': 2, 'mfs/dir.go': 11, 'mfs/file.go': 11, 'mfs/mfs_test.go': 12, 'mfs/ops.go': 9, 'mfs/system.go': 11, 'namesys/namesys.go': 45, 'namesys/publisher.go': 49, 'namesys/pubsub.go': 1, 'namesys/pubsub_test.go': 1, 'namesys/republisher/repub.go': 41, 'namesys/routing.go': 45, 'path/path.go': 3, 'path/resolver.go': 1, 'path/resolver_test.go': 1, 'pin/gc/gc.go': 41, 'pin/pin.go': 41, 'pin/pin_test.go': 41, 'pin/set.go': 41, 'pin/set_test.go': 41, 'plugin/ipld.go': 11, 'plugin/loader/initializer.go': 8, 'plugin/plugins/git/git.go': 11, 'repo/config/init.go': 3, 'repo/fsrepo/fsrepo.go': 19, 'repo/fsrepo/lock/lock.go': 1, 'repo/fsrepo/serialize/serialize.go': 2, 'repo/mock.go': 15, 'repo/repo.go': 18, 'routing/offline/offline.go': 1, 'tar/format.go': 49, 'test/dependencies/ma-pipe-unidir/main.go': 7, 'thirdparty/ds-help/key.go': 1, 'thirdparty/pollEndpoint/main.go': 10, 'thirdparty/posinfo/posinfo.go': 1, 'unixfs/archive/archive.go': 3, 'unixfs/archive/tar/writer.go': 4, 'unixfs/hamt/hamt.go': 4, 'unixfs/io/dagreader.go': 4, 'unixfs/io/dirbuilder.go': 2, 'unixfs/io/resolve.go': 4, 'unixfs/mod/dagmodifier.go': 4, 'unixfs/mod/dagmodifier_test.go': 3, 'unixfs/test/utils.go': 4, 'commands/legacy/command.go': 10, 'commands/legacy/legacy.go': 10, 'commands/legacy/legacy_test.go': 11, 'commands/legacy/request.go': 11, 'commands/legacy/response.go': 11, 'commands/legacy/responseemitter.go': 4, 'core/commands/env.go': 4, 'TODO.md': 2, 'core/commands/commands_test.go': 20, 'test/sharness/t0110-gateway.sh': 1, 'test/sharness/t0410-api-add.sh': 1, 'core/commands/files.go': 64, 'core/coreunix/cat.go': 17, 'path/resolver/resolver.go': 3, 'path/resolver/resolver_test.go': 3, 'blocks/blockstoreutil/remove.go': 18, 'blockservice/test/mock.go': 1, 'cmd/ipfs/util/ulimit.go': 6, 'cmd/ipfs/util/ulimit_freebsd.go': 2, 'cmd/ipfs/util/ulimit_unix.go': 2, 'cmd/seccat/util.go': 6, 'core/coreapi/block.go': 19, 'core/coreapi/block_test.go': 2, 'core/coreapi/dag.go': 10, 'core/coreapi/dag_test.go': 2, 'core/coreapi/interface/coreapi.go': 8, 'core/coreapi/interface/dag.go': 8, 'core/coreapi/interface/object.go': 8, 'core/coreapi/interface/options/block.go': 3, 'core/coreapi/interface/options/dag.go': 6, 'core/coreapi/interface/path.go': 33, 'core/coreapi/interface/unixfs.go': 12, 'core/coreapi/key.go': 47, 'core/coreapi/name.go': 47, 'core/coreapi/object.go': 52, 'core/coreapi/pin.go': 47, 'core/corehttp/logs.go': 6, 'fuse/ipns/link_unix.go': 2, 'fuse/mount/fuse.go': 2, 'fuse/mount/mount.go': 6, 'fuse/node/mount_darwin.go': 2, 'fuse/node/mount_unix.go': 6, 'keystore/keystore.go': 6, 'merkledag/errservice.go': 1, 'merkledag/readonly.go': 1, 'merkledag/readonly_test.go': 1, 'merkledag/rwservice.go': 1, 'merkledag/session.go': 1, 'merkledag/test/utils.go': 1, 'namesys/ipns_validate_test.go': 1, 'namesys/namesys_test.go': 50, 'namesys/validator.go': 1, 'plugin/loader/load.go': 4, 'repo/fsrepo/datastores.go': 11, 'thirdparty/verifbs/verifbs.go': 18, 'thirdparty/verifcid/validate.go': 1, 'thirdparty/verifcid/validate_test.go': 1, 'unixfs/hamt/hamt_stress_test.go': 3, 'unixfs/hamt/hamt_test.go': 3, 'unixfs/io/pbdagreader.go': 3, 'Rules.mk': 1, 'dagutils/diff.go': 43, 'dagutils/diffenum.go': 39, 'dagutils/diffenum_test.go': 39, 'dagutils/utils.go': 40, 'dagutils/utils_test.go': 40, 'unixfs/io/dagreader_test.go': 2, 'unixfs/io/directory.go': 2, 'unixfs/io/directory_test.go': 2, 'unixfs/unixfs.go': 2, 'core/coreapi/name_test.go': 31, 'core/coreapi/path.go': 52, 'core/pathresolver_test.go': 39, 'namesys/base.go': 43, 'namesys/cache.go': 39, 'namesys/ipns_resolver_validation_test.go': 43, 'core/commands/urlstore.go': 51, 'mfs/fd.go': 8, 'unixfs/importer/balanced/balanced_test.go': 1, 'unixfs/importer/balanced/builder.go': 1, 'unixfs/importer/helpers/dagbuilder.go': 1, 'unixfs/importer/helpers/helpers.go': 1, 'unixfs/importer/importer.go': 1, 'unixfs/importer/importer_test.go': 1, 'unixfs/importer/trickle/trickle_test.go': 1, 'unixfs/importer/trickle/trickledag.go': 1, 'unixfs/unixfs_test.go': 1, 'core/coreapi/interface/key.go': 7, 'filestore/pb/dataobj.pb.go': 3, 'keystore/keystore_test.go': 4, 'keystore/memkeystore.go': 4, 'pin/internal/pb/header.pb.go': 3, 'thirdparty/cidv0v1/blockstore.go': 16, 'repo/fsrepo/fsrepo_test.go': 16, 'repo/fsrepo/config_test.go': 13, 'repo/fsrepo/misc.go': 13, 'test/bench/bench_cli_ipfs_add/main.go': 14, 'test/bench/offline_add/main.go': 14, 'core/commands/cmdenv/env.go': 30, 'core/commands/name/ipns.go': 45, 'core/commands/name/publish.go': 33, 'core/coreapi/dht.go': 34, 'core/coreapi/dht_test.go': 5, 'test/sharness/t0275-cid-security.sh': 1, 'core/commands/name/ipnsps.go': 19, 'core/commands/name/name.go': 15, 'core/coreapi/interface/dht.go': 10, 'p2p/listener.go': 13, 'p2p/local.go': 13, 'p2p/remote.go': 13, 'p2p/stream.go': 13, 'core/coreapi/interface/util.go': 1, 'core/coreapi/interface/swarm.go': 9, 'core/coreapi/swarm.go': 23, 'core/coreapi/interface/options/unixfs.go': 16, 'core/coreapi/pubsub.go': 21, 'core/coreapi/unixfile.go': 17, 'core/commands/cid.go': 15, 'cmd/ipfs/dnsresolve_test.go': 5, 'core/coreapi/interface/pubsub.go': 4, 'test/dependencies/iptb/iptb.go': 12, 'plugin/plugins/badgerds/badgerds.go': 4, 'plugin/plugins/flatfs/flatfs.go': 4, 'plugin/plugins/levelds/levelds.go': 3, 'commands/context.go': 21, 'core/corehttp/proxy.go': 9, 'core/coreapi/interface/tests/name.go': 4, 'core/coreapi/interface/tests/unixfs.go': 4, 'core/coreapi/test/api_test.go': 13, 'plugin/loader/loader.go': 12, 'core/commands/cmdenv/cidbase.go': 10, 'core/commands/cmdenv/file.go': 3, 'core/corehttp/ipns_hostname.go': 11, 'namesys/dns_test.go': 10, 'plugin/daemon.go': 10, 'core/corerepo/stat.go': 2, 'core/commands/cmdenv/cidbase_test.go': 2, 'core/corehttp/metrics.go': 1, 'core/corehttp/proxy_test.go': 1, 'plugin/tracer.go': 1, 'thirdparty/notifier/notifier.go': 1, 'README.md': 1, 'go.mod': 1, 'go.sum': 1, 'package-list.json': 1, 'core/commands/pin/remotepin.go': 1}","('core/commands/ls.go', 0.9113924050632911, 0.6605504587155964)"
core/commands/unixfs/unixfs.go,20,115,0,[],22,117,0,[],2,2,0,24,24,"[{'timestamp': 1491058697.0, 'added_lines': 21, 'deleted_lines': 2, 'nloc': 34}, {'timestamp': 1511223906.0, 'added_lines': 1, 'deleted_lines': 1, 'nloc': 34}, {'timestamp': 1512365669.0, 'added_lines': 1, 'deleted_lines': 1, 'nloc': 34}, {'timestamp': 1511187070.0, 'added_lines': 1, 'deleted_lines': 1, 'nloc': 34}, {'timestamp': 1513436097.0, 'added_lines': 1, 'deleted_lines': 1, 'nloc': 34}, {'timestamp': 1513612261.0, 'added_lines': 1, 'deleted_lines': 1, 'nloc': 34}, {'timestamp': 1515277696.0, 'added_lines': 1, 'deleted_lines': 1, 'nloc': 34}, {'timestamp': 1528520460.0, 'added_lines': 1, 'deleted_lines': 1, 'nloc': 34}, {'timestamp': 1533946888.0, 'added_lines': 1, 'deleted_lines': 1, 'nloc': 34}, {'timestamp': 1534896611.0, 'added_lines': 1, 'deleted_lines': 1, 'nloc': 34}, {'timestamp': 1539850591.0, 'added_lines': 1, 'deleted_lines': 1, 'nloc': 34}, {'timestamp': 1541726812.0, 'added_lines': 2, 'deleted_lines': 18, 'nloc': 23}, {'timestamp': 1544661332.0, 'added_lines': 1, 'deleted_lines': 1, 'nloc': 23}, {'timestamp': 1540556089.0, 'added_lines': 1, 'deleted_lines': 1, 'nloc': 23}, {'timestamp': 1547152271.0, 'added_lines': 1, 'deleted_lines': 1, 'nloc': 23}, {'timestamp': 1548866534.0, 'added_lines': 1, 'deleted_lines': 1, 'nloc': 23}, {'timestamp': 1549903582.0, 'added_lines': 1, 'deleted_lines': 1, 'nloc': 23}, {'timestamp': 1550507829.0, 'added_lines': 1, 'deleted_lines': 1, 'nloc': 23}, {'timestamp': 1550610741.0, 'added_lines': 1, 'deleted_lines': 1, 'nloc': 23}, {'timestamp': 1551138343.0, 'added_lines': 1, 'deleted_lines': 1, 'nloc': 23}, {'timestamp': 1551299964.0, 'added_lines': 1, 'deleted_lines': 1, 'nloc': 23}, {'timestamp': 1551471469.0, 'added_lines': 1, 'deleted_lines': 1, 'nloc': 23}, {'timestamp': 1551551196.0, 'added_lines': 2, 'deleted_lines': 2, 'nloc': 23}, {'timestamp': 1557554420.0, 'added_lines': 1, 'deleted_lines': 2, 'nloc': 22}]","{'blocks/blockstore/caching.go': 1, 'blocks/blockstore/util/remove.go': 2, 'cmd/ipfs/daemon.go': 23, 'cmd/ipfs/init.go': 23, 'cmd/ipfs/ipfs.go': 21, 'cmd/ipfs/main.go': 22, 'cmd/ipfs/main_test.go': 4, 'cmd/ipfswatch/main.go': 10, 'cmd/seccat/seccat.go': 7, None: 13, 'commands/channelmarshaler.go': 1, 'commands/cli/cmd_suggestion.go': 1, 'commands/cli/helptext.go': 2, 'commands/cli/helptext_test.go': 2, 'commands/cli/parse.go': 2, 'commands/cli/parse_test.go': 2, 'commands/command.go': 11, 'commands/command_test.go': 7, 'commands/http/client.go': 2, 'commands/http/handler.go': 2, 'commands/http/multifilereader.go': 2, 'commands/http/multifilereader_test.go': 2, 'commands/http/parse.go': 2, 'commands/reqlog.go': 1, 'commands/request.go': 11, 'commands/response.go': 11, 'commands/response_test.go': 7, 'core/bootstrap.go': 7, 'core/commands/active.go': 23, 'core/commands/add.go': 23, 'core/commands/bitswap.go': 23, 'core/commands/block.go': 23, 'core/commands/bootstrap.go': 23, 'core/commands/cat.go': 23, 'core/commands/commands.go': 23, 'core/commands/config.go': 23, 'core/commands/dag/dag.go': 23, 'core/commands/dht.go': 23, 'core/commands/diag.go': 23, 'core/commands/dns.go': 23, 'core/commands/e/error.go': 1, 'core/commands/external.go': 23, 'core/commands/files/files.go': 7, 'core/commands/filestore.go': 23, 'core/commands/get.go': 23, 'core/commands/helptext_test.go': 21, 'core/commands/id.go': 23, 'core/commands/ipns.go': 10, 'core/commands/keystore.go': 23, 'core/commands/log.go': 23, 'core/commands/ls.go': 23, 'core/commands/mount_nofuse.go': 23, 'core/commands/mount_unix.go': 23, 'core/commands/mount_windows.go': 22, 'core/commands/name.go': 10, 'core/commands/object/diff.go': 23, 'core/commands/object/object.go': 23, 'core/commands/object/patch.go': 23, 'core/commands/p2p.go': 23, 'core/commands/pin.go': 23, 'core/commands/ping.go': 23, 'core/commands/publish.go': 10, 'core/commands/pubsub.go': 23, 'core/commands/refs.go': 23, 'core/commands/repo.go': 23, 'core/commands/resolve.go': 23, 'core/commands/root.go': 24, 'core/commands/shutdown.go': 23, 'core/commands/stat.go': 23, 'core/commands/swarm.go': 23, 'core/commands/sysdiag.go': 23, 'core/commands/tar.go': 23, 'core/commands/unixfs/ls.go': 24, 'core/commands/version.go': 23, 'core/core_test.go': 4, 'core/corehttp/commands.go': 22, 'core/corehttp/gateway.go': 9, 'core/coreunix/add.go': 17, 'core/coreunix/add_test.go': 17, 'core/coreunix/metadata_test.go': 12, 'exchange/bitswap/bitswap_test.go': 4, 'exchange/bitswap/decision/engine_test.go': 4, 'exchange/bitswap/message/message_test.go': 3, 'exchange/bitswap/message/pb/Makefile': 1, 'exchange/bitswap/testnet/network_test.go': 4, 'exchange/bitswap/testnet/peernet.go': 4, 'exchange/reprovide/reprovide_test.go': 7, 'fuse/ipns/common.go': 10, 'fuse/node/mount_test.go': 7, 'importer/balanced/balanced_test.go': 3, 'importer/chunk/rabin_test.go': 2, 'importer/helpers/dagbuilder.go': 8, 'importer/importer.go': 8, 'merkledag/utils/utils_test.go': 3, 'mfs/repub_test.go': 4, 'namesys/dns.go': 6, 'namesys/interface.go': 6, 'namesys/ipns_select_test.go': 3, 'namesys/proquint.go': 6, 'namesys/republisher/repub_test.go': 8, 'package.json': 21, 'repo/config/identity.go': 1, 'routing/offline/offline_test.go': 3, 'test/integration/addcat_test.go': 11, 'test/integration/bench_cat_test.go': 10, 'test/integration/bitswap_wo_routing_test.go': 8, 'test/integration/three_legged_cat_test.go': 10, 'core/bootstrap_test.go': 6, 'core/commands/dht_test.go': 6, 'core/commands/get_test.go': 22, 'core/core.go': 12, 'core/corehttp/gateway_test.go': 9, 'core/corehttp/metrics_test.go': 7, 'core/mock/mock.go': 7, 'exchange/bitswap/decision/bench_test.go': 3, 'exchange/bitswap/decision/peer_request_queue_test.go': 3, 'exchange/bitswap/message/message.go': 3, 'exchange/bitswap/network/interface.go': 3, 'exchange/bitswap/network/ipfs_impl.go': 3, 'exchange/bitswap/testnet/interface.go': 3, 'exchange/bitswap/testnet/virtual.go': 3, 'exchange/bitswap/testutils.go': 3, 'fuse/ipns/ipns_test.go': 6, 'fuse/readonly/ipfs_test.go': 12, 'namesys/publisher_test.go': 6, 'namesys/resolve_test.go': 7, 'p2p/p2p.go': 6, 'p2p/registry.go': 4, 'repo/config/bootstrap_peers.go': 3, 'routing/mock/centralized_client.go': 2, 'routing/mock/centralized_server.go': 2, 'routing/mock/centralized_test.go': 2, 'routing/mock/interface.go': 2, 'routing/none/none_client.go': 2, 'test/integration/bench_test.go': 6, 'assets/assets.go': 11, 'blocks/blockstore/arc_cache.go': 1, 'blocks/blockstore/arc_cache_test.go': 1, 'blocks/blockstore/blockstore.go': 1, 'blocks/blockstore/blockstore_test.go': 1, 'blocks/blockstore/bloom_cache.go': 1, 'blocks/blockstore/bloom_cache_test.go': 1, 'blocks/blocksutil/block_generator.go': 1, 'blockservice/blockservice.go': 2, 'blockservice/blockservice_test.go': 2, 'blockservice/test/blocks_test.go': 2, 'core/builder.go': 11, 'core/commands/ipnsps.go': 7, 'core/coreapi/coreapi.go': 6, 'core/coreapi/interface/interface.go': 1, 'core/coreapi/unixfs.go': 12, 'core/coreapi/unixfs_test.go': 6, 'core/coredag/cbor.go': 4, 'core/coredag/dagpb.go': 6, 'core/coredag/dagtransl.go': 4, 'core/coredag/raw.go': 6, 'core/corehttp/corehttp.go': 4, 'core/corehttp/gateway_handler.go': 12, 'core/corerepo/gc.go': 11, 'core/corerepo/pinning.go': 4, 'core/coreunix/metadata.go': 11, 'core/pathresolver.go': 6, 'exchange/bitswap/bitswap.go': 2, 'exchange/bitswap/decision/engine.go': 2, 'exchange/bitswap/decision/ledger.go': 2, 'exchange/bitswap/decision/peer_request_queue.go': 2, 'exchange/bitswap/get.go': 2, 'exchange/bitswap/notifications/notifications.go': 2, 'exchange/bitswap/notifications/notifications_test.go': 2, 'exchange/bitswap/session.go': 2, 'exchange/bitswap/session_test.go': 2, 'exchange/bitswap/stat.go': 2, 'exchange/bitswap/wantlist/wantlist.go': 2, 'exchange/bitswap/wantlist/wantlist_test.go': 2, 'exchange/bitswap/wantmanager.go': 2, 'exchange/bitswap/workers.go': 2, 'exchange/interface.go': 1, 'exchange/offline/offline.go': 1, 'exchange/offline/offline_test.go': 1, 'exchange/reprovide/providers.go': 6, 'exchange/reprovide/reprovide.go': 5, 'filestore/filestore.go': 5, 'filestore/filestore_test.go': 6, 'filestore/fsrefstore.go': 5, 'filestore/util.go': 5, 'fuse/ipns/ipns_unix.go': 11, 'fuse/readonly/readonly_unix.go': 11, 'importer/balanced/builder.go': 2, 'importer/chunk/splitting_test.go': 1, 'importer/helpers/helpers.go': 2, 'importer/importer_test.go': 2, 'importer/trickle/trickle_test.go': 2, 'importer/trickle/trickledag.go': 2, 'merkledag/batch.go': 1, 'merkledag/coding.go': 2, 'merkledag/merkledag.go': 2, 'merkledag/merkledag_test.go': 2, 'merkledag/node.go': 2, 'merkledag/node_test.go': 2, 'merkledag/raw.go': 2, 'merkledag/traverse/traverse.go': 2, 'merkledag/traverse/traverse_test.go': 2, 'merkledag/utils/diff.go': 2, 'merkledag/utils/diffenum.go': 2, 'merkledag/utils/diffenum_test.go': 2, 'merkledag/utils/utils.go': 2, 'mfs/dir.go': 3, 'mfs/file.go': 3, 'mfs/mfs_test.go': 3, 'mfs/ops.go': 2, 'mfs/system.go': 3, 'namesys/namesys.go': 7, 'namesys/publisher.go': 11, 'namesys/pubsub.go': 1, 'namesys/pubsub_test.go': 1, 'namesys/republisher/repub.go': 6, 'namesys/routing.go': 7, 'path/path.go': 2, 'path/resolver.go': 1, 'path/resolver_test.go': 1, 'pin/gc/gc.go': 6, 'pin/pin.go': 6, 'pin/pin_test.go': 6, 'pin/set.go': 6, 'pin/set_test.go': 6, 'plugin/ipld.go': 4, 'plugin/loader/initializer.go': 3, 'plugin/plugins/git/git.go': 4, 'repo/config/init.go': 2, 'repo/fsrepo/fsrepo.go': 5, 'repo/fsrepo/lock/lock.go': 1, 'repo/fsrepo/serialize/serialize.go': 2, 'repo/mock.go': 5, 'repo/repo.go': 5, 'routing/offline/offline.go': 1, 'tar/format.go': 11, 'test/dependencies/ma-pipe-unidir/main.go': 3, 'thirdparty/ds-help/key.go': 1, 'thirdparty/pollEndpoint/main.go': 4, 'thirdparty/posinfo/posinfo.go': 1, 'unixfs/archive/archive.go': 2, 'unixfs/archive/tar/writer.go': 2, 'unixfs/hamt/hamt.go': 2, 'unixfs/io/dagreader.go': 2, 'unixfs/io/dirbuilder.go': 2, 'unixfs/io/resolve.go': 2, 'unixfs/mod/dagmodifier.go': 2, 'unixfs/mod/dagmodifier_test.go': 2, 'unixfs/test/utils.go': 2, 'commands/legacy/command.go': 7, 'commands/legacy/legacy.go': 7, 'commands/legacy/legacy_test.go': 8, 'commands/legacy/request.go': 8, 'commands/legacy/response.go': 8, 'commands/legacy/responseemitter.go': 4, 'core/commands/env.go': 3, 'TODO.md': 2, 'core/commands/commands_test.go': 17, 'test/sharness/t0110-gateway.sh': 1, 'test/sharness/t0410-api-add.sh': 1, 'blocks/blockstoreutil/remove.go': 4, 'blockservice/test/mock.go': 1, 'cmd/ipfs/util/ulimit.go': 3, 'cmd/ipfs/util/ulimit_freebsd.go': 2, 'cmd/ipfs/util/ulimit_unix.go': 2, 'cmd/seccat/util.go': 3, 'core/commands/files.go': 16, 'core/coreapi/block.go': 6, 'core/coreapi/block_test.go': 1, 'core/coreapi/dag.go': 3, 'core/coreapi/dag_test.go': 1, 'core/coreapi/interface/coreapi.go': 2, 'core/coreapi/interface/dag.go': 2, 'core/coreapi/interface/object.go': 2, 'core/coreapi/interface/options/block.go': 1, 'core/coreapi/interface/options/dag.go': 2, 'core/coreapi/interface/path.go': 2, 'core/coreapi/interface/unixfs.go': 5, 'core/coreapi/key.go': 6, 'core/coreapi/name.go': 6, 'core/coreapi/object.go': 10, 'core/coreapi/pin.go': 6, 'core/corehttp/logs.go': 3, 'fuse/ipns/link_unix.go': 2, 'fuse/mount/fuse.go': 2, 'fuse/mount/mount.go': 3, 'fuse/node/mount_darwin.go': 2, 'fuse/node/mount_unix.go': 3, 'keystore/keystore.go': 3, 'merkledag/errservice.go': 1, 'merkledag/readonly.go': 1, 'merkledag/readonly_test.go': 1, 'merkledag/rwservice.go': 1, 'merkledag/session.go': 1, 'merkledag/test/utils.go': 1, 'namesys/ipns_validate_test.go': 1, 'namesys/namesys_test.go': 10, 'namesys/validator.go': 1, 'path/resolver/resolver.go': 1, 'path/resolver/resolver_test.go': 1, 'plugin/loader/load.go': 1, 'repo/fsrepo/datastores.go': 3, 'thirdparty/verifbs/verifbs.go': 4, 'thirdparty/verifcid/validate.go': 1, 'thirdparty/verifcid/validate_test.go': 1, 'unixfs/hamt/hamt_stress_test.go': 1, 'unixfs/hamt/hamt_test.go': 1, 'unixfs/io/pbdagreader.go': 1, 'core/commands/urlstore.go': 15, 'core/coreapi/path.go': 9, 'core/coreunix/cat.go': 2, 'mfs/fd.go': 1, 'core/coreapi/interface/key.go': 1, 'core/coreapi/name_test.go': 3, 'core/pathresolver_test.go': 4, 'dagutils/diff.go': 5, 'dagutils/diffenum.go': 4, 'dagutils/diffenum_test.go': 4, 'dagutils/utils.go': 4, 'dagutils/utils_test.go': 4, 'namesys/base.go': 5, 'namesys/cache.go': 4, 'namesys/ipns_resolver_validation_test.go': 5, 'repo/fsrepo/config_test.go': 3, 'repo/fsrepo/fsrepo_test.go': 3, 'repo/fsrepo/misc.go': 3, 'test/bench/bench_cli_ipfs_add/main.go': 4, 'test/bench/offline_add/main.go': 4, 'thirdparty/cidv0v1/blockstore.go': 3, 'core/commands/cid.go': 13, 'core/commands/cmdenv/env.go': 12, 'core/commands/name/ipns.go': 13, 'core/commands/name/ipnsps.go': 13, 'core/commands/name/name.go': 13, 'core/commands/name/publish.go': 13, 'core/coreapi/unixfile.go': 2, 'commands/context.go': 11, 'core/commands/cmdenv/cidbase.go': 9, 'core/commands/cmdenv/file.go': 3, 'core/coreapi/interface/tests/name.go': 1, 'core/coreapi/interface/tests/unixfs.go': 1, 'core/coreapi/dht.go': 4, 'core/coreapi/pubsub.go': 4, 'core/coreapi/swarm.go': 4, 'core/coreapi/test/api_test.go': 4, 'core/corehttp/ipns_hostname.go': 4, 'namesys/dns_test.go': 4, 'plugin/daemon.go': 4, 'plugin/loader/loader.go': 4, 'core/corehttp/proxy.go': 3, 'filestore/pb/dataobj.pb.go': 2, 'keystore/keystore_test.go': 2, 'keystore/memkeystore.go': 2, 'p2p/listener.go': 2, 'p2p/local.go': 2, 'p2p/remote.go': 2, 'p2p/stream.go': 2, 'pin/internal/pb/header.pb.go': 2, 'plugin/plugins/badgerds/badgerds.go': 3, 'plugin/plugins/flatfs/flatfs.go': 3, 'plugin/plugins/levelds/levelds.go': 2, 'test/dependencies/iptb/iptb.go': 3, 'core/corerepo/stat.go': 2, 'cmd/ipfs/dnsresolve_test.go': 1, 'core/commands/cmdenv/cidbase_test.go': 1, 'core/corehttp/metrics.go': 1, 'core/corehttp/proxy_test.go': 1, 'plugin/tracer.go': 1, 'thirdparty/notifier/notifier.go': 1, 'README.md': 1, 'go.mod': 1, 'go.sum': 1, 'package-list.json': 1}","('core/commands/root.go', 1.0, 0.21238938053097345)"
core/coreapi/coreapi.go,73,531,11,"[{'cyclomatic_complexity': 1, 'nloc': 4, 'token_count': 23, 'name': 'NewCoreAPI', 'long_name': 'NewCoreAPI n * core . IpfsNode', 'start_line': 18, 'end_line': 21, 'full_parameters': ['n * core . IpfsNode'], 'filename': '/home/dimi/Documents/Informatik_Studium/FSS/SoftEvo/DataCollection/FFS_SoftEvo/go-ipfs/core/coreapi/coreapi.go', 'top_nesting_level': 0, 'length': 4, 'fan_in': 0, 'fan_out': 0, 'general_fan_out': 0}, {'cyclomatic_complexity': 1, 'nloc': 3, 'token_count': 22, 'name': 'Unixfs', 'long_name': '(api*CoreAPI)Unixfs', 'start_line': 23, 'end_line': 25, 'full_parameters': [], 'filename': '/home/dimi/Documents/Informatik_Studium/FSS/SoftEvo/DataCollection/FFS_SoftEvo/go-ipfs/core/coreapi/coreapi.go', 'top_nesting_level': 0, 'length': 3, 'fan_in': 0, 'fan_out': 0, 'general_fan_out': 0}, {'cyclomatic_complexity': 3, 'nloc': 11, 'token_count': 83, 'name': 'ResolveNode', 'long_name': '(api*CoreAPI)ResolveNode ctx context . Context , p coreiface . Path', 'start_line': 27, 'end_line': 38, 'full_parameters': ['ctx context . Context', ' p coreiface . Path'], 'filename': '/home/dimi/Documents/Informatik_Studium/FSS/SoftEvo/DataCollection/FFS_SoftEvo/go-ipfs/core/coreapi/coreapi.go', 'top_nesting_level': 0, 'length': 12, 'fan_in': 0, 'fan_out': 0, 'general_fan_out': 0}, {'cyclomatic_complexity': 5, 'nloc': 21, 'token_count': 158, 'name': 'ResolvePath', 'long_name': '(api*CoreAPI)ResolvePath ctx context . Context , p coreiface . Path', 'start_line': 41, 'end_line': 65, 'full_parameters': ['ctx context . Context', ' p coreiface . Path'], 'filename': '/home/dimi/Documents/Informatik_Studium/FSS/SoftEvo/DataCollection/FFS_SoftEvo/go-ipfs/core/coreapi/coreapi.go', 'top_nesting_level': 0, 'length': 25, 'fan_in': 0, 'fan_out': 0, 'general_fan_out': 0}, {'cyclomatic_complexity': 2, 'nloc': 7, 'token_count': 45, 'name': 'ParsePath', 'long_name': 'ParsePath p string', 'start_line': 74, 'end_line': 80, 'full_parameters': ['p string'], 'filename': '/home/dimi/Documents/Informatik_Studium/FSS/SoftEvo/DataCollection/FFS_SoftEvo/go-ipfs/core/coreapi/coreapi.go', 'top_nesting_level': 0, 'length': 7, 'fan_in': 0, 'fan_out': 0, 'general_fan_out': 0}, {'cyclomatic_complexity': 1, 'nloc': 3, 'token_count': 35, 'name': 'ParseCid', 'long_name': 'ParseCid c * cid . Cid', 'start_line': 82, 'end_line': 84, 'full_parameters': ['c * cid . Cid'], 'filename': '/home/dimi/Documents/Informatik_Studium/FSS/SoftEvo/DataCollection/FFS_SoftEvo/go-ipfs/core/coreapi/coreapi.go', 'top_nesting_level': 0, 'length': 3, 'fan_in': 0, 'fan_out': 0, 'general_fan_out': 0}, {'cyclomatic_complexity': 1, 'nloc': 3, 'token_count': 44, 'name': 'ResolvedPath', 'long_name': 'ResolvedPath p string , c * cid . Cid , r * cid . Cid', 'start_line': 86, 'end_line': 88, 'full_parameters': ['p string', ' c * cid . Cid', ' r * cid . Cid'], 'filename': '/home/dimi/Documents/Informatik_Studium/FSS/SoftEvo/DataCollection/FFS_SoftEvo/go-ipfs/core/coreapi/coreapi.go', 'top_nesting_level': 0, 'length': 3, 'fan_in': 0, 'fan_out': 0, 'general_fan_out': 0}, {'cyclomatic_complexity': 1, 'nloc': 1, 'token_count': 20, 'name': 'String', 'long_name': '(p*path)String', 'start_line': 90, 'end_line': 90, 'full_parameters': [], 'filename': '/home/dimi/Documents/Informatik_Studium/FSS/SoftEvo/DataCollection/FFS_SoftEvo/go-ipfs/core/coreapi/coreapi.go', 'top_nesting_level': 0, 'length': 1, 'fan_in': 0, 'fan_out': 0, 'general_fan_out': 0}, {'cyclomatic_complexity': 1, 'nloc': 1, 'token_count': 19, 'name': 'Cid', 'long_name': '(p*path)Cid', 'start_line': 91, 'end_line': 91, 'full_parameters': [], 'filename': '/home/dimi/Documents/Informatik_Studium/FSS/SoftEvo/DataCollection/FFS_SoftEvo/go-ipfs/core/coreapi/coreapi.go', 'top_nesting_level': 0, 'length': 1, 'fan_in': 0, 'fan_out': 0, 'general_fan_out': 0}, {'cyclomatic_complexity': 1, 'nloc': 1, 'token_count': 19, 'name': 'Root', 'long_name': '(p*path)Root', 'start_line': 92, 'end_line': 92, 'full_parameters': [], 'filename': '/home/dimi/Documents/Informatik_Studium/FSS/SoftEvo/DataCollection/FFS_SoftEvo/go-ipfs/core/coreapi/coreapi.go', 'top_nesting_level': 0, 'length': 1, 'fan_in': 0, 'fan_out': 0, 'general_fan_out': 0}, {'cyclomatic_complexity': 1, 'nloc': 1, 'token_count': 18, 'name': 'Resolved', 'long_name': '(p*path)Resolved', 'start_line': 93, 'end_line': 93, 'full_parameters': [], 'filename': '/home/dimi/Documents/Informatik_Studium/FSS/SoftEvo/DataCollection/FFS_SoftEvo/go-ipfs/core/coreapi/coreapi.go', 'top_nesting_level': 0, 'length': 1, 'fan_in': 0, 'fan_out': 0, 'general_fan_out': 0}]",179,984,12,"[{'cyclomatic_complexity': 2, 'nloc': 7, 'token_count': 64, 'name': 'NewCoreAPI', 'long_name': 'NewCoreAPI n * core . IpfsNode , opts ... options . ApiOption', 'start_line': 85, 'end_line': 92, 'full_parameters': ['n * core . IpfsNode', ' opts ... options . ApiOption'], 'filename': '/home/dimi/Documents/Informatik_Studium/FSS/SoftEvo/DataCollection/FFS_SoftEvo/go-ipfs/core/coreapi/coreapi.go', 'top_nesting_level': 0, 'length': 8, 'fan_in': 0, 'fan_out': 0, 'general_fan_out': 0}, {'cyclomatic_complexity': 1, 'nloc': 3, 'token_count': 22, 'name': 'Unixfs', 'long_name': '(api*CoreAPI)Unixfs', 'start_line': 95, 'end_line': 97, 'full_parameters': [], 'filename': '/home/dimi/Documents/Informatik_Studium/FSS/SoftEvo/DataCollection/FFS_SoftEvo/go-ipfs/core/coreapi/coreapi.go', 'top_nesting_level': 0, 'length': 3, 'fan_in': 0, 'fan_out': 0, 'general_fan_out': 0}, {'cyclomatic_complexity': 1, 'nloc': 3, 'token_count': 22, 'name': 'Block', 'long_name': '(api*CoreAPI)Block', 'start_line': 100, 'end_line': 102, 'full_parameters': [], 'filename': '/home/dimi/Documents/Informatik_Studium/FSS/SoftEvo/DataCollection/FFS_SoftEvo/go-ipfs/core/coreapi/coreapi.go', 'top_nesting_level': 0, 'length': 3, 'fan_in': 0, 'fan_out': 0, 'general_fan_out': 0}, {'cyclomatic_complexity': 1, 'nloc': 6, 'token_count': 25, 'name': 'Dag', 'long_name': '(api*CoreAPI)Dag', 'start_line': 105, 'end_line': 110, 'full_parameters': [], 'filename': '/home/dimi/Documents/Informatik_Studium/FSS/SoftEvo/DataCollection/FFS_SoftEvo/go-ipfs/core/coreapi/coreapi.go', 'top_nesting_level': 0, 'length': 6, 'fan_in': 0, 'fan_out': 0, 'general_fan_out': 0}, {'cyclomatic_complexity': 1, 'nloc': 3, 'token_count': 22, 'name': 'Name', 'long_name': '(api*CoreAPI)Name', 'start_line': 113, 'end_line': 115, 'full_parameters': [], 'filename': '/home/dimi/Documents/Informatik_Studium/FSS/SoftEvo/DataCollection/FFS_SoftEvo/go-ipfs/core/coreapi/coreapi.go', 'top_nesting_level': 0, 'length': 3, 'fan_in': 0, 'fan_out': 0, 'general_fan_out': 0}, {'cyclomatic_complexity': 1, 'nloc': 3, 'token_count': 22, 'name': 'Key', 'long_name': '(api*CoreAPI)Key', 'start_line': 118, 'end_line': 120, 'full_parameters': [], 'filename': '/home/dimi/Documents/Informatik_Studium/FSS/SoftEvo/DataCollection/FFS_SoftEvo/go-ipfs/core/coreapi/coreapi.go', 'top_nesting_level': 0, 'length': 3, 'fan_in': 0, 'fan_out': 0, 'general_fan_out': 0}, {'cyclomatic_complexity': 1, 'nloc': 3, 'token_count': 22, 'name': 'Object', 'long_name': '(api*CoreAPI)Object', 'start_line': 123, 'end_line': 125, 'full_parameters': [], 'filename': '/home/dimi/Documents/Informatik_Studium/FSS/SoftEvo/DataCollection/FFS_SoftEvo/go-ipfs/core/coreapi/coreapi.go', 'top_nesting_level': 0, 'length': 3, 'fan_in': 0, 'fan_out': 0, 'general_fan_out': 0}, {'cyclomatic_complexity': 1, 'nloc': 3, 'token_count': 22, 'name': 'Pin', 'long_name': '(api*CoreAPI)Pin', 'start_line': 128, 'end_line': 130, 'full_parameters': [], 'filename': '/home/dimi/Documents/Informatik_Studium/FSS/SoftEvo/DataCollection/FFS_SoftEvo/go-ipfs/core/coreapi/coreapi.go', 'top_nesting_level': 0, 'length': 3, 'fan_in': 0, 'fan_out': 0, 'general_fan_out': 0}, {'cyclomatic_complexity': 1, 'nloc': 3, 'token_count': 22, 'name': 'Dht', 'long_name': '(api*CoreAPI)Dht', 'start_line': 133, 'end_line': 135, 'full_parameters': [], 'filename': '/home/dimi/Documents/Informatik_Studium/FSS/SoftEvo/DataCollection/FFS_SoftEvo/go-ipfs/core/coreapi/coreapi.go', 'top_nesting_level': 0, 'length': 3, 'fan_in': 0, 'fan_out': 0, 'general_fan_out': 0}, {'cyclomatic_complexity': 1, 'nloc': 3, 'token_count': 22, 'name': 'Swarm', 'long_name': '(api*CoreAPI)Swarm', 'start_line': 138, 'end_line': 140, 'full_parameters': [], 'filename': '/home/dimi/Documents/Informatik_Studium/FSS/SoftEvo/DataCollection/FFS_SoftEvo/go-ipfs/core/coreapi/coreapi.go', 'top_nesting_level': 0, 'length': 3, 'fan_in': 0, 'fan_out': 0, 'general_fan_out': 0}, {'cyclomatic_complexity': 1, 'nloc': 3, 'token_count': 22, 'name': 'PubSub', 'long_name': '(api*CoreAPI)PubSub', 'start_line': 143, 'end_line': 145, 'full_parameters': [], 'filename': '/home/dimi/Documents/Informatik_Studium/FSS/SoftEvo/DataCollection/FFS_SoftEvo/go-ipfs/core/coreapi/coreapi.go', 'top_nesting_level': 0, 'length': 3, 'fan_in': 0, 'fan_out': 0, 'general_fan_out': 0}, {'cyclomatic_complexity': 3, 'nloc': 6, 'token_count': 24, 'name': 'error', 'long_name': '(allowOffline bool)error', 'start_line': 193, 'end_line': 198, 'full_parameters': [], 'filename': '/home/dimi/Documents/Informatik_Studium/FSS/SoftEvo/DataCollection/FFS_SoftEvo/go-ipfs/core/coreapi/coreapi.go', 'top_nesting_level': 0, 'length': 6, 'fan_in': 0, 'fan_out': 0, 'general_fan_out': 0}]",106,453,1,87,87,"[{'timestamp': 1512365669.0, 'added_lines': 1, 'deleted_lines': 1, 'nloc': 73}, {'timestamp': 1513298089.0, 'added_lines': 1, 'deleted_lines': 0, 'nloc': 73}, {'timestamp': 1512769895.0, 'added_lines': 4, 'deleted_lines': 0, 'nloc': 76}, {'timestamp': 1513009341.0, 'added_lines': 1, 'deleted_lines': 1, 'nloc': 76}, {'timestamp': 1513477430.0, 'added_lines': 1, 'deleted_lines': 1, 'nloc': 76}, {'timestamp': 1512944137.0, 'added_lines': 4, 'deleted_lines': 0, 'nloc': 79}, {'timestamp': 1512946096.0, 'added_lines': 4, 'deleted_lines': 0, 'nloc': 82}, {'timestamp': 1513188323.0, 'added_lines': 8, 'deleted_lines': 2, 'nloc': 88}, {'timestamp': 1513296233.0, 'added_lines': 2, 'deleted_lines': 8, 'nloc': 82}, {'timestamp': 1516660984.0, 'added_lines': 12, 'deleted_lines': 1, 'nloc': 82}, {'timestamp': 1516838128.0, 'added_lines': 1, 'deleted_lines': 1, 'nloc': 82}, {'timestamp': 1513292124.0, 'added_lines': 4, 'deleted_lines': 0, 'nloc': 85}, {'timestamp': 1513959773.0, 'added_lines': 1, 'deleted_lines': 1, 'nloc': 85}, {'timestamp': 1515111187.0, 'added_lines': 1, 'deleted_lines': 0, 'nloc': 85}, {'timestamp': 1515254261.0, 'added_lines': 4, 'deleted_lines': 0, 'nloc': 88}, {'timestamp': 1517552683.0, 'added_lines': 14, 'deleted_lines': 4, 'nloc': 93}, {'timestamp': 1515606066.0, 'added_lines': 4, 'deleted_lines': 0, 'nloc': 99}, {'timestamp': 1518736190.0, 'added_lines': 2, 'deleted_lines': 1, 'nloc': 100}, {'timestamp': 1520703088.0, 'added_lines': 2, 'deleted_lines': 2, 'nloc': 100}, {'timestamp': 1520704330.0, 'added_lines': 7, 'deleted_lines': 5, 'nloc': 100}, {'timestamp': 1520790935.0, 'added_lines': 6, 'deleted_lines': 6, 'nloc': 100}, {'timestamp': 1521427288.0, 'added_lines': 1, 'deleted_lines': 1, 'nloc': 100}, {'timestamp': 1528520460.0, 'added_lines': 2, 'deleted_lines': 2, 'nloc': 100}, {'timestamp': 1528844175.0, 'added_lines': 14, 'deleted_lines': 1, 'nloc': 100}, {'timestamp': 1531779409.0, 'added_lines': 2, 'deleted_lines': 2, 'nloc': 100}, {'timestamp': 1517583637.0, 'added_lines': 16, 'deleted_lines': 4, 'nloc': 110}, {'timestamp': 1518053130.0, 'added_lines': 0, 'deleted_lines': 102, 'nloc': 35}, {'timestamp': 1518107945.0, 'added_lines': 1, 'deleted_lines': 3, 'nloc': 33}, {'timestamp': 1520705574.0, 'added_lines': 5, 'deleted_lines': 0, 'nloc': 36}, {'timestamp': 1531999626.0, 'added_lines': 1, 'deleted_lines': 1, 'nloc': 36}, {'timestamp': 1520704977.0, 'added_lines': 5, 'deleted_lines': 0, 'nloc': 39}, {'timestamp': 1538524179.0, 'added_lines': 1, 'deleted_lines': 1, 'nloc': 39}, {'timestamp': 1520706502.0, 'added_lines': 5, 'deleted_lines': 0, 'nloc': 42}, {'timestamp': 1536663160.0, 'added_lines': 4, 'deleted_lines': 0, 'nloc': 44}, {'timestamp': 1539609230.0, 'added_lines': 3, 'deleted_lines': 1, 'nloc': 46}, {'timestamp': 1540250015.0, 'added_lines': 9, 'deleted_lines': 0, 'nloc': 52}, {'timestamp': 1540250040.0, 'added_lines': 1, 'deleted_lines': 1, 'nloc': 52}, {'timestamp': 1540400358.0, 'added_lines': 1, 'deleted_lines': 1, 'nloc': 52}, {'timestamp': 1540410565.0, 'added_lines': 1, 'deleted_lines': 1, 'nloc': 52}, {'timestamp': 1540418491.0, 'added_lines': 1, 'deleted_lines': 1, 'nloc': 52}, {'timestamp': 1540603818.0, 'added_lines': 2, 'deleted_lines': 2, 'nloc': 52}, {'timestamp': 1541189794.0, 'added_lines': 1, 'deleted_lines': 1, 'nloc': 52}, {'timestamp': 1541204121.0, 'added_lines': 3, 'deleted_lines': 3, 'nloc': 52}, {'timestamp': 1541903826.0, 'added_lines': 1, 'deleted_lines': 1, 'nloc': 52}, {'timestamp': 1543443696.0, 'added_lines': 1, 'deleted_lines': 1, 'nloc': 52}, {'timestamp': 1544225843.0, 'added_lines': 1, 'deleted_lines': 1, 'nloc': 52}, {'timestamp': 1544126440.0, 'added_lines': 89, 'deleted_lines': 7, 'nloc': 116}, {'timestamp': 1544131548.0, 'added_lines': 80, 'deleted_lines': 37, 'nloc': 151}, {'timestamp': 1544448079.0, 'added_lines': 88, 'deleted_lines': 71, 'nloc': 160}, {'timestamp': 1544451987.0, 'added_lines': 5, 'deleted_lines': 1, 'nloc': 163}, {'timestamp': 1544563480.0, 'added_lines': 12, 'deleted_lines': 4, 'nloc': 170}, {'timestamp': 1545034475.0, 'added_lines': 22, 'deleted_lines': 35, 'nloc': 158}, {'timestamp': 1545181728.0, 'added_lines': 4, 'deleted_lines': 6, 'nloc': 158}, {'timestamp': 1545321731.0, 'added_lines': 1, 'deleted_lines': 1, 'nloc': 158}, {'timestamp': 1546448380.0, 'added_lines': 0, 'deleted_lines': 1, 'nloc': 157}, {'timestamp': 1546565740.0, 'added_lines': 1, 'deleted_lines': 2, 'nloc': 157}, {'timestamp': 1546612815.0, 'added_lines': 2, 'deleted_lines': 0, 'nloc': 159}, {'timestamp': 1547003974.0, 'added_lines': 7, 'deleted_lines': 7, 'nloc': 159}, {'timestamp': 1547304079.0, 'added_lines': 2, 'deleted_lines': 2, 'nloc': 159}, {'timestamp': 1548187279.0, 'added_lines': 8, 'deleted_lines': 4, 'nloc': 162}, {'timestamp': 1547499910.0, 'added_lines': 3, 'deleted_lines': 3, 'nloc': 162}, {'timestamp': 1549588289.0, 'added_lines': 9, 'deleted_lines': 9, 'nloc': 162}, {'timestamp': 1549672857.0, 'added_lines': 2, 'deleted_lines': 2, 'nloc': 162}, {'timestamp': 1549673846.0, 'added_lines': 3, 'deleted_lines': 3, 'nloc': 162}, {'timestamp': 1549903582.0, 'added_lines': 2, 'deleted_lines': 2, 'nloc': 162}, {'timestamp': 1550185115.0, 'added_lines': 4, 'deleted_lines': 4, 'nloc': 162}, {'timestamp': 1550507829.0, 'added_lines': 15, 'deleted_lines': 15, 'nloc': 162}, {'timestamp': 1550576884.0, 'added_lines': 2, 'deleted_lines': 2, 'nloc': 162}, {'timestamp': 1550711994.0, 'added_lines': 4, 'deleted_lines': 4, 'nloc': 162}, {'timestamp': 1550723346.0, 'added_lines': 10, 'deleted_lines': 10, 'nloc': 162}, {'timestamp': 1551229859.0, 'added_lines': 11, 'deleted_lines': 11, 'nloc': 162}, {'timestamp': 1551299964.0, 'added_lines': 5, 'deleted_lines': 5, 'nloc': 162}, {'timestamp': 1551754781.0, 'added_lines': 1, 'deleted_lines': 1, 'nloc': 162}, {'timestamp': 1551551196.0, 'added_lines': 17, 'deleted_lines': 17, 'nloc': 162}, {'timestamp': 1552083569.0, 'added_lines': 5, 'deleted_lines': 0, 'nloc': 165}, {'timestamp': 1552091511.0, 'added_lines': 2, 'deleted_lines': 1, 'nloc': 166}, {'timestamp': 1552093097.0, 'added_lines': 1, 'deleted_lines': 1, 'nloc': 166}, {'timestamp': 1554255872.0, 'added_lines': 2, 'deleted_lines': 1, 'nloc': 167}, {'timestamp': 1555520888.0, 'added_lines': 1, 'deleted_lines': 1, 'nloc': 167}, {'timestamp': 1559060517.0, 'added_lines': 6, 'deleted_lines': 6, 'nloc': 167}, {'timestamp': 1562188975.0, 'added_lines': 1, 'deleted_lines': 1, 'nloc': 167}, {'timestamp': 1574264289.0, 'added_lines': 6, 'deleted_lines': 6, 'nloc': 167}, {'timestamp': 1590792870.0, 'added_lines': 0, 'deleted_lines': 3, 'nloc': 165}, {'timestamp': 1613691223.0, 'added_lines': 1, 'deleted_lines': 1, 'nloc': 165}, {'timestamp': 1618224384.0, 'added_lines': 6, 'deleted_lines': 3, 'nloc': 168}, {'timestamp': 1618524335.0, 'added_lines': 9, 'deleted_lines': 1, 'nloc': 174}, {'timestamp': 1629221569.0, 'added_lines': 17, 'deleted_lines': 13, 'nloc': 179}]","{'assets/assets.go': 26, 'blocks/blockstore/arc_cache.go': 2, 'blocks/blockstore/arc_cache_test.go': 2, 'blocks/blockstore/blockstore.go': 2, 'blocks/blockstore/blockstore_test.go': 2, 'blocks/blockstore/bloom_cache.go': 2, 'blocks/blockstore/bloom_cache_test.go': 2, 'blocks/blockstore/util/remove.go': 2, 'blocks/blocksutil/block_generator.go': 2, 'blockservice/blockservice.go': 4, 'blockservice/blockservice_test.go': 4, 'blockservice/test/blocks_test.go': 4, 'cmd/ipfs/daemon.go': 13, 'cmd/ipfs/init.go': 14, 'cmd/ipfs/ipfs.go': 8, 'cmd/ipfs/main.go': 15, 'cmd/ipfs/main_test.go': 1, 'cmd/ipfswatch/main.go': 11, 'cmd/seccat/seccat.go': 14, 'commands/command.go': 4, 'commands/command_test.go': 2, 'commands/request.go': 6, 'commands/response.go': 3, 'commands/response_test.go': 2, 'core/bootstrap.go': 12, 'core/bootstrap_test.go': 12, 'core/builder.go': 31, 'core/commands/active.go': 6, 'core/commands/add.go': 18, 'core/commands/bitswap.go': 24, 'core/commands/block.go': 18, 'core/commands/bootstrap.go': 12, 'core/commands/cat.go': 16, 'core/commands/commands.go': 8, 'core/commands/config.go': 12, 'core/commands/dag/dag.go': 30, 'core/commands/dht.go': 26, 'core/commands/dht_test.go': 14, 'core/commands/diag.go': 6, 'core/commands/dns.go': 16, 'core/commands/external.go': 6, 'core/commands/files/files.go': 2, 'core/commands/filestore.go': 10, 'core/commands/get.go': 25, 'core/commands/get_test.go': 8, 'core/commands/helptext_test.go': 8, 'core/commands/id.go': 20, 'core/commands/ipns.go': 3, 'core/commands/ipnsps.go': 2, 'core/commands/keystore.go': 16, 'core/commands/log.go': 7, 'core/commands/ls.go': 28, 'core/commands/mount_nofuse.go': 6, 'core/commands/mount_unix.go': 14, 'core/commands/mount_windows.go': 6, 'core/commands/name.go': 2, 'core/commands/object/diff.go': 16, 'core/commands/object/object.go': 28, 'core/commands/object/patch.go': 15, 'core/commands/p2p.go': 16, 'core/commands/pin.go': 31, 'core/commands/ping.go': 18, 'core/commands/publish.go': 3, 'core/commands/pubsub.go': 19, 'core/commands/refs.go': 25, 'core/commands/repo.go': 16, 'core/commands/resolve.go': 27, 'core/commands/root.go': 8, 'core/commands/shutdown.go': 8, 'core/commands/stat.go': 14, 'core/commands/swarm.go': 18, 'core/commands/sysdiag.go': 12, 'core/commands/tar.go': 22, 'core/commands/unixfs/ls.go': 27, 'core/commands/unixfs/unixfs.go': 6, 'core/commands/version.go': 7, 'core/core.go': 38, 'core/coreapi/interface/interface.go': 16, 'core/coreapi/unixfs.go': 36, 'core/coreapi/unixfs_test.go': 18, 'core/coredag/cbor.go': 11, 'core/coredag/dagpb.go': 23, 'core/coredag/dagtransl.go': 10, 'core/coredag/raw.go': 23, 'core/corehttp/commands.go': 23, 'core/corehttp/corehttp.go': 9, 'core/corehttp/gateway.go': 24, 'core/corehttp/gateway_handler.go': 33, 'core/corehttp/gateway_test.go': 28, 'core/corehttp/metrics_test.go': 18, 'core/corerepo/gc.go': 25, 'core/corerepo/pinning.go': 8, 'core/coreunix/add.go': 29, 'core/coreunix/add_test.go': 28, 'core/coreunix/metadata.go': 24, 'core/coreunix/metadata_test.go': 24, 'core/mock/mock.go': 19, 'core/pathresolver.go': 25, 'exchange/bitswap/bitswap.go': 5, 'exchange/bitswap/bitswap_test.go': 4, 'exchange/bitswap/decision/bench_test.go': 4, 'exchange/bitswap/decision/engine.go': 4, 'exchange/bitswap/decision/engine_test.go': 4, 'exchange/bitswap/decision/ledger.go': 5, 'exchange/bitswap/decision/peer_request_queue.go': 4, 'exchange/bitswap/decision/peer_request_queue_test.go': 4, 'exchange/bitswap/get.go': 4, 'exchange/bitswap/message/message.go': 4, 'exchange/bitswap/message/message_test.go': 4, 'exchange/bitswap/network/interface.go': 4, 'exchange/bitswap/network/ipfs_impl.go': 4, 'exchange/bitswap/notifications/notifications.go': 4, 'exchange/bitswap/notifications/notifications_test.go': 4, 'exchange/bitswap/session.go': 4, 'exchange/bitswap/session_test.go': 4, 'exchange/bitswap/stat.go': 4, 'exchange/bitswap/testnet/interface.go': 3, 'exchange/bitswap/testnet/network_test.go': 4, 'exchange/bitswap/testnet/peernet.go': 4, 'exchange/bitswap/testnet/virtual.go': 4, 'exchange/bitswap/testutils.go': 4, 'exchange/bitswap/wantlist/wantlist.go': 4, 'exchange/bitswap/wantlist/wantlist_test.go': 4, 'exchange/bitswap/wantmanager.go': 4, 'exchange/bitswap/workers.go': 4, 'exchange/interface.go': 2, 'exchange/offline/offline.go': 2, 'exchange/offline/offline_test.go': 2, 'exchange/reprovide/providers.go': 23, 'exchange/reprovide/reprovide.go': 14, 'exchange/reprovide/reprovide_test.go': 14, 'filestore/filestore.go': 11, 'filestore/filestore_test.go': 23, 'filestore/fsrefstore.go': 11, 'filestore/util.go': 9, 'fuse/ipns/ipns_test.go': 14, 'fuse/ipns/ipns_unix.go': 25, 'fuse/node/mount_test.go': 14, 'fuse/readonly/ipfs_test.go': 29, 'fuse/readonly/readonly_unix.go': 25, 'importer/balanced/balanced_test.go': 4, 'importer/balanced/builder.go': 4, 'importer/chunk/rabin_test.go': 2, 'importer/chunk/splitting_test.go': 2, 'importer/helpers/dagbuilder.go': 5, 'importer/helpers/helpers.go': 4, 'importer/importer.go': 4, 'importer/importer_test.go': 4, 'importer/trickle/trickle_test.go': 4, 'importer/trickle/trickledag.go': 5, 'merkledag/batch.go': 2, 'merkledag/coding.go': 4, 'merkledag/merkledag.go': 5, 'merkledag/merkledag_test.go': 4, 'merkledag/node.go': 4, 'merkledag/node_test.go': 4, 'merkledag/raw.go': 5, 'merkledag/traverse/traverse.go': 4, 'merkledag/traverse/traverse_test.go': 4, 'merkledag/utils/diff.go': 4, 'merkledag/utils/diffenum.go': 4, 'merkledag/utils/diffenum_test.go': 4, 'merkledag/utils/utils.go': 4, 'merkledag/utils/utils_test.go': 4, 'mfs/dir.go': 4, 'mfs/file.go': 4, 'mfs/mfs_test.go': 4, 'mfs/ops.go': 4, 'mfs/repub_test.go': 4, 'mfs/system.go': 4, 'namesys/ipns_select_test.go': 3, 'namesys/namesys.go': 28, 'namesys/publisher.go': 27, 'namesys/publisher_test.go': 15, 'namesys/pubsub.go': 3, 'namesys/pubsub_test.go': 2, 'namesys/republisher/repub.go': 23, 'namesys/republisher/repub_test.go': 24, 'namesys/resolve_test.go': 25, 'namesys/routing.go': 28, 'p2p/p2p.go': 13, 'p2p/registry.go': 3, 'package.json': 24, 'path/path.go': 6, 'path/resolver.go': 3, 'path/resolver_test.go': 2, 'pin/gc/gc.go': 23, 'pin/pin.go': 24, 'pin/pin_test.go': 23, 'pin/set.go': 24, 'pin/set_test.go': 23, 'plugin/ipld.go': 10, 'plugin/loader/initializer.go': 6, 'plugin/plugins/git/git.go': 10, 'repo/config/bootstrap_peers.go': 3, 'repo/config/init.go': 3, 'repo/fsrepo/fsrepo.go': 14, 'repo/fsrepo/lock/lock.go': 2, 'repo/fsrepo/serialize/serialize.go': 3, 'repo/mock.go': 12, 'repo/repo.go': 13, 'routing/mock/centralized_client.go': 2, 'routing/mock/centralized_server.go': 2, 'routing/mock/centralized_test.go': 2, 'routing/mock/interface.go': 2, 'routing/none/none_client.go': 2, 'routing/offline/offline.go': 2, 'routing/offline/offline_test.go': 2, 'tar/format.go': 25, 'test/dependencies/ma-pipe-unidir/main.go': 8, 'test/integration/addcat_test.go': 21, 'test/integration/bench_cat_test.go': 21, 'test/integration/bench_test.go': 12, 'test/integration/bitswap_wo_routing_test.go': 19, 'test/integration/three_legged_cat_test.go': 21, 'thirdparty/ds-help/key.go': 2, 'thirdparty/pollEndpoint/main.go': 9, 'thirdparty/posinfo/posinfo.go': 2, 'unixfs/archive/archive.go': 4, 'unixfs/archive/tar/writer.go': 4, 'unixfs/hamt/hamt.go': 4, 'unixfs/io/dagreader.go': 5, 'unixfs/io/dirbuilder.go': 3, 'unixfs/io/resolve.go': 5, 'unixfs/mod/dagmodifier.go': 5, 'unixfs/mod/dagmodifier_test.go': 3, 'unixfs/test/utils.go': 4, 'core/coreapi/dag.go': 18, 'core/coreapi/dag_test.go': 8, 'core/coreapi/interface/options/dag.go': 6, 'core/coreapi/name.go': 37, 'core/coreapi/key.go': 31, 'core/coreapi/interface/options/key.go': 2, 'core/coreapi/interface/options/name.go': 2, 'commands/legacy/command.go': 3, 'commands/legacy/legacy.go': 3, 'commands/legacy/legacy_test.go': 3, 'commands/legacy/request.go': 3, 'commands/legacy/response.go': 3, 'core/commands/commands_test.go': 7, 'merkledag/test/utils.go': 3, 'namesys/namesys_test.go': 27, 'repo/fsrepo/datastores.go': 6, 'repo/fsrepo/fsrepo_test.go': 10, 'thirdparty/datastore2/datastore_closer.go': 1, 'thirdparty/datastore2/delayed.go': 1, 'thirdparty/datastore2/threadsafe.go': 1, 'unixfs/io/pbdagreader.go': 4, 'core/coreapi/object.go': 35, 'core/coreapi/interface/options/object.go': 3, 'core/coreapi/object_test.go': 2, 'core/coreapi/block.go': 20, 'core/coreapi/interface/options/block.go': 4, 'merkledag/errservice.go': 3, 'merkledag/readonly.go': 3, 'merkledag/readonly_test.go': 3, 'merkledag/rwservice.go': 3, 'merkledag/session.go': 3, 'core/coreapi/interface/options/pin.go': 3, 'core/coreapi/pin.go': 33, 'core/commands/files.go': 27, 'core/coreunix/cat.go': 1, 'path/resolver/resolver.go': 3, 'path/resolver/resolver_test.go': 3, 'core/coreapi/interface/coreapi.go': 14, 'core/coreapi/block_test.go': 3, 'core/coreapi/interface/block.go': 2, 'core/coreapi/interface/dag.go': 8, 'core/coreapi/interface/key.go': 5, 'core/coreapi/interface/name.go': 1, 'core/coreapi/interface/object.go': 7, 'core/coreapi/interface/pin.go': 2, 'core/coreapi/key_test.go': 1, 'core/coreapi/name_test.go': 10, 'core/coreapi/pin_test.go': 1, 'CHANGELOG.md': 2, 'README.md': 1, 'bin/dist_get': 1, 'cmd/ipfs/util/ulimit_freebsd.go': 3, 'contribute.md': 1, 'docs/experimental-features.md': 1, 'docs/file-transfer.md': 1, 'docs/releases.md': 1, 'exchange/bitswap/README.md': 1, 'plugin/plugin.go': 1, 'repo/fsrepo/migrations/mfsr_test.go': 1, 'repo/fsrepo/migrations/migrations.go': 1, 'test/sharness/README.md': 1, 'thirdparty/dir/dir.go': 1, 'blocks/blockstoreutil/remove.go': 8, 'blockservice/test/mock.go': 2, 'cmd/ipfs/util/ulimit.go': 4, 'cmd/ipfs/util/ulimit_unix.go': 2, 'cmd/seccat/util.go': 4, 'core/coreapi/interface/path.go': 16, 'core/coreapi/interface/unixfs.go': 7, 'core/corehttp/logs.go': 4, 'fuse/ipns/link_unix.go': 2, 'fuse/mount/fuse.go': 2, 'fuse/mount/mount.go': 4, 'fuse/node/mount_darwin.go': 2, 'fuse/node/mount_unix.go': 5, 'keystore/keystore.go': 5, 'namesys/ipns_validate_test.go': 1, 'namesys/validator.go': 1, 'plugin/loader/load.go': 2, 'thirdparty/verifbs/verifbs.go': 7, 'thirdparty/verifcid/validate.go': 2, 'thirdparty/verifcid/validate_test.go': 2, 'unixfs/hamt/hamt_stress_test.go': 2, 'unixfs/hamt/hamt_test.go': 2, 'core/commands/urlstore.go': 21, 'namesys/ipns_resolver_validation_test.go': 25, 'unixfs/io/directory.go': 1, 'core/coreapi/interface/options/path.go': 1, 'core/coreapi/path.go': 30, None: 39, 'core/coreapi/dht.go': 30, 'core/coreapi/interface/dht.go': 8, 'core/coreapi/interface/options/dht.go': 2, 'core/coreapi/dht_test.go': 4, 'core/coreapi/interface/swarm.go': 7, 'core/coreapi/swarm.go': 22, 'core/coreapi/interface/errors.go': 1, 'core/coreapi/interface/options/pubsub.go': 1, 'core/coreapi/interface/pubsub.go': 6, 'core/coreapi/pubsub.go': 26, 'cmd/ipfs/dnsresolve_test.go': 5, 'core/commands/cmdenv/env.go': 17, 'core/commands/name/ipns.go': 25, 'core/commands/name/ipnsps.go': 10, 'core/core_test.go': 9, 'core/coreapi/interface/options/unixfs.go': 13, 'core/coreapi/unixfile.go': 12, 'core/pathresolver_test.go': 19, 'dagutils/diff.go': 23, 'dagutils/diffenum.go': 19, 'dagutils/diffenum_test.go': 19, 'dagutils/utils.go': 19, 'dagutils/utils_test.go': 19, 'fuse/ipns/common.go': 22, 'namesys/base.go': 23, 'namesys/cache.go': 19, 'namesys/dns.go': 23, 'namesys/interface.go': 24, 'namesys/proquint.go': 23, 'p2p/listener.go': 10, 'p2p/local.go': 10, 'p2p/remote.go': 10, 'p2p/stream.go': 10, 'repo/fsrepo/config_test.go': 8, 'repo/fsrepo/misc.go': 8, 'test/bench/bench_cli_ipfs_add/main.go': 8, 'test/bench/offline_add/main.go': 8, 'core/commands/cid.go': 6, 'core/commands/name/name.go': 5, 'core/commands/name/publish.go': 13, 'keystore/keystore_test.go': 4, 'keystore/memkeystore.go': 4, 'test/dependencies/iptb/iptb.go': 12, 'thirdparty/cidv0v1/blockstore.go': 5, 'plugin/plugins/badgerds/badgerds.go': 3, 'plugin/plugins/flatfs/flatfs.go': 3, 'plugin/plugins/levelds/levelds.go': 3, 'commands/context.go': 15, 'core/corehttp/proxy.go': 10, 'core/coreapi/interface/options/global.go': 2, 'test/sharness/t0100-name.sh': 1, 'core/coreapi/interface/tests/path.go': 2, 'test/sharness/t0110-gateway.sh': 1, 'core/coreapi/interface/tests/name.go': 3, 'core/coreapi/interface/tests/unixfs.go': 4, 'core/coreapi/test/api_test.go': 16, 'core/coreapi/interface/tests/dag.go': 1, 'core/coreapi/interface/tests/pin.go': 1, 'plugin/loader/loader.go': 13, 'core/corehttp/ipns_hostname.go': 11, 'namesys/dns_test.go': 10, 'plugin/daemon.go': 10, 'core/commands/cmdenv/cidbase.go': 5, 'core/commands/cmdenv/file.go': 2, 'filestore/pb/dataobj.pb.go': 2, 'pin/internal/pb/header.pb.go': 2, 'core/commands/cmdenv/cidbase_test.go': 2, 'core/corehttp/metrics.go': 1, 'core/corehttp/proxy_test.go': 2, 'core/corerepo/stat.go': 1, 'plugin/tracer.go': 1, 'thirdparty/notifier/notifier.go': 1, 'core/coreapi/provider.go': 2, 'provider/provider.go': 4, 'provider/queue.go': 2, 'provider/offline.go': 3, 'core/bootstrap/bootstrap.go': 2, 'core/bootstrap/bootstrap_test.go': 2, 'core/ncore.go': 1, 'core/node/builder.go': 2, 'core/node/core.go': 5, 'core/node/discovery.go': 1, 'core/node/groups.go': 5, 'core/node/helpers.go': 1, 'core/node/identity.go': 2, 'core/node/ipns.go': 5, 'core/node/libp2p.go': 1, 'core/node/provider.go': 6, 'core/node/storage.go': 1, 'go.mod': 5, 'go.sum': 5, 'provider/queue/queue.go': 1, 'provider/queue/queue_test.go': 1, 'provider/simple/provider.go': 2, 'provider/simple/provider_test.go': 2, 'provider/simple/reprovide.go': 2, 'provider/simple/reprovide_test.go': 2, 'provider/system.go': 1, 'test/sharness/lib/iptb-lib.sh': 1, 'test/sharness/t0175-provider.sh': 1, 'test/sharness/t0175-reprovider.sh': 1, 'test/sharness/t0175-strategic-provider.sh': 1, 'core/node/libp2p/addrs.go': 1, 'core/node/libp2p/discovery.go': 1, 'core/node/libp2p/host.go': 1, 'core/node/libp2p/hostopt.go': 1, 'core/node/libp2p/libp2p.go': 1, 'core/node/libp2p/nat.go': 1, 'core/node/libp2p/pnet.go': 1, 'core/node/libp2p/pubsub.go': 1, 'core/node/libp2p/routing.go': 1, 'core/node/libp2p/routingopt.go': 1, 'core/node/libp2p/smux.go': 1, 'core/node/libp2p/transport.go': 1, 'Rules.mk': 1, 'gc/gc.go': 1, 'core/corehttp/hostname.go': 1, 'core/node/dns.go': 1, 'core/node/libp2p/dns.go': 1, 'core/commands/dag/get.go': 1, 'core/commands/dag/put.go': 1, 'test/sharness/t0053-dag.sh': 1, 'test/sharness/t0055-dag-put-json-new-line.sh': 1, 'test/sharness/t0280-plugin-git.sh': 1}","('core/core.go', 0.4367816091954023, 0.2122905027932961)"
core/coreapi/unixfs.go,63,401,4,"[{'cyclomatic_complexity': 3, 'nloc': 11, 'token_count': 80, 'name': 'Add', 'long_name': '(api*UnixfsAPI)Add ctx context . Context , r io . Reader', 'start_line': 17, 'end_line': 27, 'full_parameters': ['ctx context . Context', ' r io . Reader'], 'filename': '/home/dimi/Documents/Informatik_Studium/FSS/SoftEvo/DataCollection/FFS_SoftEvo/go-ipfs/core/coreapi/unixfs.go', 'top_nesting_level': 0, 'length': 11, 'fan_in': 0, 'fan_out': 0, 'general_fan_out': 0}, {'cyclomatic_complexity': 4, 'nloc': 13, 'token_count': 100, 'name': 'Cat', 'long_name': '(api*UnixfsAPI)Cat ctx context . Context , p coreiface . Path', 'start_line': 29, 'end_line': 42, 'full_parameters': ['ctx context . Context', ' p coreiface . Path'], 'filename': '/home/dimi/Documents/Informatik_Studium/FSS/SoftEvo/DataCollection/FFS_SoftEvo/go-ipfs/core/coreapi/unixfs.go', 'top_nesting_level': 0, 'length': 14, 'fan_in': 0, 'fan_out': 0, 'general_fan_out': 0}, {'cyclomatic_complexity': 6, 'nloc': 25, 'token_count': 179, 'name': 'Ls', 'long_name': '(api*UnixfsAPI)Ls ctx context . Context , p coreiface . Path', 'start_line': 44, 'end_line': 70, 'full_parameters': ['ctx context . Context', ' p coreiface . Path'], 'filename': '/home/dimi/Documents/Informatik_Studium/FSS/SoftEvo/DataCollection/FFS_SoftEvo/go-ipfs/core/coreapi/unixfs.go', 'top_nesting_level': 0, 'length': 27, 'fan_in': 0, 'fan_out': 0, 'general_fan_out': 0}, {'cyclomatic_complexity': 1, 'nloc': 3, 'token_count': 22, 'name': 'core', 'long_name': '(api*UnixfsAPI)core', 'start_line': 72, 'end_line': 74, 'full_parameters': [], 'filename': '/home/dimi/Documents/Informatik_Studium/FSS/SoftEvo/DataCollection/FFS_SoftEvo/go-ipfs/core/coreapi/unixfs.go', 'top_nesting_level': 0, 'length': 3, 'fan_in': 0, 'fan_out': 0, 'general_fan_out': 0}]",241,1470,5,"[{'cyclomatic_complexity': 3, 'nloc': 12, 'token_count': 50, 'name': '', 'long_name': '()', 'start_line': 37, 'end_line': 50, 'full_parameters': [], 'filename': '/home/dimi/Documents/Informatik_Studium/FSS/SoftEvo/DataCollection/FFS_SoftEvo/go-ipfs/core/coreapi/unixfs.go', 'top_nesting_level': 0, 'length': 14, 'fan_in': 0, 'fan_out': 0, 'general_fan_out': 0}, {'cyclomatic_complexity': 1, 'nloc': 4, 'token_count': 24, 'name': 'getOrCreateNilNode', 'long_name': 'getOrCreateNilNode', 'start_line': 36, 'end_line': 53, 'full_parameters': [], 'filename': '/home/dimi/Documents/Informatik_Studium/FSS/SoftEvo/DataCollection/FFS_SoftEvo/go-ipfs/core/coreapi/unixfs.go', 'top_nesting_level': 0, 'length': 18, 'fan_in': 0, 'fan_out': 0, 'general_fan_out': 0}, {'cyclomatic_complexity': 1, 'nloc': 3, 'token_count': 11, 'name': 'error', 'long_name': '()error', 'start_line': 107, 'end_line': 109, 'full_parameters': [], 'filename': '/home/dimi/Documents/Informatik_Studium/FSS/SoftEvo/DataCollection/FFS_SoftEvo/go-ipfs/core/coreapi/unixfs.go', 'top_nesting_level': 0, 'length': 3, 'fan_in': 0, 'fan_out': 0, 'general_fan_out': 0}, {'cyclomatic_complexity': 4, 'nloc': 10, 'token_count': 50, 'name': '', 'long_name': '()', 'start_line': 270, 'end_line': 279, 'full_parameters': [], 'filename': '/home/dimi/Documents/Informatik_Studium/FSS/SoftEvo/DataCollection/FFS_SoftEvo/go-ipfs/core/coreapi/unixfs.go', 'top_nesting_level': 0, 'length': 10, 'fan_in': 0, 'fan_out': 0, 'general_fan_out': 0}, {'cyclomatic_complexity': 1, 'nloc': 3, 'token_count': 18, 'name': 'Sync', 'long_name': '(s*syncDagService)Sync', 'start_line': 305, 'end_line': 307, 'full_parameters': [], 'filename': '/home/dimi/Documents/Informatik_Studium/FSS/SoftEvo/DataCollection/FFS_SoftEvo/go-ipfs/core/coreapi/unixfs.go', 'top_nesting_level': 0, 'length': 3, 'fan_in': 0, 'fan_out': 0, 'general_fan_out': 0}]",178,1069,1,120,120,"[{'timestamp': 1512365669.0, 'added_lines': 2, 'deleted_lines': 2, 'nloc': 63}, {'timestamp': 1516661249.0, 'added_lines': 5, 'deleted_lines': 0, 'nloc': 63}, {'timestamp': 1516838128.0, 'added_lines': 2, 'deleted_lines': 2, 'nloc': 63}, {'timestamp': 1517255734.0, 'added_lines': 2, 'deleted_lines': 2, 'nloc': 63}, {'timestamp': 1517552683.0, 'added_lines': 5, 'deleted_lines': 2, 'nloc': 65}, {'timestamp': 1518741858.0, 'added_lines': 3, 'deleted_lines': 4, 'nloc': 64}, {'timestamp': 1519177055.0, 'added_lines': 1, 'deleted_lines': 1, 'nloc': 64}, {'timestamp': 1520703088.0, 'added_lines': 3, 'deleted_lines': 3, 'nloc': 64}, {'timestamp': 1528520460.0, 'added_lines': 2, 'deleted_lines': 2, 'nloc': 64}, {'timestamp': 1531779409.0, 'added_lines': 2, 'deleted_lines': 2, 'nloc': 64}, {'timestamp': 1517583637.0, 'added_lines': 1, 'deleted_lines': 1, 'nloc': 64}, {'timestamp': 1518107945.0, 'added_lines': 1, 'deleted_lines': 1, 'nloc': 64}, {'timestamp': 1522441317.0, 'added_lines': 1, 'deleted_lines': 1, 'nloc': 64}, {'timestamp': 1528768346.0, 'added_lines': 1, 'deleted_lines': 1, 'nloc': 64}, {'timestamp': 1532986515.0, 'added_lines': 1, 'deleted_lines': 1, 'nloc': 64}, {'timestamp': 1533500571.0, 'added_lines': 1, 'deleted_lines': 1, 'nloc': 64}, {'timestamp': 1533618653.0, 'added_lines': 1, 'deleted_lines': 1, 'nloc': 64}, {'timestamp': 1533779477.0, 'added_lines': 1, 'deleted_lines': 1, 'nloc': 64}, {'timestamp': 1533946888.0, 'added_lines': 1, 'deleted_lines': 1, 'nloc': 64}, {'timestamp': 1534115707.0, 'added_lines': 3, 'deleted_lines': 3, 'nloc': 64}, {'timestamp': 1534195762.0, 'added_lines': 1, 'deleted_lines': 1, 'nloc': 64}, {'timestamp': 1534347022.0, 'added_lines': 3, 'deleted_lines': 3, 'nloc': 64}, {'timestamp': 1534896611.0, 'added_lines': 3, 'deleted_lines': 3, 'nloc': 64}, {'timestamp': 1535601896.0, 'added_lines': 1, 'deleted_lines': 1, 'nloc': 64}, {'timestamp': 1536388808.0, 'added_lines': 1, 'deleted_lines': 1, 'nloc': 64}, {'timestamp': 1536718784.0, 'added_lines': 3, 'deleted_lines': 3, 'nloc': 64}, {'timestamp': 1536723292.0, 'added_lines': 1, 'deleted_lines': 1, 'nloc': 64}, {'timestamp': 1537237833.0, 'added_lines': 1, 'deleted_lines': 1, 'nloc': 64}, {'timestamp': 1537790637.0, 'added_lines': 1, 'deleted_lines': 1, 'nloc': 64}, {'timestamp': 1537792589.0, 'added_lines': 1, 'deleted_lines': 1, 'nloc': 64}, {'timestamp': 1537448451.0, 'added_lines': 35, 'deleted_lines': 5, 'nloc': 87}, {'timestamp': 1537451993.0, 'added_lines': 49, 'deleted_lines': 3, 'nloc': 117}, {'timestamp': 1537453172.0, 'added_lines': 9, 'deleted_lines': 1, 'nloc': 124}, {'timestamp': 1537454431.0, 'added_lines': 10, 'deleted_lines': 2, 'nloc': 132}, {'timestamp': 1537455723.0, 'added_lines': 6, 'deleted_lines': 21, 'nloc': 118}, {'timestamp': 1537477522.0, 'added_lines': 53, 'deleted_lines': 4, 'nloc': 157}, {'timestamp': 1537478107.0, 'added_lines': 1, 'deleted_lines': 34, 'nloc': 132}, {'timestamp': 1537479889.0, 'added_lines': 1, 'deleted_lines': 1, 'nloc': 132}, {'timestamp': 1538466170.0, 'added_lines': 1, 'deleted_lines': 1, 'nloc': 132}, {'timestamp': 1538525337.0, 'added_lines': 3, 'deleted_lines': 13, 'nloc': 125}, {'timestamp': 1538571946.0, 'added_lines': 3, 'deleted_lines': 4, 'nloc': 124}, {'timestamp': 1538580067.0, 'added_lines': 9, 'deleted_lines': 0, 'nloc': 131}, {'timestamp': 1538598645.0, 'added_lines': 1, 'deleted_lines': 1, 'nloc': 132}, {'timestamp': 1538599782.0, 'added_lines': 1, 'deleted_lines': 1, 'nloc': 133}, {'timestamp': 1538601438.0, 'added_lines': 1, 'deleted_lines': 1, 'nloc': 134}, {'timestamp': 1538607626.0, 'added_lines': 5, 'deleted_lines': 2, 'nloc': 138}, {'timestamp': 1538609097.0, 'added_lines': 15, 'deleted_lines': 4, 'nloc': 149}, {'timestamp': 1538611045.0, 'added_lines': 8, 'deleted_lines': 0, 'nloc': 149}, {'timestamp': 1538544957.0, 'added_lines': 1, 'deleted_lines': 1, 'nloc': 64}, {'timestamp': 1538694687.0, 'added_lines': 1, 'deleted_lines': 1, 'nloc': 64}, {'timestamp': 1538695953.0, 'added_lines': 1, 'deleted_lines': 1, 'nloc': 64}, {'timestamp': 1538773916.0, 'added_lines': 8, 'deleted_lines': 8, 'nloc': 149}, {'timestamp': 1539176817.0, 'added_lines': 6, 'deleted_lines': 6, 'nloc': 149}, {'timestamp': 1539357340.0, 'added_lines': 6, 'deleted_lines': 6, 'nloc': 149}, {'timestamp': 1539850591.0, 'added_lines': 5, 'deleted_lines': 4, 'nloc': 149}, {'timestamp': 1539104245.0, 'added_lines': 2, 'deleted_lines': 19, 'nloc': 136}, {'timestamp': 1539600349.0, 'added_lines': 1, 'deleted_lines': 1, 'nloc': 136}, {'timestamp': 1539609230.0, 'added_lines': 5, 'deleted_lines': 4, 'nloc': 136}, {'timestamp': 1540250015.0, 'added_lines': 1, 'deleted_lines': 1, 'nloc': 136}, {'timestamp': 1540400358.0, 'added_lines': 6, 'deleted_lines': 6, 'nloc': 136}, {'timestamp': 1540410565.0, 'added_lines': 6, 'deleted_lines': 6, 'nloc': 136}, {'timestamp': 1540418491.0, 'added_lines': 6, 'deleted_lines': 6, 'nloc': 136}, {'timestamp': 1540603818.0, 'added_lines': 6, 'deleted_lines': 6, 'nloc': 136}, {'timestamp': 1540916861.0, 'added_lines': 1, 'deleted_lines': 1, 'nloc': 136}, {'timestamp': 1541106379.0, 'added_lines': 3, 'deleted_lines': 3, 'nloc': 136}, {'timestamp': 1541189794.0, 'added_lines': 5, 'deleted_lines': 5, 'nloc': 136}, {'timestamp': 1541204121.0, 'added_lines': 10, 'deleted_lines': 10, 'nloc': 136}, {'timestamp': 1541903826.0, 'added_lines': 8, 'deleted_lines': 8, 'nloc': 136}, {'timestamp': 1543443696.0, 'added_lines': 5, 'deleted_lines': 5, 'nloc': 136}, {'timestamp': 1544225843.0, 'added_lines': 6, 'deleted_lines': 6, 'nloc': 136}, {'timestamp': 1540556089.0, 'added_lines': 4, 'deleted_lines': 4, 'nloc': 136}, {'timestamp': 1540562190.0, 'added_lines': 2, 'deleted_lines': 2, 'nloc': 136}, {'timestamp': 1542594282.0, 'added_lines': 3, 'deleted_lines': 3, 'nloc': 136}, {'timestamp': 1544126440.0, 'added_lines': 12, 'deleted_lines': 11, 'nloc': 138}, {'timestamp': 1544451987.0, 'added_lines': 0, 'deleted_lines': 5, 'nloc': 134}, {'timestamp': 1547003974.0, 'added_lines': 6, 'deleted_lines': 6, 'nloc': 134}, {'timestamp': 1542852136.0, 'added_lines': 1, 'deleted_lines': 1, 'nloc': 134}, {'timestamp': 1547499910.0, 'added_lines': 7, 'deleted_lines': 7, 'nloc': 134}, {'timestamp': 1548358727.0, 'added_lines': 2, 'deleted_lines': 1, 'nloc': 135}, {'timestamp': 1548866534.0, 'added_lines': 5, 'deleted_lines': 5, 'nloc': 135}, {'timestamp': 1549046923.0, 'added_lines': 5, 'deleted_lines': 4, 'nloc': 136}, {'timestamp': 1549048368.0, 'added_lines': 33, 'deleted_lines': 14, 'nloc': 149}, {'timestamp': 1549058839.0, 'added_lines': 70, 'deleted_lines': 11, 'nloc': 200}, {'timestamp': 1549063124.0, 'added_lines': 8, 'deleted_lines': 5, 'nloc': 202}, {'timestamp': 1549075320.0, 'added_lines': 0, 'deleted_lines': 12, 'nloc': 192}, {'timestamp': 1549124008.0, 'added_lines': 3, 'deleted_lines': 7, 'nloc': 188}, {'timestamp': 1549124874.0, 'added_lines': 2, 'deleted_lines': 2, 'nloc': 188}, {'timestamp': 1549588289.0, 'added_lines': 8, 'deleted_lines': 8, 'nloc': 188}, {'timestamp': 1549672857.0, 'added_lines': 2, 'deleted_lines': 2, 'nloc': 188}, {'timestamp': 1549673846.0, 'added_lines': 2, 'deleted_lines': 2, 'nloc': 188}, {'timestamp': 1549903582.0, 'added_lines': 7, 'deleted_lines': 7, 'nloc': 188}, {'timestamp': 1550185115.0, 'added_lines': 10, 'deleted_lines': 10, 'nloc': 188}, {'timestamp': 1550507829.0, 'added_lines': 11, 'deleted_lines': 11, 'nloc': 188}, {'timestamp': 1550576884.0, 'added_lines': 2, 'deleted_lines': 2, 'nloc': 188}, {'timestamp': 1550711994.0, 'added_lines': 10, 'deleted_lines': 10, 'nloc': 188}, {'timestamp': 1550723346.0, 'added_lines': 14, 'deleted_lines': 14, 'nloc': 188}, {'timestamp': 1551229859.0, 'added_lines': 10, 'deleted_lines': 10, 'nloc': 188}, {'timestamp': 1551299964.0, 'added_lines': 10, 'deleted_lines': 10, 'nloc': 188}, {'timestamp': 1551551196.0, 'added_lines': 15, 'deleted_lines': 15, 'nloc': 188}, {'timestamp': 1551760156.0, 'added_lines': 20, 'deleted_lines': 12, 'nloc': 196}, {'timestamp': 1551813321.0, 'added_lines': 1, 'deleted_lines': 0, 'nloc': 197}, {'timestamp': 1552083569.0, 'added_lines': 5, 'deleted_lines': 0, 'nloc': 200}, {'timestamp': 1551111996.0, 'added_lines': 1, 'deleted_lines': 0, 'nloc': 201}, {'timestamp': 1551709270.0, 'added_lines': 1, 'deleted_lines': 0, 'nloc': 202}, {'timestamp': 1552254637.0, 'added_lines': 0, 'deleted_lines': 3, 'nloc': 199}, {'timestamp': 1552316561.0, 'added_lines': 0, 'deleted_lines': 1, 'nloc': 198}, {'timestamp': 1553536851.0, 'added_lines': 0, 'deleted_lines': 1, 'nloc': 197}, {'timestamp': 1553802279.0, 'added_lines': 2, 'deleted_lines': 3, 'nloc': 196}, {'timestamp': 1553608614.0, 'added_lines': 6, 'deleted_lines': 5, 'nloc': 197}, {'timestamp': 1553609463.0, 'added_lines': 1, 'deleted_lines': 1, 'nloc': 197}, {'timestamp': 1557554420.0, 'added_lines': 1, 'deleted_lines': 1, 'nloc': 197}, {'timestamp': 1572890730.0, 'added_lines': 1, 'deleted_lines': 0, 'nloc': 198}, {'timestamp': 1573197162.0, 'added_lines': 4, 'deleted_lines': 2, 'nloc': 199}, {'timestamp': 1573801139.0, 'added_lines': 42, 'deleted_lines': 9, 'nloc': 226}, {'timestamp': 1574069174.0, 'added_lines': 16, 'deleted_lines': 31, 'nloc': 215}, {'timestamp': 1574701117.0, 'added_lines': 1, 'deleted_lines': 1, 'nloc': 215}, {'timestamp': 1575569793.0, 'added_lines': 34, 'deleted_lines': 1, 'nloc': 241}, {'timestamp': 1573197162.0, 'added_lines': 4, 'deleted_lines': 2, 'nloc': 199}, {'timestamp': 1572890730.0, 'added_lines': 1, 'deleted_lines': 0, 'nloc': 200}, {'timestamp': 1573801139.0, 'added_lines': 27, 'deleted_lines': 9, 'nloc': 215}]","{'assets/assets.go': 52, 'blocks/blockstore/arc_cache.go': 2, 'blocks/blockstore/arc_cache_test.go': 2, 'blocks/blockstore/blockstore.go': 2, 'blocks/blockstore/blockstore_test.go': 2, 'blocks/blockstore/bloom_cache.go': 2, 'blocks/blockstore/bloom_cache_test.go': 2, 'blocks/blockstore/util/remove.go': 2, 'blocks/blocksutil/block_generator.go': 2, 'blockservice/blockservice.go': 4, 'blockservice/blockservice_test.go': 4, 'blockservice/test/blocks_test.go': 4, 'cmd/ipfs/daemon.go': 20, 'cmd/ipfs/init.go': 25, 'cmd/ipfs/ipfs.go': 15, 'cmd/ipfs/main.go': 23, 'cmd/ipfs/main_test.go': 1, 'cmd/ipfswatch/main.go': 17, 'cmd/seccat/seccat.go': 21, 'commands/command.go': 9, 'commands/command_test.go': 2, 'commands/request.go': 14, 'commands/response.go': 6, 'commands/response_test.go': 2, 'core/bootstrap.go': 20, 'core/bootstrap_test.go': 20, 'core/builder.go': 51, 'core/commands/active.go': 12, 'core/commands/add.go': 47, 'core/commands/bitswap.go': 46, 'core/commands/block.go': 31, 'core/commands/bootstrap.go': 22, 'core/commands/cat.go': 28, 'core/commands/commands.go': 16, 'core/commands/config.go': 23, 'core/commands/dag/dag.go': 57, 'core/commands/dht.go': 50, 'core/commands/dht_test.go': 19, 'core/commands/diag.go': 12, 'core/commands/dns.go': 19, 'core/commands/external.go': 12, 'core/commands/files/files.go': 3, 'core/commands/filestore.go': 21, 'core/commands/get.go': 55, 'core/commands/get_test.go': 16, 'core/commands/helptext_test.go': 15, 'core/commands/id.go': 33, 'core/commands/ipns.go': 9, 'core/commands/ipnsps.go': 5, 'core/commands/keystore.go': 24, 'core/commands/log.go': 15, 'core/commands/ls.go': 62, 'core/commands/mount_nofuse.go': 12, 'core/commands/mount_unix.go': 22, 'core/commands/mount_windows.go': 12, 'core/commands/name.go': 4, 'core/commands/object/diff.go': 23, 'core/commands/object/object.go': 58, 'core/commands/object/patch.go': 28, 'core/commands/p2p.go': 24, 'core/commands/pin.go': 57, 'core/commands/ping.go': 28, 'core/commands/publish.go': 11, 'core/commands/pubsub.go': 33, 'core/commands/refs.go': 50, 'core/commands/repo.go': 34, 'core/commands/resolve.go': 53, 'core/commands/root.go': 16, 'core/commands/shutdown.go': 15, 'core/commands/stat.go': 20, 'core/commands/swarm.go': 31, 'core/commands/sysdiag.go': 17, 'core/commands/tar.go': 50, 'core/commands/unixfs/ls.go': 54, 'core/commands/unixfs/unixfs.go': 12, 'core/commands/version.go': 13, 'core/core.go': 52, 'core/coreapi/coreapi.go': 36, 'core/coreapi/interface/interface.go': 3, 'core/coreapi/unixfs_test.go': 56, 'core/coredag/cbor.go': 18, 'core/coredag/dagpb.go': 43, 'core/coredag/dagtransl.go': 14, 'core/coredag/raw.go': 43, 'core/corehttp/commands.go': 47, 'core/corehttp/corehttp.go': 11, 'core/corehttp/gateway.go': 32, 'core/corehttp/gateway_handler.go': 64, 'core/corehttp/gateway_test.go': 49, 'core/corehttp/metrics_test.go': 28, 'core/corerepo/gc.go': 45, 'core/corerepo/pinning.go': 21, 'core/coreunix/add.go': 66, 'core/coreunix/add_test.go': 54, 'core/coreunix/metadata.go': 49, 'core/coreunix/metadata_test.go': 50, 'core/mock/mock.go': 28, 'core/pathresolver.go': 44, 'exchange/bitswap/bitswap.go': 4, 'exchange/bitswap/bitswap_test.go': 4, 'exchange/bitswap/decision/bench_test.go': 4, 'exchange/bitswap/decision/engine.go': 4, 'exchange/bitswap/decision/engine_test.go': 4, 'exchange/bitswap/decision/ledger.go': 4, 'exchange/bitswap/decision/peer_request_queue.go': 4, 'exchange/bitswap/decision/peer_request_queue_test.go': 4, 'exchange/bitswap/get.go': 4, 'exchange/bitswap/message/message.go': 4, 'exchange/bitswap/message/message_test.go': 4, 'exchange/bitswap/network/interface.go': 4, 'exchange/bitswap/network/ipfs_impl.go': 4, 'exchange/bitswap/notifications/notifications.go': 4, 'exchange/bitswap/notifications/notifications_test.go': 4, 'exchange/bitswap/session.go': 4, 'exchange/bitswap/session_test.go': 4, 'exchange/bitswap/stat.go': 4, 'exchange/bitswap/testnet/interface.go': 3, 'exchange/bitswap/testnet/network_test.go': 4, 'exchange/bitswap/testnet/peernet.go': 4, 'exchange/bitswap/testnet/virtual.go': 4, 'exchange/bitswap/testutils.go': 4, 'exchange/bitswap/wantlist/wantlist.go': 4, 'exchange/bitswap/wantlist/wantlist_test.go': 4, 'exchange/bitswap/wantmanager.go': 4, 'exchange/bitswap/workers.go': 4, 'exchange/interface.go': 2, 'exchange/offline/offline.go': 2, 'exchange/offline/offline_test.go': 2, 'exchange/reprovide/providers.go': 44, 'exchange/reprovide/reprovide.go': 25, 'exchange/reprovide/reprovide_test.go': 29, 'filestore/filestore.go': 23, 'filestore/filestore_test.go': 42, 'filestore/fsrefstore.go': 23, 'filestore/util.go': 21, 'fuse/ipns/ipns_test.go': 27, 'fuse/ipns/ipns_unix.go': 50, 'fuse/node/mount_test.go': 27, 'fuse/readonly/ipfs_test.go': 57, 'fuse/readonly/readonly_unix.go': 51, 'importer/balanced/balanced_test.go': 5, 'importer/balanced/builder.go': 5, 'importer/chunk/rabin_test.go': 2, 'importer/chunk/splitting_test.go': 2, 'importer/helpers/dagbuilder.go': 5, 'importer/helpers/helpers.go': 5, 'importer/importer.go': 5, 'importer/importer_test.go': 5, 'importer/trickle/trickle_test.go': 5, 'importer/trickle/trickledag.go': 5, 'merkledag/batch.go': 2, 'merkledag/coding.go': 5, 'merkledag/merkledag.go': 6, 'merkledag/merkledag_test.go': 5, 'merkledag/node.go': 5, 'merkledag/node_test.go': 5, 'merkledag/raw.go': 5, 'merkledag/traverse/traverse.go': 5, 'merkledag/traverse/traverse_test.go': 5, 'merkledag/utils/diff.go': 5, 'merkledag/utils/diffenum.go': 5, 'merkledag/utils/diffenum_test.go': 5, 'merkledag/utils/utils.go': 5, 'merkledag/utils/utils_test.go': 5, 'mfs/dir.go': 13, 'mfs/file.go': 13, 'mfs/mfs_test.go': 13, 'mfs/ops.go': 11, 'mfs/repub_test.go': 7, 'mfs/system.go': 13, 'namesys/ipns_select_test.go': 3, 'namesys/namesys.go': 47, 'namesys/publisher.go': 52, 'namesys/publisher_test.go': 29, 'namesys/pubsub.go': 2, 'namesys/pubsub_test.go': 2, 'namesys/republisher/repub.go': 42, 'namesys/republisher/repub_test.go': 42, 'namesys/resolve_test.go': 44, 'namesys/routing.go': 47, 'p2p/p2p.go': 20, 'p2p/registry.go': 7, 'package.json': 51, 'path/path.go': 5, 'path/resolver.go': 4, 'path/resolver_test.go': 3, 'pin/gc/gc.go': 43, 'pin/pin.go': 43, 'pin/pin_test.go': 42, 'pin/set.go': 43, 'pin/set_test.go': 42, 'plugin/ipld.go': 14, 'plugin/loader/initializer.go': 11, 'plugin/plugins/git/git.go': 13, 'repo/config/bootstrap_peers.go': 4, 'repo/config/init.go': 4, 'repo/fsrepo/fsrepo.go': 20, 'repo/fsrepo/lock/lock.go': 2, 'repo/fsrepo/serialize/serialize.go': 3, 'repo/mock.go': 16, 'repo/repo.go': 19, 'routing/mock/centralized_client.go': 2, 'routing/mock/centralized_server.go': 2, 'routing/mock/centralized_test.go': 2, 'routing/mock/interface.go': 2, 'routing/none/none_client.go': 2, 'routing/offline/offline.go': 2, 'routing/offline/offline_test.go': 2, 'tar/format.go': 51, 'test/dependencies/ma-pipe-unidir/main.go': 8, 'test/integration/addcat_test.go': 31, 'test/integration/bench_cat_test.go': 31, 'test/integration/bench_test.go': 14, 'test/integration/bitswap_wo_routing_test.go': 31, 'test/integration/three_legged_cat_test.go': 31, 'thirdparty/ds-help/key.go': 2, 'thirdparty/pollEndpoint/main.go': 11, 'thirdparty/posinfo/posinfo.go': 3, 'unixfs/archive/archive.go': 6, 'unixfs/archive/tar/writer.go': 6, 'unixfs/hamt/hamt.go': 6, 'unixfs/io/dagreader.go': 7, 'unixfs/io/dirbuilder.go': 4, 'unixfs/io/resolve.go': 7, 'unixfs/mod/dagmodifier.go': 6, 'unixfs/mod/dagmodifier_test.go': 4, 'unixfs/test/utils.go': 6, 'commands/legacy/command.go': 8, 'commands/legacy/legacy.go': 8, 'commands/legacy/legacy_test.go': 8, 'commands/legacy/request.go': 9, 'commands/legacy/response.go': 9, 'core/commands/commands_test.go': 14, 'core/coreapi/dag.go': 18, 'core/coreapi/dag_test.go': 6, 'core/coreapi/interface/options/dag.go': 8, 'core/coreapi/key.go': 49, 'core/coreapi/name.go': 51, 'merkledag/test/utils.go': 4, 'namesys/namesys_test.go': 52, 'repo/fsrepo/datastores.go': 12, 'repo/fsrepo/fsrepo_test.go': 17, 'thirdparty/datastore2/datastore_closer.go': 1, 'thirdparty/datastore2/delayed.go': 1, 'thirdparty/datastore2/threadsafe.go': 1, 'unixfs/io/pbdagreader.go': 6, 'unixfs/hamt/hamt_stress_test.go': 4, 'unixfs/hamt/hamt_test.go': 4, 'merkledag/errservice.go': 3, 'merkledag/readonly.go': 3, 'merkledag/readonly_test.go': 3, 'merkledag/rwservice.go': 3, 'merkledag/session.go': 3, 'core/coreapi/block.go': 26, 'core/coreapi/object_test.go': 1, 'core/coreapi/object.go': 59, 'blocks/blockstoreutil/remove.go': 19, 'blockservice/test/mock.go': 2, 'cmd/ipfs/util/ulimit.go': 6, 'cmd/ipfs/util/ulimit_freebsd.go': 2, 'cmd/ipfs/util/ulimit_unix.go': 2, 'cmd/seccat/util.go': 6, 'core/commands/files.go': 57, 'core/coreapi/block_test.go': 2, 'core/coreapi/interface/coreapi.go': 13, 'core/coreapi/interface/dag.go': 10, 'core/coreapi/interface/object.go': 10, 'core/coreapi/interface/options/block.go': 3, 'core/coreapi/interface/path.go': 36, 'core/coreapi/interface/unixfs.go': 28, 'core/coreapi/pin.go': 54, 'core/corehttp/logs.go': 6, 'fuse/ipns/link_unix.go': 2, 'fuse/mount/fuse.go': 2, 'fuse/mount/mount.go': 6, 'fuse/node/mount_darwin.go': 2, 'fuse/node/mount_unix.go': 6, 'keystore/keystore.go': 6, 'namesys/ipns_validate_test.go': 1, 'namesys/validator.go': 1, 'path/resolver/resolver.go': 2, 'path/resolver/resolver_test.go': 2, 'plugin/loader/load.go': 4, 'thirdparty/verifbs/verifbs.go': 19, 'thirdparty/verifcid/validate.go': 2, 'thirdparty/verifcid/validate_test.go': 2, 'core/commands/urlstore.go': 47, 'namesys/ipns_resolver_validation_test.go': 44, 'unixfs/io/directory.go': 2, 'core/coreapi/interface/options/path.go': 1, 'core/coreapi/interface/block.go': 1, None: 2, 'core/coreapi/interface/pin.go': 1, 'core/coreapi/path.go': 58, 'core/coreapi/pin_test.go': 3, 'core/coreapi/path_test.go': 1, 'core/coreunix/cat.go': 15, 'fuse/ipns/common.go': 46, 'mfs/fd.go': 8, 'unixfs/importer/balanced/balanced_test.go': 1, 'unixfs/importer/balanced/builder.go': 1, 'unixfs/importer/helpers/dagbuilder.go': 1, 'unixfs/importer/helpers/helpers.go': 1, 'unixfs/importer/importer.go': 1, 'unixfs/importer/importer_test.go': 1, 'unixfs/importer/trickle/trickle_test.go': 1, 'unixfs/importer/trickle/trickledag.go': 1, 'unixfs/io/dagreader_test.go': 1, 'unixfs/io/directory_test.go': 1, 'unixfs/unixfs.go': 1, 'unixfs/unixfs_test.go': 1, 'core/coreapi/name_test.go': 34, 'core/pathresolver_test.go': 39, 'dagutils/diff.go': 42, 'dagutils/diffenum.go': 38, 'dagutils/diffenum_test.go': 38, 'dagutils/utils.go': 39, 'dagutils/utils_test.go': 39, 'namesys/base.go': 43, 'namesys/cache.go': 39, 'namesys/dns.go': 43, 'namesys/interface.go': 43, 'namesys/proquint.go': 43, 'core/commands/env.go': 3, 'core/coreapi/interface/key.go': 7, 'filestore/pb/dataobj.pb.go': 3, 'keystore/keystore_test.go': 4, 'keystore/memkeystore.go': 4, 'pin/internal/pb/header.pb.go': 3, 'repo/config/identity.go': 1, 'thirdparty/cidv0v1/blockstore.go': 16, 'core/core_test.go': 16, 'repo/fsrepo/config_test.go': 13, 'repo/fsrepo/misc.go': 13, 'test/bench/bench_cli_ipfs_add/main.go': 13, 'test/bench/offline_add/main.go': 13, 'core/commands/cmdenv/env.go': 24, 'core/commands/name/ipns.go': 41, 'core/commands/name/publish.go': 26, 'core/coreapi/dht.go': 36, 'core/coreapi/dht_test.go': 5, 'test/sharness/t0275-cid-security.sh': 1, 'core/coreapi/interface/options/name.go': 1, 'core/commands/name/ipnsps.go': 14, 'core/commands/name/name.go': 10, 'core/coreapi/interface/dht.go': 10, 'p2p/listener.go': 13, 'p2p/local.go': 13, 'p2p/remote.go': 13, 'p2p/stream.go': 13, 'core/coreapi/interface/options/unixfs.go': 34, 'core/coreapi/unixfile.go': 21, 'core/coreapi/interface/swarm.go': 9, 'core/coreapi/swarm.go': 24, 'core/coreapi/pubsub.go': 22, 'core/commands/cid.go': 11, 'cmd/ipfs/dnsresolve_test.go': 5, 'core/coreapi/interface/pubsub.go': 4, 'test/dependencies/iptb/iptb.go': 12, 'plugin/plugins/badgerds/badgerds.go': 3, 'plugin/plugins/flatfs/flatfs.go': 3, 'plugin/plugins/levelds/levelds.go': 3, 'commands/context.go': 16, 'core/corehttp/proxy.go': 9, 'core/coreapi/interface/tests/name.go': 4, 'core/coreapi/interface/tests/unixfs.go': 7, 'core/coreapi/test/api_test.go': 13, 'plugin/loader/loader.go': 12, 'core/commands/cmdenv/cidbase.go': 7, 'core/commands/cmdenv/file.go': 3, 'core/corehttp/ipns_hostname.go': 11, 'namesys/dns_test.go': 10, 'plugin/daemon.go': 10, 'core/commands/cmdenv/cidbase_test.go': 2, 'core/corehttp/metrics.go': 1, 'core/corehttp/proxy_test.go': 1, 'core/corerepo/stat.go': 1, 'plugin/tracer.go': 1, 'thirdparty/notifier/notifier.go': 1, 'core/coreapi/provider.go': 1, 'provider/provider.go': 1, 'provider/queue.go': 1, 'test/sharness/t0270-filestore.sh': 1, 'README.md': 1, 'go.mod': 3, 'go.sum': 3, 'package-list.json': 1, 'core/node/core.go': 1}","('core/coreunix/add.go', 0.55, 0.5238095238095238)"
core/coredag/cbor.go,25,151,2,"[{'cyclomatic_complexity': 2, 'nloc': 7, 'token_count': 60, 'name': 'cborJSONParser', 'long_name': 'cborJSONParser r io . Reader , mhType uint64 , mhLen int', 'start_line': 11, 'end_line': 18, 'full_parameters': ['r io . Reader', ' mhType uint64', ' mhLen int'], 'filename': '/home/dimi/Documents/Informatik_Studium/FSS/SoftEvo/DataCollection/FFS_SoftEvo/go-ipfs/core/coredag/cbor.go', 'top_nesting_level': 0, 'length': 8, 'fan_in': 0, 'fan_out': 0, 'general_fan_out': 0}, {'cyclomatic_complexity': 3, 'nloc': 11, 'token_count': 80, 'name': 'cborRawParser', 'long_name': 'cborRawParser r io . Reader , mhType uint64 , mhLen int', 'start_line': 20, 'end_line': 32, 'full_parameters': ['r io . Reader', ' mhType uint64', ' mhLen int'], 'filename': '/home/dimi/Documents/Informatik_Studium/FSS/SoftEvo/DataCollection/FFS_SoftEvo/go-ipfs/core/coredag/cbor.go', 'top_nesting_level': 0, 'length': 13, 'fan_in': 0, 'fan_out': 0, 'general_fan_out': 0}]",25,151,2,"[{'cyclomatic_complexity': 2, 'nloc': 7, 'token_count': 60, 'name': 'cborJSONParser', 'long_name': 'cborJSONParser r io . Reader , mhType uint64 , mhLen int', 'start_line': 11, 'end_line': 18, 'full_parameters': ['r io . Reader', ' mhType uint64', ' mhLen int'], 'filename': '/home/dimi/Documents/Informatik_Studium/FSS/SoftEvo/DataCollection/FFS_SoftEvo/go-ipfs/core/coredag/cbor.go', 'top_nesting_level': 0, 'length': 8, 'fan_in': 0, 'fan_out': 0, 'general_fan_out': 0}, {'cyclomatic_complexity': 3, 'nloc': 11, 'token_count': 80, 'name': 'cborRawParser', 'long_name': 'cborRawParser r io . Reader , mhType uint64 , mhLen int', 'start_line': 20, 'end_line': 32, 'full_parameters': ['r io . Reader', ' mhType uint64', ' mhLen int'], 'filename': '/home/dimi/Documents/Informatik_Studium/FSS/SoftEvo/DataCollection/FFS_SoftEvo/go-ipfs/core/coredag/cbor.go', 'top_nesting_level': 0, 'length': 13, 'fan_in': 0, 'fan_out': 0, 'general_fan_out': 0}]",0,0,0,19,19,"[{'timestamp': 1507204270.0, 'added_lines': 1, 'deleted_lines': 1, 'nloc': 25}, {'timestamp': 1512365669.0, 'added_lines': 2, 'deleted_lines': 2, 'nloc': 25}, {'timestamp': 1516838128.0, 'added_lines': 2, 'deleted_lines': 2, 'nloc': 25}, {'timestamp': 1517255734.0, 'added_lines': 5, 'deleted_lines': 5, 'nloc': 25}, {'timestamp': 1528520460.0, 'added_lines': 2, 'deleted_lines': 2, 'nloc': 25}, {'timestamp': 1531779409.0, 'added_lines': 2, 'deleted_lines': 2, 'nloc': 25}, {'timestamp': 1534115707.0, 'added_lines': 2, 'deleted_lines': 2, 'nloc': 25}, {'timestamp': 1534347022.0, 'added_lines': 2, 'deleted_lines': 2, 'nloc': 25}, {'timestamp': 1534896611.0, 'added_lines': 2, 'deleted_lines': 2, 'nloc': 25}, {'timestamp': 1536718784.0, 'added_lines': 2, 'deleted_lines': 2, 'nloc': 25}, {'timestamp': 1537792589.0, 'added_lines': 2, 'deleted_lines': 2, 'nloc': 25}, {'timestamp': 1539357340.0, 'added_lines': 1, 'deleted_lines': 1, 'nloc': 25}, {'timestamp': 1540603818.0, 'added_lines': 2, 'deleted_lines': 2, 'nloc': 25}, {'timestamp': 1541189794.0, 'added_lines': 1, 'deleted_lines': 1, 'nloc': 25}, {'timestamp': 1541204121.0, 'added_lines': 2, 'deleted_lines': 2, 'nloc': 25}, {'timestamp': 1547499910.0, 'added_lines': 2, 'deleted_lines': 2, 'nloc': 25}, {'timestamp': 1550711994.0, 'added_lines': 1, 'deleted_lines': 1, 'nloc': 25}, {'timestamp': 1550723346.0, 'added_lines': 2, 'deleted_lines': 2, 'nloc': 25}, {'timestamp': 1551551196.0, 'added_lines': 2, 'deleted_lines': 2, 'nloc': 25}]","{'core/core.go': 19, 'core/coreapi/unixfs_test.go': 14, 'merkledag/merkledag.go': 6, 'package.json': 17, 'assets/assets.go': 17, 'blocks/blockstore/arc_cache.go': 2, 'blocks/blockstore/arc_cache_test.go': 2, 'blocks/blockstore/blockstore.go': 2, 'blocks/blockstore/blockstore_test.go': 2, 'blocks/blockstore/bloom_cache.go': 2, 'blocks/blockstore/bloom_cache_test.go': 2, 'blocks/blockstore/util/remove.go': 2, 'blocks/blocksutil/block_generator.go': 2, 'blockservice/blockservice.go': 4, 'blockservice/blockservice_test.go': 4, 'blockservice/test/blocks_test.go': 4, 'cmd/ipfs/daemon.go': 7, 'cmd/ipfs/init.go': 6, 'cmd/ipfs/ipfs.go': 7, 'cmd/ipfs/main.go': 7, 'cmd/ipfs/main_test.go': 1, 'cmd/ipfswatch/main.go': 6, 'cmd/seccat/seccat.go': 7, 'commands/command.go': 6, 'commands/command_test.go': 2, 'commands/request.go': 6, 'commands/response.go': 4, 'commands/response_test.go': 2, 'core/bootstrap.go': 7, 'core/bootstrap_test.go': 7, 'core/builder.go': 17, 'core/commands/active.go': 4, 'core/commands/add.go': 13, 'core/commands/bitswap.go': 15, 'core/commands/block.go': 12, 'core/commands/bootstrap.go': 6, 'core/commands/cat.go': 9, 'core/commands/commands.go': 7, 'core/commands/config.go': 6, 'core/commands/dag/dag.go': 18, 'core/commands/dht.go': 18, 'core/commands/dht_test.go': 7, 'core/commands/diag.go': 4, 'core/commands/dns.go': 7, 'core/commands/external.go': 4, 'core/commands/files/files.go': 3, 'core/commands/filestore.go': 12, 'core/commands/get.go': 16, 'core/commands/get_test.go': 7, 'core/commands/helptext_test.go': 7, 'core/commands/id.go': 9, 'core/commands/ipns.go': 6, 'core/commands/ipnsps.go': 3, 'core/commands/keystore.go': 9, 'core/commands/log.go': 6, 'core/commands/ls.go': 18, 'core/commands/mount_nofuse.go': 4, 'core/commands/mount_unix.go': 6, 'core/commands/mount_windows.go': 4, 'core/commands/name.go': 3, 'core/commands/object/diff.go': 7, 'core/commands/object/object.go': 18, 'core/commands/object/patch.go': 8, 'core/commands/p2p.go': 7, 'core/commands/pin.go': 17, 'core/commands/ping.go': 8, 'core/commands/publish.go': 6, 'core/commands/pubsub.go': 13, 'core/commands/refs.go': 18, 'core/commands/repo.go': 12, 'core/commands/resolve.go': 15, 'core/commands/root.go': 7, 'core/commands/shutdown.go': 6, 'core/commands/stat.go': 7, 'core/commands/swarm.go': 8, 'core/commands/sysdiag.go': 6, 'core/commands/tar.go': 15, 'core/commands/unixfs/ls.go': 15, 'core/commands/unixfs/unixfs.go': 4, 'core/commands/version.go': 5, 'core/coreapi/coreapi.go': 11, 'core/coreapi/interface/interface.go': 2, 'core/coreapi/unixfs.go': 18, 'core/coredag/dagpb.go': 18, 'core/coredag/dagtransl.go': 14, 'core/coredag/raw.go': 18, 'core/corehttp/commands.go': 16, 'core/corehttp/corehttp.go': 6, 'core/corehttp/gateway.go': 10, 'core/corehttp/gateway_handler.go': 18, 'core/corehttp/gateway_test.go': 16, 'core/corehttp/metrics_test.go': 9, 'core/corerepo/gc.go': 17, 'core/corerepo/pinning.go': 10, 'core/coreunix/add.go': 18, 'core/coreunix/add_test.go': 17, 'core/coreunix/metadata.go': 17, 'core/coreunix/metadata_test.go': 18, 'core/mock/mock.go': 9, 'core/pathresolver.go': 18, 'exchange/bitswap/bitswap.go': 4, 'exchange/bitswap/bitswap_test.go': 4, 'exchange/bitswap/decision/bench_test.go': 4, 'exchange/bitswap/decision/engine.go': 4, 'exchange/bitswap/decision/engine_test.go': 4, 'exchange/bitswap/decision/ledger.go': 4, 'exchange/bitswap/decision/peer_request_queue.go': 4, 'exchange/bitswap/decision/peer_request_queue_test.go': 4, 'exchange/bitswap/get.go': 4, 'exchange/bitswap/message/message.go': 4, 'exchange/bitswap/message/message_test.go': 4, 'exchange/bitswap/network/interface.go': 4, 'exchange/bitswap/network/ipfs_impl.go': 4, 'exchange/bitswap/notifications/notifications.go': 4, 'exchange/bitswap/notifications/notifications_test.go': 4, 'exchange/bitswap/session.go': 4, 'exchange/bitswap/session_test.go': 4, 'exchange/bitswap/stat.go': 4, 'exchange/bitswap/testnet/interface.go': 3, 'exchange/bitswap/testnet/network_test.go': 4, 'exchange/bitswap/testnet/peernet.go': 4, 'exchange/bitswap/testnet/virtual.go': 4, 'exchange/bitswap/testutils.go': 4, 'exchange/bitswap/wantlist/wantlist.go': 4, 'exchange/bitswap/wantlist/wantlist_test.go': 4, 'exchange/bitswap/wantmanager.go': 4, 'exchange/bitswap/workers.go': 4, 'exchange/interface.go': 2, 'exchange/offline/offline.go': 2, 'exchange/offline/offline_test.go': 2, 'exchange/reprovide/providers.go': 18, 'exchange/reprovide/reprovide.go': 12, 'exchange/reprovide/reprovide_test.go': 12, 'filestore/filestore.go': 14, 'filestore/filestore_test.go': 17, 'filestore/fsrefstore.go': 14, 'filestore/util.go': 12, 'fuse/ipns/ipns_test.go': 11, 'fuse/ipns/ipns_unix.go': 17, 'fuse/node/mount_test.go': 11, 'fuse/readonly/ipfs_test.go': 18, 'fuse/readonly/readonly_unix.go': 18, 'importer/balanced/balanced_test.go': 5, 'importer/balanced/builder.go': 5, 'importer/chunk/rabin_test.go': 2, 'importer/chunk/splitting_test.go': 2, 'importer/helpers/dagbuilder.go': 5, 'importer/helpers/helpers.go': 5, 'importer/importer.go': 5, 'importer/importer_test.go': 5, 'importer/trickle/trickle_test.go': 5, 'importer/trickle/trickledag.go': 5, 'merkledag/batch.go': 2, 'merkledag/coding.go': 5, 'merkledag/merkledag_test.go': 5, 'merkledag/node.go': 5, 'merkledag/node_test.go': 5, 'merkledag/raw.go': 5, 'merkledag/traverse/traverse.go': 5, 'merkledag/traverse/traverse_test.go': 5, 'merkledag/utils/diff.go': 5, 'merkledag/utils/diffenum.go': 5, 'merkledag/utils/diffenum_test.go': 5, 'merkledag/utils/utils.go': 5, 'merkledag/utils/utils_test.go': 5, 'mfs/dir.go': 7, 'mfs/file.go': 7, 'mfs/mfs_test.go': 7, 'mfs/ops.go': 7, 'mfs/repub_test.go': 6, 'mfs/system.go': 7, 'namesys/ipns_select_test.go': 3, 'namesys/namesys.go': 17, 'namesys/publisher.go': 17, 'namesys/publisher_test.go': 12, 'namesys/pubsub.go': 2, 'namesys/pubsub_test.go': 2, 'namesys/republisher/repub.go': 16, 'namesys/republisher/repub_test.go': 16, 'namesys/resolve_test.go': 17, 'namesys/routing.go': 17, 'p2p/p2p.go': 7, 'p2p/registry.go': 4, 'path/path.go': 4, 'path/resolver.go': 3, 'path/resolver_test.go': 3, 'pin/gc/gc.go': 18, 'pin/pin.go': 18, 'pin/pin_test.go': 17, 'pin/set.go': 18, 'pin/set_test.go': 17, 'plugin/ipld.go': 14, 'plugin/loader/initializer.go': 11, 'plugin/plugins/git/git.go': 13, 'repo/config/bootstrap_peers.go': 3, 'repo/config/init.go': 3, 'repo/fsrepo/fsrepo.go': 7, 'repo/fsrepo/lock/lock.go': 2, 'repo/fsrepo/serialize/serialize.go': 3, 'repo/mock.go': 7, 'repo/repo.go': 7, 'routing/mock/centralized_client.go': 2, 'routing/mock/centralized_server.go': 2, 'routing/mock/centralized_test.go': 2, 'routing/mock/interface.go': 2, 'routing/none/none_client.go': 2, 'routing/offline/offline.go': 2, 'routing/offline/offline_test.go': 2, 'tar/format.go': 18, 'test/dependencies/ma-pipe-unidir/main.go': 5, 'test/integration/addcat_test.go': 9, 'test/integration/bench_cat_test.go': 9, 'test/integration/bench_test.go': 7, 'test/integration/bitswap_wo_routing_test.go': 13, 'test/integration/three_legged_cat_test.go': 9, 'thirdparty/ds-help/key.go': 2, 'thirdparty/pollEndpoint/main.go': 6, 'thirdparty/posinfo/posinfo.go': 3, 'unixfs/archive/archive.go': 5, 'unixfs/archive/tar/writer.go': 5, 'unixfs/hamt/hamt.go': 5, 'unixfs/io/dagreader.go': 5, 'unixfs/io/dirbuilder.go': 4, 'unixfs/io/resolve.go': 5, 'unixfs/mod/dagmodifier.go': 5, 'unixfs/mod/dagmodifier_test.go': 3, 'unixfs/test/utils.go': 5, 'commands/legacy/command.go': 5, 'commands/legacy/legacy.go': 5, 'commands/legacy/legacy_test.go': 5, 'commands/legacy/request.go': 5, 'commands/legacy/response.go': 5, 'core/commands/commands_test.go': 6, 'core/coreapi/dag.go': 12, 'core/coreapi/dag_test.go': 3, 'core/coreapi/interface/options/dag.go': 8, 'core/coreapi/key.go': 15, 'core/coreapi/name.go': 16, 'merkledag/test/utils.go': 4, 'namesys/namesys_test.go': 16, 'repo/fsrepo/datastores.go': 5, 'repo/fsrepo/fsrepo_test.go': 5, 'thirdparty/datastore2/datastore_closer.go': 1, 'thirdparty/datastore2/delayed.go': 1, 'thirdparty/datastore2/threadsafe.go': 1, 'unixfs/io/pbdagreader.go': 4, 'unixfs/hamt/hamt_stress_test.go': 3, 'unixfs/hamt/hamt_test.go': 3, 'blocks/blockstoreutil/remove.go': 10, 'blockservice/test/mock.go': 2, 'cmd/ipfs/util/ulimit.go': 4, 'cmd/ipfs/util/ulimit_freebsd.go': 2, 'cmd/ipfs/util/ulimit_unix.go': 2, 'cmd/seccat/util.go': 4, 'core/commands/files.go': 15, 'core/coreapi/block.go': 10, 'core/coreapi/block_test.go': 2, 'core/coreapi/interface/coreapi.go': 9, 'core/coreapi/interface/dag.go': 9, 'core/coreapi/interface/object.go': 9, 'core/coreapi/interface/options/block.go': 3, 'core/coreapi/interface/path.go': 12, 'core/coreapi/interface/unixfs.go': 9, 'core/coreapi/object.go': 15, 'core/coreapi/pin.go': 15, 'core/corehttp/logs.go': 4, 'fuse/ipns/link_unix.go': 2, 'fuse/mount/fuse.go': 2, 'fuse/mount/mount.go': 4, 'fuse/node/mount_darwin.go': 2, 'fuse/node/mount_unix.go': 4, 'keystore/keystore.go': 4, 'merkledag/errservice.go': 2, 'merkledag/readonly.go': 2, 'merkledag/readonly_test.go': 2, 'merkledag/rwservice.go': 2, 'merkledag/session.go': 2, 'namesys/ipns_validate_test.go': 1, 'namesys/validator.go': 1, 'path/resolver/resolver.go': 2, 'path/resolver/resolver_test.go': 2, 'plugin/loader/load.go': 3, 'thirdparty/verifbs/verifbs.go': 10, 'thirdparty/verifcid/validate.go': 2, 'thirdparty/verifcid/validate_test.go': 2, 'core/commands/urlstore.go': 14, 'namesys/ipns_resolver_validation_test.go': 14, 'unixfs/io/directory.go': 1, 'core/coreapi/name_test.go': 9, 'core/coreapi/path.go': 13, 'core/coreunix/cat.go': 5, 'core/pathresolver_test.go': 13, 'dagutils/diff.go': 13, 'dagutils/diffenum.go': 13, 'dagutils/diffenum_test.go': 13, 'dagutils/utils.go': 13, 'dagutils/utils_test.go': 13, 'fuse/ipns/common.go': 13, 'mfs/fd.go': 2, 'namesys/base.go': 13, 'namesys/cache.go': 13, 'namesys/dns.go': 13, 'namesys/interface.go': 13, 'namesys/proquint.go': 13, 'thirdparty/cidv0v1/blockstore.go': 8, 'core/commands/env.go': 1, 'core/core_test.go': 4, 'core/coreapi/interface/key.go': 3, 'repo/fsrepo/config_test.go': 4, 'repo/fsrepo/misc.go': 4, 'test/bench/bench_cli_ipfs_add/main.go': 4, 'test/bench/offline_add/main.go': 4, 'core/commands/name/ipns.go': 10, 'core/commands/name/publish.go': 6, 'core/coreapi/dht.go': 10, 'core/coreapi/dht_test.go': 3, 'test/sharness/t0275-cid-security.sh': 1, 'core/commands/cmdenv/env.go': 5, 'core/commands/name/ipnsps.go': 3, 'core/commands/name/name.go': 3, 'core/coreapi/interface/dht.go': 2, 'p2p/listener.go': 3, 'p2p/local.go': 3, 'p2p/remote.go': 3, 'p2p/stream.go': 3, 'core/coreapi/interface/options/unixfs.go': 5, 'core/coreapi/pubsub.go': 5, 'core/coreapi/swarm.go': 5, 'core/coreapi/unixfile.go': 5, 'cmd/ipfs/dnsresolve_test.go': 2, 'core/commands/cid.go': 3, 'core/coreapi/interface/pubsub.go': 1, 'core/coreapi/interface/swarm.go': 1, 'keystore/keystore_test.go': 2, 'keystore/memkeystore.go': 2, 'test/dependencies/iptb/iptb.go': 4, 'core/coreapi/interface/tests/name.go': 1, 'core/coreapi/interface/tests/unixfs.go': 1, 'plugin/loader/loader.go': 4, 'commands/context.go': 3, 'core/coreapi/test/api_test.go': 3, 'core/corehttp/ipns_hostname.go': 3, 'namesys/dns_test.go': 3, 'plugin/daemon.go': 3, 'core/commands/cmdenv/cidbase.go': 2, 'core/commands/cmdenv/cidbase_test.go': 2, 'core/corehttp/proxy.go': 2, 'core/commands/cmdenv/file.go': 1, 'core/corehttp/metrics.go': 1, 'core/corehttp/proxy_test.go': 1, 'core/corerepo/stat.go': 1, 'filestore/pb/dataobj.pb.go': 1, 'pin/internal/pb/header.pb.go': 1, 'plugin/plugins/badgerds/badgerds.go': 1, 'plugin/plugins/flatfs/flatfs.go': 1, 'plugin/plugins/levelds/levelds.go': 1, 'plugin/tracer.go': 1, 'thirdparty/notifier/notifier.go': 1}","('core/core.go', 1.0, 0.10614525139664804)"
core/coredag/dagpb.go,50,264,3,"[{'cyclomatic_complexity': 3, 'nloc': 13, 'token_count': 93, 'name': 'dagpbJSONParser', 'long_name': 'dagpbJSONParser r io . Reader , mhType uint64 , mhLen int', 'start_line': 15, 'end_line': 31, 'full_parameters': ['r io . Reader', ' mhType uint64', ' mhLen int'], 'filename': '/home/dimi/Documents/Informatik_Studium/FSS/SoftEvo/DataCollection/FFS_SoftEvo/go-ipfs/core/coredag/dagpb.go', 'top_nesting_level': 0, 'length': 17, 'fan_in': 0, 'fan_out': 0, 'general_fan_out': 0}, {'cyclomatic_complexity': 3, 'nloc': 12, 'token_count': 87, 'name': 'dagpbRawParser', 'long_name': 'dagpbRawParser r io . Reader , mhType uint64 , mhLen int', 'start_line': 33, 'end_line': 47, 'full_parameters': ['r io . Reader', ' mhType uint64', ' mhLen int'], 'filename': '/home/dimi/Documents/Informatik_Studium/FSS/SoftEvo/DataCollection/FFS_SoftEvo/go-ipfs/core/coredag/dagpb.go', 'top_nesting_level': 0, 'length': 15, 'fan_in': 0, 'fan_out': 0, 'general_fan_out': 0}, {'cyclomatic_complexity': 3, 'nloc': 15, 'token_count': 69, 'name': 'cidPrefix', 'long_name': 'cidPrefix mhType uint64 , mhLen int', 'start_line': 49, 'end_line': 66, 'full_parameters': ['mhType uint64', ' mhLen int'], 'filename': '/home/dimi/Documents/Informatik_Studium/FSS/SoftEvo/DataCollection/FFS_SoftEvo/go-ipfs/core/coredag/dagpb.go', 'top_nesting_level': 0, 'length': 18, 'fan_in': 0, 'fan_out': 0, 'general_fan_out': 0}]",50,264,3,"[{'cyclomatic_complexity': 3, 'nloc': 13, 'token_count': 93, 'name': 'dagpbJSONParser', 'long_name': 'dagpbJSONParser r io . Reader , mhType uint64 , mhLen int', 'start_line': 15, 'end_line': 31, 'full_parameters': ['r io . Reader', ' mhType uint64', ' mhLen int'], 'filename': '/home/dimi/Documents/Informatik_Studium/FSS/SoftEvo/DataCollection/FFS_SoftEvo/go-ipfs/core/coredag/dagpb.go', 'top_nesting_level': 0, 'length': 17, 'fan_in': 0, 'fan_out': 0, 'general_fan_out': 0}, {'cyclomatic_complexity': 3, 'nloc': 12, 'token_count': 87, 'name': 'dagpbRawParser', 'long_name': 'dagpbRawParser r io . Reader , mhType uint64 , mhLen int', 'start_line': 33, 'end_line': 47, 'full_parameters': ['r io . Reader', ' mhType uint64', ' mhLen int'], 'filename': '/home/dimi/Documents/Informatik_Studium/FSS/SoftEvo/DataCollection/FFS_SoftEvo/go-ipfs/core/coredag/dagpb.go', 'top_nesting_level': 0, 'length': 15, 'fan_in': 0, 'fan_out': 0, 'general_fan_out': 0}, {'cyclomatic_complexity': 3, 'nloc': 15, 'token_count': 69, 'name': 'cidPrefix', 'long_name': 'cidPrefix mhType uint64 , mhLen int', 'start_line': 49, 'end_line': 66, 'full_parameters': ['mhType uint64', ' mhLen int'], 'filename': '/home/dimi/Documents/Informatik_Studium/FSS/SoftEvo/DataCollection/FFS_SoftEvo/go-ipfs/core/coredag/dagpb.go', 'top_nesting_level': 0, 'length': 18, 'fan_in': 0, 'fan_out': 0, 'general_fan_out': 0}]",0,0,0,44,44,"[{'timestamp': 1512365669.0, 'added_lines': 3, 'deleted_lines': 3, 'nloc': 50}, {'timestamp': 1516838128.0, 'added_lines': 3, 'deleted_lines': 3, 'nloc': 50}, {'timestamp': 1517255734.0, 'added_lines': 5, 'deleted_lines': 5, 'nloc': 50}, {'timestamp': 1528520460.0, 'added_lines': 3, 'deleted_lines': 3, 'nloc': 50}, {'timestamp': 1531779409.0, 'added_lines': 2, 'deleted_lines': 2, 'nloc': 50}, {'timestamp': 1532764253.0, 'added_lines': 1, 'deleted_lines': 1, 'nloc': 50}, {'timestamp': 1533500571.0, 'added_lines': 1, 'deleted_lines': 1, 'nloc': 50}, {'timestamp': 1533618653.0, 'added_lines': 1, 'deleted_lines': 1, 'nloc': 50}, {'timestamp': 1533779477.0, 'added_lines': 1, 'deleted_lines': 1, 'nloc': 50}, {'timestamp': 1534115707.0, 'added_lines': 5, 'deleted_lines': 5, 'nloc': 50}, {'timestamp': 1534195762.0, 'added_lines': 1, 'deleted_lines': 1, 'nloc': 50}, {'timestamp': 1534347022.0, 'added_lines': 3, 'deleted_lines': 3, 'nloc': 50}, {'timestamp': 1534896611.0, 'added_lines': 3, 'deleted_lines': 3, 'nloc': 50}, {'timestamp': 1535601896.0, 'added_lines': 1, 'deleted_lines': 1, 'nloc': 50}, {'timestamp': 1536388808.0, 'added_lines': 1, 'deleted_lines': 1, 'nloc': 50}, {'timestamp': 1536718784.0, 'added_lines': 3, 'deleted_lines': 3, 'nloc': 50}, {'timestamp': 1536723292.0, 'added_lines': 1, 'deleted_lines': 1, 'nloc': 50}, {'timestamp': 1537790637.0, 'added_lines': 1, 'deleted_lines': 1, 'nloc': 50}, {'timestamp': 1537792589.0, 'added_lines': 1, 'deleted_lines': 1, 'nloc': 50}, {'timestamp': 1538544957.0, 'added_lines': 1, 'deleted_lines': 1, 'nloc': 50}, {'timestamp': 1538694687.0, 'added_lines': 1, 'deleted_lines': 1, 'nloc': 50}, {'timestamp': 1538695953.0, 'added_lines': 1, 'deleted_lines': 1, 'nloc': 50}, {'timestamp': 1538773916.0, 'added_lines': 1, 'deleted_lines': 1, 'nloc': 50}, {'timestamp': 1539176817.0, 'added_lines': 1, 'deleted_lines': 1, 'nloc': 50}, {'timestamp': 1539357340.0, 'added_lines': 1, 'deleted_lines': 1, 'nloc': 50}, {'timestamp': 1540400358.0, 'added_lines': 1, 'deleted_lines': 1, 'nloc': 50}, {'timestamp': 1540410565.0, 'added_lines': 1, 'deleted_lines': 1, 'nloc': 50}, {'timestamp': 1540418491.0, 'added_lines': 1, 'deleted_lines': 1, 'nloc': 50}, {'timestamp': 1540603818.0, 'added_lines': 2, 'deleted_lines': 2, 'nloc': 50}, {'timestamp': 1541189794.0, 'added_lines': 1, 'deleted_lines': 1, 'nloc': 50}, {'timestamp': 1541204121.0, 'added_lines': 4, 'deleted_lines': 4, 'nloc': 50}, {'timestamp': 1541903826.0, 'added_lines': 1, 'deleted_lines': 1, 'nloc': 50}, {'timestamp': 1543443696.0, 'added_lines': 1, 'deleted_lines': 1, 'nloc': 50}, {'timestamp': 1544225843.0, 'added_lines': 1, 'deleted_lines': 1, 'nloc': 50}, {'timestamp': 1547003974.0, 'added_lines': 1, 'deleted_lines': 1, 'nloc': 50}, {'timestamp': 1547499910.0, 'added_lines': 2, 'deleted_lines': 2, 'nloc': 50}, {'timestamp': 1549588289.0, 'added_lines': 1, 'deleted_lines': 1, 'nloc': 50}, {'timestamp': 1550185115.0, 'added_lines': 1, 'deleted_lines': 1, 'nloc': 50}, {'timestamp': 1550507829.0, 'added_lines': 1, 'deleted_lines': 1, 'nloc': 50}, {'timestamp': 1550711994.0, 'added_lines': 1, 'deleted_lines': 1, 'nloc': 50}, {'timestamp': 1550723346.0, 'added_lines': 3, 'deleted_lines': 3, 'nloc': 50}, {'timestamp': 1551229859.0, 'added_lines': 1, 'deleted_lines': 1, 'nloc': 50}, {'timestamp': 1551299964.0, 'added_lines': 1, 'deleted_lines': 1, 'nloc': 50}, {'timestamp': 1551551196.0, 'added_lines': 4, 'deleted_lines': 4, 'nloc': 50}]","{'assets/assets.go': 41, 'blocks/blockstore/arc_cache.go': 2, 'blocks/blockstore/arc_cache_test.go': 2, 'blocks/blockstore/blockstore.go': 2, 'blocks/blockstore/blockstore_test.go': 2, 'blocks/blockstore/bloom_cache.go': 2, 'blocks/blockstore/bloom_cache_test.go': 2, 'blocks/blockstore/util/remove.go': 2, 'blocks/blocksutil/block_generator.go': 2, 'blockservice/blockservice.go': 4, 'blockservice/blockservice_test.go': 4, 'blockservice/test/blocks_test.go': 4, 'cmd/ipfs/daemon.go': 13, 'cmd/ipfs/init.go': 17, 'cmd/ipfs/ipfs.go': 10, 'cmd/ipfs/main.go': 18, 'cmd/ipfs/main_test.go': 1, 'cmd/ipfswatch/main.go': 15, 'cmd/seccat/seccat.go': 21, 'commands/command.go': 7, 'commands/command_test.go': 2, 'commands/request.go': 11, 'commands/response.go': 4, 'commands/response_test.go': 2, 'core/bootstrap.go': 20, 'core/bootstrap_test.go': 20, 'core/builder.go': 43, 'core/commands/active.go': 6, 'core/commands/add.go': 29, 'core/commands/bitswap.go': 39, 'core/commands/block.go': 17, 'core/commands/bootstrap.go': 16, 'core/commands/cat.go': 14, 'core/commands/commands.go': 10, 'core/commands/config.go': 16, 'core/commands/dag/dag.go': 43, 'core/commands/dht.go': 44, 'core/commands/dht_test.go': 19, 'core/commands/diag.go': 6, 'core/commands/dns.go': 11, 'core/commands/external.go': 6, 'core/commands/files/files.go': 3, 'core/commands/filestore.go': 15, 'core/commands/get.go': 41, 'core/commands/get_test.go': 10, 'core/commands/helptext_test.go': 10, 'core/commands/id.go': 27, 'core/commands/ipns.go': 8, 'core/commands/ipnsps.go': 4, 'core/commands/keystore.go': 14, 'core/commands/log.go': 9, 'core/commands/ls.go': 43, 'core/commands/mount_nofuse.go': 6, 'core/commands/mount_unix.go': 16, 'core/commands/mount_windows.go': 6, 'core/commands/name.go': 3, 'core/commands/object/diff.go': 11, 'core/commands/object/object.go': 44, 'core/commands/object/patch.go': 14, 'core/commands/p2p.go': 18, 'core/commands/pin.go': 43, 'core/commands/ping.go': 22, 'core/commands/publish.go': 10, 'core/commands/pubsub.go': 23, 'core/commands/refs.go': 43, 'core/commands/repo.go': 28, 'core/commands/resolve.go': 40, 'core/commands/root.go': 10, 'core/commands/shutdown.go': 9, 'core/commands/stat.go': 14, 'core/commands/swarm.go': 24, 'core/commands/sysdiag.go': 11, 'core/commands/tar.go': 41, 'core/commands/unixfs/ls.go': 41, 'core/commands/unixfs/unixfs.go': 6, 'core/commands/version.go': 7, 'core/core.go': 44, 'core/coreapi/coreapi.go': 23, 'core/coreapi/interface/interface.go': 2, 'core/coreapi/unixfs.go': 43, 'core/coreapi/unixfs_test.go': 33, 'core/coredag/cbor.go': 18, 'core/coredag/dagtransl.go': 14, 'core/coredag/raw.go': 44, 'core/corehttp/commands.go': 41, 'core/corehttp/corehttp.go': 11, 'core/corehttp/gateway.go': 28, 'core/corehttp/gateway_handler.go': 44, 'core/corehttp/gateway_test.go': 42, 'core/corehttp/metrics_test.go': 27, 'core/corerepo/gc.go': 39, 'core/corerepo/pinning.go': 18, 'core/coreunix/add.go': 44, 'core/coreunix/add_test.go': 43, 'core/coreunix/metadata.go': 43, 'core/coreunix/metadata_test.go': 44, 'core/mock/mock.go': 28, 'core/pathresolver.go': 43, 'exchange/bitswap/bitswap.go': 4, 'exchange/bitswap/bitswap_test.go': 4, 'exchange/bitswap/decision/bench_test.go': 4, 'exchange/bitswap/decision/engine.go': 4, 'exchange/bitswap/decision/engine_test.go': 4, 'exchange/bitswap/decision/ledger.go': 4, 'exchange/bitswap/decision/peer_request_queue.go': 4, 'exchange/bitswap/decision/peer_request_queue_test.go': 4, 'exchange/bitswap/get.go': 4, 'exchange/bitswap/message/message.go': 4, 'exchange/bitswap/message/message_test.go': 4, 'exchange/bitswap/network/interface.go': 4, 'exchange/bitswap/network/ipfs_impl.go': 4, 'exchange/bitswap/notifications/notifications.go': 4, 'exchange/bitswap/notifications/notifications_test.go': 4, 'exchange/bitswap/session.go': 4, 'exchange/bitswap/session_test.go': 4, 'exchange/bitswap/stat.go': 4, 'exchange/bitswap/testnet/interface.go': 3, 'exchange/bitswap/testnet/network_test.go': 4, 'exchange/bitswap/testnet/peernet.go': 4, 'exchange/bitswap/testnet/virtual.go': 4, 'exchange/bitswap/testutils.go': 4, 'exchange/bitswap/wantlist/wantlist.go': 4, 'exchange/bitswap/wantlist/wantlist_test.go': 4, 'exchange/bitswap/wantmanager.go': 4, 'exchange/bitswap/workers.go': 4, 'exchange/interface.go': 2, 'exchange/offline/offline.go': 2, 'exchange/offline/offline_test.go': 2, 'exchange/reprovide/providers.go': 44, 'exchange/reprovide/reprovide.go': 25, 'exchange/reprovide/reprovide_test.go': 29, 'filestore/filestore.go': 23, 'filestore/filestore_test.go': 43, 'filestore/fsrefstore.go': 23, 'filestore/util.go': 21, 'fuse/ipns/ipns_test.go': 27, 'fuse/ipns/ipns_unix.go': 43, 'fuse/node/mount_test.go': 27, 'fuse/readonly/ipfs_test.go': 44, 'fuse/readonly/readonly_unix.go': 44, 'importer/balanced/balanced_test.go': 6, 'importer/balanced/builder.go': 5, 'importer/chunk/rabin_test.go': 2, 'importer/chunk/splitting_test.go': 2, 'importer/helpers/dagbuilder.go': 6, 'importer/helpers/helpers.go': 6, 'importer/importer.go': 5, 'importer/importer_test.go': 6, 'importer/trickle/trickle_test.go': 6, 'importer/trickle/trickledag.go': 6, 'merkledag/batch.go': 2, 'merkledag/coding.go': 5, 'merkledag/merkledag.go': 5, 'merkledag/merkledag_test.go': 5, 'merkledag/node.go': 5, 'merkledag/node_test.go': 5, 'merkledag/raw.go': 5, 'merkledag/traverse/traverse.go': 5, 'merkledag/traverse/traverse_test.go': 5, 'merkledag/utils/diff.go': 5, 'merkledag/utils/diffenum.go': 5, 'merkledag/utils/diffenum_test.go': 5, 'merkledag/utils/utils.go': 5, 'merkledag/utils/utils_test.go': 5, 'mfs/dir.go': 12, 'mfs/file.go': 12, 'mfs/mfs_test.go': 12, 'mfs/ops.go': 11, 'mfs/repub_test.go': 7, 'mfs/system.go': 12, 'namesys/ipns_select_test.go': 3, 'namesys/namesys.go': 42, 'namesys/publisher.go': 42, 'namesys/publisher_test.go': 28, 'namesys/pubsub.go': 2, 'namesys/pubsub_test.go': 2, 'namesys/republisher/repub.go': 41, 'namesys/republisher/repub_test.go': 41, 'namesys/resolve_test.go': 42, 'namesys/routing.go': 42, 'p2p/p2p.go': 20, 'p2p/registry.go': 7, 'package.json': 42, 'path/path.go': 4, 'path/resolver.go': 3, 'path/resolver_test.go': 3, 'pin/gc/gc.go': 44, 'pin/pin.go': 44, 'pin/pin_test.go': 43, 'pin/set.go': 44, 'pin/set_test.go': 43, 'plugin/ipld.go': 14, 'plugin/loader/initializer.go': 11, 'plugin/plugins/git/git.go': 13, 'repo/config/bootstrap_peers.go': 4, 'repo/config/init.go': 4, 'repo/fsrepo/fsrepo.go': 20, 'repo/fsrepo/lock/lock.go': 2, 'repo/fsrepo/serialize/serialize.go': 3, 'repo/mock.go': 16, 'repo/repo.go': 19, 'routing/mock/centralized_client.go': 2, 'routing/mock/centralized_server.go': 2, 'routing/mock/centralized_test.go': 2, 'routing/mock/interface.go': 2, 'routing/none/none_client.go': 2, 'routing/offline/offline.go': 2, 'routing/offline/offline_test.go': 2, 'tar/format.go': 44, 'test/dependencies/ma-pipe-unidir/main.go': 8, 'test/integration/addcat_test.go': 27, 'test/integration/bench_cat_test.go': 27, 'test/integration/bench_test.go': 14, 'test/integration/bitswap_wo_routing_test.go': 31, 'test/integration/three_legged_cat_test.go': 27, 'thirdparty/ds-help/key.go': 2, 'thirdparty/pollEndpoint/main.go': 11, 'thirdparty/posinfo/posinfo.go': 3, 'unixfs/archive/archive.go': 5, 'unixfs/archive/tar/writer.go': 6, 'unixfs/hamt/hamt.go': 6, 'unixfs/io/dagreader.go': 6, 'unixfs/io/dirbuilder.go': 4, 'unixfs/io/resolve.go': 6, 'unixfs/mod/dagmodifier.go': 6, 'unixfs/mod/dagmodifier_test.go': 3, 'unixfs/test/utils.go': 6, 'commands/legacy/command.go': 6, 'commands/legacy/legacy.go': 6, 'commands/legacy/legacy_test.go': 6, 'commands/legacy/request.go': 6, 'commands/legacy/response.go': 6, 'core/commands/commands_test.go': 9, 'core/coreapi/dag.go': 12, 'core/coreapi/dag_test.go': 3, 'core/coreapi/interface/options/dag.go': 8, 'core/coreapi/key.go': 40, 'core/coreapi/name.go': 41, 'merkledag/test/utils.go': 4, 'namesys/namesys_test.go': 41, 'repo/fsrepo/datastores.go': 12, 'repo/fsrepo/fsrepo_test.go': 17, 'thirdparty/datastore2/datastore_closer.go': 1, 'thirdparty/datastore2/delayed.go': 1, 'thirdparty/datastore2/threadsafe.go': 1, 'unixfs/io/pbdagreader.go': 5, 'unixfs/hamt/hamt_stress_test.go': 4, 'unixfs/hamt/hamt_test.go': 4, 'blocks/blockstoreutil/remove.go': 19, 'blockservice/test/mock.go': 2, 'cmd/ipfs/util/ulimit.go': 6, 'cmd/ipfs/util/ulimit_freebsd.go': 2, 'cmd/ipfs/util/ulimit_unix.go': 2, 'cmd/seccat/util.go': 6, 'core/commands/files.go': 41, 'core/coreapi/block.go': 14, 'core/coreapi/block_test.go': 2, 'core/coreapi/interface/coreapi.go': 9, 'core/coreapi/interface/dag.go': 9, 'core/coreapi/interface/object.go': 9, 'core/coreapi/interface/options/block.go': 3, 'core/coreapi/interface/path.go': 33, 'core/coreapi/interface/unixfs.go': 10, 'core/coreapi/object.go': 41, 'core/coreapi/pin.go': 41, 'core/corehttp/logs.go': 6, 'fuse/ipns/link_unix.go': 2, 'fuse/mount/fuse.go': 2, 'fuse/mount/mount.go': 6, 'fuse/node/mount_darwin.go': 2, 'fuse/node/mount_unix.go': 6, 'keystore/keystore.go': 6, 'merkledag/errservice.go': 2, 'merkledag/readonly.go': 2, 'merkledag/readonly_test.go': 2, 'merkledag/rwservice.go': 2, 'merkledag/session.go': 2, 'namesys/ipns_validate_test.go': 1, 'namesys/validator.go': 1, 'path/resolver/resolver.go': 3, 'path/resolver/resolver_test.go': 3, 'plugin/loader/load.go': 4, 'thirdparty/verifbs/verifbs.go': 19, 'thirdparty/verifcid/validate.go': 2, 'thirdparty/verifcid/validate_test.go': 2, 'core/commands/urlstore.go': 39, 'namesys/ipns_resolver_validation_test.go': 39, 'unixfs/io/directory.go': 2, 'Rules.mk': 1, 'dagutils/diff.go': 39, 'dagutils/diffenum.go': 39, 'dagutils/diffenum_test.go': 39, 'dagutils/utils.go': 39, 'dagutils/utils_test.go': 39, None: 18, 'unixfs/io/dagreader_test.go': 1, 'unixfs/io/directory_test.go': 1, 'unixfs/unixfs.go': 1, 'core/coreapi/name_test.go': 28, 'core/coreapi/path.go': 38, 'core/coreunix/cat.go': 13, 'core/pathresolver_test.go': 38, 'fuse/ipns/common.go': 38, 'mfs/fd.go': 6, 'namesys/base.go': 38, 'namesys/cache.go': 38, 'namesys/dns.go': 38, 'namesys/interface.go': 38, 'namesys/proquint.go': 38, 'core/commands/env.go': 2, 'core/coreapi/interface/key.go': 7, 'filestore/pb/dataobj.pb.go': 3, 'keystore/keystore_test.go': 4, 'keystore/memkeystore.go': 4, 'pin/internal/pb/header.pb.go': 3, 'repo/config/identity.go': 1, 'thirdparty/cidv0v1/blockstore.go': 16, 'core/core_test.go': 16, 'repo/fsrepo/config_test.go': 13, 'repo/fsrepo/misc.go': 13, 'test/bench/bench_cli_ipfs_add/main.go': 13, 'test/bench/offline_add/main.go': 13, 'core/commands/cmdenv/env.go': 16, 'core/commands/name/ipns.go': 31, 'core/commands/name/publish.go': 15, 'core/coreapi/dht.go': 29, 'core/coreapi/dht_test.go': 5, 'test/sharness/t0275-cid-security.sh': 1, 'core/commands/name/ipnsps.go': 9, 'core/commands/name/name.go': 5, 'core/coreapi/interface/dht.go': 10, 'p2p/listener.go': 13, 'p2p/local.go': 13, 'p2p/remote.go': 13, 'p2p/stream.go': 13, 'core/coreapi/interface/swarm.go': 9, 'core/coreapi/swarm.go': 19, 'core/coreapi/interface/options/unixfs.go': 15, 'core/coreapi/pubsub.go': 17, 'core/coreapi/unixfile.go': 14, 'cmd/ipfs/dnsresolve_test.go': 5, 'core/coreapi/interface/pubsub.go': 4, 'core/commands/cid.go': 5, 'test/dependencies/iptb/iptb.go': 12, 'plugin/plugins/badgerds/badgerds.go': 3, 'plugin/plugins/flatfs/flatfs.go': 3, 'plugin/plugins/levelds/levelds.go': 3, 'commands/context.go': 10, 'core/corehttp/proxy.go': 9, 'core/coreapi/interface/tests/name.go': 3, 'core/coreapi/interface/tests/unixfs.go': 3, 'core/coreapi/test/api_test.go': 9, 'plugin/loader/loader.go': 8, 'core/corehttp/ipns_hostname.go': 7, 'namesys/dns_test.go': 7, 'plugin/daemon.go': 7, 'core/commands/cmdenv/cidbase.go': 4, 'core/commands/cmdenv/cidbase_test.go': 2, 'core/commands/cmdenv/file.go': 1, 'core/corehttp/metrics.go': 1, 'core/corehttp/proxy_test.go': 1, 'core/corerepo/stat.go': 1, 'plugin/tracer.go': 1, 'thirdparty/notifier/notifier.go': 1}","('core/core.go', 1.0, 0.24581005586592178)"
core/coredag/dagtransl.go,52,309,3,"[{'cyclomatic_complexity': 1, 'nloc': 3, 'token_count': 45, 'name': 'ParseInputs', 'long_name': 'ParseInputs ienc , format string , r io . Reader , mhType uint64 , mhLen int', 'start_line': 49, 'end_line': 51, 'full_parameters': ['ienc', ' format string', ' r io . Reader', ' mhType uint64', ' mhLen int'], 'filename': '/home/dimi/Documents/Informatik_Studium/FSS/SoftEvo/DataCollection/FFS_SoftEvo/go-ipfs/core/coredag/dagtransl.go', 'top_nesting_level': 0, 'length': 3, 'fan_in': 0, 'fan_out': 0, 'general_fan_out': 0}, {'cyclomatic_complexity': 2, 'nloc': 8, 'token_count': 48, 'name': 'AddParser', 'long_name': '(iep InputEncParsers)AddParser ienv , format string , f DagParser', 'start_line': 54, 'end_line': 62, 'full_parameters': ['ienv', ' format string', ' f DagParser'], 'filename': '/home/dimi/Documents/Informatik_Studium/FSS/SoftEvo/DataCollection/FFS_SoftEvo/go-ipfs/core/coredag/dagtransl.go', 'top_nesting_level': 0, 'length': 9, 'fan_in': 0, 'fan_out': 0, 'general_fan_out': 0}, {'cyclomatic_complexity': 3, 'nloc': 11, 'token_count': 93, 'name': 'ParseInputs', 'long_name': '(iep InputEncParsers)ParseInputs ienc , format string , r io . Reader , mhType uint64 , mhLen int', 'start_line': 66, 'end_line': 78, 'full_parameters': ['ienc', ' format string', ' r io . Reader', ' mhType uint64', ' mhLen int'], 'filename': '/home/dimi/Documents/Informatik_Studium/FSS/SoftEvo/DataCollection/FFS_SoftEvo/go-ipfs/core/coredag/dagtransl.go', 'top_nesting_level': 0, 'length': 13, 'fan_in': 0, 'fan_out': 0, 'general_fan_out': 0}]",58,331,3,"[{'cyclomatic_complexity': 1, 'nloc': 3, 'token_count': 45, 'name': 'ParseInputs', 'long_name': 'ParseInputs ienc , format string , r io . Reader , mhType uint64 , mhLen int', 'start_line': 57, 'end_line': 59, 'full_parameters': ['ienc', ' format string', ' r io . Reader', ' mhType uint64', ' mhLen int'], 'filename': '/home/dimi/Documents/Informatik_Studium/FSS/SoftEvo/DataCollection/FFS_SoftEvo/go-ipfs/core/coredag/dagtransl.go', 'top_nesting_level': 0, 'length': 3, 'fan_in': 0, 'fan_out': 0, 'general_fan_out': 0}, {'cyclomatic_complexity': 2, 'nloc': 8, 'token_count': 48, 'name': 'AddParser', 'long_name': '(iep InputEncParsers)AddParser ienc , format string , f DagParser', 'start_line': 62, 'end_line': 70, 'full_parameters': ['ienc', ' format string', ' f DagParser'], 'filename': '/home/dimi/Documents/Informatik_Studium/FSS/SoftEvo/DataCollection/FFS_SoftEvo/go-ipfs/core/coredag/dagtransl.go', 'top_nesting_level': 0, 'length': 9, 'fan_in': 0, 'fan_out': 0, 'general_fan_out': 0}, {'cyclomatic_complexity': 3, 'nloc': 11, 'token_count': 93, 'name': 'ParseInputs', 'long_name': '(iep InputEncParsers)ParseInputs ienc , format string , r io . Reader , mhType uint64 , mhLen int', 'start_line': 74, 'end_line': 86, 'full_parameters': ['ienc', ' format string', ' r io . Reader', ' mhType uint64', ' mhLen int'], 'filename': '/home/dimi/Documents/Informatik_Studium/FSS/SoftEvo/DataCollection/FFS_SoftEvo/go-ipfs/core/coredag/dagtransl.go', 'top_nesting_level': 0, 'length': 13, 'fan_in': 0, 'fan_out': 0, 'general_fan_out': 0}]",6,22,0,17,17,"[{'timestamp': 1507233594.0, 'added_lines': 2, 'deleted_lines': 0, 'nloc': 53}, {'timestamp': 1512365669.0, 'added_lines': 1, 'deleted_lines': 1, 'nloc': 53}, {'timestamp': 1516838128.0, 'added_lines': 1, 'deleted_lines': 1, 'nloc': 53}, {'timestamp': 1515082816.0, 'added_lines': 9, 'deleted_lines': 3, 'nloc': 58}, {'timestamp': 1517255734.0, 'added_lines': 4, 'deleted_lines': 4, 'nloc': 53}, {'timestamp': 1521427288.0, 'added_lines': 3, 'deleted_lines': 3, 'nloc': 58}, {'timestamp': 1528520460.0, 'added_lines': 1, 'deleted_lines': 1, 'nloc': 58}, {'timestamp': 1531779409.0, 'added_lines': 1, 'deleted_lines': 1, 'nloc': 58}, {'timestamp': 1534115707.0, 'added_lines': 1, 'deleted_lines': 1, 'nloc': 58}, {'timestamp': 1534347022.0, 'added_lines': 1, 'deleted_lines': 1, 'nloc': 58}, {'timestamp': 1534896611.0, 'added_lines': 1, 'deleted_lines': 1, 'nloc': 58}, {'timestamp': 1536718784.0, 'added_lines': 1, 'deleted_lines': 1, 'nloc': 58}, {'timestamp': 1540603818.0, 'added_lines': 1, 'deleted_lines': 1, 'nloc': 58}, {'timestamp': 1541204121.0, 'added_lines': 1, 'deleted_lines': 1, 'nloc': 58}, {'timestamp': 1547499910.0, 'added_lines': 1, 'deleted_lines': 1, 'nloc': 58}, {'timestamp': 1550723346.0, 'added_lines': 1, 'deleted_lines': 1, 'nloc': 58}, {'timestamp': 1551551196.0, 'added_lines': 1, 'deleted_lines': 1, 'nloc': 58}]","{'core/coredag/raw.go': 15, 'test/sharness/t0053-dag.sh': 1, 'assets/assets.go': 13, 'blocks/blockstore/arc_cache.go': 2, 'blocks/blockstore/arc_cache_test.go': 2, 'blocks/blockstore/blockstore.go': 2, 'blocks/blockstore/blockstore_test.go': 2, 'blocks/blockstore/bloom_cache.go': 2, 'blocks/blockstore/bloom_cache_test.go': 2, 'blocks/blockstore/util/remove.go': 2, 'blocks/blocksutil/block_generator.go': 2, 'blockservice/blockservice.go': 4, 'blockservice/blockservice_test.go': 4, 'blockservice/test/blocks_test.go': 4, 'cmd/ipfs/daemon.go': 6, 'cmd/ipfs/init.go': 6, 'cmd/ipfs/ipfs.go': 6, 'cmd/ipfs/main.go': 7, 'cmd/ipfs/main_test.go': 1, 'cmd/ipfswatch/main.go': 5, 'cmd/seccat/seccat.go': 7, 'commands/command.go': 5, 'commands/command_test.go': 2, 'commands/request.go': 6, 'commands/response.go': 4, 'commands/response_test.go': 2, 'core/bootstrap.go': 6, 'core/bootstrap_test.go': 6, 'core/builder.go': 14, 'core/commands/active.go': 4, 'core/commands/add.go': 12, 'core/commands/bitswap.go': 12, 'core/commands/block.go': 11, 'core/commands/bootstrap.go': 5, 'core/commands/cat.go': 7, 'core/commands/commands.go': 6, 'core/commands/config.go': 5, 'core/commands/dag/dag.go': 15, 'core/commands/dht.go': 14, 'core/commands/dht_test.go': 6, 'core/commands/diag.go': 4, 'core/commands/dns.go': 6, 'core/commands/external.go': 4, 'core/commands/files/files.go': 3, 'core/commands/filestore.go': 11, 'core/commands/get.go': 12, 'core/commands/get_test.go': 6, 'core/commands/helptext_test.go': 6, 'core/commands/id.go': 7, 'core/commands/ipns.go': 6, 'core/commands/ipnsps.go': 3, 'core/commands/keystore.go': 7, 'core/commands/log.go': 5, 'core/commands/ls.go': 14, 'core/commands/mount_nofuse.go': 4, 'core/commands/mount_unix.go': 6, 'core/commands/mount_windows.go': 4, 'core/commands/name.go': 3, 'core/commands/object/diff.go': 6, 'core/commands/object/object.go': 14, 'core/commands/object/patch.go': 6, 'core/commands/p2p.go': 6, 'core/commands/pin.go': 13, 'core/commands/ping.go': 7, 'core/commands/publish.go': 6, 'core/commands/pubsub.go': 11, 'core/commands/refs.go': 15, 'core/commands/repo.go': 11, 'core/commands/resolve.go': 11, 'core/commands/root.go': 6, 'core/commands/shutdown.go': 5, 'core/commands/stat.go': 6, 'core/commands/swarm.go': 6, 'core/commands/sysdiag.go': 6, 'core/commands/tar.go': 11, 'core/commands/unixfs/ls.go': 11, 'core/commands/unixfs/unixfs.go': 4, 'core/commands/version.go': 5, 'core/core.go': 14, 'core/coreapi/coreapi.go': 10, 'core/coreapi/interface/interface.go': 3, 'core/coreapi/unixfs.go': 14, 'core/coreapi/unixfs_test.go': 10, 'core/coredag/cbor.go': 14, 'core/coredag/dagpb.go': 14, 'core/corehttp/commands.go': 12, 'core/corehttp/corehttp.go': 5, 'core/corehttp/gateway.go': 7, 'core/corehttp/gateway_handler.go': 14, 'core/corehttp/gateway_test.go': 12, 'core/corehttp/metrics_test.go': 7, 'core/corerepo/gc.go': 13, 'core/corerepo/pinning.go': 10, 'core/coreunix/add.go': 14, 'core/coreunix/add_test.go': 13, 'core/coreunix/metadata.go': 13, 'core/coreunix/metadata_test.go': 14, 'core/mock/mock.go': 7, 'core/pathresolver.go': 15, 'exchange/bitswap/bitswap.go': 5, 'exchange/bitswap/bitswap_test.go': 4, 'exchange/bitswap/decision/bench_test.go': 4, 'exchange/bitswap/decision/engine.go': 4, 'exchange/bitswap/decision/engine_test.go': 4, 'exchange/bitswap/decision/ledger.go': 5, 'exchange/bitswap/decision/peer_request_queue.go': 4, 'exchange/bitswap/decision/peer_request_queue_test.go': 4, 'exchange/bitswap/get.go': 4, 'exchange/bitswap/message/message.go': 4, 'exchange/bitswap/message/message_test.go': 4, 'exchange/bitswap/network/interface.go': 4, 'exchange/bitswap/network/ipfs_impl.go': 4, 'exchange/bitswap/notifications/notifications.go': 4, 'exchange/bitswap/notifications/notifications_test.go': 4, 'exchange/bitswap/session.go': 4, 'exchange/bitswap/session_test.go': 4, 'exchange/bitswap/stat.go': 4, 'exchange/bitswap/testnet/interface.go': 3, 'exchange/bitswap/testnet/network_test.go': 4, 'exchange/bitswap/testnet/peernet.go': 4, 'exchange/bitswap/testnet/virtual.go': 4, 'exchange/bitswap/testutils.go': 4, 'exchange/bitswap/wantlist/wantlist.go': 4, 'exchange/bitswap/wantlist/wantlist_test.go': 4, 'exchange/bitswap/wantmanager.go': 4, 'exchange/bitswap/workers.go': 4, 'exchange/interface.go': 2, 'exchange/offline/offline.go': 2, 'exchange/offline/offline_test.go': 2, 'exchange/reprovide/providers.go': 14, 'exchange/reprovide/reprovide.go': 11, 'exchange/reprovide/reprovide_test.go': 11, 'filestore/filestore.go': 13, 'filestore/filestore_test.go': 13, 'filestore/fsrefstore.go': 13, 'filestore/util.go': 11, 'fuse/ipns/ipns_test.go': 10, 'fuse/ipns/ipns_unix.go': 13, 'fuse/node/mount_test.go': 10, 'fuse/readonly/ipfs_test.go': 14, 'fuse/readonly/readonly_unix.go': 14, 'importer/balanced/balanced_test.go': 5, 'importer/balanced/builder.go': 5, 'importer/chunk/rabin_test.go': 2, 'importer/chunk/splitting_test.go': 2, 'importer/helpers/dagbuilder.go': 6, 'importer/helpers/helpers.go': 5, 'importer/importer.go': 5, 'importer/importer_test.go': 5, 'importer/trickle/trickle_test.go': 5, 'importer/trickle/trickledag.go': 6, 'merkledag/batch.go': 2, 'merkledag/coding.go': 5, 'merkledag/merkledag.go': 5, 'merkledag/merkledag_test.go': 5, 'merkledag/node.go': 5, 'merkledag/node_test.go': 5, 'merkledag/raw.go': 6, 'merkledag/traverse/traverse.go': 5, 'merkledag/traverse/traverse_test.go': 5, 'merkledag/utils/diff.go': 5, 'merkledag/utils/diffenum.go': 5, 'merkledag/utils/diffenum_test.go': 5, 'merkledag/utils/utils.go': 5, 'merkledag/utils/utils_test.go': 5, 'mfs/dir.go': 7, 'mfs/file.go': 7, 'mfs/mfs_test.go': 7, 'mfs/ops.go': 7, 'mfs/repub_test.go': 6, 'mfs/system.go': 7, 'namesys/ipns_select_test.go': 3, 'namesys/namesys.go': 13, 'namesys/publisher.go': 13, 'namesys/publisher_test.go': 11, 'namesys/pubsub.go': 3, 'namesys/pubsub_test.go': 2, 'namesys/republisher/repub.go': 12, 'namesys/republisher/repub_test.go': 12, 'namesys/resolve_test.go': 13, 'namesys/routing.go': 13, 'p2p/p2p.go': 6, 'p2p/registry.go': 4, 'package.json': 12, 'path/path.go': 4, 'path/resolver.go': 3, 'path/resolver_test.go': 3, 'pin/gc/gc.go': 14, 'pin/pin.go': 15, 'pin/pin_test.go': 13, 'pin/set.go': 15, 'pin/set_test.go': 13, 'plugin/ipld.go': 14, 'plugin/loader/initializer.go': 11, 'plugin/plugins/git/git.go': 13, 'repo/config/bootstrap_peers.go': 3, 'repo/config/init.go': 3, 'repo/fsrepo/fsrepo.go': 7, 'repo/fsrepo/lock/lock.go': 2, 'repo/fsrepo/serialize/serialize.go': 3, 'repo/mock.go': 6, 'repo/repo.go': 6, 'routing/mock/centralized_client.go': 2, 'routing/mock/centralized_server.go': 2, 'routing/mock/centralized_test.go': 2, 'routing/mock/interface.go': 2, 'routing/none/none_client.go': 2, 'routing/offline/offline.go': 2, 'routing/offline/offline_test.go': 2, 'tar/format.go': 14, 'test/dependencies/ma-pipe-unidir/main.go': 5, 'test/integration/addcat_test.go': 7, 'test/integration/bench_cat_test.go': 7, 'test/integration/bench_test.go': 6, 'test/integration/bitswap_wo_routing_test.go': 11, 'test/integration/three_legged_cat_test.go': 7, 'thirdparty/ds-help/key.go': 2, 'thirdparty/pollEndpoint/main.go': 5, 'thirdparty/posinfo/posinfo.go': 3, 'unixfs/archive/archive.go': 5, 'unixfs/archive/tar/writer.go': 5, 'unixfs/hamt/hamt.go': 5, 'unixfs/io/dagreader.go': 5, 'unixfs/io/dirbuilder.go': 4, 'unixfs/io/resolve.go': 5, 'unixfs/mod/dagmodifier.go': 6, 'unixfs/mod/dagmodifier_test.go': 3, 'unixfs/test/utils.go': 5, 'commands/legacy/command.go': 4, 'commands/legacy/legacy.go': 4, 'commands/legacy/legacy_test.go': 4, 'commands/legacy/request.go': 4, 'commands/legacy/response.go': 4, 'core/commands/commands_test.go': 5, 'core/coreapi/dag.go': 12, 'core/coreapi/dag_test.go': 3, 'core/coreapi/interface/options/dag.go': 8, 'core/coreapi/key.go': 11, 'core/coreapi/name.go': 12, 'merkledag/test/utils.go': 4, 'namesys/namesys_test.go': 12, 'repo/fsrepo/datastores.go': 4, 'repo/fsrepo/fsrepo_test.go': 4, 'thirdparty/datastore2/datastore_closer.go': 1, 'thirdparty/datastore2/delayed.go': 1, 'thirdparty/datastore2/threadsafe.go': 1, 'unixfs/io/pbdagreader.go': 4, 'core/coreapi/interface/options/object.go': 1, 'core/coreapi/object.go': 12, 'unixfs/hamt/hamt_stress_test.go': 3, 'unixfs/hamt/hamt_test.go': 3, 'CHANGELOG.md': 1, 'README.md': 1, 'bin/dist_get': 1, 'cmd/ipfs/util/ulimit_freebsd.go': 3, 'contribute.md': 1, 'core/coreapi/interface/options/pin.go': 1, 'docs/experimental-features.md': 1, 'docs/file-transfer.md': 1, 'docs/releases.md': 1, 'exchange/bitswap/README.md': 1, 'plugin/plugin.go': 1, 'repo/fsrepo/migrations/mfsr_test.go': 1, 'repo/fsrepo/migrations/migrations.go': 1, 'test/sharness/README.md': 1, 'thirdparty/dir/dir.go': 1, 'blocks/blockstoreutil/remove.go': 9, 'blockservice/test/mock.go': 2, 'cmd/ipfs/util/ulimit.go': 3, 'cmd/ipfs/util/ulimit_unix.go': 2, 'cmd/seccat/util.go': 3, 'core/commands/files.go': 11, 'core/coreapi/block.go': 9, 'core/coreapi/block_test.go': 2, 'core/coreapi/interface/coreapi.go': 9, 'core/coreapi/interface/dag.go': 9, 'core/coreapi/interface/object.go': 9, 'core/coreapi/interface/options/block.go': 3, 'core/coreapi/interface/path.go': 9, 'core/coreapi/interface/unixfs.go': 9, 'core/coreapi/pin.go': 11, 'core/corehttp/logs.go': 3, 'fuse/ipns/link_unix.go': 2, 'fuse/mount/fuse.go': 2, 'fuse/mount/mount.go': 3, 'fuse/node/mount_darwin.go': 2, 'fuse/node/mount_unix.go': 3, 'keystore/keystore.go': 3, 'merkledag/errservice.go': 2, 'merkledag/readonly.go': 2, 'merkledag/readonly_test.go': 2, 'merkledag/rwservice.go': 2, 'merkledag/session.go': 2, 'namesys/ipns_validate_test.go': 1, 'namesys/validator.go': 1, 'path/resolver/resolver.go': 2, 'path/resolver/resolver_test.go': 2, 'plugin/loader/load.go': 2, 'thirdparty/verifbs/verifbs.go': 9, 'thirdparty/verifcid/validate.go': 2, 'thirdparty/verifcid/validate_test.go': 2, 'core/commands/urlstore.go': 10, 'namesys/ipns_resolver_validation_test.go': 10, 'unixfs/io/directory.go': 1, 'core/coreapi/name_test.go': 6, 'core/coreapi/path.go': 9, 'core/coreunix/cat.go': 4, 'core/pathresolver_test.go': 9, 'dagutils/diff.go': 9, 'dagutils/diffenum.go': 9, 'dagutils/diffenum_test.go': 9, 'dagutils/utils.go': 9, 'dagutils/utils_test.go': 9, 'fuse/ipns/common.go': 9, 'mfs/fd.go': 2, 'namesys/base.go': 9, 'namesys/cache.go': 9, 'namesys/dns.go': 9, 'namesys/interface.go': 9, 'namesys/proquint.go': 9, 'thirdparty/cidv0v1/blockstore.go': 7, 'core/commands/env.go': 1, 'core/core_test.go': 3, 'core/coreapi/interface/key.go': 2, 'repo/fsrepo/config_test.go': 3, 'repo/fsrepo/misc.go': 3, 'test/bench/bench_cli_ipfs_add/main.go': 3, 'test/bench/offline_add/main.go': 3, 'core/commands/name/ipns.go': 6, 'core/commands/name/publish.go': 4, 'core/coreapi/dht.go': 6, 'core/coreapi/dht_test.go': 2, 'test/sharness/t0275-cid-security.sh': 1, 'core/coreapi/interface/options/unixfs.go': 3, 'core/coreapi/unixfile.go': 3, 'cmd/ipfs/dnsresolve_test.go': 2, 'core/commands/cid.go': 3, 'core/commands/cmdenv/env.go': 3, 'core/commands/name/ipnsps.go': 2, 'core/commands/name/name.go': 2, 'core/coreapi/interface/dht.go': 1, 'core/coreapi/interface/pubsub.go': 1, 'core/coreapi/interface/swarm.go': 1, 'core/coreapi/pubsub.go': 3, 'core/coreapi/swarm.go': 3, 'keystore/keystore_test.go': 2, 'keystore/memkeystore.go': 2, 'p2p/listener.go': 2, 'p2p/local.go': 2, 'p2p/remote.go': 2, 'p2p/stream.go': 2, 'test/dependencies/iptb/iptb.go': 3, 'core/coreapi/interface/tests/name.go': 1, 'core/coreapi/interface/tests/unixfs.go': 1, 'plugin/loader/loader.go': 3, 'commands/context.go': 2, 'core/commands/cmdenv/cidbase.go': 2, 'core/commands/cmdenv/cidbase_test.go': 2, 'core/coreapi/test/api_test.go': 2, 'core/corehttp/ipns_hostname.go': 2, 'core/corehttp/proxy.go': 2, 'namesys/dns_test.go': 2, 'plugin/daemon.go': 2, 'core/commands/cmdenv/file.go': 1, 'core/corehttp/metrics.go': 1, 'core/corehttp/proxy_test.go': 1, 'core/corerepo/stat.go': 1, 'filestore/pb/dataobj.pb.go': 1, 'pin/internal/pb/header.pb.go': 1, 'plugin/plugins/badgerds/badgerds.go': 1, 'plugin/plugins/flatfs/flatfs.go': 1, 'plugin/plugins/levelds/levelds.go': 1, 'plugin/tracer.go': 1, 'thirdparty/notifier/notifier.go': 1}","('core/commands/dag/dag.go', 0.8823529411764706, 0.125)"
core/corehttp/commands.go,101,654,8,"[{'cyclomatic_complexity': 3, 'nloc': 10, 'token_count': 62, 'name': 'addCORSFromEnv', 'long_name': 'addCORSFromEnv c * cmdsHttp . ServerConfig', 'start_line': 38, 'end_line': 47, 'full_parameters': ['c * cmdsHttp . ServerConfig'], 'filename': '/home/dimi/Documents/Informatik_Studium/FSS/SoftEvo/DataCollection/FFS_SoftEvo/go-ipfs/core/corehttp/commands.go', 'top_nesting_level': 0, 'length': 10, 'fan_in': 0, 'fan_out': 0, 'general_fan_out': 0}, {'cyclomatic_complexity': 5, 'nloc': 15, 'token_count': 131, 'name': 'addHeadersFromConfig', 'long_name': 'addHeadersFromConfig c * cmdsHttp . ServerConfig , nc * config . Config', 'start_line': 49, 'end_line': 65, 'full_parameters': ['c * cmdsHttp . ServerConfig', ' nc * config . Config'], 'filename': '/home/dimi/Documents/Informatik_Studium/FSS/SoftEvo/DataCollection/FFS_SoftEvo/go-ipfs/core/corehttp/commands.go', 'top_nesting_level': 0, 'length': 17, 'fan_in': 0, 'fan_out': 0, 'general_fan_out': 0}, {'cyclomatic_complexity': 3, 'nloc': 8, 'token_count': 54, 'name': 'addCORSDefaults', 'long_name': 'addCORSDefaults c * cmdsHttp . ServerConfig', 'start_line': 67, 'end_line': 77, 'full_parameters': ['c * cmdsHttp . ServerConfig'], 'filename': '/home/dimi/Documents/Informatik_Studium/FSS/SoftEvo/DataCollection/FFS_SoftEvo/go-ipfs/core/corehttp/commands.go', 'top_nesting_level': 0, 'length': 11, 'fan_in': 0, 'fan_out': 0, 'general_fan_out': 0}, {'cyclomatic_complexity': 5, 'nloc': 16, 'token_count': 124, 'name': 'patchCORSVars', 'long_name': 'patchCORSVars c * cmdsHttp . ServerConfig , addr net . Addr', 'start_line': 79, 'end_line': 100, 'full_parameters': ['c * cmdsHttp . ServerConfig', ' addr net . Addr'], 'filename': '/home/dimi/Documents/Informatik_Studium/FSS/SoftEvo/DataCollection/FFS_SoftEvo/go-ipfs/core/corehttp/commands.go', 'top_nesting_level': 0, 'length': 22, 'fan_in': 0, 'fan_out': 0, 'general_fan_out': 0}, {'cyclomatic_complexity': 2, 'nloc': 15, 'token_count': 119, 'name': '', 'long_name': '(n*core.IpfsNode,l net.Listener,mux*http.ServeMux)(*http.ServeMux,error)', 'start_line': 103, 'end_line': 120, 'full_parameters': [], 'filename': '/home/dimi/Documents/Informatik_Studium/FSS/SoftEvo/DataCollection/FFS_SoftEvo/go-ipfs/core/corehttp/commands.go', 'top_nesting_level': 0, 'length': 18, 'fan_in': 0, 'fan_out': 0, 'general_fan_out': 0}, {'cyclomatic_complexity': 1, 'nloc': 3, 'token_count': 19, 'name': 'commandsOption', 'long_name': 'commandsOption cctx commands . Context , command * commands . Command', 'start_line': 102, 'end_line': 121, 'full_parameters': ['cctx commands . Context', ' command * commands . Command'], 'filename': '/home/dimi/Documents/Informatik_Studium/FSS/SoftEvo/DataCollection/FFS_SoftEvo/go-ipfs/core/corehttp/commands.go', 'top_nesting_level': 0, 'length': 20, 'fan_in': 0, 'fan_out': 0, 'general_fan_out': 0}, {'cyclomatic_complexity': 1, 'nloc': 3, 'token_count': 20, 'name': 'CommandsOption', 'long_name': 'CommandsOption cctx commands . Context', 'start_line': 123, 'end_line': 125, 'full_parameters': ['cctx commands . Context'], 'filename': '/home/dimi/Documents/Informatik_Studium/FSS/SoftEvo/DataCollection/FFS_SoftEvo/go-ipfs/core/corehttp/commands.go', 'top_nesting_level': 0, 'length': 3, 'fan_in': 0, 'fan_out': 0, 'general_fan_out': 0}, {'cyclomatic_complexity': 1, 'nloc': 3, 'token_count': 20, 'name': 'CommandsROOption', 'long_name': 'CommandsROOption cctx commands . Context', 'start_line': 127, 'end_line': 129, 'full_parameters': ['cctx commands . Context'], 'filename': '/home/dimi/Documents/Informatik_Studium/FSS/SoftEvo/DataCollection/FFS_SoftEvo/go-ipfs/core/corehttp/commands.go', 'top_nesting_level': 0, 'length': 3, 'fan_in': 0, 'fan_out': 0, 'general_fan_out': 0}]",142,958,11,"[{'cyclomatic_complexity': 2, 'nloc': 7, 'token_count': 37, 'name': 'addCORSFromEnv', 'long_name': 'addCORSFromEnv c * cmdsHttp . ServerConfig', 'start_line': 49, 'end_line': 55, 'full_parameters': ['c * cmdsHttp . ServerConfig'], 'filename': '/home/dimi/Documents/Informatik_Studium/FSS/SoftEvo/DataCollection/FFS_SoftEvo/go-ipfs/core/corehttp/commands.go', 'top_nesting_level': 0, 'length': 7, 'fan_in': 0, 'fan_out': 0, 'general_fan_out': 0}, {'cyclomatic_complexity': 6, 'nloc': 22, 'token_count': 202, 'name': 'addHeadersFromConfig', 'long_name': 'addHeadersFromConfig c * cmdsHttp . ServerConfig , nc * config . Config', 'start_line': 57, 'end_line': 84, 'full_parameters': ['c * cmdsHttp . ServerConfig', ' nc * config . Config'], 'filename': '/home/dimi/Documents/Informatik_Studium/FSS/SoftEvo/DataCollection/FFS_SoftEvo/go-ipfs/core/corehttp/commands.go', 'top_nesting_level': 0, 'length': 28, 'fan_in': 0, 'fan_out': 0, 'general_fan_out': 0}, {'cyclomatic_complexity': 3, 'nloc': 8, 'token_count': 60, 'name': 'addCORSDefaults', 'long_name': 'addCORSDefaults c * cmdsHttp . ServerConfig', 'start_line': 86, 'end_line': 96, 'full_parameters': ['c * cmdsHttp . ServerConfig'], 'filename': '/home/dimi/Documents/Informatik_Studium/FSS/SoftEvo/DataCollection/FFS_SoftEvo/go-ipfs/core/corehttp/commands.go', 'top_nesting_level': 0, 'length': 11, 'fan_in': 0, 'fan_out': 0, 'general_fan_out': 0}, {'cyclomatic_complexity': 5, 'nloc': 17, 'token_count': 137, 'name': 'patchCORSVars', 'long_name': 'patchCORSVars c * cmdsHttp . ServerConfig , addr net . Addr', 'start_line': 98, 'end_line': 120, 'full_parameters': ['c * cmdsHttp . ServerConfig', ' addr net . Addr'], 'filename': '/home/dimi/Documents/Informatik_Studium/FSS/SoftEvo/DataCollection/FFS_SoftEvo/go-ipfs/core/corehttp/commands.go', 'top_nesting_level': 0, 'length': 23, 'fan_in': 0, 'fan_out': 0, 'general_fan_out': 0}, {'cyclomatic_complexity': 3, 'nloc': 21, 'token_count': 149, 'name': '', 'long_name': '(n*core.IpfsNode,l net.Listener,mux*http.ServeMux)(*http.ServeMux,error)', 'start_line': 123, 'end_line': 147, 'full_parameters': [], 'filename': '/home/dimi/Documents/Informatik_Studium/FSS/SoftEvo/DataCollection/FFS_SoftEvo/go-ipfs/core/corehttp/commands.go', 'top_nesting_level': 0, 'length': 25, 'fan_in': 0, 'fan_out': 0, 'general_fan_out': 0}, {'cyclomatic_complexity': 1, 'nloc': 3, 'token_count': 22, 'name': 'commandsOption', 'long_name': 'commandsOption cctx oldcmds . Context , command * cmds . Command , allowGet bool', 'start_line': 122, 'end_line': 148, 'full_parameters': ['cctx oldcmds . Context', ' command * cmds . Command', ' allowGet bool'], 'filename': '/home/dimi/Documents/Informatik_Studium/FSS/SoftEvo/DataCollection/FFS_SoftEvo/go-ipfs/core/corehttp/commands.go', 'top_nesting_level': 0, 'length': 27, 'fan_in': 0, 'fan_out': 0, 'general_fan_out': 0}, {'cyclomatic_complexity': 1, 'nloc': 3, 'token_count': 22, 'name': 'CommandsOption', 'long_name': 'CommandsOption cctx oldcmds . Context', 'start_line': 152, 'end_line': 154, 'full_parameters': ['cctx oldcmds . Context'], 'filename': '/home/dimi/Documents/Informatik_Studium/FSS/SoftEvo/DataCollection/FFS_SoftEvo/go-ipfs/core/corehttp/commands.go', 'top_nesting_level': 0, 'length': 3, 'fan_in': 0, 'fan_out': 0, 'general_fan_out': 0}, {'cyclomatic_complexity': 1, 'nloc': 3, 'token_count': 22, 'name': 'CommandsROOption', 'long_name': 'CommandsROOption cctx oldcmds . Context', 'start_line': 158, 'end_line': 160, 'full_parameters': ['cctx oldcmds . Context'], 'filename': '/home/dimi/Documents/Informatik_Studium/FSS/SoftEvo/DataCollection/FFS_SoftEvo/go-ipfs/core/corehttp/commands.go', 'top_nesting_level': 0, 'length': 3, 'fan_in': 0, 'fan_out': 0, 'general_fan_out': 0}, {'cyclomatic_complexity': 6, 'nloc': 14, 'token_count': 122, 'name': '', 'long_name': '(w http.ResponseWriter,r*http.Request)', 'start_line': 168, 'end_line': 185, 'full_parameters': [], 'filename': '/home/dimi/Documents/Informatik_Studium/FSS/SoftEvo/DataCollection/FFS_SoftEvo/go-ipfs/core/corehttp/commands.go', 'top_nesting_level': 0, 'length': 18, 'fan_in': 0, 'fan_out': 0, 'general_fan_out': 0}, {'cyclomatic_complexity': 1, 'nloc': 5, 'token_count': 48, 'name': '', 'long_name': '(n*core.IpfsNode,l net.Listener,parent*http.ServeMux)(*http.ServeMux,error)', 'start_line': 166, 'end_line': 188, 'full_parameters': [], 'filename': '/home/dimi/Documents/Informatik_Studium/FSS/SoftEvo/DataCollection/FFS_SoftEvo/go-ipfs/core/corehttp/commands.go', 'top_nesting_level': 0, 'length': 23, 'fan_in': 0, 'fan_out': 0, 'general_fan_out': 0}, {'cyclomatic_complexity': 1, 'nloc': 4, 'token_count': 17, 'name': 'CheckVersionOption', 'long_name': 'CheckVersionOption', 'start_line': 163, 'end_line': 189, 'full_parameters': [], 'filename': '/home/dimi/Documents/Informatik_Studium/FSS/SoftEvo/DataCollection/FFS_SoftEvo/go-ipfs/core/corehttp/commands.go', 'top_nesting_level': 0, 'length': 27, 'fan_in': 0, 'fan_out': 0, 'general_fan_out': 0}]",41,304,3,117,117,"[{'timestamp': 1491058697.0, 'added_lines': 6, 'deleted_lines': 5, 'nloc': 101}, {'timestamp': 1508770239.0, 'added_lines': 2, 'deleted_lines': 2, 'nloc': 101}, {'timestamp': 1509016767.0, 'added_lines': 2, 'deleted_lines': 2, 'nloc': 101}, {'timestamp': 1511223906.0, 'added_lines': 2, 'deleted_lines': 2, 'nloc': 101}, {'timestamp': 1511373659.0, 'added_lines': 2, 'deleted_lines': 2, 'nloc': 101}, {'timestamp': 1512365669.0, 'added_lines': 2, 'deleted_lines': 2, 'nloc': 101}, {'timestamp': 1511187070.0, 'added_lines': 10, 'deleted_lines': 7, 'nloc': 103}, {'timestamp': 1511800961.0, 'added_lines': 47, 'deleted_lines': 0, 'nloc': 139}, {'timestamp': 1512121226.0, 'added_lines': 15, 'deleted_lines': 14, 'nloc': 140}, {'timestamp': 1513436097.0, 'added_lines': 2, 'deleted_lines': 2, 'nloc': 140}, {'timestamp': 1513607935.0, 'added_lines': 0, 'deleted_lines': 13, 'nloc': 130}, {'timestamp': 1513612261.0, 'added_lines': 2, 'deleted_lines': 2, 'nloc': 130}, {'timestamp': 1513614564.0, 'added_lines': 6, 'deleted_lines': 4, 'nloc': 131}, {'timestamp': 1513764708.0, 'added_lines': 2, 'deleted_lines': 2, 'nloc': 131}, {'timestamp': 1513765470.0, 'added_lines': 2, 'deleted_lines': 2, 'nloc': 131}, {'timestamp': 1513766201.0, 'added_lines': 2, 'deleted_lines': 2, 'nloc': 131}, {'timestamp': 1513772654.0, 'added_lines': 2, 'deleted_lines': 2, 'nloc': 131}, {'timestamp': 1513773452.0, 'added_lines': 2, 'deleted_lines': 2, 'nloc': 131}, {'timestamp': 1513788060.0, 'added_lines': 3, 'deleted_lines': 3, 'nloc': 131}, {'timestamp': 1513791994.0, 'added_lines': 3, 'deleted_lines': 3, 'nloc': 131}, {'timestamp': 1515277696.0, 'added_lines': 1, 'deleted_lines': 0, 'nloc': 132}, {'timestamp': 1515465466.0, 'added_lines': 2, 'deleted_lines': 2, 'nloc': 132}, {'timestamp': 1515708108.0, 'added_lines': 2, 'deleted_lines': 2, 'nloc': 132}, {'timestamp': 1515708133.0, 'added_lines': 1, 'deleted_lines': 0, 'nloc': 132}, {'timestamp': 1515713724.0, 'added_lines': 2, 'deleted_lines': 2, 'nloc': 132}, {'timestamp': 1516341168.0, 'added_lines': 2, 'deleted_lines': 2, 'nloc': 132}, {'timestamp': 1516766685.0, 'added_lines': 4, 'deleted_lines': 0, 'nloc': 132}, {'timestamp': 1516768035.0, 'added_lines': 1, 'deleted_lines': 1, 'nloc': 132}, {'timestamp': 1516779407.0, 'added_lines': 12, 'deleted_lines': 5, 'nloc': 136}, {'timestamp': 1516779411.0, 'added_lines': 0, 'deleted_lines': 3, 'nloc': 133}, {'timestamp': 1516838128.0, 'added_lines': 2, 'deleted_lines': 2, 'nloc': 133}, {'timestamp': 1517105039.0, 'added_lines': 2, 'deleted_lines': 2, 'nloc': 133}, {'timestamp': 1517453697.0, 'added_lines': 2, 'deleted_lines': 2, 'nloc': 133}, {'timestamp': 1519173780.0, 'added_lines': 2, 'deleted_lines': 2, 'nloc': 133}, {'timestamp': 1521314540.0, 'added_lines': 2, 'deleted_lines': 2, 'nloc': 133}, {'timestamp': 1521500314.0, 'added_lines': 2, 'deleted_lines': 2, 'nloc': 133}, {'timestamp': 1524596476.0, 'added_lines': 2, 'deleted_lines': 2, 'nloc': 133}, {'timestamp': 1525408792.0, 'added_lines': 2, 'deleted_lines': 2, 'nloc': 133}, {'timestamp': 1528059336.0, 'added_lines': 2, 'deleted_lines': 2, 'nloc': 133}, {'timestamp': 1528520460.0, 'added_lines': 2, 'deleted_lines': 2, 'nloc': 133}, {'timestamp': 1529984485.0, 'added_lines': 2, 'deleted_lines': 2, 'nloc': 133}, {'timestamp': 1532847462.0, 'added_lines': 1, 'deleted_lines': 1, 'nloc': 133}, {'timestamp': 1533500571.0, 'added_lines': 1, 'deleted_lines': 1, 'nloc': 133}, {'timestamp': 1533618653.0, 'added_lines': 1, 'deleted_lines': 1, 'nloc': 133}, {'timestamp': 1533779477.0, 'added_lines': 3, 'deleted_lines': 3, 'nloc': 133}, {'timestamp': 1532357069.0, 'added_lines': 2, 'deleted_lines': 2, 'nloc': 133}, {'timestamp': 1532365899.0, 'added_lines': 4, 'deleted_lines': 3, 'nloc': 134}, {'timestamp': 1532388583.0, 'added_lines': 1, 'deleted_lines': 1, 'nloc': 134}, {'timestamp': 1532507240.0, 'added_lines': 4, 'deleted_lines': 4, 'nloc': 134}, {'timestamp': 1533809170.0, 'added_lines': 1, 'deleted_lines': 1, 'nloc': 134}, {'timestamp': 1533946888.0, 'added_lines': 2, 'deleted_lines': 2, 'nloc': 134}, {'timestamp': 1534115707.0, 'added_lines': 1, 'deleted_lines': 1, 'nloc': 134}, {'timestamp': 1534195762.0, 'added_lines': 1, 'deleted_lines': 1, 'nloc': 134}, {'timestamp': 1534347022.0, 'added_lines': 1, 'deleted_lines': 1, 'nloc': 134}, {'timestamp': 1534072974.0, 'added_lines': 1, 'deleted_lines': 1, 'nloc': 134}, {'timestamp': 1534896611.0, 'added_lines': 4, 'deleted_lines': 4, 'nloc': 134}, {'timestamp': 1535255498.0, 'added_lines': 1, 'deleted_lines': 1, 'nloc': 134}, {'timestamp': 1535601896.0, 'added_lines': 2, 'deleted_lines': 2, 'nloc': 134}, {'timestamp': 1536388808.0, 'added_lines': 2, 'deleted_lines': 2, 'nloc': 134}, {'timestamp': 1536718784.0, 'added_lines': 1, 'deleted_lines': 1, 'nloc': 134}, {'timestamp': 1536723292.0, 'added_lines': 1, 'deleted_lines': 1, 'nloc': 134}, {'timestamp': 1536796877.0, 'added_lines': 1, 'deleted_lines': 5, 'nloc': 132}, {'timestamp': 1523628870.0, 'added_lines': 2, 'deleted_lines': 2, 'nloc': 132}, {'timestamp': 1535044155.0, 'added_lines': 2, 'deleted_lines': 2, 'nloc': 132}, {'timestamp': 1537193530.0, 'added_lines': 2, 'deleted_lines': 2, 'nloc': 132}, {'timestamp': 1537391809.0, 'added_lines': 2, 'deleted_lines': 2, 'nloc': 132}, {'timestamp': 1537790637.0, 'added_lines': 1, 'deleted_lines': 1, 'nloc': 132}, {'timestamp': 1537792589.0, 'added_lines': 4, 'deleted_lines': 4, 'nloc': 132}, {'timestamp': 1538544957.0, 'added_lines': 2, 'deleted_lines': 2, 'nloc': 132}, {'timestamp': 1538547366.0, 'added_lines': 1, 'deleted_lines': 1, 'nloc': 132}, {'timestamp': 1538694687.0, 'added_lines': 1, 'deleted_lines': 1, 'nloc': 132}, {'timestamp': 1538695953.0, 'added_lines': 1, 'deleted_lines': 1, 'nloc': 132}, {'timestamp': 1538773916.0, 'added_lines': 1, 'deleted_lines': 1, 'nloc': 132}, {'timestamp': 1539176817.0, 'added_lines': 1, 'deleted_lines': 1, 'nloc': 132}, {'timestamp': 1539357340.0, 'added_lines': 1, 'deleted_lines': 1, 'nloc': 132}, {'timestamp': 1539850591.0, 'added_lines': 2, 'deleted_lines': 2, 'nloc': 132}, {'timestamp': 1540400358.0, 'added_lines': 2, 'deleted_lines': 2, 'nloc': 132}, {'timestamp': 1540410565.0, 'added_lines': 1, 'deleted_lines': 1, 'nloc': 132}, {'timestamp': 1540418491.0, 'added_lines': 1, 'deleted_lines': 1, 'nloc': 132}, {'timestamp': 1540489644.0, 'added_lines': 1, 'deleted_lines': 1, 'nloc': 132}, {'timestamp': 1540552487.0, 'added_lines': 2, 'deleted_lines': 2, 'nloc': 132}, {'timestamp': 1540597832.0, 'added_lines': 2, 'deleted_lines': 2, 'nloc': 132}, {'timestamp': 1540603818.0, 'added_lines': 1, 'deleted_lines': 1, 'nloc': 132}, {'timestamp': 1540916861.0, 'added_lines': 1, 'deleted_lines': 1, 'nloc': 132}, {'timestamp': 1541189794.0, 'added_lines': 1, 'deleted_lines': 1, 'nloc': 132}, {'timestamp': 1541204121.0, 'added_lines': 4, 'deleted_lines': 4, 'nloc': 132}, {'timestamp': 1541903826.0, 'added_lines': 1, 'deleted_lines': 1, 'nloc': 132}, {'timestamp': 1543282933.0, 'added_lines': 1, 'deleted_lines': 1, 'nloc': 132}, {'timestamp': 1543443696.0, 'added_lines': 1, 'deleted_lines': 1, 'nloc': 132}, {'timestamp': 1544225843.0, 'added_lines': 2, 'deleted_lines': 2, 'nloc': 132}, {'timestamp': 1544661332.0, 'added_lines': 2, 'deleted_lines': 2, 'nloc': 132}, {'timestamp': 1540556089.0, 'added_lines': 2, 'deleted_lines': 2, 'nloc': 132}, {'timestamp': 1545323704.0, 'added_lines': 1, 'deleted_lines': 1, 'nloc': 132}, {'timestamp': 1546553605.0, 'added_lines': 1, 'deleted_lines': 1, 'nloc': 132}, {'timestamp': 1546629504.0, 'added_lines': 7, 'deleted_lines': 2, 'nloc': 136}, {'timestamp': 1546635631.0, 'added_lines': 1, 'deleted_lines': 0, 'nloc': 137}, {'timestamp': 1547003974.0, 'added_lines': 2, 'deleted_lines': 2, 'nloc': 137}, {'timestamp': 1547152271.0, 'added_lines': 2, 'deleted_lines': 2, 'nloc': 137}, {'timestamp': 1547499910.0, 'added_lines': 1, 'deleted_lines': 1, 'nloc': 137}, {'timestamp': 1548866534.0, 'added_lines': 2, 'deleted_lines': 2, 'nloc': 137}, {'timestamp': 1549588289.0, 'added_lines': 2, 'deleted_lines': 2, 'nloc': 137}, {'timestamp': 1549903582.0, 'added_lines': 2, 'deleted_lines': 2, 'nloc': 137}, {'timestamp': 1550185115.0, 'added_lines': 1, 'deleted_lines': 1, 'nloc': 137}, {'timestamp': 1550507829.0, 'added_lines': 4, 'deleted_lines': 4, 'nloc': 137}, {'timestamp': 1550610741.0, 'added_lines': 2, 'deleted_lines': 2, 'nloc': 137}, {'timestamp': 1550711994.0, 'added_lines': 1, 'deleted_lines': 1, 'nloc': 137}, {'timestamp': 1550723346.0, 'added_lines': 1, 'deleted_lines': 1, 'nloc': 137}, {'timestamp': 1551138343.0, 'added_lines': 2, 'deleted_lines': 2, 'nloc': 137}, {'timestamp': 1551229859.0, 'added_lines': 2, 'deleted_lines': 2, 'nloc': 137}, {'timestamp': 1551299964.0, 'added_lines': 3, 'deleted_lines': 3, 'nloc': 137}, {'timestamp': 1551471469.0, 'added_lines': 2, 'deleted_lines': 2, 'nloc': 137}, {'timestamp': 1551551196.0, 'added_lines': 4, 'deleted_lines': 4, 'nloc': 137}, {'timestamp': 1557557624.0, 'added_lines': 2, 'deleted_lines': 4, 'nloc': 135}, {'timestamp': 1551228784.0, 'added_lines': 2, 'deleted_lines': 2, 'nloc': 135}, {'timestamp': 1579218500.0, 'added_lines': 1, 'deleted_lines': 1, 'nloc': 135}, {'timestamp': 1585958136.0, 'added_lines': 12, 'deleted_lines': 6, 'nloc': 140}, {'timestamp': 1603147246.0, 'added_lines': 2, 'deleted_lines': 0, 'nloc': 142}]","{'blocks/blockstore/caching.go': 1, 'blocks/blockstore/util/remove.go': 3, 'cmd/ipfs/daemon.go': 61, 'cmd/ipfs/init.go': 53, 'cmd/ipfs/ipfs.go': 51, 'cmd/ipfs/main.go': 71, 'cmd/ipfs/main_test.go': 4, 'cmd/ipfswatch/main.go': 36, 'cmd/seccat/seccat.go': 26, None: 17, 'commands/channelmarshaler.go': 1, 'commands/cli/cmd_suggestion.go': 1, 'commands/cli/helptext.go': 2, 'commands/cli/helptext_test.go': 2, 'commands/cli/parse.go': 2, 'commands/cli/parse_test.go': 2, 'commands/command.go': 29, 'commands/command_test.go': 20, 'commands/http/client.go': 2, 'commands/http/handler.go': 2, 'commands/http/multifilereader.go': 2, 'commands/http/multifilereader_test.go': 2, 'commands/http/parse.go': 2, 'commands/reqlog.go': 1, 'commands/request.go': 51, 'commands/response.go': 24, 'commands/response_test.go': 20, 'core/bootstrap.go': 37, 'core/commands/active.go': 22, 'core/commands/add.go': 70, 'core/commands/bitswap.go': 80, 'core/commands/block.go': 59, 'core/commands/bootstrap.go': 43, 'core/commands/cat.go': 57, 'core/commands/commands.go': 52, 'core/commands/config.go': 44, 'core/commands/dag/dag.go': 61, 'core/commands/dht.go': 63, 'core/commands/diag.go': 22, 'core/commands/dns.go': 28, 'core/commands/e/error.go': 1, 'core/commands/external.go': 22, 'core/commands/files/files.go': 10, 'core/commands/filestore.go': 56, 'core/commands/get.go': 84, 'core/commands/helptext_test.go': 51, 'core/commands/id.go': 49, 'core/commands/ipns.go': 16, 'core/commands/keystore.go': 39, 'core/commands/log.go': 28, 'core/commands/ls.go': 59, 'core/commands/mount_nofuse.go': 22, 'core/commands/mount_unix.go': 43, 'core/commands/mount_windows.go': 21, 'core/commands/name.go': 10, 'core/commands/object/diff.go': 28, 'core/commands/object/object.go': 69, 'core/commands/object/patch.go': 42, 'core/commands/p2p.go': 35, 'core/commands/pin.go': 60, 'core/commands/ping.go': 41, 'core/commands/publish.go': 21, 'core/commands/pubsub.go': 64, 'core/commands/refs.go': 59, 'core/commands/repo.go': 80, 'core/commands/resolve.go': 61, 'core/commands/root.go': 52, 'core/commands/shutdown.go': 31, 'core/commands/stat.go': 56, 'core/commands/swarm.go': 57, 'core/commands/sysdiag.go': 31, 'core/commands/tar.go': 59, 'core/commands/unixfs/ls.go': 57, 'core/commands/unixfs/unixfs.go': 22, 'core/commands/version.go': 27, 'core/core_test.go': 28, 'core/corehttp/gateway.go': 40, 'core/coreunix/add.go': 56, 'core/coreunix/add_test.go': 65, 'core/coreunix/metadata_test.go': 49, 'exchange/bitswap/bitswap_test.go': 10, 'exchange/bitswap/decision/engine_test.go': 8, 'exchange/bitswap/message/message_test.go': 4, 'exchange/bitswap/message/pb/Makefile': 1, 'exchange/bitswap/testnet/network_test.go': 8, 'exchange/bitswap/testnet/peernet.go': 9, 'exchange/reprovide/reprovide_test.go': 33, 'fuse/ipns/common.go': 47, 'fuse/node/mount_test.go': 31, 'importer/balanced/balanced_test.go': 6, 'importer/chunk/rabin_test.go': 3, 'importer/helpers/dagbuilder.go': 11, 'importer/importer.go': 11, 'merkledag/utils/utils_test.go': 4, 'mfs/repub_test.go': 11, 'namesys/dns.go': 42, 'namesys/interface.go': 43, 'namesys/ipns_select_test.go': 5, 'namesys/proquint.go': 42, 'namesys/republisher/repub_test.go': 50, 'package.json': 95, 'repo/config/identity.go': 3, 'routing/offline/offline_test.go': 6, 'test/integration/addcat_test.go': 36, 'test/integration/bench_cat_test.go': 35, 'test/integration/bitswap_wo_routing_test.go': 36, 'test/integration/three_legged_cat_test.go': 35, 'test/sharness/t0600-issues-and-regressions-online.sh': 2, 'core/bootstrap_test.go': 34, 'core/commands/dht_test.go': 23, 'core/commands/get_test.go': 49, 'core/core.go': 67, 'core/corehttp/gateway_test.go': 62, 'core/corehttp/metrics_test.go': 32, 'core/mock/mock.go': 43, 'exchange/bitswap/decision/bench_test.go': 7, 'exchange/bitswap/decision/peer_request_queue_test.go': 7, 'exchange/bitswap/message/message.go': 7, 'exchange/bitswap/network/interface.go': 7, 'exchange/bitswap/network/ipfs_impl.go': 7, 'exchange/bitswap/testnet/interface.go': 7, 'exchange/bitswap/testnet/virtual.go': 7, 'exchange/bitswap/testutils.go': 8, 'fuse/ipns/ipns_test.go': 30, 'fuse/readonly/ipfs_test.go': 50, 'namesys/publisher_test.go': 31, 'namesys/resolve_test.go': 47, 'p2p/p2p.go': 24, 'p2p/registry.go': 11, 'repo/config/bootstrap_peers.go': 9, 'routing/mock/centralized_client.go': 4, 'routing/mock/centralized_server.go': 4, 'routing/mock/centralized_test.go': 4, 'routing/mock/interface.go': 4, 'routing/none/none_client.go': 4, 'test/integration/bench_test.go': 18, 'assets/assets.go': 45, 'blocks/blockstore/arc_cache.go': 2, 'blocks/blockstore/arc_cache_test.go': 2, 'blocks/blockstore/blockstore.go': 3, 'blocks/blockstore/blockstore_test.go': 2, 'blocks/blockstore/bloom_cache.go': 2, 'blocks/blockstore/bloom_cache_test.go': 2, 'blocks/blocksutil/block_generator.go': 2, 'blockservice/blockservice.go': 6, 'blockservice/blockservice_test.go': 5, 'blockservice/test/blocks_test.go': 5, 'core/builder.go': 63, 'core/commands/ipnsps.go': 9, 'core/coreapi/coreapi.go': 23, 'core/coreapi/interface/interface.go': 2, 'core/coreapi/unixfs.go': 47, 'core/coreapi/unixfs_test.go': 46, 'core/coredag/cbor.go': 16, 'core/coredag/dagpb.go': 41, 'core/coredag/dagtransl.go': 12, 'core/coredag/raw.go': 41, 'core/corehttp/corehttp.go': 14, 'core/corehttp/gateway_handler.go': 55, 'core/corerepo/gc.go': 48, 'core/corerepo/pinning.go': 19, 'core/coreunix/metadata.go': 46, 'core/pathresolver.go': 46, 'exchange/bitswap/bitswap.go': 6, 'exchange/bitswap/decision/engine.go': 6, 'exchange/bitswap/decision/ledger.go': 6, 'exchange/bitswap/decision/peer_request_queue.go': 6, 'exchange/bitswap/get.go': 5, 'exchange/bitswap/notifications/notifications.go': 3, 'exchange/bitswap/notifications/notifications_test.go': 3, 'exchange/bitswap/session.go': 7, 'exchange/bitswap/session_test.go': 5, 'exchange/bitswap/stat.go': 3, 'exchange/bitswap/wantlist/wantlist.go': 3, 'exchange/bitswap/wantlist/wantlist_test.go': 3, 'exchange/bitswap/wantmanager.go': 6, 'exchange/bitswap/workers.go': 6, 'exchange/interface.go': 2, 'exchange/offline/offline.go': 2, 'exchange/offline/offline_test.go': 2, 'exchange/reprovide/providers.go': 43, 'exchange/reprovide/reprovide.go': 27, 'filestore/filestore.go': 25, 'filestore/filestore_test.go': 43, 'filestore/fsrefstore.go': 25, 'filestore/util.go': 22, 'fuse/ipns/ipns_unix.go': 52, 'fuse/readonly/readonly_unix.go': 53, 'importer/balanced/builder.go': 3, 'importer/chunk/splitting_test.go': 2, 'importer/helpers/helpers.go': 3, 'importer/importer_test.go': 5, 'importer/trickle/trickle_test.go': 5, 'importer/trickle/trickledag.go': 3, 'merkledag/batch.go': 2, 'merkledag/coding.go': 3, 'merkledag/merkledag.go': 3, 'merkledag/merkledag_test.go': 5, 'merkledag/node.go': 3, 'merkledag/node_test.go': 3, 'merkledag/raw.go': 3, 'merkledag/traverse/traverse.go': 3, 'merkledag/traverse/traverse_test.go': 3, 'merkledag/utils/diff.go': 3, 'merkledag/utils/diffenum.go': 3, 'merkledag/utils/diffenum_test.go': 3, 'merkledag/utils/utils.go': 5, 'mfs/dir.go': 10, 'mfs/file.go': 12, 'mfs/mfs_test.go': 13, 'mfs/ops.go': 10, 'mfs/system.go': 13, 'namesys/namesys.go': 48, 'namesys/publisher.go': 51, 'namesys/pubsub.go': 5, 'namesys/pubsub_test.go': 5, 'namesys/republisher/repub.go': 46, 'namesys/routing.go': 47, 'path/path.go': 3, 'path/resolver.go': 3, 'path/resolver_test.go': 2, 'pin/gc/gc.go': 44, 'pin/pin.go': 44, 'pin/pin_test.go': 43, 'pin/set.go': 41, 'pin/set_test.go': 43, 'plugin/ipld.go': 12, 'plugin/loader/initializer.go': 9, 'plugin/plugins/git/git.go': 12, 'repo/config/init.go': 7, 'repo/fsrepo/fsrepo.go': 35, 'repo/fsrepo/lock/lock.go': 3, 'repo/fsrepo/serialize/serialize.go': 3, 'repo/mock.go': 28, 'repo/repo.go': 32, 'routing/offline/offline.go': 3, 'tar/format.go': 51, 'test/dependencies/ma-pipe-unidir/main.go': 9, 'thirdparty/ds-help/key.go': 2, 'thirdparty/pollEndpoint/main.go': 14, 'thirdparty/posinfo/posinfo.go': 2, 'unixfs/archive/archive.go': 3, 'unixfs/archive/tar/writer.go': 3, 'unixfs/hamt/hamt.go': 3, 'unixfs/io/dagreader.go': 3, 'unixfs/io/dirbuilder.go': 3, 'unixfs/io/resolve.go': 3, 'unixfs/mod/dagmodifier.go': 5, 'unixfs/mod/dagmodifier_test.go': 3, 'unixfs/test/utils.go': 5, 'commands/legacy/command.go': 34, 'commands/legacy/legacy.go': 35, 'commands/legacy/legacy_test.go': 35, 'commands/legacy/request.go': 35, 'commands/legacy/response.go': 35, 'commands/legacy/responseemitter.go': 4, 'core/commands/env.go': 10, 'core/corehttp/option_test.go': 6, 'core/commands/commands_test.go': 44, 'test/sharness/t0040-add-and-cat.sh': 1, 'TODO.md': 4, 'test/sharness/t0110-gateway.sh': 2, 'test/sharness/t0410-api-add.sh': 1, 'core/coreapi/dag.go': 11, 'core/coreapi/dag_test.go': 3, 'core/coreapi/interface/options/dag.go': 7, 'core/coreapi/key.go': 46, 'core/coreapi/name.go': 46, 'merkledag/test/utils.go': 4, 'namesys/namesys_test.go': 49, 'repo/fsrepo/datastores.go': 15, 'repo/fsrepo/fsrepo_test.go': 28, 'thirdparty/datastore2/datastore_closer.go': 1, 'thirdparty/datastore2/delayed.go': 1, 'thirdparty/datastore2/threadsafe.go': 1, 'unixfs/io/pbdagreader.go': 2, 'cmd/ipfs/util/ulimit.go': 9, 'cmd/seccat/util.go': 9, 'core/corehttp/logs.go': 9, 'fuse/mount/mount.go': 10, 'fuse/node/mount_unix.go': 9, 'importer/chunk/splitting.go': 1, 'namesys/ipns_validate_test.go': 3, 'plugin/loader/load.go': 7, 'core/commands/files.go': 63, 'core/commands/root_test.go': 1, 'test/sharness/t0090-get.sh': 2, 'blocks/blockstoreutil/remove.go': 20, 'blockservice/test/mock.go': 3, 'core/coreapi/pin.go': 42, 'keystore/keystore.go': 9, 'keystore/keystore_test.go': 5, 'keystore/memkeystore.go': 5, 'namesys/validator.go': 2, 'path/resolver/resolver.go': 3, 'thirdparty/verifbs/verifbs.go': 20, 'core/corehttp/ipns_hostname.go': 9, 'cmd/ipfs/util/ulimit_freebsd.go': 2, 'cmd/ipfs/util/ulimit_unix.go': 2, 'core/coreapi/block.go': 14, 'core/coreapi/block_test.go': 2, 'core/coreapi/interface/coreapi.go': 8, 'core/coreapi/interface/dag.go': 8, 'core/coreapi/interface/object.go': 8, 'core/coreapi/interface/options/block.go': 3, 'core/coreapi/interface/path.go': 34, 'core/coreapi/interface/unixfs.go': 12, 'core/coreapi/object.go': 44, 'fuse/ipns/link_unix.go': 2, 'fuse/mount/fuse.go': 3, 'fuse/node/mount_darwin.go': 2, 'merkledag/errservice.go': 1, 'merkledag/readonly.go': 1, 'merkledag/readonly_test.go': 1, 'merkledag/rwservice.go': 1, 'merkledag/session.go': 1, 'path/resolver/resolver_test.go': 1, 'thirdparty/verifcid/validate.go': 1, 'thirdparty/verifcid/validate_test.go': 1, 'unixfs/hamt/hamt_stress_test.go': 1, 'unixfs/hamt/hamt_test.go': 1, 'namesys/ipns_resolver_validation_test.go': 42, 'test/sharness/t0170-dht.sh': 1, 'core/coreapi/name_test.go': 32, 'core/coreapi/path.go': 45, 'core/coreunix/cat.go': 15, 'core/pathresolver_test.go': 40, 'dagutils/utils.go': 40, 'dagutils/utils_test.go': 40, 'namesys/base.go': 41, 'namesys/cache.go': 40, 'core/commands/urlstore.go': 54, 'dagutils/diff.go': 39, 'dagutils/diffenum.go': 38, 'dagutils/diffenum_test.go': 38, 'mfs/fd.go': 7, 'core/coreapi/interface/key.go': 7, 'filestore/pb/dataobj.pb.go': 3, 'pin/internal/pb/header.pb.go': 3, 'thirdparty/cidv0v1/blockstore.go': 16, 'repo/fsrepo/misc.go': 24, 'cmd/ipfs/Rules.mk': 1, 'docs/releases.md': 2, 'docs/windows.md': 2, 'repo/fsrepo/config_test.go': 23, 'repo/version.go': 1, 'test/bench/bench_cli_ipfs_add/main.go': 24, 'test/bench/offline_add/main.go': 24, 'version.go': 1, 'core/commands/cmdenv/env.go': 37, 'core/commands/name/ipns.go': 47, 'core/commands/name/publish.go': 30, 'core/coreapi/dht.go': 30, 'core/coreapi/dht_test.go': 5, 'test/sharness/t0275-cid-security.sh': 1, 'core/commands/name/ipnsps.go': 24, 'core/commands/name/name.go': 20, 'test/sharness/lib/test-lib.sh': 1, 'core/coreapi/interface/dht.go': 10, 'p2p/listener.go': 13, 'p2p/local.go': 14, 'p2p/remote.go': 13, 'p2p/stream.go': 13, 'core/coreapi/interface/swarm.go': 9, 'core/coreapi/swarm.go': 20, 'core/coreapi/interface/options/unixfs.go': 15, 'core/coreapi/pubsub.go': 19, 'core/coreapi/unixfile.go': 16, 'core/commands/cid.go': 16, 'cmd/ipfs/dnsresolve_test.go': 5, 'core/coreapi/interface/pubsub.go': 4, 'test/sharness/t0180-pubsub.sh': 1, 'test/dependencies/iptb/iptb.go': 15, 'plugin/plugins/badgerds/badgerds.go': 4, 'plugin/plugins/flatfs/flatfs.go': 4, 'plugin/plugins/levelds/levelds.go': 3, 'commands/context.go': 20, 'core/corehttp/proxy.go': 9, 'core/coreapi/test/api_test.go': 11, 'core/coreapi/interface/tests/name.go': 4, 'core/coreapi/interface/tests/unixfs.go': 4, 'plugin/loader/loader.go': 9, 'core/commands/cmdenv/cidbase.go': 9, 'core/commands/cmdenv/file.go': 3, 'namesys/dns_test.go': 8, 'plugin/daemon.go': 8, 'core/corerepo/stat.go': 2, 'core/commands/cmdenv/cidbase_test.go': 2, 'core/corehttp/metrics.go': 1, 'core/corehttp/proxy_test.go': 2, 'plugin/tracer.go': 1, 'thirdparty/notifier/notifier.go': 1, 'cmd/ipfs/util/ulimit_test.go': 1, 'core/node/builder.go': 1, 'core/node/storage.go': 1, 'repo/fsrepo/migrations/migrations.go': 1, 'core/bootstrap/bootstrap.go': 1, 'core/node/libp2p/discovery.go': 1, 'core/node/libp2p/pnet.go': 1, 'core/node/libp2p/smux.go': 1, 'core/node/libp2p/transport.go': 1, 'plugin/loader/load_unix.go': 1, 'core/corehttp/webui.go': 1, 'go.mod': 1, 'go.sum': 1, 'test/dependencies/go.mod': 1, 'test/dependencies/go.sum': 1, 'test/sharness/t0051-object.sh': 1, 'test/sharness/t0060-daemon.sh': 1, 'test/sharness/t0100-name.sh': 1, 'test/sharness/t0230-channel-streaming-http-content-type.sh': 1, 'test/sharness/t0112-gateway-cors.sh': 1, 'test/sharness/t0400-api-no-gateway.sh': 1, 'test/sharness/t0401-api-browser-security.sh': 1}","('core/commands/get.go', 0.717948717948718, 0.7)"
core/corehttp/corehttp.go,78,429,3,"[{'cyclomatic_complexity': 3, 'nloc': 13, 'token_count': 84, 'name': 'ListenAndServe', 'long_name': 'ListenAndServe n * core . IpfsNode , listeningMultiAddr string , options ... ServeOption', 'start_line': 49, 'end_line': 65, 'full_parameters': ['n * core . IpfsNode', ' listeningMultiAddr string', ' options ... ServeOption'], 'filename': '/home/dimi/Documents/Informatik_Studium/FSS/SoftEvo/DataCollection/FFS_SoftEvo/go-ipfs/core/corehttp/corehttp.go', 'top_nesting_level': 0, 'length': 17, 'fan_in': 0, 'fan_out': 0, 'general_fan_out': 0}, {'cyclomatic_complexity': 1, 'nloc': 4, 'token_count': 23, 'name': '', 'long_name': '(p goprocess.Process)', 'start_line': 88, 'end_line': 91, 'full_parameters': [], 'filename': '/home/dimi/Documents/Informatik_Studium/FSS/SoftEvo/DataCollection/FFS_SoftEvo/go-ipfs/core/corehttp/corehttp.go', 'top_nesting_level': 0, 'length': 4, 'fan_in': 0, 'fan_out': 0, 'general_fan_out': 0}, {'cyclomatic_complexity': 9, 'nloc': 36, 'token_count': 195, 'name': 'Serve', 'long_name': 'Serve node * core . IpfsNode , lis net . Listener , options ... ServeOption', 'start_line': 67, 'end_line': 119, 'full_parameters': ['node * core . IpfsNode', ' lis net . Listener', ' options ... ServeOption'], 'filename': '/home/dimi/Documents/Informatik_Studium/FSS/SoftEvo/DataCollection/FFS_SoftEvo/go-ipfs/core/corehttp/corehttp.go', 'top_nesting_level': 0, 'length': 53, 'fan_in': 0, 'fan_out': 0, 'general_fan_out': 0}]",88,521,5,"[{'cyclomatic_complexity': 2, 'nloc': 7, 'token_count': 42, 'name': '', 'long_name': '(w http.ResponseWriter,r*http.Request)', 'start_line': 46, 'end_line': 55, 'full_parameters': [], 'filename': '/home/dimi/Documents/Informatik_Studium/FSS/SoftEvo/DataCollection/FFS_SoftEvo/go-ipfs/core/corehttp/corehttp.go', 'top_nesting_level': 0, 'length': 10, 'fan_in': 0, 'fan_out': 0, 'general_fan_out': 0}, {'cyclomatic_complexity': 3, 'nloc': 13, 'token_count': 85, 'name': 'ListenAndServe', 'long_name': 'ListenAndServe n * core . IpfsNode , listeningMultiAddr string , options ... ServeOption', 'start_line': 65, 'end_line': 81, 'full_parameters': ['n * core . IpfsNode', ' listeningMultiAddr string', ' options ... ServeOption'], 'filename': '/home/dimi/Documents/Informatik_Studium/FSS/SoftEvo/DataCollection/FFS_SoftEvo/go-ipfs/core/corehttp/corehttp.go', 'top_nesting_level': 0, 'length': 17, 'fan_in': 0, 'fan_out': 0, 'general_fan_out': 0}, {'cyclomatic_complexity': 1, 'nloc': 3, 'token_count': 17, 'name': '', 'long_name': '(p goprocess.Process)', 'start_line': 110, 'end_line': 112, 'full_parameters': [], 'filename': '/home/dimi/Documents/Informatik_Studium/FSS/SoftEvo/DataCollection/FFS_SoftEvo/go-ipfs/core/corehttp/corehttp.go', 'top_nesting_level': 0, 'length': 3, 'fan_in': 0, 'fan_out': 0, 'general_fan_out': 0}, {'cyclomatic_complexity': 1, 'nloc': 3, 'token_count': 17, 'name': '', 'long_name': '(_goprocess.Process)', 'start_line': 121, 'end_line': 123, 'full_parameters': [], 'filename': '/home/dimi/Documents/Informatik_Studium/FSS/SoftEvo/DataCollection/FFS_SoftEvo/go-ipfs/core/corehttp/corehttp.go', 'top_nesting_level': 0, 'length': 3, 'fan_in': 0, 'fan_out': 0, 'general_fan_out': 0}, {'cyclomatic_complexity': 6, 'nloc': 35, 'token_count': 216, 'name': 'Serve', 'long_name': 'Serve node * core . IpfsNode , lis net . Listener , options ... ServeOption', 'start_line': 85, 'end_line': 141, 'full_parameters': ['node * core . IpfsNode', ' lis net . Listener', ' options ... ServeOption'], 'filename': '/home/dimi/Documents/Informatik_Studium/FSS/SoftEvo/DataCollection/FFS_SoftEvo/go-ipfs/core/corehttp/corehttp.go', 'top_nesting_level': 0, 'length': 57, 'fan_in': 0, 'fan_out': 0, 'general_fan_out': 0}]",10,92,2,21,21,"[{'timestamp': 1512365669.0, 'added_lines': 2, 'deleted_lines': 2, 'nloc': 78}, {'timestamp': 1516838128.0, 'added_lines': 2, 'deleted_lines': 2, 'nloc': 78}, {'timestamp': 1517453697.0, 'added_lines': 1, 'deleted_lines': 1, 'nloc': 78}, {'timestamp': 1525408792.0, 'added_lines': 1, 'deleted_lines': 1, 'nloc': 78}, {'timestamp': 1520489177.0, 'added_lines': 1, 'deleted_lines': 1, 'nloc': 78}, {'timestamp': 1528268108.0, 'added_lines': 1, 'deleted_lines': 1, 'nloc': 78}, {'timestamp': 1528520460.0, 'added_lines': 3, 'deleted_lines': 3, 'nloc': 78}, {'timestamp': 1529984485.0, 'added_lines': 3, 'deleted_lines': 3, 'nloc': 78}, {'timestamp': 1533066339.0, 'added_lines': 33, 'deleted_lines': 23, 'nloc': 81}, {'timestamp': 1533779477.0, 'added_lines': 1, 'deleted_lines': 1, 'nloc': 81}, {'timestamp': 1537792589.0, 'added_lines': 1, 'deleted_lines': 1, 'nloc': 81}, {'timestamp': 1540400358.0, 'added_lines': 2, 'deleted_lines': 2, 'nloc': 81}, {'timestamp': 1541204121.0, 'added_lines': 3, 'deleted_lines': 3, 'nloc': 81}, {'timestamp': 1547003974.0, 'added_lines': 2, 'deleted_lines': 2, 'nloc': 81}, {'timestamp': 1550507829.0, 'added_lines': 1, 'deleted_lines': 1, 'nloc': 81}, {'timestamp': 1551229859.0, 'added_lines': 2, 'deleted_lines': 2, 'nloc': 81}, {'timestamp': 1551551196.0, 'added_lines': 5, 'deleted_lines': 5, 'nloc': 81}, {'timestamp': 1553871352.0, 'added_lines': 3, 'deleted_lines': 3, 'nloc': 81}, {'timestamp': 1552609298.0, 'added_lines': 13, 'deleted_lines': 1, 'nloc': 88}, {'timestamp': 1587221101.0, 'added_lines': 1, 'deleted_lines': 1, 'nloc': 88}, {'timestamp': 1597895573.0, 'added_lines': 1, 'deleted_lines': 1, 'nloc': 88}]","{'assets/assets.go': 11, 'blocks/blockstore/arc_cache.go': 2, 'blocks/blockstore/arc_cache_test.go': 2, 'blocks/blockstore/blockstore.go': 3, 'blocks/blockstore/blockstore_test.go': 2, 'blocks/blockstore/bloom_cache.go': 2, 'blocks/blockstore/bloom_cache_test.go': 2, 'blocks/blockstore/util/remove.go': 2, 'blocks/blocksutil/block_generator.go': 2, 'blockservice/blockservice.go': 6, 'blockservice/blockservice_test.go': 5, 'blockservice/test/blocks_test.go': 5, 'cmd/ipfs/daemon.go': 20, 'cmd/ipfs/init.go': 12, 'cmd/ipfs/ipfs.go': 11, 'cmd/ipfs/main.go': 16, 'cmd/ipfs/main_test.go': 1, 'cmd/ipfswatch/main.go': 9, 'cmd/seccat/seccat.go': 16, 'commands/command.go': 9, 'commands/command_test.go': 3, 'commands/request.go': 10, 'commands/response.go': 4, 'commands/response_test.go': 3, 'core/bootstrap.go': 15, 'core/bootstrap_test.go': 15, 'core/builder.go': 17, 'core/commands/active.go': 4, 'core/commands/add.go': 12, 'core/commands/bitswap.go': 14, 'core/commands/block.go': 12, 'core/commands/bootstrap.go': 9, 'core/commands/cat.go': 12, 'core/commands/commands.go': 12, 'core/commands/config.go': 9, 'core/commands/dag/dag.go': 13, 'core/commands/dht.go': 15, 'core/commands/dht_test.go': 14, 'core/commands/diag.go': 4, 'core/commands/dns.go': 6, 'core/commands/external.go': 4, 'core/commands/files/files.go': 3, 'core/commands/filestore.go': 11, 'core/commands/get.go': 15, 'core/commands/get_test.go': 11, 'core/commands/helptext_test.go': 11, 'core/commands/id.go': 15, 'core/commands/ipns.go': 6, 'core/commands/ipnsps.go': 4, 'core/commands/keystore.go': 12, 'core/commands/log.go': 10, 'core/commands/ls.go': 13, 'core/commands/mount_nofuse.go': 4, 'core/commands/mount_unix.go': 9, 'core/commands/mount_windows.go': 4, 'core/commands/name.go': 2, 'core/commands/object/diff.go': 6, 'core/commands/object/object.go': 13, 'core/commands/object/patch.go': 11, 'core/commands/p2p.go': 11, 'core/commands/pin.go': 14, 'core/commands/ping.go': 15, 'core/commands/publish.go': 7, 'core/commands/pubsub.go': 13, 'core/commands/refs.go': 11, 'core/commands/repo.go': 14, 'core/commands/resolve.go': 10, 'core/commands/root.go': 11, 'core/commands/shutdown.go': 8, 'core/commands/stat.go': 14, 'core/commands/swarm.go': 16, 'core/commands/sysdiag.go': 12, 'core/commands/tar.go': 10, 'core/commands/unixfs/ls.go': 10, 'core/commands/unixfs/unixfs.go': 4, 'core/commands/version.go': 5, 'core/core.go': 17, 'core/coreapi/coreapi.go': 9, 'core/coreapi/interface/interface.go': 2, 'core/coreapi/unixfs.go': 11, 'core/coreapi/unixfs_test.go': 10, 'core/coredag/cbor.go': 6, 'core/coredag/dagpb.go': 11, 'core/coredag/dagtransl.go': 5, 'core/coredag/raw.go': 11, 'core/corehttp/commands.go': 14, 'core/corehttp/gateway.go': 15, 'core/corehttp/gateway_handler.go': 17, 'core/corehttp/gateway_test.go': 16, 'core/corehttp/metrics_test.go': 16, 'core/corerepo/gc.go': 14, 'core/corerepo/pinning.go': 6, 'core/coreunix/add.go': 14, 'core/coreunix/add_test.go': 14, 'core/coreunix/metadata.go': 11, 'core/coreunix/metadata_test.go': 13, 'core/mock/mock.go': 16, 'core/pathresolver.go': 14, 'exchange/bitswap/bitswap.go': 6, 'exchange/bitswap/bitswap_test.go': 7, 'exchange/bitswap/decision/bench_test.go': 6, 'exchange/bitswap/decision/engine.go': 6, 'exchange/bitswap/decision/engine_test.go': 6, 'exchange/bitswap/decision/ledger.go': 6, 'exchange/bitswap/decision/peer_request_queue.go': 6, 'exchange/bitswap/decision/peer_request_queue_test.go': 6, 'exchange/bitswap/get.go': 5, 'exchange/bitswap/message/message.go': 7, 'exchange/bitswap/message/message_test.go': 3, 'exchange/bitswap/network/interface.go': 7, 'exchange/bitswap/network/ipfs_impl.go': 8, 'exchange/bitswap/notifications/notifications.go': 3, 'exchange/bitswap/notifications/notifications_test.go': 3, 'exchange/bitswap/session.go': 6, 'exchange/bitswap/session_test.go': 5, 'exchange/bitswap/stat.go': 3, 'exchange/bitswap/testnet/interface.go': 6, 'exchange/bitswap/testnet/network_test.go': 7, 'exchange/bitswap/testnet/peernet.go': 7, 'exchange/bitswap/testnet/virtual.go': 7, 'exchange/bitswap/testutils.go': 7, 'exchange/bitswap/wantlist/wantlist.go': 3, 'exchange/bitswap/wantlist/wantlist_test.go': 3, 'exchange/bitswap/wantmanager.go': 6, 'exchange/bitswap/workers.go': 6, 'exchange/interface.go': 2, 'exchange/offline/offline.go': 2, 'exchange/offline/offline_test.go': 2, 'exchange/reprovide/providers.go': 13, 'exchange/reprovide/reprovide.go': 15, 'exchange/reprovide/reprovide_test.go': 15, 'filestore/filestore.go': 11, 'filestore/filestore_test.go': 13, 'filestore/fsrefstore.go': 10, 'filestore/util.go': 10, 'fuse/ipns/ipns_test.go': 16, 'fuse/ipns/ipns_unix.go': 14, 'fuse/node/mount_test.go': 15, 'fuse/readonly/ipfs_test.go': 14, 'fuse/readonly/readonly_unix.go': 15, 'importer/balanced/balanced_test.go': 5, 'importer/balanced/builder.go': 3, 'importer/chunk/rabin_test.go': 2, 'importer/chunk/splitting_test.go': 2, 'importer/helpers/dagbuilder.go': 5, 'importer/helpers/helpers.go': 3, 'importer/importer.go': 5, 'importer/importer_test.go': 5, 'importer/trickle/trickle_test.go': 5, 'importer/trickle/trickledag.go': 3, 'merkledag/batch.go': 2, 'merkledag/coding.go': 3, 'merkledag/merkledag.go': 3, 'merkledag/merkledag_test.go': 5, 'merkledag/node.go': 3, 'merkledag/node_test.go': 3, 'merkledag/raw.go': 3, 'merkledag/traverse/traverse.go': 3, 'merkledag/traverse/traverse_test.go': 3, 'merkledag/utils/diff.go': 3, 'merkledag/utils/diffenum.go': 3, 'merkledag/utils/diffenum_test.go': 3, 'merkledag/utils/utils.go': 5, 'merkledag/utils/utils_test.go': 3, 'mfs/dir.go': 4, 'mfs/file.go': 6, 'mfs/mfs_test.go': 6, 'mfs/ops.go': 4, 'mfs/repub_test.go': 7, 'mfs/system.go': 7, 'namesys/ipns_select_test.go': 4, 'namesys/namesys.go': 17, 'namesys/publisher.go': 15, 'namesys/publisher_test.go': 15, 'namesys/pubsub.go': 4, 'namesys/pubsub_test.go': 4, 'namesys/republisher/repub.go': 14, 'namesys/republisher/repub_test.go': 16, 'namesys/resolve_test.go': 15, 'namesys/routing.go': 16, 'p2p/p2p.go': 15, 'p2p/registry.go': 8, 'package.json': 15, 'path/path.go': 3, 'path/resolver.go': 3, 'path/resolver_test.go': 2, 'pin/gc/gc.go': 14, 'pin/pin.go': 14, 'pin/pin_test.go': 13, 'pin/set.go': 11, 'pin/set_test.go': 13, 'plugin/ipld.go': 5, 'plugin/loader/initializer.go': 4, 'plugin/plugins/git/git.go': 5, 'repo/config/bootstrap_peers.go': 8, 'repo/config/init.go': 7, 'repo/fsrepo/fsrepo.go': 14, 'repo/fsrepo/lock/lock.go': 3, 'repo/fsrepo/serialize/serialize.go': 3, 'repo/mock.go': 11, 'repo/repo.go': 12, 'routing/mock/centralized_client.go': 3, 'routing/mock/centralized_server.go': 3, 'routing/mock/centralized_test.go': 3, 'routing/mock/interface.go': 3, 'routing/none/none_client.go': 3, 'routing/offline/offline.go': 3, 'routing/offline/offline_test.go': 3, 'tar/format.go': 14, 'test/dependencies/ma-pipe-unidir/main.go': 10, 'test/integration/addcat_test.go': 15, 'test/integration/bench_cat_test.go': 15, 'test/integration/bench_test.go': 14, 'test/integration/bitswap_wo_routing_test.go': 15, 'test/integration/three_legged_cat_test.go': 15, 'thirdparty/ds-help/key.go': 2, 'thirdparty/pollEndpoint/main.go': 15, 'thirdparty/posinfo/posinfo.go': 2, 'unixfs/archive/archive.go': 3, 'unixfs/archive/tar/writer.go': 3, 'unixfs/hamt/hamt.go': 3, 'unixfs/io/dagreader.go': 3, 'unixfs/io/dirbuilder.go': 3, 'unixfs/io/resolve.go': 3, 'unixfs/mod/dagmodifier.go': 5, 'unixfs/mod/dagmodifier_test.go': 3, 'unixfs/test/utils.go': 5, 'commands/legacy/command.go': 8, 'commands/legacy/legacy.go': 8, 'commands/legacy/legacy_test.go': 8, 'commands/legacy/request.go': 8, 'commands/legacy/response.go': 8, 'core/commands/commands_test.go': 10, 'core/coreapi/dag.go': 4, 'core/coreapi/dag_test.go': 3, 'core/coreapi/interface/options/dag.go': 3, 'core/coreapi/key.go': 13, 'core/coreapi/name.go': 14, 'merkledag/test/utils.go': 4, 'namesys/namesys_test.go': 14, 'repo/fsrepo/datastores.go': 10, 'repo/fsrepo/fsrepo_test.go': 9, 'thirdparty/datastore2/datastore_closer.go': 1, 'thirdparty/datastore2/delayed.go': 1, 'thirdparty/datastore2/threadsafe.go': 1, 'unixfs/io/pbdagreader.go': 2, 'cmd/ipfs/util/ulimit.go': 10, 'cmd/seccat/util.go': 10, 'core/corehttp/logs.go': 9, 'fuse/mount/mount.go': 9, 'fuse/node/mount_unix.go': 9, 'importer/chunk/splitting.go': 1, 'namesys/ipns_validate_test.go': 4, 'plugin/loader/load.go': 7, 'blocks/blockstoreutil/remove.go': 9, 'blockservice/test/mock.go': 4, 'core/commands/files.go': 12, 'core/core_test.go': 8, 'core/coreapi/pin.go': 11, 'fuse/ipns/common.go': 9, 'keystore/keystore.go': 9, 'keystore/keystore_test.go': 6, 'keystore/memkeystore.go': 6, 'namesys/interface.go': 9, 'namesys/validator.go': 3, 'path/resolver/resolver.go': 3, 'repo/config/identity.go': 2, 'thirdparty/verifbs/verifbs.go': 8, 'cmd/ipfs/util/ulimit_freebsd.go': 2, 'cmd/ipfs/util/ulimit_unix.go': 2, 'core/coreapi/block.go': 5, 'core/coreapi/block_test.go': 2, 'core/coreapi/interface/coreapi.go': 2, 'core/coreapi/interface/dag.go': 2, 'core/coreapi/interface/object.go': 2, 'core/coreapi/interface/options/block.go': 2, 'core/coreapi/interface/path.go': 6, 'core/coreapi/interface/unixfs.go': 2, 'core/coreapi/object.go': 9, 'fuse/ipns/link_unix.go': 2, 'fuse/mount/fuse.go': 2, 'fuse/node/mount_darwin.go': 3, 'merkledag/errservice.go': 1, 'merkledag/readonly.go': 1, 'merkledag/readonly_test.go': 1, 'merkledag/rwservice.go': 1, 'merkledag/session.go': 1, 'path/resolver/resolver_test.go': 1, 'thirdparty/verifcid/validate.go': 1, 'thirdparty/verifcid/validate_test.go': 1, 'unixfs/hamt/hamt_stress_test.go': 1, 'unixfs/hamt/hamt_test.go': 1, 'namesys/ipns_resolver_validation_test.go': 9, 'test/sharness/t0170-dht.sh': 1, 'test/sharness/t0023-shutdown.sh': 1, 'core/commands/env.go': 1, 'core/commands/urlstore.go': 8, 'core/coreapi/interface/key.go': 4, 'core/coreapi/name_test.go': 4, 'core/coreapi/path.go': 8, 'core/coreunix/cat.go': 2, 'core/pathresolver_test.go': 8, 'dagutils/diff.go': 8, 'dagutils/diffenum.go': 8, 'dagutils/diffenum_test.go': 8, 'dagutils/utils.go': 8, 'dagutils/utils_test.go': 8, 'filestore/pb/dataobj.pb.go': 3, 'mfs/fd.go': 1, 'namesys/base.go': 8, 'namesys/cache.go': 8, 'namesys/dns.go': 8, 'namesys/proquint.go': 8, 'pin/internal/pb/header.pb.go': 3, 'thirdparty/cidv0v1/blockstore.go': 5, 'core/commands/cmdenv/env.go': 7, 'core/commands/name/ipns.go': 7, 'core/commands/name/ipnsps.go': 6, 'core/commands/name/name.go': 4, 'core/commands/name/publish.go': 5, 'core/coreapi/dht.go': 7, 'core/coreapi/dht_test.go': 3, 'core/coreapi/interface/dht.go': 4, 'p2p/listener.go': 7, 'p2p/local.go': 8, 'p2p/remote.go': 8, 'p2p/stream.go': 8, 'repo/fsrepo/config_test.go': 7, 'repo/fsrepo/misc.go': 7, 'test/bench/bench_cli_ipfs_add/main.go': 7, 'test/bench/offline_add/main.go': 7, 'cmd/ipfs/dnsresolve_test.go': 5, 'core/coreapi/interface/options/unixfs.go': 3, 'core/coreapi/interface/pubsub.go': 2, 'core/coreapi/interface/swarm.go': 3, 'core/coreapi/pubsub.go': 6, 'core/coreapi/swarm.go': 6, 'core/coreapi/unixfile.go': 3, 'core/commands/cid.go': 4, 'test/dependencies/iptb/iptb.go': 5, 'commands/context.go': 4, 'core/coreapi/interface/tests/name.go': 1, 'core/coreapi/interface/tests/unixfs.go': 1, 'core/coreapi/test/api_test.go': 4, 'core/corehttp/proxy.go': 4, 'core/commands/cmdenv/cidbase.go': 2, 'core/corehttp/ipns_hostname.go': 3, 'namesys/dns_test.go': 3, 'plugin/daemon.go': 3, 'plugin/loader/loader.go': 3, 'plugin/plugins/badgerds/badgerds.go': 2, 'plugin/plugins/flatfs/flatfs.go': 2, 'plugin/plugins/levelds/levelds.go': 2, 'core/commands/cmdenv/cidbase_test.go': 1, 'core/commands/cmdenv/file.go': 1, 'core/corehttp/metrics.go': 1, 'core/corehttp/proxy_test.go': 1, 'core/corerepo/stat.go': 1, 'plugin/tracer.go': 1, 'thirdparty/notifier/notifier.go': 2, 'core/ncore.go': 1, 'fuse/ipns/mount_unix.go': 1, 'fuse/readonly/mount_unix.go': 1, 'core/corehttp/hostname.go': 1, 'core/corehttp/hostname_test.go': 1, None: 1, 'docs/config.md': 2, 'docs/environment-variables.md': 2, 'go.mod': 2, 'go.sum': 2, 'test/sharness/t0111-gateway-writeable.sh': 1, 'test/sharness/t0114-gateway-subdomains.sh': 2, 'test/sharness/t0160-resolve.sh': 1, 'test/sharness/t0184-http-proxy-over-p2p.sh': 1, 'CHANGELOG.md': 1, 'Dockerfile': 1, 'README.md': 1, 'bin/check_go_version': 1, 'coverage/Rules.mk': 1, 'docs/debug-guide.md': 1, 'gc/gc.go': 1, 'keystore/memkeystore_test.go': 1, 'misc/completion/ipfs-completion.bash': 1, 'plugin/plugins/gen_main.sh': 1, 'repo/fsrepo/migrations/migrations.go': 1, 'repo/onlyone.go': 1, 'test/3nodetest/run-test-on-img.sh': 1, 'test/ipfs-test-lib.sh': 1, 'test/sharness/README.md': 1, 'test/sharness/lib/iptb-lib.sh': 1, 'test/sharness/t0010-basic-commands.sh': 1, 'test/sharness/t0020-init.sh': 1, 'test/sharness/t0030-mount.sh': 1, 'test/sharness/t0031-mount-publish.sh': 1, 'test/sharness/t0040-add-and-cat.sh': 1, 'test/sharness/t0050-block.sh': 1, 'test/sharness/t0051-object.sh': 1, 'test/sharness/t0053-dag.sh': 1, 'test/sharness/t0060-daemon.sh': 1, 'test/sharness/t0062-daemon-api.sh': 1, 'test/sharness/t0080-repo.sh': 1, 'test/sharness/t0087-repo-robust-gc.sh': 1, 'test/sharness/t0090-get.sh': 1, 'test/sharness/t0110-gateway.sh': 1, 'test/sharness/t0131-multinode-client-routing.sh': 1, 'test/sharness/t0140-swarm.sh': 1, 'test/sharness/t0183-namesys-pubsub.sh': 1, 'test/sharness/t0250-files-api.sh': 1, 'test/sharness/t0270-filestore.sh': 1, 'test/sharness/t0272-urlstore.sh': 1, 'test/sharness/t0410-api-add.sh': 1, 'test/sharness/t0600-issues-and-regressions-online.sh': 1, 'test/sharness_test_coverage_helper.sh': 1, 'thirdparty/README.md': 1}","('cmd/ipfs/daemon.go', 0.9523809523809523, 0.13071895424836602)"
core/corehttp/gateway.go,42,258,5,"[{'cyclomatic_complexity': 3, 'nloc': 15, 'token_count': 110, 'name': '', 'long_name': '(n*core.IpfsNode,_net.Listener,mux*http.ServeMux)(*http.ServeMux,error)', 'start_line': 21, 'end_line': 37, 'full_parameters': [], 'filename': '/home/dimi/Documents/Informatik_Studium/FSS/SoftEvo/DataCollection/FFS_SoftEvo/go-ipfs/core/corehttp/gateway.go', 'top_nesting_level': 0, 'length': 17, 'fan_in': 0, 'fan_out': 0, 'general_fan_out': 0}, {'cyclomatic_complexity': 1, 'nloc': 3, 'token_count': 15, 'name': 'GatewayOption', 'long_name': 'GatewayOption writable bool , paths ... string', 'start_line': 20, 'end_line': 38, 'full_parameters': ['writable bool', ' paths ... string'], 'filename': '/home/dimi/Documents/Informatik_Studium/FSS/SoftEvo/DataCollection/FFS_SoftEvo/go-ipfs/core/corehttp/gateway.go', 'top_nesting_level': 0, 'length': 19, 'fan_in': 0, 'fan_out': 0, 'general_fan_out': 0}, {'cyclomatic_complexity': 1, 'nloc': 5, 'token_count': 51, 'name': '', 'long_name': '(w http.ResponseWriter,r*http.Request)', 'start_line': 42, 'end_line': 46, 'full_parameters': [], 'filename': '/home/dimi/Documents/Informatik_Studium/FSS/SoftEvo/DataCollection/FFS_SoftEvo/go-ipfs/core/corehttp/gateway.go', 'top_nesting_level': 0, 'length': 5, 'fan_in': 0, 'fan_out': 0, 'general_fan_out': 0}, {'cyclomatic_complexity': 1, 'nloc': 4, 'token_count': 41, 'name': '', 'long_name': '(_*core.IpfsNode,_net.Listener,mux*http.ServeMux)(*http.ServeMux,error)', 'start_line': 41, 'end_line': 48, 'full_parameters': [], 'filename': '/home/dimi/Documents/Informatik_Studium/FSS/SoftEvo/DataCollection/FFS_SoftEvo/go-ipfs/core/corehttp/gateway.go', 'top_nesting_level': 0, 'length': 8, 'fan_in': 0, 'fan_out': 0, 'general_fan_out': 0}, {'cyclomatic_complexity': 1, 'nloc': 3, 'token_count': 9, 'name': 'VersionOption', 'long_name': 'VersionOption', 'start_line': 40, 'end_line': 49, 'full_parameters': [], 'filename': '/home/dimi/Documents/Informatik_Studium/FSS/SoftEvo/DataCollection/FFS_SoftEvo/go-ipfs/core/corehttp/gateway.go', 'top_nesting_level': 0, 'length': 10, 'fan_in': 0, 'fan_out': 0, 'general_fan_out': 0}]",87,549,6,"[{'cyclomatic_complexity': 3, 'nloc': 12, 'token_count': 92, 'name': 'cleanHeaderSet', 'long_name': 'cleanHeaderSet headers [ ] string', 'start_line': 27, 'end_line': 41, 'full_parameters': ['headers [ ] string'], 'filename': '/home/dimi/Documents/Informatik_Studium/FSS/SoftEvo/DataCollection/FFS_SoftEvo/go-ipfs/core/corehttp/gateway.go', 'top_nesting_level': 0, 'length': 15, 'fan_in': 0, 'fan_out': 0, 'general_fan_out': 0}, {'cyclomatic_complexity': 7, 'nloc': 46, 'token_count': 304, 'name': '', 'long_name': '(n*core.IpfsNode,_net.Listener,mux*http.ServeMux)(*http.ServeMux,error)', 'start_line': 44, 'end_line': 100, 'full_parameters': [], 'filename': '/home/dimi/Documents/Informatik_Studium/FSS/SoftEvo/DataCollection/FFS_SoftEvo/go-ipfs/core/corehttp/gateway.go', 'top_nesting_level': 0, 'length': 57, 'fan_in': 0, 'fan_out': 0, 'general_fan_out': 0}, {'cyclomatic_complexity': 1, 'nloc': 3, 'token_count': 15, 'name': 'GatewayOption', 'long_name': 'GatewayOption writable bool , paths ... string', 'start_line': 43, 'end_line': 101, 'full_parameters': ['writable bool', ' paths ... string'], 'filename': '/home/dimi/Documents/Informatik_Studium/FSS/SoftEvo/DataCollection/FFS_SoftEvo/go-ipfs/core/corehttp/gateway.go', 'top_nesting_level': 0, 'length': 59, 'fan_in': 0, 'fan_out': 0, 'general_fan_out': 0}, {'cyclomatic_complexity': 1, 'nloc': 5, 'token_count': 53, 'name': '', 'long_name': '(w http.ResponseWriter,r*http.Request)', 'start_line': 105, 'end_line': 109, 'full_parameters': [], 'filename': '/home/dimi/Documents/Informatik_Studium/FSS/SoftEvo/DataCollection/FFS_SoftEvo/go-ipfs/core/corehttp/gateway.go', 'top_nesting_level': 0, 'length': 5, 'fan_in': 0, 'fan_out': 0, 'general_fan_out': 0}, {'cyclomatic_complexity': 1, 'nloc': 4, 'token_count': 41, 'name': '', 'long_name': '(_*core.IpfsNode,_net.Listener,mux*http.ServeMux)(*http.ServeMux,error)', 'start_line': 104, 'end_line': 111, 'full_parameters': [], 'filename': '/home/dimi/Documents/Informatik_Studium/FSS/SoftEvo/DataCollection/FFS_SoftEvo/go-ipfs/core/corehttp/gateway.go', 'top_nesting_level': 0, 'length': 8, 'fan_in': 0, 'fan_out': 0, 'general_fan_out': 0}, {'cyclomatic_complexity': 1, 'nloc': 3, 'token_count': 9, 'name': 'VersionOption', 'long_name': 'VersionOption', 'start_line': 103, 'end_line': 112, 'full_parameters': [], 'filename': '/home/dimi/Documents/Informatik_Studium/FSS/SoftEvo/DataCollection/FFS_SoftEvo/go-ipfs/core/corehttp/gateway.go', 'top_nesting_level': 0, 'length': 10, 'fan_in': 0, 'fan_out': 0, 'general_fan_out': 0}]",45,291,1,56,56,"[{'timestamp': 1507304579.0, 'added_lines': 1, 'deleted_lines': 1, 'nloc': 42}, {'timestamp': 1508424715.0, 'added_lines': 1, 'deleted_lines': 1, 'nloc': 42}, {'timestamp': 1491058697.0, 'added_lines': 1, 'deleted_lines': 0, 'nloc': 42}, {'timestamp': 1511223906.0, 'added_lines': 1, 'deleted_lines': 1, 'nloc': 42}, {'timestamp': 1512365669.0, 'added_lines': 1, 'deleted_lines': 1, 'nloc': 42}, {'timestamp': 1516838128.0, 'added_lines': 1, 'deleted_lines': 1, 'nloc': 42}, {'timestamp': 1517105039.0, 'added_lines': 1, 'deleted_lines': 1, 'nloc': 42}, {'timestamp': 1517453697.0, 'added_lines': 1, 'deleted_lines': 1, 'nloc': 42}, {'timestamp': 1525408792.0, 'added_lines': 1, 'deleted_lines': 1, 'nloc': 42}, {'timestamp': 1528131220.0, 'added_lines': 1, 'deleted_lines': 1, 'nloc': 42}, {'timestamp': 1528268108.0, 'added_lines': 1, 'deleted_lines': 1, 'nloc': 42}, {'timestamp': 1528520460.0, 'added_lines': 1, 'deleted_lines': 1, 'nloc': 42}, {'timestamp': 1529984485.0, 'added_lines': 1, 'deleted_lines': 1, 'nloc': 42}, {'timestamp': 1532146078.0, 'added_lines': 1, 'deleted_lines': 1, 'nloc': 42}, {'timestamp': 1533779477.0, 'added_lines': 1, 'deleted_lines': 1, 'nloc': 42}, {'timestamp': 1532357069.0, 'added_lines': 1, 'deleted_lines': 1, 'nloc': 42}, {'timestamp': 1532365899.0, 'added_lines': 2, 'deleted_lines': 2, 'nloc': 42}, {'timestamp': 1532507240.0, 'added_lines': 2, 'deleted_lines': 2, 'nloc': 42}, {'timestamp': 1534896611.0, 'added_lines': 1, 'deleted_lines': 1, 'nloc': 42}, {'timestamp': 1535601896.0, 'added_lines': 1, 'deleted_lines': 1, 'nloc': 42}, {'timestamp': 1536388808.0, 'added_lines': 1, 'deleted_lines': 1, 'nloc': 42}, {'timestamp': 1537792589.0, 'added_lines': 1, 'deleted_lines': 1, 'nloc': 42}, {'timestamp': 1538544957.0, 'added_lines': 1, 'deleted_lines': 1, 'nloc': 42}, {'timestamp': 1538695953.0, 'added_lines': 1, 'deleted_lines': 1, 'nloc': 42}, {'timestamp': 1538773916.0, 'added_lines': 1, 'deleted_lines': 1, 'nloc': 42}, {'timestamp': 1539176817.0, 'added_lines': 1, 'deleted_lines': 1, 'nloc': 42}, {'timestamp': 1539357340.0, 'added_lines': 1, 'deleted_lines': 1, 'nloc': 42}, {'timestamp': 1540400358.0, 'added_lines': 1, 'deleted_lines': 1, 'nloc': 42}, {'timestamp': 1540410565.0, 'added_lines': 1, 'deleted_lines': 1, 'nloc': 42}, {'timestamp': 1540418491.0, 'added_lines': 1, 'deleted_lines': 1, 'nloc': 42}, {'timestamp': 1541204121.0, 'added_lines': 1, 'deleted_lines': 1, 'nloc': 42}, {'timestamp': 1541903826.0, 'added_lines': 1, 'deleted_lines': 1, 'nloc': 42}, {'timestamp': 1544225843.0, 'added_lines': 1, 'deleted_lines': 1, 'nloc': 42}, {'timestamp': 1544131548.0, 'added_lines': 6, 'deleted_lines': 1, 'nloc': 46}, {'timestamp': 1540513708.0, 'added_lines': 2, 'deleted_lines': 1, 'nloc': 47}, {'timestamp': 1546565740.0, 'added_lines': 1, 'deleted_lines': 1, 'nloc': 47}, {'timestamp': 1546613768.0, 'added_lines': 1, 'deleted_lines': 1, 'nloc': 47}, {'timestamp': 1546632537.0, 'added_lines': 57, 'deleted_lines': 1, 'nloc': 86}, {'timestamp': 1546635631.0, 'added_lines': 1, 'deleted_lines': 1, 'nloc': 86}, {'timestamp': 1547003974.0, 'added_lines': 1, 'deleted_lines': 1, 'nloc': 87}, {'timestamp': 1549588289.0, 'added_lines': 1, 'deleted_lines': 1, 'nloc': 87}, {'timestamp': 1549672857.0, 'added_lines': 1, 'deleted_lines': 1, 'nloc': 87}, {'timestamp': 1549673846.0, 'added_lines': 1, 'deleted_lines': 1, 'nloc': 87}, {'timestamp': 1549903582.0, 'added_lines': 1, 'deleted_lines': 1, 'nloc': 87}, {'timestamp': 1550185115.0, 'added_lines': 2, 'deleted_lines': 2, 'nloc': 87}, {'timestamp': 1550507829.0, 'added_lines': 2, 'deleted_lines': 2, 'nloc': 87}, {'timestamp': 1550576884.0, 'added_lines': 1, 'deleted_lines': 1, 'nloc': 87}, {'timestamp': 1550711994.0, 'added_lines': 1, 'deleted_lines': 1, 'nloc': 87}, {'timestamp': 1550723346.0, 'added_lines': 2, 'deleted_lines': 2, 'nloc': 87}, {'timestamp': 1551229859.0, 'added_lines': 2, 'deleted_lines': 2, 'nloc': 87}, {'timestamp': 1551299964.0, 'added_lines': 2, 'deleted_lines': 2, 'nloc': 87}, {'timestamp': 1551551196.0, 'added_lines': 2, 'deleted_lines': 2, 'nloc': 87}, {'timestamp': 1564101035.0, 'added_lines': 1, 'deleted_lines': 1, 'nloc': 87}, {'timestamp': 1569537492.0, 'added_lines': 1, 'deleted_lines': 1, 'nloc': 87}, {'timestamp': 1551228784.0, 'added_lines': 1, 'deleted_lines': 1, 'nloc': 87}, {'timestamp': 1632249068.0, 'added_lines': 1, 'deleted_lines': 1, 'nloc': 87}]","{'core/bootstrap.go': 31, 'core/bootstrap_test.go': 27, 'core/commands/dht.go': 39, 'core/commands/dht_test.go': 24, 'core/commands/id.go': 41, 'core/commands/pubsub.go': 33, 'core/core.go': 43, 'core/corehttp/gateway_test.go': 47, 'core/corehttp/metrics_test.go': 37, 'core/mock/mock.go': 38, 'exchange/bitswap/bitswap_test.go': 14, 'exchange/bitswap/decision/bench_test.go': 8, 'exchange/bitswap/decision/engine_test.go': 10, 'exchange/bitswap/decision/peer_request_queue_test.go': 8, 'exchange/bitswap/network/ipfs_impl.go': 10, 'exchange/bitswap/testnet/interface.go': 8, 'exchange/bitswap/testnet/network_test.go': 11, 'exchange/bitswap/testnet/peernet.go': 14, 'exchange/bitswap/testnet/virtual.go': 10, 'exchange/bitswap/testutils.go': 13, 'exchange/reprovide/reprovide_test.go': 30, 'fuse/ipns/ipns_test.go': 27, 'fuse/node/mount_test.go': 28, 'fuse/readonly/ipfs_test.go': 38, 'mfs/repub_test.go': 10, 'namesys/publisher_test.go': 28, 'namesys/republisher/repub_test.go': 39, 'namesys/resolve_test.go': 36, 'p2p/p2p.go': 27, 'package.json': 42, 'routing/mock/centralized_client.go': 5, 'routing/mock/centralized_server.go': 5, 'routing/mock/centralized_test.go': 5, 'routing/mock/interface.go': 5, 'routing/none/none_client.go': 5, 'routing/offline/offline_test.go': 6, 'test/integration/addcat_test.go': 40, 'test/integration/bench_cat_test.go': 40, 'test/integration/bench_test.go': 19, 'test/integration/bitswap_wo_routing_test.go': 38, 'test/integration/three_legged_cat_test.go': 40, 'thirdparty/ipfsaddr/ipfsaddr.go': 2, 'core/commands/swarm.go': 37, 'blocks/blockstore/caching.go': 1, 'blocks/blockstore/util/remove.go': 3, 'cmd/ipfs/daemon.go': 23, 'cmd/ipfs/init.go': 24, 'cmd/ipfs/ipfs.go': 17, 'cmd/ipfs/main.go': 28, 'cmd/ipfs/main_test.go': 3, 'cmd/ipfswatch/main.go': 20, 'cmd/seccat/seccat.go': 27, None: 12, 'commands/channelmarshaler.go': 1, 'commands/cli/cmd_suggestion.go': 1, 'commands/cli/helptext.go': 2, 'commands/cli/helptext_test.go': 2, 'commands/cli/parse.go': 2, 'commands/cli/parse_test.go': 2, 'commands/command.go': 13, 'commands/command_test.go': 6, 'commands/http/client.go': 2, 'commands/http/handler.go': 2, 'commands/http/multifilereader.go': 2, 'commands/http/multifilereader_test.go': 2, 'commands/http/parse.go': 2, 'commands/reqlog.go': 1, 'commands/request.go': 19, 'commands/response.go': 8, 'commands/response_test.go': 6, 'core/commands/active.go': 9, 'core/commands/add.go': 29, 'core/commands/bitswap.go': 35, 'core/commands/block.go': 24, 'core/commands/bootstrap.go': 21, 'core/commands/cat.go': 24, 'core/commands/commands.go': 17, 'core/commands/config.go': 21, 'core/commands/dag/dag.go': 35, 'core/commands/diag.go': 9, 'core/commands/dns.go': 16, 'core/commands/e/error.go': 1, 'core/commands/external.go': 9, 'core/commands/files/files.go': 5, 'core/commands/filestore.go': 18, 'core/commands/get.go': 37, 'core/commands/helptext_test.go': 17, 'core/commands/ipns.go': 10, 'core/commands/keystore.go': 23, 'core/commands/log.go': 15, 'core/commands/ls.go': 36, 'core/commands/mount_nofuse.go': 9, 'core/commands/mount_unix.go': 21, 'core/commands/mount_windows.go': 8, 'core/commands/name.go': 5, 'core/commands/object/diff.go': 17, 'core/commands/object/object.go': 36, 'core/commands/object/patch.go': 22, 'core/commands/p2p.go': 22, 'core/commands/pin.go': 37, 'core/commands/ping.go': 29, 'core/commands/publish.go': 10, 'core/commands/refs.go': 31, 'core/commands/repo.go': 31, 'core/commands/resolve.go': 33, 'core/commands/root.go': 17, 'core/commands/shutdown.go': 12, 'core/commands/stat.go': 22, 'core/commands/sysdiag.go': 19, 'core/commands/tar.go': 30, 'core/commands/unixfs/ls.go': 33, 'core/commands/unixfs/unixfs.go': 9, 'core/commands/version.go': 13, 'core/core_test.go': 18, 'core/corehttp/commands.go': 40, 'core/coreunix/add.go': 38, 'core/coreunix/add_test.go': 38, 'core/coreunix/metadata_test.go': 33, 'exchange/bitswap/message/message_test.go': 4, 'exchange/bitswap/message/pb/Makefile': 1, 'fuse/ipns/common.go': 28, 'importer/balanced/balanced_test.go': 6, 'importer/chunk/rabin_test.go': 3, 'importer/helpers/dagbuilder.go': 7, 'importer/importer.go': 7, 'merkledag/utils/utils_test.go': 4, 'namesys/dns.go': 30, 'namesys/interface.go': 31, 'namesys/ipns_select_test.go': 5, 'namesys/proquint.go': 30, 'repo/config/identity.go': 3, 'core/commands/get_test.go': 16, 'exchange/bitswap/message/message.go': 8, 'exchange/bitswap/network/interface.go': 8, 'p2p/registry.go': 12, 'repo/config/bootstrap_peers.go': 12, 'assets/assets.go': 31, 'blocks/blockstore/arc_cache.go': 2, 'blocks/blockstore/arc_cache_test.go': 2, 'blocks/blockstore/blockstore.go': 3, 'blocks/blockstore/blockstore_test.go': 2, 'blocks/blockstore/bloom_cache.go': 2, 'blocks/blockstore/bloom_cache_test.go': 2, 'blocks/blocksutil/block_generator.go': 2, 'blockservice/blockservice.go': 7, 'blockservice/blockservice_test.go': 6, 'blockservice/test/blocks_test.go': 6, 'core/builder.go': 36, 'core/commands/ipnsps.go': 5, 'core/coreapi/coreapi.go': 24, 'core/coreapi/interface/interface.go': 2, 'core/coreapi/unixfs.go': 32, 'core/coreapi/unixfs_test.go': 24, 'core/coredag/cbor.go': 10, 'core/coredag/dagpb.go': 28, 'core/coredag/dagtransl.go': 7, 'core/coredag/raw.go': 28, 'core/corehttp/corehttp.go': 15, 'core/corehttp/gateway_handler.go': 40, 'core/corerepo/gc.go': 32, 'core/corerepo/pinning.go': 9, 'core/coreunix/metadata.go': 29, 'core/pathresolver.go': 31, 'exchange/bitswap/bitswap.go': 7, 'exchange/bitswap/decision/engine.go': 7, 'exchange/bitswap/decision/ledger.go': 6, 'exchange/bitswap/decision/peer_request_queue.go': 6, 'exchange/bitswap/get.go': 6, 'exchange/bitswap/notifications/notifications.go': 3, 'exchange/bitswap/notifications/notifications_test.go': 3, 'exchange/bitswap/session.go': 7, 'exchange/bitswap/session_test.go': 5, 'exchange/bitswap/stat.go': 3, 'exchange/bitswap/wantlist/wantlist.go': 3, 'exchange/bitswap/wantlist/wantlist_test.go': 3, 'exchange/bitswap/wantmanager.go': 7, 'exchange/bitswap/workers.go': 6, 'exchange/interface.go': 2, 'exchange/offline/offline.go': 2, 'exchange/offline/offline_test.go': 2, 'exchange/reprovide/providers.go': 31, 'exchange/reprovide/reprovide.go': 24, 'filestore/filestore.go': 18, 'filestore/filestore_test.go': 31, 'filestore/fsrefstore.go': 17, 'filestore/util.go': 17, 'fuse/ipns/ipns_unix.go': 32, 'fuse/readonly/readonly_unix.go': 33, 'importer/balanced/builder.go': 3, 'importer/chunk/splitting_test.go': 2, 'importer/helpers/helpers.go': 3, 'importer/importer_test.go': 5, 'importer/trickle/trickle_test.go': 5, 'importer/trickle/trickledag.go': 3, 'merkledag/batch.go': 2, 'merkledag/coding.go': 3, 'merkledag/merkledag.go': 3, 'merkledag/merkledag_test.go': 6, 'merkledag/node.go': 3, 'merkledag/node_test.go': 3, 'merkledag/raw.go': 3, 'merkledag/traverse/traverse.go': 3, 'merkledag/traverse/traverse_test.go': 3, 'merkledag/utils/diff.go': 3, 'merkledag/utils/diffenum.go': 3, 'merkledag/utils/diffenum_test.go': 3, 'merkledag/utils/utils.go': 6, 'mfs/dir.go': 4, 'mfs/file.go': 6, 'mfs/mfs_test.go': 7, 'mfs/ops.go': 4, 'mfs/system.go': 7, 'namesys/namesys.go': 37, 'namesys/publisher.go': 34, 'namesys/pubsub.go': 5, 'namesys/pubsub_test.go': 5, 'namesys/republisher/repub.go': 31, 'namesys/routing.go': 38, 'path/path.go': 3, 'path/resolver.go': 3, 'path/resolver_test.go': 2, 'pin/gc/gc.go': 32, 'pin/pin.go': 31, 'pin/pin_test.go': 31, 'pin/set.go': 28, 'pin/set_test.go': 31, 'plugin/ipld.go': 7, 'plugin/loader/initializer.go': 5, 'plugin/plugins/git/git.go': 7, 'repo/config/init.go': 7, 'repo/fsrepo/fsrepo.go': 25, 'repo/fsrepo/lock/lock.go': 3, 'repo/fsrepo/serialize/serialize.go': 3, 'repo/mock.go': 19, 'repo/repo.go': 22, 'routing/offline/offline.go': 3, 'tar/format.go': 32, 'test/dependencies/ma-pipe-unidir/main.go': 10, 'thirdparty/ds-help/key.go': 2, 'thirdparty/pollEndpoint/main.go': 15, 'thirdparty/posinfo/posinfo.go': 2, 'unixfs/archive/archive.go': 3, 'unixfs/archive/tar/writer.go': 3, 'unixfs/hamt/hamt.go': 3, 'unixfs/io/dagreader.go': 3, 'unixfs/io/dirbuilder.go': 3, 'unixfs/io/resolve.go': 3, 'unixfs/mod/dagmodifier.go': 5, 'unixfs/mod/dagmodifier_test.go': 3, 'unixfs/test/utils.go': 5, 'commands/legacy/command.go': 10, 'commands/legacy/legacy.go': 10, 'commands/legacy/legacy_test.go': 10, 'commands/legacy/request.go': 10, 'commands/legacy/response.go': 10, 'core/commands/commands_test.go': 14, 'core/coreapi/dag.go': 6, 'core/coreapi/dag_test.go': 3, 'core/coreapi/interface/options/dag.go': 4, 'core/coreapi/key.go': 34, 'core/coreapi/name.go': 37, 'merkledag/test/utils.go': 5, 'namesys/namesys_test.go': 35, 'repo/fsrepo/datastores.go': 15, 'repo/fsrepo/fsrepo_test.go': 18, 'thirdparty/datastore2/datastore_closer.go': 1, 'thirdparty/datastore2/delayed.go': 1, 'thirdparty/datastore2/threadsafe.go': 1, 'unixfs/io/pbdagreader.go': 2, 'cmd/ipfs/util/ulimit.go': 9, 'cmd/seccat/util.go': 9, 'core/corehttp/logs.go': 9, 'fuse/mount/mount.go': 9, 'fuse/node/mount_unix.go': 9, 'importer/chunk/splitting.go': 1, 'namesys/ipns_validate_test.go': 5, 'plugin/loader/load.go': 7, 'blocks/blockstoreutil/remove.go': 15, 'blockservice/test/mock.go': 5, 'core/commands/files.go': 33, 'core/coreapi/pin.go': 33, 'keystore/keystore.go': 8, 'keystore/keystore_test.go': 5, 'keystore/memkeystore.go': 5, 'namesys/validator.go': 3, 'path/resolver/resolver.go': 3, 'thirdparty/verifbs/verifbs.go': 15, 'cmd/ipfs/util/ulimit_freebsd.go': 2, 'cmd/ipfs/util/ulimit_unix.go': 2, 'core/coreapi/block.go': 14, 'core/coreapi/block_test.go': 2, 'core/coreapi/interface/coreapi.go': 3, 'core/coreapi/interface/dag.go': 3, 'core/coreapi/interface/object.go': 3, 'core/coreapi/interface/options/block.go': 2, 'core/coreapi/interface/path.go': 20, 'core/coreapi/interface/unixfs.go': 4, 'core/coreapi/object.go': 30, 'fuse/ipns/link_unix.go': 2, 'fuse/mount/fuse.go': 2, 'fuse/node/mount_darwin.go': 2, 'merkledag/errservice.go': 1, 'merkledag/readonly.go': 1, 'merkledag/readonly_test.go': 1, 'merkledag/rwservice.go': 1, 'merkledag/session.go': 1, 'path/resolver/resolver_test.go': 1, 'thirdparty/verifcid/validate.go': 1, 'thirdparty/verifcid/validate_test.go': 1, 'unixfs/hamt/hamt_stress_test.go': 1, 'unixfs/hamt/hamt_test.go': 1, 'namesys/ipns_resolver_validation_test.go': 30, 'test/sharness/t0170-dht.sh': 1, 'core/corehttp/metrics.go': 2, 'core/commands/env.go': 4, 'core/commands/urlstore.go': 26, 'core/coreapi/interface/key.go': 7, 'core/coreapi/name_test.go': 16, 'core/coreapi/path.go': 29, 'core/coreunix/cat.go': 5, 'core/pathresolver_test.go': 25, 'dagutils/diff.go': 29, 'dagutils/diffenum.go': 25, 'dagutils/diffenum_test.go': 25, 'dagutils/utils.go': 25, 'dagutils/utils_test.go': 25, 'filestore/pb/dataobj.pb.go': 3, 'mfs/fd.go': 1, 'namesys/base.go': 29, 'namesys/cache.go': 25, 'pin/internal/pb/header.pb.go': 3, 'thirdparty/cidv0v1/blockstore.go': 11, 'repo/fsrepo/misc.go': 15, 'cmd/ipfs/Rules.mk': 1, 'core/corehttp/option_test.go': 3, 'docs/releases.md': 2, 'docs/windows.md': 2, 'repo/fsrepo/config_test.go': 14, 'repo/version.go': 1, 'test/bench/bench_cli_ipfs_add/main.go': 14, 'test/bench/offline_add/main.go': 14, 'version.go': 3, 'core/commands/cmdenv/env.go': 20, 'core/commands/name/ipns.go': 27, 'core/commands/name/publish.go': 16, 'core/commands/name/ipnsps.go': 10, 'core/commands/name/name.go': 6, 'core/coreapi/dht.go': 26, 'core/coreapi/dht_test.go': 4, 'core/coreapi/interface/dht.go': 10, 'p2p/listener.go': 13, 'p2p/local.go': 13, 'p2p/remote.go': 13, 'p2p/stream.go': 13, 'core/coreapi/interface/swarm.go': 9, 'core/coreapi/swarm.go': 23, 'core/coreapi/interface/options/unixfs.go': 11, 'core/coreapi/pubsub.go': 22, 'core/coreapi/unixfile.go': 11, 'cmd/ipfs/dnsresolve_test.go': 5, 'core/coreapi/interface/pubsub.go': 4, 'core/commands/cid.go': 6, 'test/dependencies/iptb/iptb.go': 12, 'plugin/plugins/badgerds/badgerds.go': 3, 'plugin/plugins/flatfs/flatfs.go': 3, 'plugin/plugins/levelds/levelds.go': 3, 'commands/context.go': 16, 'core/corehttp/proxy.go': 9, 'core/coreapi/interface/tests/path.go': 1, 'test/sharness/t0110-gateway.sh': 2, 'core/coreapi/interface/tests/name.go': 2, 'core/coreapi/interface/tests/unixfs.go': 2, 'core/coreapi/test/api_test.go': 13, 'core/corehttp/ipns_hostname.go': 11, 'namesys/dns_test.go': 10, 'plugin/daemon.go': 10, 'plugin/loader/loader.go': 11, 'core/commands/cmdenv/cidbase.go': 5, 'core/commands/cmdenv/file.go': 2, 'core/commands/cmdenv/cidbase_test.go': 2, 'core/corehttp/proxy_test.go': 2, 'core/corerepo/stat.go': 1, 'plugin/tracer.go': 1, 'thirdparty/notifier/notifier.go': 1, 'go.mod': 1, 'go.sum': 1, 'test/sharness/t0111-gateway-writeable.sh': 1, 'core/node/groups.go': 1, 'core/node/libp2p/libp2p.go': 2, 'repo/fsrepo/migrations/migrations.go': 1, 'test/sharness/t0026-id.sh': 1}","('core/corehttp/gateway_test.go', 0.8392857142857143, 0.42342342342342343)"
core/corehttp/gateway_handler.go,452,2988,7,"[{'cyclomatic_complexity': 1, 'nloc': 8, 'token_count': 41, 'name': 'newGatewayHandler', 'long_name': 'newGatewayHandler n * core . IpfsNode , c GatewayConfig , api coreiface . CoreAPI', 'start_line': 46, 'end_line': 53, 'full_parameters': ['n * core . IpfsNode', ' c GatewayConfig', ' api coreiface . CoreAPI'], 'filename': '/home/dimi/Documents/Informatik_Studium/FSS/SoftEvo/DataCollection/FFS_SoftEvo/go-ipfs/core/corehttp/gateway_handler.go', 'top_nesting_level': 0, 'length': 8, 'fan_in': 0, 'fan_out': 0, 'general_fan_out': 0}, {'cyclomatic_complexity': 1, 'nloc': 5, 'token_count': 40, 'name': 'newDagFromReader', 'long_name': '(i*gatewayHandler)newDagFromReader r io . Reader', 'start_line': 56, 'end_line': 62, 'full_parameters': ['r io . Reader'], 'filename': '/home/dimi/Documents/Informatik_Studium/FSS/SoftEvo/DataCollection/FFS_SoftEvo/go-ipfs/core/corehttp/gateway_handler.go', 'top_nesting_level': 0, 'length': 7, 'fan_in': 0, 'fan_out': 0, 'general_fan_out': 0}, {'cyclomatic_complexity': 3, 'nloc': 7, 'token_count': 25, 'name': '', 'long_name': '()', 'start_line': 72, 'end_line': 78, 'full_parameters': [], 'filename': '/home/dimi/Documents/Informatik_Studium/FSS/SoftEvo/DataCollection/FFS_SoftEvo/go-ipfs/core/corehttp/gateway_handler.go', 'top_nesting_level': 0, 'length': 7, 'fan_in': 0, 'fan_out': 0, 'general_fan_out': 0}, {'cyclomatic_complexity': 2, 'nloc': 7, 'token_count': 34, 'name': '', 'long_name': '()', 'start_line': 81, 'end_line': 87, 'full_parameters': [], 'filename': '/home/dimi/Documents/Informatik_Studium/FSS/SoftEvo/DataCollection/FFS_SoftEvo/go-ipfs/core/corehttp/gateway_handler.go', 'top_nesting_level': 0, 'length': 7, 'fan_in': 0, 'fan_out': 0, 'general_fan_out': 0}, {'cyclomatic_complexity': 10, 'nloc': 40, 'token_count': 237, 'name': 'ServeHTTP', 'long_name': '(i*gatewayHandler)ServeHTTP w http . ResponseWriter , r * http . Request', 'start_line': 65, 'end_line': 123, 'full_parameters': ['w http . ResponseWriter', ' r * http . Request'], 'filename': '/home/dimi/Documents/Informatik_Studium/FSS/SoftEvo/DataCollection/FFS_SoftEvo/go-ipfs/core/corehttp/gateway_handler.go', 'top_nesting_level': 0, 'length': 59, 'fan_in': 0, 'fan_out': 0, 'general_fan_out': 0}, {'cyclomatic_complexity': 1, 'nloc': 3, 'token_count': 27, 'name': 'optionsHandler', 'long_name': '(i*gatewayHandler)optionsHandler w http . ResponseWriter , r * http . Request', 'start_line': 125, 'end_line': 132, 'full_parameters': ['w http . ResponseWriter', ' r * http . Request'], 'filename': '/home/dimi/Documents/Informatik_Studium/FSS/SoftEvo/DataCollection/FFS_SoftEvo/go-ipfs/core/corehttp/gateway_handler.go', 'top_nesting_level': 0, 'length': 8, 'fan_in': 0, 'fan_out': 0, 'general_fan_out': 0}, {'cyclomatic_complexity': 1, 'nloc': 5, 'token_count': 49, 'name': 'error', 'long_name': '(link*node.Link)error', 'start_line': 323, 'end_line': 328, 'full_parameters': [], 'filename': '/home/dimi/Documents/Informatik_Studium/FSS/SoftEvo/DataCollection/FFS_SoftEvo/go-ipfs/core/corehttp/gateway_handler.go', 'top_nesting_level': 0, 'length': 6, 'fan_in': 0, 'fan_out': 0, 'general_fan_out': 0}]",651,4425,20,"[{'cyclomatic_complexity': 3, 'nloc': 7, 'token_count': 52, 'name': 'WriteHeader', 'long_name': '(sw*statusResponseWriter)WriteHeader code int', 'start_line': 77, 'end_line': 87, 'full_parameters': ['code int'], 'filename': '/home/dimi/Documents/Informatik_Studium/FSS/SoftEvo/DataCollection/FFS_SoftEvo/go-ipfs/core/corehttp/gateway_handler.go', 'top_nesting_level': 0, 'length': 11, 'fan_in': 0, 'fan_out': 0, 'general_fan_out': 0}, {'cyclomatic_complexity': 3, 'nloc': 24, 'token_count': 125, 'name': 'newGatewayHandler', 'long_name': 'newGatewayHandler c GatewayConfig , api coreiface . CoreAPI', 'start_line': 89, 'end_line': 113, 'full_parameters': ['c GatewayConfig', ' api coreiface . CoreAPI'], 'filename': '/home/dimi/Documents/Informatik_Studium/FSS/SoftEvo/DataCollection/FFS_SoftEvo/go-ipfs/core/corehttp/gateway_handler.go', 'top_nesting_level': 0, 'length': 25, 'fan_in': 0, 'fan_out': 0, 'general_fan_out': 0}, {'cyclomatic_complexity': 4, 'nloc': 15, 'token_count': 118, 'name': 'parseIpfsPath', 'long_name': 'parseIpfsPath p string', 'start_line': 115, 'end_line': 133, 'full_parameters': ['p string'], 'filename': '/home/dimi/Documents/Informatik_Studium/FSS/SoftEvo/DataCollection/FFS_SoftEvo/go-ipfs/core/corehttp/gateway_handler.go', 'top_nesting_level': 0, 'length': 19, 'fan_in': 0, 'fan_out': 0, 'general_fan_out': 0}, {'cyclomatic_complexity': 2, 'nloc': 7, 'token_count': 34, 'name': '', 'long_name': '()', 'start_line': 141, 'end_line': 147, 'full_parameters': [], 'filename': '/home/dimi/Documents/Informatik_Studium/FSS/SoftEvo/DataCollection/FFS_SoftEvo/go-ipfs/core/corehttp/gateway_handler.go', 'top_nesting_level': 0, 'length': 7, 'fan_in': 0, 'fan_out': 0, 'general_fan_out': 0}, {'cyclomatic_complexity': 8, 'nloc': 40, 'token_count': 251, 'name': 'ServeHTTP', 'long_name': '(i*gatewayHandler)ServeHTTP w http . ResponseWriter , r * http . Request', 'start_line': 135, 'end_line': 185, 'full_parameters': ['w http . ResponseWriter', ' r * http . Request'], 'filename': '/home/dimi/Documents/Informatik_Studium/FSS/SoftEvo/DataCollection/FFS_SoftEvo/go-ipfs/core/corehttp/gateway_handler.go', 'top_nesting_level': 0, 'length': 51, 'fan_in': 0, 'fan_out': 0, 'general_fan_out': 0}, {'cyclomatic_complexity': 1, 'nloc': 3, 'token_count': 27, 'name': 'optionsHandler', 'long_name': '(i*gatewayHandler)optionsHandler w http . ResponseWriter , r * http . Request', 'start_line': 187, 'end_line': 194, 'full_parameters': ['w http . ResponseWriter', ' r * http . Request'], 'filename': '/home/dimi/Documents/Informatik_Studium/FSS/SoftEvo/DataCollection/FFS_SoftEvo/go-ipfs/core/corehttp/gateway_handler.go', 'top_nesting_level': 0, 'length': 8, 'fan_in': 0, 'fan_out': 0, 'general_fan_out': 0}, {'cyclomatic_complexity': 48, 'nloc': 213, 'token_count': 1460, 'name': 'getOrHeadHandler', 'long_name': '(i*gatewayHandler)getOrHeadHandler w http . ResponseWriter , r * http . Request', 'start_line': 196, 'end_line': 498, 'full_parameters': ['w http . ResponseWriter', ' r * http . Request'], 'filename': '/home/dimi/Documents/Informatik_Studium/FSS/SoftEvo/DataCollection/FFS_SoftEvo/go-ipfs/core/corehttp/gateway_handler.go', 'top_nesting_level': 0, 'length': 303, 'fan_in': 0, 'fan_out': 0, 'general_fan_out': 0}, {'cyclomatic_complexity': 7, 'nloc': 36, 'token_count': 248, 'name': 'serveFile', 'long_name': '(i*gatewayHandler)serveFile w http . ResponseWriter , req * http . Request , name string , modtime time . Time , file files . File', 'start_line': 500, 'end_line': 547, 'full_parameters': ['w http . ResponseWriter', ' req * http . Request', ' name string', ' modtime time . Time', ' file files . File'], 'filename': '/home/dimi/Documents/Informatik_Studium/FSS/SoftEvo/DataCollection/FFS_SoftEvo/go-ipfs/core/corehttp/gateway_handler.go', 'top_nesting_level': 0, 'length': 48, 'fan_in': 0, 'fan_out': 0, 'general_fan_out': 0}, {'cyclomatic_complexity': 5, 'nloc': 25, 'token_count': 189, 'name': 'servePretty404IfPresent', 'long_name': '(i*gatewayHandler)servePretty404IfPresent w http . ResponseWriter , r * http . Request , parsedPath ipath . Path', 'start_line': 549, 'end_line': 577, 'full_parameters': ['w http . ResponseWriter', ' r * http . Request', ' parsedPath ipath . Path'], 'filename': '/home/dimi/Documents/Informatik_Studium/FSS/SoftEvo/DataCollection/FFS_SoftEvo/go-ipfs/core/corehttp/gateway_handler.go', 'top_nesting_level': 0, 'length': 29, 'fan_in': 0, 'fan_out': 0, 'general_fan_out': 0}, {'cyclomatic_complexity': 2, 'nloc': 10, 'token_count': 107, 'name': 'postHandler', 'long_name': '(i*gatewayHandler)postHandler w http . ResponseWriter , r * http . Request', 'start_line': 579, 'end_line': 589, 'full_parameters': ['w http . ResponseWriter', ' r * http . Request'], 'filename': '/home/dimi/Documents/Informatik_Studium/FSS/SoftEvo/DataCollection/FFS_SoftEvo/go-ipfs/core/corehttp/gateway_handler.go', 'top_nesting_level': 0, 'length': 11, 'fan_in': 0, 'fan_out': 0, 'general_fan_out': 0}, {'cyclomatic_complexity': 16, 'nloc': 77, 'token_count': 540, 'name': 'putHandler', 'long_name': '(i*gatewayHandler)putHandler w http . ResponseWriter , r * http . Request', 'start_line': 591, 'end_line': 681, 'full_parameters': ['w http . ResponseWriter', ' r * http . Request'], 'filename': '/home/dimi/Documents/Informatik_Studium/FSS/SoftEvo/DataCollection/FFS_SoftEvo/go-ipfs/core/corehttp/gateway_handler.go', 'top_nesting_level': 0, 'length': 91, 'fan_in': 0, 'fan_out': 0, 'general_fan_out': 0}, {'cyclomatic_complexity': 11, 'nloc': 52, 'token_count': 381, 'name': 'deleteHandler', 'long_name': '(i*gatewayHandler)deleteHandler w http . ResponseWriter , r * http . Request', 'start_line': 683, 'end_line': 753, 'full_parameters': ['w http . ResponseWriter', ' r * http . Request'], 'filename': '/home/dimi/Documents/Informatik_Studium/FSS/SoftEvo/DataCollection/FFS_SoftEvo/go-ipfs/core/corehttp/gateway_handler.go', 'top_nesting_level': 0, 'length': 71, 'fan_in': 0, 'fan_out': 0, 'general_fan_out': 0}, {'cyclomatic_complexity': 2, 'nloc': 5, 'token_count': 38, 'name': 'addUserHeaders', 'long_name': '(i*gatewayHandler)addUserHeaders w http . ResponseWriter', 'start_line': 755, 'end_line': 759, 'full_parameters': ['w http . ResponseWriter'], 'filename': '/home/dimi/Documents/Informatik_Studium/FSS/SoftEvo/DataCollection/FFS_SoftEvo/go-ipfs/core/corehttp/gateway_handler.go', 'top_nesting_level': 0, 'length': 5, 'fan_in': 0, 'fan_out': 0, 'general_fan_out': 0}, {'cyclomatic_complexity': 4, 'nloc': 11, 'token_count': 102, 'name': 'webError', 'long_name': 'webError w http . ResponseWriter , message string , err error , defaultCode int', 'start_line': 761, 'end_line': 771, 'full_parameters': ['w http . ResponseWriter', ' message string', ' err error', ' defaultCode int'], 'filename': '/home/dimi/Documents/Informatik_Studium/FSS/SoftEvo/DataCollection/FFS_SoftEvo/go-ipfs/core/corehttp/gateway_handler.go', 'top_nesting_level': 0, 'length': 11, 'fan_in': 0, 'fan_out': 0, 'general_fan_out': 0}, {'cyclomatic_complexity': 2, 'nloc': 6, 'token_count': 52, 'name': 'webErrorWithCode', 'long_name': 'webErrorWithCode w http . ResponseWriter , message string , err error , code int', 'start_line': 773, 'end_line': 778, 'full_parameters': ['w http . ResponseWriter', ' message string', ' err error', ' code int'], 'filename': '/home/dimi/Documents/Informatik_Studium/FSS/SoftEvo/DataCollection/FFS_SoftEvo/go-ipfs/core/corehttp/gateway_handler.go', 'top_nesting_level': 0, 'length': 6, 'fan_in': 0, 'fan_out': 0, 'general_fan_out': 0}, {'cyclomatic_complexity': 1, 'nloc': 3, 'token_count': 25, 'name': 'internalWebError', 'long_name': 'internalWebError w http . ResponseWriter , err error', 'start_line': 781, 'end_line': 783, 'full_parameters': ['w http . ResponseWriter', ' err error'], 'filename': '/home/dimi/Documents/Informatik_Studium/FSS/SoftEvo/DataCollection/FFS_SoftEvo/go-ipfs/core/corehttp/gateway_handler.go', 'top_nesting_level': 0, 'length': 3, 'fan_in': 0, 'fan_out': 0, 'general_fan_out': 0}, {'cyclomatic_complexity': 4, 'nloc': 6, 'token_count': 56, 'name': 'getFilename', 'long_name': 'getFilename s string', 'start_line': 785, 'end_line': 791, 'full_parameters': ['s string'], 'filename': '/home/dimi/Documents/Informatik_Studium/FSS/SoftEvo/DataCollection/FFS_SoftEvo/go-ipfs/core/corehttp/gateway_handler.go', 'top_nesting_level': 0, 'length': 7, 'fan_in': 0, 'fan_out': 0, 'general_fan_out': 0}, {'cyclomatic_complexity': 5, 'nloc': 20, 'token_count': 171, 'name': 'searchUpTreeFor404', 'long_name': '(i*gatewayHandler)searchUpTreeFor404 r * http . Request , parsedPath ipath . Path', 'start_line': 793, 'end_line': 815, 'full_parameters': ['r * http . Request', ' parsedPath ipath . Path'], 'filename': '/home/dimi/Documents/Informatik_Studium/FSS/SoftEvo/DataCollection/FFS_SoftEvo/go-ipfs/core/corehttp/gateway_handler.go', 'top_nesting_level': 0, 'length': 23, 'fan_in': 0, 'fan_out': 0, 'general_fan_out': 0}, {'cyclomatic_complexity': 4, 'nloc': 13, 'token_count': 88, 'name': 'preferred404Filename', 'long_name': 'preferred404Filename acceptHeaders [ ] string', 'start_line': 817, 'end_line': 833, 'full_parameters': ['acceptHeaders [ ] string'], 'filename': '/home/dimi/Documents/Informatik_Studium/FSS/SoftEvo/DataCollection/FFS_SoftEvo/go-ipfs/core/corehttp/gateway_handler.go', 'top_nesting_level': 0, 'length': 17, 'fan_in': 0, 'fan_out': 0, 'general_fan_out': 0}, {'cyclomatic_complexity': 5, 'nloc': 20, 'token_count': 157, 'name': 'fixupSuperfluousNamespace', 'long_name': 'fixupSuperfluousNamespace w http . ResponseWriter , urlPath string , urlQuery string', 'start_line': 839, 'end_line': 863, 'full_parameters': ['w http . ResponseWriter', ' urlPath string', ' urlQuery string'], 'filename': '/home/dimi/Documents/Informatik_Studium/FSS/SoftEvo/DataCollection/FFS_SoftEvo/go-ipfs/core/corehttp/gateway_handler.go', 'top_nesting_level': 0, 'length': 25, 'fan_in': 0, 'fan_out': 0, 'general_fan_out': 0}]",199,1437,13,157,157,"[{'timestamp': 1508350222.0, 'added_lines': 12, 'deleted_lines': 1, 'nloc': 458}, {'timestamp': 1508358336.0, 'added_lines': 24, 'deleted_lines': 0, 'nloc': 476}, {'timestamp': 1508358363.0, 'added_lines': 1, 'deleted_lines': 1, 'nloc': 476}, {'timestamp': 1508499397.0, 'added_lines': 2, 'deleted_lines': 9, 'nloc': 473}, {'timestamp': 1511663870.0, 'added_lines': 3, 'deleted_lines': 6, 'nloc': 471}, {'timestamp': 1512365669.0, 'added_lines': 3, 'deleted_lines': 3, 'nloc': 471}, {'timestamp': 1503963045.0, 'added_lines': 9, 'deleted_lines': 2, 'nloc': 479}, {'timestamp': 1516838128.0, 'added_lines': 4, 'deleted_lines': 4, 'nloc': 471}, {'timestamp': 1516911711.0, 'added_lines': 6, 'deleted_lines': 6, 'nloc': 471}, {'timestamp': 1517255734.0, 'added_lines': 4, 'deleted_lines': 4, 'nloc': 471}, {'timestamp': 1517453697.0, 'added_lines': 1, 'deleted_lines': 1, 'nloc': 471}, {'timestamp': 1517858907.0, 'added_lines': 1, 'deleted_lines': 1, 'nloc': 471}, {'timestamp': 1517996381.0, 'added_lines': 1, 'deleted_lines': 1, 'nloc': 471}, {'timestamp': 1518090209.0, 'added_lines': 1, 'deleted_lines': 1, 'nloc': 471}, {'timestamp': 1518090579.0, 'added_lines': 2, 'deleted_lines': 2, 'nloc': 471}, {'timestamp': 1518736190.0, 'added_lines': 3, 'deleted_lines': 2, 'nloc': 472}, {'timestamp': 1525408792.0, 'added_lines': 2, 'deleted_lines': 2, 'nloc': 472}, {'timestamp': 1528059336.0, 'added_lines': 7, 'deleted_lines': 14, 'nloc': 466}, {'timestamp': 1528268108.0, 'added_lines': 1, 'deleted_lines': 1, 'nloc': 472}, {'timestamp': 1528520460.0, 'added_lines': 4, 'deleted_lines': 4, 'nloc': 472}, {'timestamp': 1529984485.0, 'added_lines': 2, 'deleted_lines': 2, 'nloc': 466}, {'timestamp': 1531779409.0, 'added_lines': 4, 'deleted_lines': 4, 'nloc': 466}, {'timestamp': 1517583637.0, 'added_lines': 2, 'deleted_lines': 3, 'nloc': 465}, {'timestamp': 1522441317.0, 'added_lines': 2, 'deleted_lines': 2, 'nloc': 465}, {'timestamp': 1528768346.0, 'added_lines': 2, 'deleted_lines': 2, 'nloc': 465}, {'timestamp': 1532722333.0, 'added_lines': 1, 'deleted_lines': 1, 'nloc': 465}, {'timestamp': 1532764253.0, 'added_lines': 1, 'deleted_lines': 1, 'nloc': 465}, {'timestamp': 1532847462.0, 'added_lines': 2, 'deleted_lines': 2, 'nloc': 465}, {'timestamp': 1532986515.0, 'added_lines': 3, 'deleted_lines': 3, 'nloc': 465}, {'timestamp': 1533500571.0, 'added_lines': 6, 'deleted_lines': 6, 'nloc': 465}, {'timestamp': 1533618653.0, 'added_lines': 6, 'deleted_lines': 6, 'nloc': 465}, {'timestamp': 1533779477.0, 'added_lines': 8, 'deleted_lines': 8, 'nloc': 465}, {'timestamp': 1533946888.0, 'added_lines': 3, 'deleted_lines': 3, 'nloc': 465}, {'timestamp': 1534115707.0, 'added_lines': 11, 'deleted_lines': 11, 'nloc': 465}, {'timestamp': 1534195762.0, 'added_lines': 6, 'deleted_lines': 6, 'nloc': 465}, {'timestamp': 1534347022.0, 'added_lines': 10, 'deleted_lines': 10, 'nloc': 465}, {'timestamp': 1534896611.0, 'added_lines': 10, 'deleted_lines': 10, 'nloc': 473}, {'timestamp': 1535601896.0, 'added_lines': 6, 'deleted_lines': 6, 'nloc': 473}, {'timestamp': 1536388808.0, 'added_lines': 7, 'deleted_lines': 7, 'nloc': 473}, {'timestamp': 1536718784.0, 'added_lines': 12, 'deleted_lines': 12, 'nloc': 473}, {'timestamp': 1536723292.0, 'added_lines': 6, 'deleted_lines': 6, 'nloc': 473}, {'timestamp': 1537790637.0, 'added_lines': 7, 'deleted_lines': 7, 'nloc': 473}, {'timestamp': 1537792589.0, 'added_lines': 8, 'deleted_lines': 8, 'nloc': 473}, {'timestamp': 1538571946.0, 'added_lines': 3, 'deleted_lines': 1, 'nloc': 475}, {'timestamp': 1538544957.0, 'added_lines': 7, 'deleted_lines': 7, 'nloc': 473}, {'timestamp': 1538694687.0, 'added_lines': 6, 'deleted_lines': 6, 'nloc': 473}, {'timestamp': 1538695953.0, 'added_lines': 6, 'deleted_lines': 6, 'nloc': 473}, {'timestamp': 1538692589.0, 'added_lines': 9, 'deleted_lines': 1, 'nloc': 479}, {'timestamp': 1538773916.0, 'added_lines': 8, 'deleted_lines': 8, 'nloc': 481}, {'timestamp': 1539176817.0, 'added_lines': 8, 'deleted_lines': 8, 'nloc': 481}, {'timestamp': 1539357340.0, 'added_lines': 6, 'deleted_lines': 6, 'nloc': 481}, {'timestamp': 1539850591.0, 'added_lines': 7, 'deleted_lines': 7, 'nloc': 481}, {'timestamp': 1539104245.0, 'added_lines': 5, 'deleted_lines': 7, 'nloc': 479}, {'timestamp': 1539172054.0, 'added_lines': 9, 'deleted_lines': 7, 'nloc': 482}, {'timestamp': 1539600349.0, 'added_lines': 2, 'deleted_lines': 2, 'nloc': 482}, {'timestamp': 1540250040.0, 'added_lines': 6, 'deleted_lines': 8, 'nloc': 479}, {'timestamp': 1540400358.0, 'added_lines': 7, 'deleted_lines': 7, 'nloc': 479}, {'timestamp': 1540410565.0, 'added_lines': 6, 'deleted_lines': 6, 'nloc': 479}, {'timestamp': 1540418491.0, 'added_lines': 6, 'deleted_lines': 6, 'nloc': 479}, {'timestamp': 1540603818.0, 'added_lines': 7, 'deleted_lines': 7, 'nloc': 479}, {'timestamp': 1540916861.0, 'added_lines': 2, 'deleted_lines': 2, 'nloc': 479}, {'timestamp': 1541106379.0, 'added_lines': 3, 'deleted_lines': 3, 'nloc': 479}, {'timestamp': 1541189794.0, 'added_lines': 6, 'deleted_lines': 6, 'nloc': 479}, {'timestamp': 1541204121.0, 'added_lines': 10, 'deleted_lines': 10, 'nloc': 479}, {'timestamp': 1541903826.0, 'added_lines': 7, 'deleted_lines': 7, 'nloc': 479}, {'timestamp': 1542586303.0, 'added_lines': 1, 'deleted_lines': 13, 'nloc': 469}, {'timestamp': 1543443696.0, 'added_lines': 6, 'deleted_lines': 6, 'nloc': 469}, {'timestamp': 1544225843.0, 'added_lines': 7, 'deleted_lines': 7, 'nloc': 469}, {'timestamp': 1540556089.0, 'added_lines': 4, 'deleted_lines': 4, 'nloc': 469}, {'timestamp': 1540562190.0, 'added_lines': 1, 'deleted_lines': 1, 'nloc': 469}, {'timestamp': 1542594282.0, 'added_lines': 16, 'deleted_lines': 12, 'nloc': 471}, {'timestamp': 1544737281.0, 'added_lines': 9, 'deleted_lines': 10, 'nloc': 470}, {'timestamp': 1546565740.0, 'added_lines': 22, 'deleted_lines': 27, 'nloc': 468}, {'timestamp': 1546632537.0, 'added_lines': 0, 'deleted_lines': 13, 'nloc': 462}, {'timestamp': 1541682253.0, 'added_lines': 6, 'deleted_lines': 0, 'nloc': 475}, {'timestamp': 1546563655.0, 'added_lines': 1, 'deleted_lines': 1, 'nloc': 475}, {'timestamp': 1546723786.0, 'added_lines': 4, 'deleted_lines': 5, 'nloc': 466}, {'timestamp': 1547003974.0, 'added_lines': 6, 'deleted_lines': 6, 'nloc': 463}, {'timestamp': 1547499910.0, 'added_lines': 6, 'deleted_lines': 6, 'nloc': 463}, {'timestamp': 1548866534.0, 'added_lines': 3, 'deleted_lines': 3, 'nloc': 463}, {'timestamp': 1549588289.0, 'added_lines': 6, 'deleted_lines': 6, 'nloc': 463}, {'timestamp': 1549672857.0, 'added_lines': 1, 'deleted_lines': 1, 'nloc': 463}, {'timestamp': 1549673846.0, 'added_lines': 1, 'deleted_lines': 1, 'nloc': 463}, {'timestamp': 1549903582.0, 'added_lines': 4, 'deleted_lines': 4, 'nloc': 463}, {'timestamp': 1550185115.0, 'added_lines': 6, 'deleted_lines': 6, 'nloc': 463}, {'timestamp': 1550507829.0, 'added_lines': 8, 'deleted_lines': 8, 'nloc': 463}, {'timestamp': 1550576884.0, 'added_lines': 1, 'deleted_lines': 1, 'nloc': 463}, {'timestamp': 1550610741.0, 'added_lines': 1, 'deleted_lines': 1, 'nloc': 463}, {'timestamp': 1550711994.0, 'added_lines': 6, 'deleted_lines': 6, 'nloc': 463}, {'timestamp': 1550723346.0, 'added_lines': 10, 'deleted_lines': 10, 'nloc': 463}, {'timestamp': 1551229859.0, 'added_lines': 7, 'deleted_lines': 7, 'nloc': 463}, {'timestamp': 1551299964.0, 'added_lines': 6, 'deleted_lines': 6, 'nloc': 463}, {'timestamp': 1551754781.0, 'added_lines': 1, 'deleted_lines': 1, 'nloc': 463}, {'timestamp': 1551551196.0, 'added_lines': 13, 'deleted_lines': 13, 'nloc': 463}, {'timestamp': 1553529899.0, 'added_lines': 2, 'deleted_lines': 2, 'nloc': 463}, {'timestamp': 1553608614.0, 'added_lines': 3, 'deleted_lines': 2, 'nloc': 464}, {'timestamp': 1553609463.0, 'added_lines': 1, 'deleted_lines': 1, 'nloc': 464}, {'timestamp': 1554256305.0, 'added_lines': 2, 'deleted_lines': 1, 'nloc': 465}, {'timestamp': 1555954761.0, 'added_lines': 41, 'deleted_lines': 33, 'nloc': 472}, {'timestamp': 1558751639.0, 'added_lines': 5, 'deleted_lines': 6, 'nloc': 472}, {'timestamp': 1559060517.0, 'added_lines': 1, 'deleted_lines': 1, 'nloc': 472}, {'timestamp': 1559692105.0, 'added_lines': 2, 'deleted_lines': 0, 'nloc': 474}, {'timestamp': 1559694893.0, 'added_lines': 2, 'deleted_lines': 1, 'nloc': 474}, {'timestamp': 1564101035.0, 'added_lines': 129, 'deleted_lines': 152, 'nloc': 453}, {'timestamp': 1572728214.0, 'added_lines': 6, 'deleted_lines': 0, 'nloc': 458}, {'timestamp': 1572971786.0, 'added_lines': 4, 'deleted_lines': 1, 'nloc': 460}, {'timestamp': 1573001569.0, 'added_lines': 17, 'deleted_lines': 8, 'nloc': 470}, {'timestamp': 1573040672.0, 'added_lines': 2, 'deleted_lines': 2, 'nloc': 470}, {'timestamp': 1573040696.0, 'added_lines': 1, 'deleted_lines': 1, 'nloc': 470}, {'timestamp': 1573040741.0, 'added_lines': 0, 'deleted_lines': 1, 'nloc': 469}, {'timestamp': 1573040847.0, 'added_lines': 4, 'deleted_lines': 0, 'nloc': 469}, {'timestamp': 1576545095.0, 'added_lines': 13, 'deleted_lines': 0, 'nloc': 478}, {'timestamp': 1569525942.0, 'added_lines': 1, 'deleted_lines': 1, 'nloc': 478}, {'timestamp': 1569526449.0, 'added_lines': 6, 'deleted_lines': 6, 'nloc': 477}, {'timestamp': 1569529611.0, 'added_lines': 9, 'deleted_lines': 19, 'nloc': 471}, {'timestamp': 1569531234.0, 'added_lines': 24, 'deleted_lines': 16, 'nloc': 476}, {'timestamp': 1569532786.0, 'added_lines': 0, 'deleted_lines': 4, 'nloc': 473}, {'timestamp': 1551228784.0, 'added_lines': 6, 'deleted_lines': 6, 'nloc': 473}, {'timestamp': 1551228942.0, 'added_lines': 3, 'deleted_lines': 4, 'nloc': 473}, {'timestamp': 1576545095.0, 'added_lines': 13, 'deleted_lines': 0, 'nloc': 481}, {'timestamp': 1579218500.0, 'added_lines': 1, 'deleted_lines': 1, 'nloc': 473}, {'timestamp': 1552604940.0, 'added_lines': 7, 'deleted_lines': 52, 'nloc': 447}, {'timestamp': 1552609298.0, 'added_lines': 5, 'deleted_lines': 4, 'nloc': 448}, {'timestamp': 1583946448.0, 'added_lines': 20, 'deleted_lines': 0, 'nloc': 459}, {'timestamp': 1585958766.0, 'added_lines': 3, 'deleted_lines': 0, 'nloc': 462}, {'timestamp': 1586950949.0, 'added_lines': 10, 'deleted_lines': 0, 'nloc': 466}, {'timestamp': 1587221101.0, 'added_lines': 2, 'deleted_lines': 2, 'nloc': 466}, {'timestamp': 1587942542.0, 'added_lines': 1, 'deleted_lines': 4, 'nloc': 463}, {'timestamp': 1587942680.0, 'added_lines': 1, 'deleted_lines': 1, 'nloc': 463}, {'timestamp': 1588315776.0, 'added_lines': 4, 'deleted_lines': 1, 'nloc': 464}, {'timestamp': 1588345172.0, 'added_lines': 8, 'deleted_lines': 4, 'nloc': 467}, {'timestamp': 1588352840.0, 'added_lines': 1, 'deleted_lines': 1, 'nloc': 467}, {'timestamp': 1588409341.0, 'added_lines': 1, 'deleted_lines': 1, 'nloc': 467}, {'timestamp': 1588979785.0, 'added_lines': 81, 'deleted_lines': 0, 'nloc': 532}, {'timestamp': 1589973710.0, 'added_lines': 9, 'deleted_lines': 9, 'nloc': 532}, {'timestamp': 1589803089.0, 'added_lines': 3, 'deleted_lines': 0, 'nloc': 533}, {'timestamp': 1590026869.0, 'added_lines': 0, 'deleted_lines': 4, 'nloc': 530}, {'timestamp': 1561317459.0, 'added_lines': 15, 'deleted_lines': 4, 'nloc': 537}, {'timestamp': 1594352765.0, 'added_lines': 37, 'deleted_lines': 5, 'nloc': 560}, {'timestamp': 1600287036.0, 'added_lines': 5, 'deleted_lines': 1, 'nloc': 564}, {'timestamp': 1600288744.0, 'added_lines': 5, 'deleted_lines': 1, 'nloc': 567}, {'timestamp': 1601065604.0, 'added_lines': 8, 'deleted_lines': 3, 'nloc': 560}, {'timestamp': 1601294969.0, 'added_lines': 4, 'deleted_lines': 1, 'nloc': 562}, {'timestamp': 1601339248.0, 'added_lines': 0, 'deleted_lines': 4, 'nloc': 562}, {'timestamp': 1602629217.0, 'added_lines': 6, 'deleted_lines': 1, 'nloc': 571}, {'timestamp': 1607184160.0, 'added_lines': 17, 'deleted_lines': 0, 'nloc': 586}, {'timestamp': 1607737396.0, 'added_lines': 16, 'deleted_lines': 5, 'nloc': 595}, {'timestamp': 1607772522.0, 'added_lines': 1, 'deleted_lines': 7, 'nloc': 590}, {'timestamp': 1613776157.0, 'added_lines': 11, 'deleted_lines': 0, 'nloc': 596}, {'timestamp': 1614383292.0, 'added_lines': 29, 'deleted_lines': 5, 'nloc': 611}, {'timestamp': 1616098507.0, 'added_lines': 38, 'deleted_lines': 22, 'nloc': 624}, {'timestamp': 1616100484.0, 'added_lines': 8, 'deleted_lines': 7, 'nloc': 626}, {'timestamp': 1616107733.0, 'added_lines': 8, 'deleted_lines': 3, 'nloc': 630}, {'timestamp': 1616194858.0, 'added_lines': 1, 'deleted_lines': 1, 'nloc': 630}, {'timestamp': 1616197988.0, 'added_lines': 1, 'deleted_lines': 0, 'nloc': 590}, {'timestamp': 1627670055.0, 'added_lines': 5, 'deleted_lines': 4, 'nloc': 632}, {'timestamp': 1564463657.0, 'added_lines': 24, 'deleted_lines': 3, 'nloc': 649}]","{'test/sharness/t0110-gateway-data/foo.block': 1, 'test/sharness/t0110-gateway-data/foofoo.block': 1, 'test/sharness/t0110-gateway.sh': 11, 'unixfs/io/pbdagreader.go': 9, 'merkledag/merkledag.go': 7, 'assets/assets.go': 54, 'blocks/blockstore/arc_cache.go': 2, 'blocks/blockstore/arc_cache_test.go': 2, 'blocks/blockstore/blockstore.go': 3, 'blocks/blockstore/blockstore_test.go': 2, 'blocks/blockstore/bloom_cache.go': 2, 'blocks/blockstore/bloom_cache_test.go': 2, 'blocks/blockstore/util/remove.go': 2, 'blocks/blocksutil/block_generator.go': 2, 'blockservice/blockservice.go': 8, 'blockservice/blockservice_test.go': 6, 'blockservice/test/blocks_test.go': 7, 'cmd/ipfs/daemon.go': 29, 'cmd/ipfs/init.go': 28, 'cmd/ipfs/ipfs.go': 19, 'cmd/ipfs/main.go': 29, 'cmd/ipfs/main_test.go': 1, 'cmd/ipfswatch/main.go': 17, 'cmd/seccat/seccat.go': 26, 'commands/command.go': 12, 'commands/command_test.go': 3, 'commands/request.go': 16, 'commands/response.go': 7, 'commands/response_test.go': 3, 'core/bootstrap.go': 24, 'core/bootstrap_test.go': 24, 'core/builder.go': 58, 'core/commands/active.go': 12, 'core/commands/add.go': 45, 'core/commands/bitswap.go': 50, 'core/commands/block.go': 36, 'core/commands/bootstrap.go': 22, 'core/commands/cat.go': 34, 'core/commands/commands.go': 20, 'core/commands/config.go': 24, 'core/commands/dag/dag.go': 63, 'core/commands/dht.go': 59, 'core/commands/dht_test.go': 23, 'core/commands/diag.go': 12, 'core/commands/dns.go': 20, 'core/commands/external.go': 12, 'core/commands/files/files.go': 5, 'core/commands/filestore.go': 24, 'core/commands/get.go': 61, 'core/commands/get_test.go': 19, 'core/commands/helptext_test.go': 19, 'core/commands/id.go': 39, 'core/commands/ipns.go': 12, 'core/commands/ipnsps.go': 6, 'core/commands/keystore.go': 26, 'core/commands/log.go': 18, 'core/commands/ls.go': 62, 'core/commands/mount_nofuse.go': 12, 'core/commands/mount_unix.go': 23, 'core/commands/mount_windows.go': 12, 'core/commands/name.go': 4, 'core/commands/object/diff.go': 25, 'core/commands/object/object.go': 64, 'core/commands/object/patch.go': 36, 'core/commands/p2p.go': 27, 'core/commands/pin.go': 62, 'core/commands/ping.go': 34, 'core/commands/publish.go': 15, 'core/commands/pubsub.go': 37, 'core/commands/refs.go': 53, 'core/commands/repo.go': 37, 'core/commands/resolve.go': 54, 'core/commands/root.go': 19, 'core/commands/shutdown.go': 16, 'core/commands/stat.go': 26, 'core/commands/swarm.go': 35, 'core/commands/sysdiag.go': 20, 'core/commands/tar.go': 54, 'core/commands/unixfs/ls.go': 57, 'core/commands/unixfs/unixfs.go': 12, 'core/commands/version.go': 13, 'core/core.go': 63, 'core/coreapi/coreapi.go': 33, 'core/coreapi/interface/interface.go': 2, 'core/coreapi/unixfs.go': 64, 'core/coreapi/unixfs_test.go': 50, 'core/coredag/cbor.go': 18, 'core/coredag/dagpb.go': 44, 'core/coredag/dagtransl.go': 14, 'core/coredag/raw.go': 44, 'core/corehttp/commands.go': 55, 'core/corehttp/corehttp.go': 17, 'core/corehttp/gateway.go': 40, 'core/corehttp/gateway_test.go': 67, 'core/corehttp/metrics_test.go': 32, 'core/corerepo/gc.go': 51, 'core/corerepo/pinning.go': 22, 'core/coreunix/add.go': 67, 'core/coreunix/add_test.go': 58, 'core/coreunix/metadata.go': 51, 'core/coreunix/metadata_test.go': 58, 'core/mock/mock.go': 33, 'core/pathresolver.go': 49, 'exchange/bitswap/bitswap.go': 7, 'exchange/bitswap/bitswap_test.go': 8, 'exchange/bitswap/decision/bench_test.go': 7, 'exchange/bitswap/decision/engine.go': 7, 'exchange/bitswap/decision/engine_test.go': 7, 'exchange/bitswap/decision/ledger.go': 7, 'exchange/bitswap/decision/peer_request_queue.go': 7, 'exchange/bitswap/decision/peer_request_queue_test.go': 7, 'exchange/bitswap/get.go': 6, 'exchange/bitswap/message/message.go': 8, 'exchange/bitswap/message/message_test.go': 4, 'exchange/bitswap/network/interface.go': 8, 'exchange/bitswap/network/ipfs_impl.go': 8, 'exchange/bitswap/notifications/notifications.go': 4, 'exchange/bitswap/notifications/notifications_test.go': 4, 'exchange/bitswap/session.go': 7, 'exchange/bitswap/session_test.go': 6, 'exchange/bitswap/stat.go': 4, 'exchange/bitswap/testnet/interface.go': 6, 'exchange/bitswap/testnet/network_test.go': 8, 'exchange/bitswap/testnet/peernet.go': 8, 'exchange/bitswap/testnet/virtual.go': 8, 'exchange/bitswap/testutils.go': 8, 'exchange/bitswap/wantlist/wantlist.go': 4, 'exchange/bitswap/wantlist/wantlist_test.go': 4, 'exchange/bitswap/wantmanager.go': 7, 'exchange/bitswap/workers.go': 7, 'exchange/interface.go': 2, 'exchange/offline/offline.go': 2, 'exchange/offline/offline_test.go': 2, 'exchange/reprovide/providers.go': 47, 'exchange/reprovide/reprovide.go': 29, 'exchange/reprovide/reprovide_test.go': 33, 'filestore/filestore.go': 26, 'filestore/filestore_test.go': 45, 'filestore/fsrefstore.go': 25, 'filestore/util.go': 23, 'fuse/ipns/ipns_test.go': 33, 'fuse/ipns/ipns_unix.go': 58, 'fuse/node/mount_test.go': 32, 'fuse/readonly/ipfs_test.go': 68, 'fuse/readonly/readonly_unix.go': 59, 'importer/balanced/balanced_test.go': 13, 'importer/balanced/builder.go': 5, 'importer/chunk/rabin_test.go': 2, 'importer/chunk/splitting_test.go': 2, 'importer/helpers/dagbuilder.go': 13, 'importer/helpers/helpers.go': 7, 'importer/importer.go': 12, 'importer/importer_test.go': 13, 'importer/trickle/trickle_test.go': 13, 'importer/trickle/trickledag.go': 6, 'merkledag/batch.go': 2, 'merkledag/coding.go': 5, 'merkledag/merkledag_test.go': 12, 'merkledag/node.go': 6, 'merkledag/node_test.go': 6, 'merkledag/raw.go': 5, 'merkledag/traverse/traverse.go': 5, 'merkledag/traverse/traverse_test.go': 6, 'merkledag/utils/diff.go': 6, 'merkledag/utils/diffenum.go': 5, 'merkledag/utils/diffenum_test.go': 6, 'merkledag/utils/utils.go': 8, 'merkledag/utils/utils_test.go': 6, 'mfs/dir.go': 15, 'mfs/file.go': 21, 'mfs/mfs_test.go': 22, 'mfs/ops.go': 12, 'mfs/repub_test.go': 10, 'mfs/system.go': 18, 'namesys/ipns_select_test.go': 4, 'namesys/namesys.go': 55, 'namesys/publisher.go': 57, 'namesys/publisher_test.go': 33, 'namesys/pubsub.go': 4, 'namesys/pubsub_test.go': 4, 'namesys/republisher/repub.go': 47, 'namesys/republisher/repub_test.go': 49, 'namesys/resolve_test.go': 50, 'namesys/routing.go': 54, 'p2p/p2p.go': 25, 'p2p/registry.go': 11, 'package.json': 61, 'path/path.go': 5, 'path/resolver.go': 5, 'path/resolver_test.go': 4, 'pin/gc/gc.go': 48, 'pin/pin.go': 49, 'pin/pin_test.go': 46, 'pin/set.go': 45, 'pin/set_test.go': 45, 'plugin/ipld.go': 14, 'plugin/loader/initializer.go': 11, 'plugin/plugins/git/git.go': 13, 'repo/config/bootstrap_peers.go': 8, 'repo/config/init.go': 7, 'repo/fsrepo/fsrepo.go': 24, 'repo/fsrepo/lock/lock.go': 3, 'repo/fsrepo/serialize/serialize.go': 3, 'repo/mock.go': 17, 'repo/repo.go': 21, 'routing/mock/centralized_client.go': 3, 'routing/mock/centralized_server.go': 3, 'routing/mock/centralized_test.go': 3, 'routing/mock/interface.go': 3, 'routing/none/none_client.go': 3, 'routing/offline/offline.go': 3, 'routing/offline/offline_test.go': 3, 'tar/format.go': 62, 'test/dependencies/ma-pipe-unidir/main.go': 10, 'test/integration/addcat_test.go': 37, 'test/integration/bench_cat_test.go': 36, 'test/integration/bench_test.go': 18, 'test/integration/bitswap_wo_routing_test.go': 35, 'test/integration/three_legged_cat_test.go': 36, 'thirdparty/ds-help/key.go': 2, 'thirdparty/pollEndpoint/main.go': 15, 'thirdparty/posinfo/posinfo.go': 3, 'unixfs/archive/archive.go': 7, 'unixfs/archive/tar/writer.go': 8, 'unixfs/hamt/hamt.go': 8, 'unixfs/io/dagreader.go': 8, 'unixfs/io/dirbuilder.go': 5, 'unixfs/io/resolve.go': 8, 'unixfs/mod/dagmodifier.go': 14, 'unixfs/mod/dagmodifier_test.go': 4, 'unixfs/test/utils.go': 14, 'commands/legacy/command.go': 11, 'commands/legacy/legacy.go': 11, 'commands/legacy/legacy_test.go': 11, 'commands/legacy/request.go': 11, 'commands/legacy/response.go': 11, 'core/commands/commands_test.go': 18, 'core/coreapi/dag.go': 16, 'core/coreapi/dag_test.go': 5, 'core/coreapi/interface/options/dag.go': 8, 'core/coreapi/key.go': 54, 'core/coreapi/name.go': 56, 'merkledag/test/utils.go': 7, 'namesys/namesys_test.go': 58, 'repo/fsrepo/datastores.go': 15, 'repo/fsrepo/fsrepo_test.go': 18, 'thirdparty/datastore2/datastore_closer.go': 1, 'thirdparty/datastore2/delayed.go': 1, 'thirdparty/datastore2/threadsafe.go': 1, None: 29, 'mfs/fd.go': 9, 'unixfs/hamt/hamt_stress_test.go': 6, 'unixfs/hamt/hamt_test.go': 7, 'unixfs/io/dagreader_test.go': 3, 'unixfs/io/dirbuilder_test.go': 1, 'cmd/ipfs/util/ulimit.go': 10, 'cmd/seccat/util.go': 9, 'core/corehttp/logs.go': 9, 'fuse/mount/mount.go': 10, 'fuse/node/mount_unix.go': 10, 'importer/chunk/splitting.go': 1, 'namesys/ipns_validate_test.go': 4, 'plugin/loader/load.go': 7, 'core/commands/files.go': 64, 'core/coreunix/cat.go': 17, 'path/resolver/resolver.go': 6, 'path/resolver/resolver_test.go': 4, 'blocks/blockstoreutil/remove.go': 22, 'blockservice/test/mock.go': 5, 'core/core_test.go': 17, 'core/coreapi/pin.go': 52, 'fuse/ipns/common.go': 49, 'keystore/keystore.go': 11, 'keystore/keystore_test.go': 7, 'keystore/memkeystore.go': 7, 'namesys/interface.go': 46, 'namesys/validator.go': 3, 'repo/config/identity.go': 2, 'thirdparty/verifbs/verifbs.go': 21, 'core/corehttp/ipns_hostname.go': 13, 'cmd/ipfs/util/ulimit_freebsd.go': 2, 'cmd/ipfs/util/ulimit_unix.go': 2, 'core/coreapi/block.go': 23, 'core/coreapi/block_test.go': 2, 'core/coreapi/interface/coreapi.go': 12, 'core/coreapi/interface/dag.go': 9, 'core/coreapi/interface/object.go': 9, 'core/coreapi/interface/options/block.go': 3, 'core/coreapi/interface/path.go': 37, 'core/coreapi/interface/unixfs.go': 18, 'core/coreapi/object.go': 57, 'fuse/ipns/link_unix.go': 2, 'fuse/mount/fuse.go': 3, 'fuse/node/mount_darwin.go': 3, 'merkledag/errservice.go': 2, 'merkledag/readonly.go': 2, 'merkledag/readonly_test.go': 2, 'merkledag/rwservice.go': 2, 'merkledag/session.go': 2, 'thirdparty/verifcid/validate.go': 2, 'thirdparty/verifcid/validate_test.go': 2, 'namesys/ipns_resolver_validation_test.go': 47, 'test/sharness/t0170-dht.sh': 1, 'core/commands/urlstore.go': 47, 'unixfs/io/directory.go': 3, 'core/coreapi/interface/options/path.go': 1, 'core/coreapi/path.go': 56, 'core/coreapi/pin_test.go': 2, 'core/coreapi/path_test.go': 1, 'dagutils/diff.go': 44, 'dagutils/diffenum.go': 40, 'dagutils/diffenum_test.go': 40, 'dagutils/utils.go': 42, 'dagutils/utils_test.go': 42, 'Rules.mk': 1, 'unixfs/io/directory_test.go': 2, 'unixfs/unixfs.go': 2, 'core/coreapi/name_test.go': 35, 'core/pathresolver_test.go': 40, 'namesys/base.go': 44, 'namesys/cache.go': 40, 'namesys/dns.go': 44, 'namesys/proquint.go': 44, 'unixfs/importer/balanced/balanced_test.go': 1, 'unixfs/importer/balanced/builder.go': 1, 'unixfs/importer/helpers/dagbuilder.go': 1, 'unixfs/importer/helpers/helpers.go': 1, 'unixfs/importer/importer.go': 1, 'unixfs/importer/importer_test.go': 1, 'unixfs/importer/trickle/trickle_test.go': 1, 'unixfs/importer/trickle/trickledag.go': 1, 'unixfs/unixfs_test.go': 1, 'core/commands/env.go': 3, 'core/coreapi/interface/key.go': 7, 'filestore/pb/dataobj.pb.go': 3, 'pin/internal/pb/header.pb.go': 3, 'thirdparty/cidv0v1/blockstore.go': 16, 'repo/fsrepo/config_test.go': 13, 'repo/fsrepo/misc.go': 13, 'test/bench/bench_cli_ipfs_add/main.go': 14, 'test/bench/offline_add/main.go': 14, 'core/commands/cmdenv/env.go': 24, 'core/commands/name/ipns.go': 40, 'core/commands/name/publish.go': 26, 'core/coreapi/dht.go': 35, 'core/coreapi/dht_test.go': 5, 'test/sharness/t0275-cid-security.sh': 1, 'core/commands/name/ipnsps.go': 15, 'core/commands/name/name.go': 10, 'core/coreapi/interface/dht.go': 10, 'p2p/listener.go': 14, 'p2p/local.go': 15, 'p2p/remote.go': 14, 'p2p/stream.go': 14, 'core/coreapi/interface/swarm.go': 9, 'core/coreapi/swarm.go': 24, 'core/coreapi/interface/options/unixfs.go': 15, 'core/coreapi/pubsub.go': 22, 'core/coreapi/unixfile.go': 21, 'core/commands/cid.go': 11, 'cmd/ipfs/dnsresolve_test.go': 5, 'core/coreapi/interface/pubsub.go': 4, 'test/dependencies/iptb/iptb.go': 12, 'plugin/plugins/badgerds/badgerds.go': 4, 'plugin/plugins/flatfs/flatfs.go': 3, 'plugin/plugins/levelds/levelds.go': 3, 'commands/context.go': 17, 'core/corehttp/proxy.go': 11, 'core/coreapi/interface/tests/path.go': 1, 'assets/bindata.go': 2, 'core/corehttp/gateway_indexPage.go': 5, 'core/coreapi/interface/tests/name.go': 4, 'core/coreapi/interface/tests/unixfs.go': 4, 'core/coreapi/test/api_test.go': 14, 'plugin/loader/loader.go': 12, 'core/commands/cmdenv/cidbase.go': 7, 'core/commands/cmdenv/file.go': 3, 'namesys/dns_test.go': 10, 'plugin/daemon.go': 10, 'core/corerepo/stat.go': 2, 'core/commands/cmdenv/cidbase_test.go': 2, 'core/corehttp/metrics.go': 4, 'core/corehttp/proxy_test.go': 3, 'plugin/tracer.go': 1, 'thirdparty/notifier/notifier.go': 2, 'namesys/resolve/pathresolver_test.go': 1, 'namesys/resolve/resolve.go': 1, 'core/corehttp/mutex_profile.go': 1, 'go.mod': 5, 'go.sum': 5, 'core/bootstrap/bootstrap.go': 2, 'core/bootstrap/bootstrap_test.go': 1, 'core/node/builder.go': 1, 'core/node/core.go': 1, 'core/node/groups.go': 1, 'core/node/identity.go': 1, 'core/node/ipns.go': 1, 'core/node/libp2p/addrs.go': 1, 'core/node/libp2p/discovery.go': 2, 'core/node/libp2p/host.go': 1, 'core/node/libp2p/hostopt.go': 1, 'core/node/libp2p/libp2p.go': 1, 'core/node/libp2p/nat.go': 1, 'core/node/libp2p/pnet.go': 2, 'core/node/libp2p/pubsub.go': 1, 'core/node/libp2p/routing.go': 1, 'core/node/libp2p/routingopt.go': 1, 'core/node/libp2p/smux.go': 2, 'core/node/libp2p/transport.go': 2, 'core/node/provider.go': 1, 'provider/simple/provider.go': 1, 'provider/simple/provider_test.go': 1, 'provider/simple/reprovide.go': 1, 'provider/simple/reprovide_test.go': 1, 'test/sharness/t0111-gateway-writeable.sh': 2, 'core/corehttp/lazyseek.go': 1, 'core/corehttp/option_test.go': 1, 'repo/fsrepo/migrations/migrations.go': 2, 'plugin/loader/load_unix.go': 1, 'core/corehttp/hostname.go': 4, 'core/corehttp/hostname_test.go': 1, 'docs/config.md': 3, 'docs/environment-variables.md': 2, 'test/sharness/t0114-gateway-subdomains.sh': 5, 'test/sharness/t0160-resolve.sh': 1, 'test/sharness/t0184-http-proxy-over-p2p.sh': 1, 'CHANGELOG.md': 1, 'Dockerfile': 1, 'README.md': 1, 'bin/check_go_version': 1, 'coverage/Rules.mk': 1, 'docs/debug-guide.md': 1, 'gc/gc.go': 1, 'keystore/memkeystore_test.go': 1, 'misc/completion/ipfs-completion.bash': 1, 'plugin/plugins/gen_main.sh': 1, 'repo/onlyone.go': 1, 'test/3nodetest/run-test-on-img.sh': 1, 'test/ipfs-test-lib.sh': 1, 'test/sharness/README.md': 1, 'test/sharness/lib/iptb-lib.sh': 1, 'test/sharness/t0010-basic-commands.sh': 1, 'test/sharness/t0020-init.sh': 1, 'test/sharness/t0030-mount.sh': 1, 'test/sharness/t0031-mount-publish.sh': 1, 'test/sharness/t0040-add-and-cat.sh': 1, 'test/sharness/t0050-block.sh': 1, 'test/sharness/t0051-object.sh': 1, 'test/sharness/t0053-dag.sh': 1, 'test/sharness/t0060-daemon.sh': 1, 'test/sharness/t0062-daemon-api.sh': 1, 'test/sharness/t0080-repo.sh': 1, 'test/sharness/t0087-repo-robust-gc.sh': 1, 'test/sharness/t0090-get.sh': 1, 'test/sharness/t0131-multinode-client-routing.sh': 1, 'test/sharness/t0140-swarm.sh': 1, 'test/sharness/t0183-namesys-pubsub.sh': 1, 'test/sharness/t0250-files-api.sh': 1, 'test/sharness/t0270-filestore.sh': 1, 'test/sharness/t0272-urlstore.sh': 1, 'test/sharness/t0410-api-add.sh': 1, 'test/sharness/t0600-issues-and-regressions-online.sh': 1, 'test/sharness_test_coverage_helper.sh': 1, 'thirdparty/README.md': 1, 'assets/bindata_version_hash.go': 2, 'docs/gateway.md': 1, 'assets/dir-index-html': 1, 'test/sharness/t0115-gateway-dir-listing.sh': 1}","('fuse/readonly/ipfs_test.go', 0.43312101910828027, 0.8192771084337349)"
core/corehttp/gateway_indexPage.go,49,239,1,"[{'cyclomatic_complexity': 2, 'nloc': 8, 'token_count': 39, 'name': 'string', 'long_name': '(name string)string', 'start_line': 38, 'end_line': 46, 'full_parameters': [], 'filename': '/home/dimi/Documents/Informatik_Studium/FSS/SoftEvo/DataCollection/FFS_SoftEvo/go-ipfs/core/corehttp/gateway_indexPage.go', 'top_nesting_level': 0, 'length': 9, 'fan_in': 0, 'fan_out': 0, 'general_fan_out': 0}]",103,529,4,"[{'cyclomatic_complexity': 7, 'nloc': 29, 'token_count': 177, 'name': 'breadcrumbs', 'long_name': 'breadcrumbs urlPath string , dnslinkOrigin bool', 'start_line': 38, 'end_line': 75, 'full_parameters': ['urlPath string', ' dnslinkOrigin bool'], 'filename': '/home/dimi/Documents/Informatik_Studium/FSS/SoftEvo/DataCollection/FFS_SoftEvo/go-ipfs/core/corehttp/gateway_indexPage.go', 'top_nesting_level': 0, 'length': 38, 'fan_in': 0, 'fan_out': 0, 'general_fan_out': 0}, {'cyclomatic_complexity': 2, 'nloc': 6, 'token_count': 42, 'name': 'shortHash', 'long_name': 'shortHash hash string', 'start_line': 77, 'end_line': 82, 'full_parameters': ['hash string'], 'filename': '/home/dimi/Documents/Informatik_Studium/FSS/SoftEvo/DataCollection/FFS_SoftEvo/go-ipfs/core/corehttp/gateway_indexPage.go', 'top_nesting_level': 0, 'length': 6, 'fan_in': 0, 'fan_out': 0, 'general_fan_out': 0}, {'cyclomatic_complexity': 2, 'nloc': 7, 'token_count': 44, 'name': 'hasDNSLinkOrigin', 'long_name': 'hasDNSLinkOrigin gwURL string , path string', 'start_line': 86, 'end_line': 92, 'full_parameters': ['gwURL string', ' path string'], 'filename': '/home/dimi/Documents/Informatik_Studium/FSS/SoftEvo/DataCollection/FFS_SoftEvo/go-ipfs/core/corehttp/gateway_indexPage.go', 'top_nesting_level': 0, 'length': 7, 'fan_in': 0, 'fan_out': 0, 'general_fan_out': 0}, {'cyclomatic_complexity': 2, 'nloc': 8, 'token_count': 39, 'name': 'string', 'long_name': '(name string)string', 'start_line': 107, 'end_line': 115, 'full_parameters': [], 'filename': '/home/dimi/Documents/Informatik_Studium/FSS/SoftEvo/DataCollection/FFS_SoftEvo/go-ipfs/core/corehttp/gateway_indexPage.go', 'top_nesting_level': 0, 'length': 9, 'fan_in': 0, 'fan_out': 0, 'general_fan_out': 0}]",54,290,3,6,6,"[{'timestamp': 1541682253.0, 'added_lines': 1, 'deleted_lines': 0, 'nloc': 50}, {'timestamp': 1594352765.0, 'added_lines': 44, 'deleted_lines': 5, 'nloc': 82}, {'timestamp': 1601065604.0, 'added_lines': 17, 'deleted_lines': 2, 'nloc': 93}, {'timestamp': 1601294969.0, 'added_lines': 17, 'deleted_lines': 6, 'nloc': 100}, {'timestamp': 1601339248.0, 'added_lines': 2, 'deleted_lines': 2, 'nloc': 100}, {'timestamp': 1627670033.0, 'added_lines': 3, 'deleted_lines': 0, 'nloc': 103}]","{'assets/assets.go': 1, 'assets/bindata.go': 2, 'core/corehttp/gateway_handler.go': 5, 'core/corehttp/gateway_test.go': 3, 'package.json': 1, 'core/corehttp/hostname.go': 2, 'assets/bindata_version_hash.go': 1, 'assets/dir-index-html': 1, 'test/sharness/t0114-gateway-subdomains.sh': 1, 'test/sharness/t0115-gateway-dir-listing.sh': 1}","('core/corehttp/gateway_handler.go', 0.8333333333333334, 0.03184713375796178)"
core/corehttp/gateway_test.go,447,2964,14,"[{'cyclomatic_complexity': 1, 'nloc': 3, 'token_count': 39, 'name': 'Resolve', 'long_name': '(m mockNamesys)Resolve ctx context . Context , name string', 'start_line': 31, 'end_line': 33, 'full_parameters': ['ctx context . Context', ' name string'], 'filename': '/home/dimi/Documents/Informatik_Studium/FSS/SoftEvo/DataCollection/FFS_SoftEvo/go-ipfs/core/corehttp/gateway_test.go', 'top_nesting_level': 0, 'length': 3, 'fan_in': 0, 'fan_out': 0, 'general_fan_out': 0}, {'cyclomatic_complexity': 2, 'nloc': 7, 'token_count': 52, 'name': 'ResolveN', 'long_name': '(m mockNamesys)ResolveN ctx context . Context , name string , depth int', 'start_line': 35, 'end_line': 41, 'full_parameters': ['ctx context . Context', ' name string', ' depth int'], 'filename': '/home/dimi/Documents/Informatik_Studium/FSS/SoftEvo/DataCollection/FFS_SoftEvo/go-ipfs/core/corehttp/gateway_test.go', 'top_nesting_level': 0, 'length': 7, 'fan_in': 0, 'fan_out': 0, 'general_fan_out': 0}, {'cyclomatic_complexity': 1, 'nloc': 3, 'token_count': 32, 'name': 'Publish', 'long_name': '(m mockNamesys)Publish ctx context . Context , name ci . PrivKey , value path . Path', 'start_line': 43, 'end_line': 45, 'full_parameters': ['ctx context . Context', ' name ci . PrivKey', ' value path . Path'], 'filename': '/home/dimi/Documents/Informatik_Studium/FSS/SoftEvo/DataCollection/FFS_SoftEvo/go-ipfs/core/corehttp/gateway_test.go', 'top_nesting_level': 0, 'length': 3, 'fan_in': 0, 'fan_out': 0, 'general_fan_out': 0}, {'cyclomatic_complexity': 1, 'nloc': 3, 'token_count': 37, 'name': 'PublishWithEOL', 'long_name': '(m mockNamesys)PublishWithEOL ctx context . Context , name ci . PrivKey , value path . Path , _ time . Time', 'start_line': 47, 'end_line': 49, 'full_parameters': ['ctx context . Context', ' name ci . PrivKey', ' value path . Path', ' _ time . Time'], 'filename': '/home/dimi/Documents/Informatik_Studium/FSS/SoftEvo/DataCollection/FFS_SoftEvo/go-ipfs/core/corehttp/gateway_test.go', 'top_nesting_level': 0, 'length': 3, 'fan_in': 0, 'fan_out': 0, 'general_fan_out': 0}, {'cyclomatic_complexity': 2, 'nloc': 17, 'token_count': 98, 'name': 'newNodeWithMockNamesys', 'long_name': 'newNodeWithMockNamesys ns mockNamesys', 'start_line': 51, 'end_line': 67, 'full_parameters': ['ns mockNamesys'], 'filename': '/home/dimi/Documents/Informatik_Studium/FSS/SoftEvo/DataCollection/FFS_SoftEvo/go-ipfs/core/corehttp/gateway_test.go', 'top_nesting_level': 0, 'length': 17, 'fan_in': 0, 'fan_out': 0, 'general_fan_out': 0}, {'cyclomatic_complexity': 1, 'nloc': 3, 'token_count': 31, 'name': 'ServeHTTP', 'long_name': '(dh*delegatedHandler)ServeHTTP w http . ResponseWriter , r * http . Request', 'start_line': 73, 'end_line': 75, 'full_parameters': ['w http . ResponseWriter', ' r * http . Request'], 'filename': '/home/dimi/Documents/Informatik_Studium/FSS/SoftEvo/DataCollection/FFS_SoftEvo/go-ipfs/core/corehttp/gateway_test.go', 'top_nesting_level': 0, 'length': 3, 'fan_in': 0, 'fan_out': 0, 'general_fan_out': 0}, {'cyclomatic_complexity': 1, 'nloc': 4, 'token_count': 28, 'name': 'error', 'long_name': '(req*http.Request,via[]*http.Request)error', 'start_line': 80, 'end_line': 83, 'full_parameters': [], 'filename': '/home/dimi/Documents/Informatik_Studium/FSS/SoftEvo/DataCollection/FFS_SoftEvo/go-ipfs/core/corehttp/gateway_test.go', 'top_nesting_level': 0, 'length': 4, 'fan_in': 0, 'fan_out': 0, 'general_fan_out': 0}, {'cyclomatic_complexity': 4, 'nloc': 23, 'token_count': 142, 'name': 'newTestServerAndNode', 'long_name': 'newTestServerAndNode t * testing . T , ns mockNamesys', 'start_line': 91, 'end_line': 119, 'full_parameters': ['t * testing . T', ' ns mockNamesys'], 'filename': '/home/dimi/Documents/Informatik_Studium/FSS/SoftEvo/DataCollection/FFS_SoftEvo/go-ipfs/core/corehttp/gateway_test.go', 'top_nesting_level': 0, 'length': 29, 'fan_in': 0, 'fan_out': 0, 'general_fan_out': 0}, {'cyclomatic_complexity': 8, 'nloc': 51, 'token_count': 384, 'name': 'TestGatewayGet', 'long_name': 'TestGatewayGet t * testing . T', 'start_line': 121, 'end_line': 174, 'full_parameters': ['t * testing . T'], 'filename': '/home/dimi/Documents/Informatik_Studium/FSS/SoftEvo/DataCollection/FFS_SoftEvo/go-ipfs/core/corehttp/gateway_test.go', 'top_nesting_level': 0, 'length': 54, 'fan_in': 0, 'fan_out': 0, 'general_fan_out': 0}, {'cyclomatic_complexity': 16, 'nloc': 66, 'token_count': 459, 'name': 'TestIPNSHostnameRedirect', 'long_name': 'TestIPNSHostnameRedirect t * testing . T', 'start_line': 176, 'end_line': 258, 'full_parameters': ['t * testing . T'], 'filename': '/home/dimi/Documents/Informatik_Studium/FSS/SoftEvo/DataCollection/FFS_SoftEvo/go-ipfs/core/corehttp/gateway_test.go', 'top_nesting_level': 0, 'length': 83, 'fan_in': 0, 'fan_out': 0, 'general_fan_out': 0}, {'cyclomatic_complexity': 39, 'nloc': 166, 'token_count': 1104, 'name': 'TestIPNSHostnameBacklinks', 'long_name': 'TestIPNSHostnameBacklinks t * testing . T', 'start_line': 260, 'end_line': 461, 'full_parameters': ['t * testing . T'], 'filename': '/home/dimi/Documents/Informatik_Studium/FSS/SoftEvo/DataCollection/FFS_SoftEvo/go-ipfs/core/corehttp/gateway_test.go', 'top_nesting_level': 0, 'length': 202, 'fan_in': 0, 'fan_out': 0, 'general_fan_out': 0}, {'cyclomatic_complexity': 6, 'nloc': 21, 'token_count': 131, 'name': 'TestCacheControlImmutable', 'long_name': 'TestCacheControlImmutable t * testing . T', 'start_line': 463, 'end_line': 487, 'full_parameters': ['t * testing . T'], 'filename': '/home/dimi/Documents/Informatik_Studium/FSS/SoftEvo/DataCollection/FFS_SoftEvo/go-ipfs/core/corehttp/gateway_test.go', 'top_nesting_level': 0, 'length': 25, 'fan_in': 0, 'fan_out': 0, 'general_fan_out': 0}, {'cyclomatic_complexity': 4, 'nloc': 16, 'token_count': 107, 'name': 'TestGoGetSupport', 'long_name': 'TestGoGetSupport t * testing . T', 'start_line': 489, 'end_line': 508, 'full_parameters': ['t * testing . T'], 'filename': '/home/dimi/Documents/Informatik_Studium/FSS/SoftEvo/DataCollection/FFS_SoftEvo/go-ipfs/core/corehttp/gateway_test.go', 'top_nesting_level': 0, 'length': 20, 'fan_in': 0, 'fan_out': 0, 'general_fan_out': 0}, {'cyclomatic_complexity': 7, 'nloc': 29, 'token_count': 197, 'name': 'TestVersion', 'long_name': 'TestVersion t * testing . T', 'start_line': 510, 'end_line': 544, 'full_parameters': ['t * testing . T'], 'filename': '/home/dimi/Documents/Informatik_Studium/FSS/SoftEvo/DataCollection/FFS_SoftEvo/go-ipfs/core/corehttp/gateway_test.go', 'top_nesting_level': 0, 'length': 35, 'fan_in': 0, 'fan_out': 0, 'general_fan_out': 0}]",605,4399,19,"[{'cyclomatic_complexity': 6, 'nloc': 23, 'token_count': 131, 'name': 'Resolve', 'long_name': '(m mockNamesys)Resolve ctx context . Context , name string , opts ... nsopts . ResolveOpt', 'start_line': 37, 'end_line': 61, 'full_parameters': ['ctx context . Context', ' name string', ' opts ... nsopts . ResolveOpt'], 'filename': '/home/dimi/Documents/Informatik_Studium/FSS/SoftEvo/DataCollection/FFS_SoftEvo/go-ipfs/core/corehttp/gateway_test.go', 'top_nesting_level': 0, 'length': 25, 'fan_in': 0, 'fan_out': 0, 'general_fan_out': 0}, {'cyclomatic_complexity': 1, 'nloc': 7, 'token_count': 76, 'name': 'ResolveAsync', 'long_name': '(m mockNamesys)ResolveAsync ctx context . Context , name string , opts ... nsopts . ResolveOpt', 'start_line': 63, 'end_line': 69, 'full_parameters': ['ctx context . Context', ' name string', ' opts ... nsopts . ResolveOpt'], 'filename': '/home/dimi/Documents/Informatik_Studium/FSS/SoftEvo/DataCollection/FFS_SoftEvo/go-ipfs/core/corehttp/gateway_test.go', 'top_nesting_level': 0, 'length': 7, 'fan_in': 0, 'fan_out': 0, 'general_fan_out': 0}, {'cyclomatic_complexity': 1, 'nloc': 3, 'token_count': 32, 'name': 'Publish', 'long_name': '(m mockNamesys)Publish ctx context . Context , name ci . PrivKey , value path . Path', 'start_line': 71, 'end_line': 73, 'full_parameters': ['ctx context . Context', ' name ci . PrivKey', ' value path . Path'], 'filename': '/home/dimi/Documents/Informatik_Studium/FSS/SoftEvo/DataCollection/FFS_SoftEvo/go-ipfs/core/corehttp/gateway_test.go', 'top_nesting_level': 0, 'length': 3, 'fan_in': 0, 'fan_out': 0, 'general_fan_out': 0}, {'cyclomatic_complexity': 1, 'nloc': 3, 'token_count': 37, 'name': 'PublishWithEOL', 'long_name': '(m mockNamesys)PublishWithEOL ctx context . Context , name ci . PrivKey , value path . Path , _ time . Time', 'start_line': 75, 'end_line': 77, 'full_parameters': ['ctx context . Context', ' name ci . PrivKey', ' value path . Path', ' _ time . Time'], 'filename': '/home/dimi/Documents/Informatik_Studium/FSS/SoftEvo/DataCollection/FFS_SoftEvo/go-ipfs/core/corehttp/gateway_test.go', 'top_nesting_level': 0, 'length': 3, 'fan_in': 0, 'fan_out': 0, 'general_fan_out': 0}, {'cyclomatic_complexity': 1, 'nloc': 3, 'token_count': 23, 'name': 'GetResolver', 'long_name': '(m mockNamesys)GetResolver subs string', 'start_line': 79, 'end_line': 81, 'full_parameters': ['subs string'], 'filename': '/home/dimi/Documents/Informatik_Studium/FSS/SoftEvo/DataCollection/FFS_SoftEvo/go-ipfs/core/corehttp/gateway_test.go', 'top_nesting_level': 0, 'length': 3, 'fan_in': 0, 'fan_out': 0, 'general_fan_out': 0}, {'cyclomatic_complexity': 2, 'nloc': 17, 'token_count': 103, 'name': 'newNodeWithMockNamesys', 'long_name': 'newNodeWithMockNamesys ns mockNamesys', 'start_line': 83, 'end_line': 99, 'full_parameters': ['ns mockNamesys'], 'filename': '/home/dimi/Documents/Informatik_Studium/FSS/SoftEvo/DataCollection/FFS_SoftEvo/go-ipfs/core/corehttp/gateway_test.go', 'top_nesting_level': 0, 'length': 17, 'fan_in': 0, 'fan_out': 0, 'general_fan_out': 0}, {'cyclomatic_complexity': 1, 'nloc': 3, 'token_count': 31, 'name': 'ServeHTTP', 'long_name': '(dh*delegatedHandler)ServeHTTP w http . ResponseWriter , r * http . Request', 'start_line': 105, 'end_line': 107, 'full_parameters': ['w http . ResponseWriter', ' r * http . Request'], 'filename': '/home/dimi/Documents/Informatik_Studium/FSS/SoftEvo/DataCollection/FFS_SoftEvo/go-ipfs/core/corehttp/gateway_test.go', 'top_nesting_level': 0, 'length': 3, 'fan_in': 0, 'fan_out': 0, 'general_fan_out': 0}, {'cyclomatic_complexity': 1, 'nloc': 4, 'token_count': 28, 'name': 'error', 'long_name': '(req*http.Request,via[]*http.Request)error', 'start_line': 112, 'end_line': 115, 'full_parameters': [], 'filename': '/home/dimi/Documents/Informatik_Studium/FSS/SoftEvo/DataCollection/FFS_SoftEvo/go-ipfs/core/corehttp/gateway_test.go', 'top_nesting_level': 0, 'length': 4, 'fan_in': 0, 'fan_out': 0, 'general_fan_out': 0}, {'cyclomatic_complexity': 1, 'nloc': 1, 'token_count': 10, 'name': '', 'long_name': '()', 'start_line': 139, 'end_line': 139, 'full_parameters': [], 'filename': '/home/dimi/Documents/Informatik_Studium/FSS/SoftEvo/DataCollection/FFS_SoftEvo/go-ipfs/core/corehttp/gateway_test.go', 'top_nesting_level': 0, 'length': 1, 'fan_in': 0, 'fan_out': 0, 'general_fan_out': 0}, {'cyclomatic_complexity': 5, 'nloc': 28, 'token_count': 179, 'name': 'newTestServerAndNode', 'long_name': 'newTestServerAndNode t * testing . T , ns mockNamesys', 'start_line': 123, 'end_line': 157, 'full_parameters': ['t * testing . T', ' ns mockNamesys'], 'filename': '/home/dimi/Documents/Informatik_Studium/FSS/SoftEvo/DataCollection/FFS_SoftEvo/go-ipfs/core/corehttp/gateway_test.go', 'top_nesting_level': 0, 'length': 35, 'fan_in': 0, 'fan_out': 0, 'general_fan_out': 0}, {'cyclomatic_complexity': 1, 'nloc': 4, 'token_count': 33, 'name': 'matchPathOrBreadcrumbs', 'long_name': 'matchPathOrBreadcrumbs s string , expected string', 'start_line': 159, 'end_line': 162, 'full_parameters': ['s string', ' expected string'], 'filename': '/home/dimi/Documents/Informatik_Studium/FSS/SoftEvo/DataCollection/FFS_SoftEvo/go-ipfs/core/corehttp/gateway_test.go', 'top_nesting_level': 0, 'length': 4, 'fan_in': 0, 'fan_out': 0, 'general_fan_out': 0}, {'cyclomatic_complexity': 6, 'nloc': 40, 'token_count': 343, 'name': 'TestUriQueryRedirect', 'long_name': 'TestUriQueryRedirect t * testing . T', 'start_line': 164, 'end_line': 210, 'full_parameters': ['t * testing . T'], 'filename': '/home/dimi/Documents/Informatik_Studium/FSS/SoftEvo/DataCollection/FFS_SoftEvo/go-ipfs/core/corehttp/gateway_test.go', 'top_nesting_level': 0, 'length': 47, 'fan_in': 0, 'fan_out': 0, 'general_fan_out': 0}, {'cyclomatic_complexity': 9, 'nloc': 67, 'token_count': 650, 'name': 'TestGatewayGet', 'long_name': 'TestGatewayGet t * testing . T', 'start_line': 212, 'end_line': 290, 'full_parameters': ['t * testing . T'], 'filename': '/home/dimi/Documents/Informatik_Studium/FSS/SoftEvo/DataCollection/FFS_SoftEvo/go-ipfs/core/corehttp/gateway_test.go', 'top_nesting_level': 0, 'length': 79, 'fan_in': 0, 'fan_out': 0, 'general_fan_out': 0}, {'cyclomatic_complexity': 9, 'nloc': 55, 'token_count': 449, 'name': 'TestPretty404', 'long_name': 'TestPretty404 t * testing . T', 'start_line': 292, 'end_line': 353, 'full_parameters': ['t * testing . T'], 'filename': '/home/dimi/Documents/Informatik_Studium/FSS/SoftEvo/DataCollection/FFS_SoftEvo/go-ipfs/core/corehttp/gateway_test.go', 'top_nesting_level': 0, 'length': 62, 'fan_in': 0, 'fan_out': 0, 'general_fan_out': 0}, {'cyclomatic_complexity': 15, 'nloc': 67, 'token_count': 483, 'name': 'TestIPNSHostnameRedirect', 'long_name': 'TestIPNSHostnameRedirect t * testing . T', 'start_line': 355, 'end_line': 440, 'full_parameters': ['t * testing . T'], 'filename': '/home/dimi/Documents/Informatik_Studium/FSS/SoftEvo/DataCollection/FFS_SoftEvo/go-ipfs/core/corehttp/gateway_test.go', 'top_nesting_level': 0, 'length': 86, 'fan_in': 0, 'fan_out': 0, 'general_fan_out': 0}, {'cyclomatic_complexity': 42, 'nloc': 177, 'token_count': 1228, 'name': 'TestIPNSHostnameBacklinks', 'long_name': 'TestIPNSHostnameBacklinks t * testing . T', 'start_line': 446, 'end_line': 662, 'full_parameters': ['t * testing . T'], 'filename': '/home/dimi/Documents/Informatik_Studium/FSS/SoftEvo/DataCollection/FFS_SoftEvo/go-ipfs/core/corehttp/gateway_test.go', 'top_nesting_level': 0, 'length': 217, 'fan_in': 0, 'fan_out': 0, 'general_fan_out': 0}, {'cyclomatic_complexity': 6, 'nloc': 20, 'token_count': 129, 'name': 'TestCacheControlImmutable', 'long_name': 'TestCacheControlImmutable t * testing . T', 'start_line': 664, 'end_line': 687, 'full_parameters': ['t * testing . T'], 'filename': '/home/dimi/Documents/Informatik_Studium/FSS/SoftEvo/DataCollection/FFS_SoftEvo/go-ipfs/core/corehttp/gateway_test.go', 'top_nesting_level': 0, 'length': 24, 'fan_in': 0, 'fan_out': 0, 'general_fan_out': 0}, {'cyclomatic_complexity': 4, 'nloc': 15, 'token_count': 105, 'name': 'TestGoGetSupport', 'long_name': 'TestGoGetSupport t * testing . T', 'start_line': 689, 'end_line': 707, 'full_parameters': ['t * testing . T'], 'filename': '/home/dimi/Documents/Informatik_Studium/FSS/SoftEvo/DataCollection/FFS_SoftEvo/go-ipfs/core/corehttp/gateway_test.go', 'top_nesting_level': 0, 'length': 19, 'fan_in': 0, 'fan_out': 0, 'general_fan_out': 0}, {'cyclomatic_complexity': 7, 'nloc': 28, 'token_count': 197, 'name': 'TestVersion', 'long_name': 'TestVersion t * testing . T', 'start_line': 709, 'end_line': 742, 'full_parameters': ['t * testing . T'], 'filename': '/home/dimi/Documents/Informatik_Studium/FSS/SoftEvo/DataCollection/FFS_SoftEvo/go-ipfs/core/corehttp/gateway_test.go', 'top_nesting_level': 0, 'length': 34, 'fan_in': 0, 'fan_out': 0, 'general_fan_out': 0}]",158,1435,5,111,111,"[{'timestamp': 1507304579.0, 'added_lines': 1, 'deleted_lines': 1, 'nloc': 447}, {'timestamp': 1508424715.0, 'added_lines': 1, 'deleted_lines': 1, 'nloc': 447}, {'timestamp': 1511223906.0, 'added_lines': 1, 'deleted_lines': 1, 'nloc': 447}, {'timestamp': 1499441579.0, 'added_lines': 4, 'deleted_lines': 0, 'nloc': 450}, {'timestamp': 1512365669.0, 'added_lines': 1, 'deleted_lines': 1, 'nloc': 450}, {'timestamp': 1516838128.0, 'added_lines': 1, 'deleted_lines': 1, 'nloc': 450}, {'timestamp': 1516919560.0, 'added_lines': 1, 'deleted_lines': 1, 'nloc': 450}, {'timestamp': 1516911711.0, 'added_lines': 11, 'deleted_lines': 5, 'nloc': 454}, {'timestamp': 1517105039.0, 'added_lines': 1, 'deleted_lines': 1, 'nloc': 454}, {'timestamp': 1517453697.0, 'added_lines': 1, 'deleted_lines': 1, 'nloc': 454}, {'timestamp': 1519609615.0, 'added_lines': 1, 'deleted_lines': 5, 'nloc': 451}, {'timestamp': 1519855044.0, 'added_lines': 2, 'deleted_lines': 1, 'nloc': 452}, {'timestamp': 1519765635.0, 'added_lines': 3, 'deleted_lines': 2, 'nloc': 453}, {'timestamp': 1525408792.0, 'added_lines': 4, 'deleted_lines': 4, 'nloc': 453}, {'timestamp': 1524678804.0, 'added_lines': 30, 'deleted_lines': 4, 'nloc': 477}, {'timestamp': 1528131220.0, 'added_lines': 1, 'deleted_lines': 1, 'nloc': 477}, {'timestamp': 1528268108.0, 'added_lines': 1, 'deleted_lines': 1, 'nloc': 477}, {'timestamp': 1528520460.0, 'added_lines': 1, 'deleted_lines': 1, 'nloc': 477}, {'timestamp': 1529984485.0, 'added_lines': 1, 'deleted_lines': 1, 'nloc': 477}, {'timestamp': 1530947910.0, 'added_lines': 4, 'deleted_lines': 1, 'nloc': 480}, {'timestamp': 1528311650.0, 'added_lines': 1, 'deleted_lines': 1, 'nloc': 480}, {'timestamp': 1532146078.0, 'added_lines': 1, 'deleted_lines': 1, 'nloc': 480}, {'timestamp': 1532764253.0, 'added_lines': 1, 'deleted_lines': 1, 'nloc': 480}, {'timestamp': 1532847462.0, 'added_lines': 1, 'deleted_lines': 1, 'nloc': 480}, {'timestamp': 1533500571.0, 'added_lines': 2, 'deleted_lines': 2, 'nloc': 480}, {'timestamp': 1533618653.0, 'added_lines': 2, 'deleted_lines': 2, 'nloc': 480}, {'timestamp': 1533779477.0, 'added_lines': 4, 'deleted_lines': 4, 'nloc': 480}, {'timestamp': 1532365899.0, 'added_lines': 3, 'deleted_lines': 3, 'nloc': 480}, {'timestamp': 1532388583.0, 'added_lines': 1, 'deleted_lines': 1, 'nloc': 480}, {'timestamp': 1532507240.0, 'added_lines': 2, 'deleted_lines': 1, 'nloc': 481}, {'timestamp': 1533809170.0, 'added_lines': 2, 'deleted_lines': 2, 'nloc': 481}, {'timestamp': 1534115707.0, 'added_lines': 2, 'deleted_lines': 2, 'nloc': 481}, {'timestamp': 1534195762.0, 'added_lines': 4, 'deleted_lines': 4, 'nloc': 481}, {'timestamp': 1534347022.0, 'added_lines': 2, 'deleted_lines': 2, 'nloc': 481}, {'timestamp': 1534072974.0, 'added_lines': 1, 'deleted_lines': 1, 'nloc': 481}, {'timestamp': 1534896611.0, 'added_lines': 4, 'deleted_lines': 4, 'nloc': 481}, {'timestamp': 1535255498.0, 'added_lines': 1, 'deleted_lines': 1, 'nloc': 481}, {'timestamp': 1535601896.0, 'added_lines': 4, 'deleted_lines': 4, 'nloc': 481}, {'timestamp': 1536256817.0, 'added_lines': 18, 'deleted_lines': 1, 'nloc': 494}, {'timestamp': 1536388808.0, 'added_lines': 6, 'deleted_lines': 6, 'nloc': 481}, {'timestamp': 1536718784.0, 'added_lines': 2, 'deleted_lines': 2, 'nloc': 481}, {'timestamp': 1536723292.0, 'added_lines': 2, 'deleted_lines': 2, 'nloc': 481}, {'timestamp': 1537790637.0, 'added_lines': 2, 'deleted_lines': 2, 'nloc': 494}, {'timestamp': 1537792589.0, 'added_lines': 6, 'deleted_lines': 6, 'nloc': 494}, {'timestamp': 1535411172.0, 'added_lines': 9, 'deleted_lines': 1, 'nloc': 501}, {'timestamp': 1538544957.0, 'added_lines': 6, 'deleted_lines': 6, 'nloc': 494}, {'timestamp': 1538547366.0, 'added_lines': 1, 'deleted_lines': 1, 'nloc': 494}, {'timestamp': 1538694687.0, 'added_lines': 2, 'deleted_lines': 2, 'nloc': 494}, {'timestamp': 1538695953.0, 'added_lines': 3, 'deleted_lines': 3, 'nloc': 494}, {'timestamp': 1538692589.0, 'added_lines': 6, 'deleted_lines': 0, 'nloc': 500}, {'timestamp': 1538714527.0, 'added_lines': 6, 'deleted_lines': 0, 'nloc': 500}, {'timestamp': 1538763876.0, 'added_lines': 3, 'deleted_lines': 1, 'nloc': 500}, {'timestamp': 1538773916.0, 'added_lines': 5, 'deleted_lines': 5, 'nloc': 500}, {'timestamp': 1539176817.0, 'added_lines': 3, 'deleted_lines': 3, 'nloc': 500}, {'timestamp': 1539357340.0, 'added_lines': 3, 'deleted_lines': 3, 'nloc': 500}, {'timestamp': 1539682860.0, 'added_lines': 1, 'deleted_lines': 1, 'nloc': 507}, {'timestamp': 1540400358.0, 'added_lines': 4, 'deleted_lines': 4, 'nloc': 507}, {'timestamp': 1540410565.0, 'added_lines': 3, 'deleted_lines': 3, 'nloc': 507}, {'timestamp': 1540418491.0, 'added_lines': 3, 'deleted_lines': 3, 'nloc': 507}, {'timestamp': 1540489644.0, 'added_lines': 1, 'deleted_lines': 1, 'nloc': 507}, {'timestamp': 1540603818.0, 'added_lines': 2, 'deleted_lines': 2, 'nloc': 507}, {'timestamp': 1540916861.0, 'added_lines': 1, 'deleted_lines': 1, 'nloc': 507}, {'timestamp': 1540920976.0, 'added_lines': 1, 'deleted_lines': 1, 'nloc': 507}, {'timestamp': 1541189794.0, 'added_lines': 2, 'deleted_lines': 2, 'nloc': 507}, {'timestamp': 1541204121.0, 'added_lines': 5, 'deleted_lines': 5, 'nloc': 507}, {'timestamp': 1541903826.0, 'added_lines': 5, 'deleted_lines': 5, 'nloc': 507}, {'timestamp': 1543282933.0, 'added_lines': 1, 'deleted_lines': 1, 'nloc': 507}, {'timestamp': 1543443696.0, 'added_lines': 2, 'deleted_lines': 2, 'nloc': 507}, {'timestamp': 1544225843.0, 'added_lines': 4, 'deleted_lines': 4, 'nloc': 507}, {'timestamp': 1545323704.0, 'added_lines': 1, 'deleted_lines': 1, 'nloc': 507}, {'timestamp': 1546553605.0, 'added_lines': 1, 'deleted_lines': 1, 'nloc': 507}, {'timestamp': 1541682253.0, 'added_lines': 15, 'deleted_lines': 0, 'nloc': 522}, {'timestamp': 1547003974.0, 'added_lines': 4, 'deleted_lines': 4, 'nloc': 522}, {'timestamp': 1547499910.0, 'added_lines': 2, 'deleted_lines': 2, 'nloc': 522}, {'timestamp': 1548165641.0, 'added_lines': 56, 'deleted_lines': 69, 'nloc': 508}, {'timestamp': 1548866534.0, 'added_lines': 1, 'deleted_lines': 1, 'nloc': 508}, {'timestamp': 1549588289.0, 'added_lines': 3, 'deleted_lines': 3, 'nloc': 508}, {'timestamp': 1549650181.0, 'added_lines': 1, 'deleted_lines': 1, 'nloc': 508}, {'timestamp': 1549672857.0, 'added_lines': 3, 'deleted_lines': 3, 'nloc': 508}, {'timestamp': 1549673846.0, 'added_lines': 3, 'deleted_lines': 3, 'nloc': 508}, {'timestamp': 1549903582.0, 'added_lines': 4, 'deleted_lines': 4, 'nloc': 508}, {'timestamp': 1550185115.0, 'added_lines': 5, 'deleted_lines': 5, 'nloc': 508}, {'timestamp': 1550507829.0, 'added_lines': 9, 'deleted_lines': 9, 'nloc': 508}, {'timestamp': 1550576884.0, 'added_lines': 3, 'deleted_lines': 3, 'nloc': 508}, {'timestamp': 1550711994.0, 'added_lines': 4, 'deleted_lines': 4, 'nloc': 508}, {'timestamp': 1550723346.0, 'added_lines': 5, 'deleted_lines': 5, 'nloc': 508}, {'timestamp': 1551229859.0, 'added_lines': 6, 'deleted_lines': 6, 'nloc': 508}, {'timestamp': 1551299964.0, 'added_lines': 5, 'deleted_lines': 5, 'nloc': 508}, {'timestamp': 1551756943.0, 'added_lines': 2, 'deleted_lines': 2, 'nloc': 507}, {'timestamp': 1551551196.0, 'added_lines': 10, 'deleted_lines': 10, 'nloc': 507}, {'timestamp': 1551650987.0, 'added_lines': 3, 'deleted_lines': 2, 'nloc': 508}, {'timestamp': 1551707448.0, 'added_lines': 2, 'deleted_lines': 2, 'nloc': 508}, {'timestamp': 1552254637.0, 'added_lines': 0, 'deleted_lines': 1, 'nloc': 507}, {'timestamp': 1553697989.0, 'added_lines': 1, 'deleted_lines': 7, 'nloc': 503}, {'timestamp': 1553608614.0, 'added_lines': 3, 'deleted_lines': 2, 'nloc': 504}, {'timestamp': 1559060517.0, 'added_lines': 1, 'deleted_lines': 1, 'nloc': 504}, {'timestamp': 1569537492.0, 'added_lines': 1, 'deleted_lines': 1, 'nloc': 504}, {'timestamp': 1551228784.0, 'added_lines': 13, 'deleted_lines': 13, 'nloc': 504}, {'timestamp': 1552609298.0, 'added_lines': 9, 'deleted_lines': 9, 'nloc': 504}, {'timestamp': 1587942680.0, 'added_lines': 3, 'deleted_lines': 3, 'nloc': 504}, {'timestamp': 1588979785.0, 'added_lines': 64, 'deleted_lines': 0, 'nloc': 560}, {'timestamp': 1590026869.0, 'added_lines': 3, 'deleted_lines': 3, 'nloc': 560}, {'timestamp': 1595098027.0, 'added_lines': 1, 'deleted_lines': 7, 'nloc': 554}, {'timestamp': 1595733213.0, 'added_lines': 11, 'deleted_lines': 5, 'nloc': 565}, {'timestamp': 1601065604.0, 'added_lines': 5, 'deleted_lines': 3, 'nloc': 559}, {'timestamp': 1601339248.0, 'added_lines': 11, 'deleted_lines': 1, 'nloc': 565}, {'timestamp': 1607184160.0, 'added_lines': 41, 'deleted_lines': 0, 'nloc': 601}, {'timestamp': 1607737396.0, 'added_lines': 8, 'deleted_lines': 2, 'nloc': 604}, {'timestamp': 1610653862.0, 'added_lines': 1, 'deleted_lines': 0, 'nloc': 605}, {'timestamp': 1613691223.0, 'added_lines': 1, 'deleted_lines': 1, 'nloc': 605}, {'timestamp': 1632249068.0, 'added_lines': 1, 'deleted_lines': 1, 'nloc': 605}]","{'core/bootstrap.go': 38, 'core/bootstrap_test.go': 36, 'core/commands/dht.go': 57, 'core/commands/dht_test.go': 26, 'core/commands/id.go': 42, 'core/commands/pubsub.go': 38, 'core/core.go': 73, 'core/corehttp/gateway.go': 47, 'core/corehttp/metrics_test.go': 38, 'core/mock/mock.go': 50, 'exchange/bitswap/bitswap_test.go': 13, 'exchange/bitswap/decision/bench_test.go': 8, 'exchange/bitswap/decision/engine_test.go': 9, 'exchange/bitswap/decision/peer_request_queue_test.go': 8, 'exchange/bitswap/network/ipfs_impl.go': 10, 'exchange/bitswap/testnet/interface.go': 8, 'exchange/bitswap/testnet/network_test.go': 10, 'exchange/bitswap/testnet/peernet.go': 13, 'exchange/bitswap/testnet/virtual.go': 10, 'exchange/bitswap/testutils.go': 13, 'exchange/reprovide/reprovide_test.go': 37, 'fuse/ipns/ipns_test.go': 35, 'fuse/node/mount_test.go': 34, 'fuse/readonly/ipfs_test.go': 56, 'mfs/repub_test.go': 11, 'namesys/publisher_test.go': 35, 'namesys/republisher/repub_test.go': 56, 'namesys/resolve_test.go': 53, 'p2p/p2p.go': 28, 'package.json': 67, 'routing/mock/centralized_client.go': 5, 'routing/mock/centralized_server.go': 5, 'routing/mock/centralized_test.go': 5, 'routing/mock/interface.go': 5, 'routing/none/none_client.go': 5, 'routing/offline/offline_test.go': 5, 'test/integration/addcat_test.go': 42, 'test/integration/bench_cat_test.go': 42, 'test/integration/bench_test.go': 20, 'test/integration/bitswap_wo_routing_test.go': 41, 'test/integration/three_legged_cat_test.go': 42, 'thirdparty/ipfsaddr/ipfsaddr.go': 2, 'core/commands/swarm.go': 47, 'cmd/ipfs/daemon.go': 26, 'cmd/ipfs/init.go': 33, 'cmd/ipfs/ipfs.go': 17, 'cmd/ipfs/main.go': 37, 'cmd/ipfs/main_test.go': 2, 'cmd/ipfswatch/main.go': 30, 'cmd/seccat/seccat.go': 28, 'commands/cli/helptext.go': 1, 'commands/cli/helptext_test.go': 1, 'commands/cli/parse.go': 1, 'commands/cli/parse_test.go': 1, 'commands/command.go': 12, 'commands/command_test.go': 5, 'commands/http/client.go': 1, 'commands/http/handler.go': 1, 'commands/http/multifilereader.go': 1, 'commands/http/multifilereader_test.go': 1, 'commands/http/parse.go': 1, 'commands/request.go': 24, 'commands/response.go': 7, 'commands/response_test.go': 5, 'core/commands/active.go': 9, 'core/commands/add.go': 41, 'core/commands/bitswap.go': 46, 'core/commands/block.go': 28, 'core/commands/bootstrap.go': 29, 'core/commands/cat.go': 25, 'core/commands/commands.go': 18, 'core/commands/config.go': 30, 'core/commands/dag/dag.go': 52, 'core/commands/diag.go': 9, 'core/commands/dns.go': 20, 'core/commands/external.go': 9, 'core/commands/files/files.go': 5, 'core/commands/filestore.go': 21, 'core/commands/get.go': 55, 'core/commands/get_test.go': 17, 'core/commands/helptext_test.go': 17, 'core/commands/ipns.go': 13, 'core/commands/keystore.go': 23, 'core/commands/log.go': 15, 'core/commands/ls.go': 53, 'core/commands/mount_nofuse.go': 9, 'core/commands/mount_unix.go': 29, 'core/commands/name.go': 5, 'core/commands/object/diff.go': 19, 'core/commands/object/object.go': 53, 'core/commands/object/patch.go': 26, 'core/commands/p2p.go': 24, 'core/commands/pin.go': 54, 'core/commands/ping.go': 30, 'core/commands/publish.go': 15, 'core/commands/refs.go': 47, 'core/commands/repo.go': 46, 'core/commands/resolve.go': 52, 'core/commands/root.go': 17, 'core/commands/shutdown.go': 12, 'core/commands/stat.go': 23, 'core/commands/sysdiag.go': 18, 'core/commands/tar.go': 47, 'core/commands/unixfs/ls.go': 49, 'core/commands/unixfs/unixfs.go': 9, 'core/commands/version.go': 12, 'core/corehttp/commands.go': 62, 'core/coreunix/add.go': 57, 'core/coreunix/add_test.go': 66, 'exchange/bitswap/message/message.go': 8, 'exchange/bitswap/network/interface.go': 8, 'importer/helpers/dagbuilder.go': 8, 'importer/importer.go': 7, 'p2p/registry.go': 12, 'repo/config/bootstrap_peers.go': 12, 'core/builder.go': 63, 'core/commands/ipnsps.go': 6, 'core/commands/mount_windows.go': 9, 'namesys/interface.go': 50, 'namesys/namesys.go': 59, 'namesys/namesys_test.go': 58, 'namesys/pubsub.go': 7, 'namesys/pubsub_test.go': 7, 'test/sharness/t0183-namesys-pubsub.sh': 1, 'assets/assets.go': 48, 'blocks/blockstore/arc_cache.go': 2, 'blocks/blockstore/arc_cache_test.go': 2, 'blocks/blockstore/blockstore.go': 3, 'blocks/blockstore/blockstore_test.go': 2, 'blocks/blockstore/bloom_cache.go': 2, 'blocks/blockstore/bloom_cache_test.go': 2, 'blocks/blockstore/util/remove.go': 2, 'blocks/blocksutil/block_generator.go': 2, 'blockservice/blockservice.go': 8, 'blockservice/blockservice_test.go': 6, 'blockservice/test/blocks_test.go': 7, 'core/coreapi/coreapi.go': 28, 'core/coreapi/interface/interface.go': 2, 'core/coreapi/unixfs.go': 49, 'core/coreapi/unixfs_test.go': 47, 'core/coredag/cbor.go': 16, 'core/coredag/dagpb.go': 42, 'core/coredag/dagtransl.go': 12, 'core/coredag/raw.go': 42, 'core/corehttp/corehttp.go': 16, 'core/corehttp/gateway_handler.go': 67, 'core/corerepo/gc.go': 46, 'core/corerepo/pinning.go': 18, 'core/coreunix/metadata.go': 45, 'core/coreunix/metadata_test.go': 49, 'core/pathresolver.go': 47, 'exchange/bitswap/bitswap.go': 7, 'exchange/bitswap/decision/engine.go': 7, 'exchange/bitswap/decision/ledger.go': 6, 'exchange/bitswap/decision/peer_request_queue.go': 6, 'exchange/bitswap/get.go': 6, 'exchange/bitswap/message/message_test.go': 3, 'exchange/bitswap/notifications/notifications.go': 3, 'exchange/bitswap/notifications/notifications_test.go': 3, 'exchange/bitswap/session.go': 7, 'exchange/bitswap/session_test.go': 5, 'exchange/bitswap/stat.go': 3, 'exchange/bitswap/wantlist/wantlist.go': 3, 'exchange/bitswap/wantlist/wantlist_test.go': 3, 'exchange/bitswap/wantmanager.go': 7, 'exchange/bitswap/workers.go': 6, 'exchange/interface.go': 2, 'exchange/offline/offline.go': 2, 'exchange/offline/offline_test.go': 2, 'exchange/reprovide/providers.go': 46, 'exchange/reprovide/reprovide.go': 28, 'filestore/filestore.go': 26, 'filestore/filestore_test.go': 45, 'filestore/fsrefstore.go': 25, 'filestore/util.go': 23, 'fuse/ipns/ipns_unix.go': 51, 'fuse/readonly/readonly_unix.go': 51, 'importer/balanced/balanced_test.go': 7, 'importer/balanced/builder.go': 3, 'importer/chunk/rabin_test.go': 2, 'importer/chunk/splitting_test.go': 2, 'importer/helpers/helpers.go': 5, 'importer/importer_test.go': 7, 'importer/trickle/trickle_test.go': 7, 'importer/trickle/trickledag.go': 4, 'merkledag/batch.go': 2, 'merkledag/coding.go': 3, 'merkledag/merkledag.go': 4, 'merkledag/merkledag_test.go': 7, 'merkledag/node.go': 4, 'merkledag/node_test.go': 4, 'merkledag/raw.go': 3, 'merkledag/traverse/traverse.go': 3, 'merkledag/traverse/traverse_test.go': 4, 'merkledag/utils/diff.go': 4, 'merkledag/utils/diffenum.go': 3, 'merkledag/utils/diffenum_test.go': 4, 'merkledag/utils/utils.go': 7, 'merkledag/utils/utils_test.go': 4, 'mfs/dir.go': 11, 'mfs/file.go': 13, 'mfs/mfs_test.go': 15, 'mfs/ops.go': 10, 'mfs/system.go': 14, 'namesys/ipns_select_test.go': 4, 'namesys/publisher.go': 51, 'namesys/republisher/repub.go': 47, 'namesys/routing.go': 58, 'path/path.go': 3, 'path/resolver.go': 4, 'path/resolver_test.go': 3, 'pin/gc/gc.go': 47, 'pin/pin.go': 46, 'pin/pin_test.go': 47, 'pin/set.go': 43, 'pin/set_test.go': 45, 'plugin/ipld.go': 12, 'plugin/loader/initializer.go': 9, 'plugin/plugins/git/git.go': 12, 'repo/config/init.go': 7, 'repo/fsrepo/fsrepo.go': 35, 'repo/fsrepo/lock/lock.go': 3, 'repo/fsrepo/serialize/serialize.go': 3, 'repo/mock.go': 28, 'repo/repo.go': 32, 'routing/offline/offline.go': 3, 'tar/format.go': 50, 'test/dependencies/ma-pipe-unidir/main.go': 11, 'thirdparty/ds-help/key.go': 2, 'thirdparty/pollEndpoint/main.go': 15, 'thirdparty/posinfo/posinfo.go': 2, 'unixfs/archive/archive.go': 4, 'unixfs/archive/tar/writer.go': 5, 'unixfs/hamt/hamt.go': 5, 'unixfs/io/dagreader.go': 5, 'unixfs/io/dirbuilder.go': 4, 'unixfs/io/resolve.go': 5, 'unixfs/mod/dagmodifier.go': 7, 'unixfs/mod/dagmodifier_test.go': 3, 'unixfs/test/utils.go': 7, 'commands/legacy/command.go': 10, 'commands/legacy/legacy.go': 10, 'commands/legacy/legacy_test.go': 10, 'commands/legacy/request.go': 10, 'commands/legacy/response.go': 10, 'core/commands/commands_test.go': 15, 'core/coreapi/dag.go': 12, 'core/coreapi/dag_test.go': 3, 'core/coreapi/interface/options/dag.go': 7, 'core/coreapi/key.go': 51, 'core/coreapi/name.go': 56, 'merkledag/test/utils.go': 6, 'repo/fsrepo/datastores.go': 16, 'repo/fsrepo/fsrepo_test.go': 28, 'thirdparty/datastore2/datastore_closer.go': 1, 'thirdparty/datastore2/delayed.go': 1, 'thirdparty/datastore2/threadsafe.go': 1, 'unixfs/io/pbdagreader.go': 4, 'core/coreapi/key_test.go': 1, None: 47, 'mfs/fd.go': 7, 'unixfs/hamt/hamt_stress_test.go': 3, 'unixfs/hamt/hamt_test.go': 3, 'unixfs/io/dagreader_test.go': 2, 'unixfs/io/dirbuilder_test.go': 1, 'cmd/ipfs/util/ulimit.go': 9, 'cmd/seccat/util.go': 9, 'core/corehttp/logs.go': 9, 'fuse/mount/mount.go': 9, 'fuse/node/mount_unix.go': 10, 'importer/chunk/splitting.go': 1, 'namesys/ipns_validate_test.go': 6, 'plugin/loader/load.go': 7, 'core/corehttp/ipns_hostname.go': 15, 'namesys/base.go': 48, 'namesys/dns.go': 48, 'namesys/dns_test.go': 12, 'namesys/opts/opts.go': 1, 'namesys/proquint.go': 46, 'core/core_test.go': 28, 'repo/fsrepo/config_test.go': 24, 'blocks/blockstoreutil/remove.go': 21, 'blockservice/test/mock.go': 5, 'core/commands/files.go': 52, 'core/coreapi/pin.go': 48, 'fuse/ipns/common.go': 45, 'keystore/keystore.go': 9, 'keystore/keystore_test.go': 7, 'keystore/memkeystore.go': 6, 'namesys/validator.go': 3, 'path/resolver/resolver.go': 4, 'repo/config/identity.go': 2, 'thirdparty/verifbs/verifbs.go': 21, 'cmd/ipfs/util/ulimit_freebsd.go': 2, 'cmd/ipfs/util/ulimit_unix.go': 2, 'core/coreapi/block.go': 18, 'core/coreapi/block_test.go': 2, 'core/coreapi/interface/coreapi.go': 8, 'core/coreapi/interface/dag.go': 8, 'core/coreapi/interface/object.go': 8, 'core/coreapi/interface/options/block.go': 3, 'core/coreapi/interface/path.go': 34, 'core/coreapi/interface/unixfs.go': 10, 'core/coreapi/object.go': 46, 'fuse/ipns/link_unix.go': 2, 'fuse/mount/fuse.go': 3, 'fuse/node/mount_darwin.go': 2, 'merkledag/errservice.go': 1, 'merkledag/readonly.go': 1, 'merkledag/readonly_test.go': 1, 'merkledag/rwservice.go': 1, 'merkledag/session.go': 1, 'path/resolver/resolver_test.go': 2, 'thirdparty/verifcid/validate.go': 1, 'thirdparty/verifcid/validate_test.go': 1, 'namesys/ipns_resolver_validation_test.go': 47, 'test/sharness/t0170-dht.sh': 1, 'core/corehttp/metrics.go': 2, 'Rules.mk': 1, 'dagutils/diff.go': 44, 'dagutils/diffenum.go': 39, 'dagutils/diffenum_test.go': 39, 'dagutils/utils.go': 42, 'dagutils/utils_test.go': 41, 'unixfs/io/directory.go': 1, 'unixfs/io/directory_test.go': 1, 'unixfs/unixfs.go': 1, 'core/coreapi/name_test.go': 30, 'core/coreapi/path.go': 47, 'core/coreunix/cat.go': 14, 'core/pathresolver_test.go': 40, 'namesys/cache.go': 40, 'core/commands/urlstore.go': 40, 'core/commands/env.go': 6, 'core/coreapi/interface/key.go': 7, 'filestore/pb/dataobj.pb.go': 3, 'pin/internal/pb/header.pb.go': 3, 'thirdparty/cidv0v1/blockstore.go': 16, 'cmd/ipfs/Rules.mk': 1, 'core/corehttp/option_test.go': 4, 'docs/releases.md': 2, 'docs/windows.md': 2, 'repo/fsrepo/misc.go': 23, 'repo/version.go': 1, 'test/bench/bench_cli_ipfs_add/main.go': 24, 'test/bench/offline_add/main.go': 24, 'version.go': 3, 'core/commands/cmdenv/env.go': 27, 'core/commands/name/ipns.go': 39, 'core/commands/name/publish.go': 21, 'core/coreapi/dht.go': 35, 'core/coreapi/dht_test.go': 5, 'test/sharness/t0275-cid-security.sh': 1, 'core/commands/name/ipnsps.go': 12, 'core/commands/name/name.go': 7, 'core/coreapi/interface/dht.go': 10, 'p2p/listener.go': 14, 'p2p/local.go': 14, 'p2p/remote.go': 15, 'p2p/stream.go': 15, 'core/coreapi/interface/swarm.go': 9, 'core/coreapi/swarm.go': 25, 'core/coreapi/interface/options/unixfs.go': 15, 'core/coreapi/pubsub.go': 24, 'core/coreapi/unixfile.go': 14, 'core/coreapi/interface/name.go': 1, 'cmd/ipfs/dnsresolve_test.go': 5, 'core/coreapi/interface/pubsub.go': 4, 'test/sharness/t0180-pubsub.sh': 1, 'core/commands/cid.go': 8, 'test/dependencies/iptb/iptb.go': 15, 'plugin/plugins/badgerds/badgerds.go': 3, 'plugin/plugins/flatfs/flatfs.go': 3, 'plugin/plugins/levelds/levelds.go': 3, 'commands/context.go': 17, 'core/corehttp/proxy.go': 10, 'core/coreapi/test/api_test.go': 16, 'assets/bindata.go': 1, 'core/corehttp/gateway_indexPage.go': 3, 'core/coreapi/interface/tests/name.go': 4, 'core/coreapi/interface/tests/unixfs.go': 4, 'plugin/loader/loader.go': 13, 'core/commands/cmdenv/cidbase.go': 6, 'core/commands/cmdenv/file.go': 3, 'core/coreapi/interface/options/name.go': 1, 'core/coreapi/interface/options/namesys/opts.go': 1, 'plugin/daemon.go': 10, 'core/commands/cmdenv/cidbase_test.go': 2, 'core/corehttp/proxy_test.go': 3, 'core/corerepo/stat.go': 1, 'plugin/tracer.go': 1, 'thirdparty/notifier/notifier.go': 1, 'go.mod': 4, 'go.sum': 4, 'commands/reqlog.go': 1, 'core/corehttp/mutex_profile.go': 1, 'provider/queue.go': 1, 'provider/queue_test.go': 1, 'core/bootstrap/bootstrap.go': 1, 'core/bootstrap/bootstrap_test.go': 1, 'core/node/builder.go': 1, 'core/node/core.go': 1, 'core/node/groups.go': 2, 'core/node/identity.go': 1, 'core/node/ipns.go': 2, 'core/node/libp2p/addrs.go': 1, 'core/node/libp2p/discovery.go': 1, 'core/node/libp2p/host.go': 1, 'core/node/libp2p/hostopt.go': 1, 'core/node/libp2p/libp2p.go': 3, 'core/node/libp2p/nat.go': 1, 'core/node/libp2p/pnet.go': 1, 'core/node/libp2p/pubsub.go': 1, 'core/node/libp2p/routing.go': 1, 'core/node/libp2p/routingopt.go': 1, 'core/node/libp2p/smux.go': 1, 'core/node/libp2p/transport.go': 1, 'core/node/provider.go': 1, 'provider/simple/provider.go': 1, 'provider/simple/provider_test.go': 1, 'provider/simple/reprovide.go': 1, 'provider/simple/reprovide_test.go': 1, 'repo/fsrepo/migrations/migrations.go': 1, 'core/corehttp/hostname.go': 3, 'core/corehttp/hostname_test.go': 1, 'docs/config.md': 1, 'docs/environment-variables.md': 1, 'test/sharness/t0111-gateway-writeable.sh': 2, 'test/sharness/t0114-gateway-subdomains.sh': 2, 'test/sharness/t0160-resolve.sh': 1, 'test/sharness/t0184-http-proxy-over-p2p.sh': 1, 'test/sharness/t0115-gateway-dir-listing.sh': 1, 'test/sharness/t0026-id.sh': 1}","('core/core.go', 0.6576576576576577, 0.40782122905027934)"
core/corehttp/logs.go,51,275,6,"[{'cyclomatic_complexity': 1, 'nloc': 7, 'token_count': 44, 'name': 'newWriteErrNotifier', 'long_name': 'newWriteErrNotifier w io . Writer', 'start_line': 17, 'end_line': 23, 'full_parameters': ['w io . Writer'], 'filename': '/home/dimi/Documents/Informatik_Studium/FSS/SoftEvo/DataCollection/FFS_SoftEvo/go-ipfs/core/corehttp/logs.go', 'top_nesting_level': 0, 'length': 7, 'fan_in': 0, 'fan_out': 0, 'general_fan_out': 0}, {'cyclomatic_complexity': 4, 'nloc': 13, 'token_count': 78, 'name': 'Write', 'long_name': '(w*writeErrNotifier)Write b [ ] byte', 'start_line': 25, 'end_line': 37, 'full_parameters': ['b [ ] byte'], 'filename': '/home/dimi/Documents/Informatik_Studium/FSS/SoftEvo/DataCollection/FFS_SoftEvo/go-ipfs/core/corehttp/logs.go', 'top_nesting_level': 0, 'length': 13, 'fan_in': 0, 'fan_out': 0, 'general_fan_out': 0}, {'cyclomatic_complexity': 2, 'nloc': 7, 'token_count': 29, 'name': 'Close', 'long_name': '(w*writeErrNotifier)Close', 'start_line': 39, 'end_line': 45, 'full_parameters': [], 'filename': '/home/dimi/Documents/Informatik_Studium/FSS/SoftEvo/DataCollection/FFS_SoftEvo/go-ipfs/core/corehttp/logs.go', 'top_nesting_level': 0, 'length': 7, 'fan_in': 0, 'fan_out': 0, 'general_fan_out': 0}, {'cyclomatic_complexity': 1, 'nloc': 7, 'token_count': 52, 'name': '', 'long_name': '(w http.ResponseWriter,r*http.Request)', 'start_line': 49, 'end_line': 55, 'full_parameters': [], 'filename': '/home/dimi/Documents/Informatik_Studium/FSS/SoftEvo/DataCollection/FFS_SoftEvo/go-ipfs/core/corehttp/logs.go', 'top_nesting_level': 0, 'length': 7, 'fan_in': 0, 'fan_out': 0, 'general_fan_out': 0}, {'cyclomatic_complexity': 1, 'nloc': 4, 'token_count': 41, 'name': '', 'long_name': '(n*core.IpfsNode,_net.Listener,mux*http.ServeMux)(*http.ServeMux,error)', 'start_line': 48, 'end_line': 57, 'full_parameters': [], 'filename': '/home/dimi/Documents/Informatik_Studium/FSS/SoftEvo/DataCollection/FFS_SoftEvo/go-ipfs/core/corehttp/logs.go', 'top_nesting_level': 0, 'length': 10, 'fan_in': 0, 'fan_out': 0, 'general_fan_out': 0}, {'cyclomatic_complexity': 1, 'nloc': 3, 'token_count': 9, 'name': 'LogOption', 'long_name': 'LogOption', 'start_line': 47, 'end_line': 58, 'full_parameters': [], 'filename': '/home/dimi/Documents/Informatik_Studium/FSS/SoftEvo/DataCollection/FFS_SoftEvo/go-ipfs/core/corehttp/logs.go', 'top_nesting_level': 0, 'length': 12, 'fan_in': 0, 'fan_out': 0, 'general_fan_out': 0}]",51,275,6,"[{'cyclomatic_complexity': 1, 'nloc': 7, 'token_count': 44, 'name': 'newWriteErrNotifier', 'long_name': 'newWriteErrNotifier w io . Writer', 'start_line': 17, 'end_line': 23, 'full_parameters': ['w io . Writer'], 'filename': '/home/dimi/Documents/Informatik_Studium/FSS/SoftEvo/DataCollection/FFS_SoftEvo/go-ipfs/core/corehttp/logs.go', 'top_nesting_level': 0, 'length': 7, 'fan_in': 0, 'fan_out': 0, 'general_fan_out': 0}, {'cyclomatic_complexity': 4, 'nloc': 13, 'token_count': 78, 'name': 'Write', 'long_name': '(w*writeErrNotifier)Write b [ ] byte', 'start_line': 25, 'end_line': 37, 'full_parameters': ['b [ ] byte'], 'filename': '/home/dimi/Documents/Informatik_Studium/FSS/SoftEvo/DataCollection/FFS_SoftEvo/go-ipfs/core/corehttp/logs.go', 'top_nesting_level': 0, 'length': 13, 'fan_in': 0, 'fan_out': 0, 'general_fan_out': 0}, {'cyclomatic_complexity': 2, 'nloc': 7, 'token_count': 29, 'name': 'Close', 'long_name': '(w*writeErrNotifier)Close', 'start_line': 39, 'end_line': 45, 'full_parameters': [], 'filename': '/home/dimi/Documents/Informatik_Studium/FSS/SoftEvo/DataCollection/FFS_SoftEvo/go-ipfs/core/corehttp/logs.go', 'top_nesting_level': 0, 'length': 7, 'fan_in': 0, 'fan_out': 0, 'general_fan_out': 0}, {'cyclomatic_complexity': 1, 'nloc': 7, 'token_count': 52, 'name': '', 'long_name': '(w http.ResponseWriter,r*http.Request)', 'start_line': 49, 'end_line': 55, 'full_parameters': [], 'filename': '/home/dimi/Documents/Informatik_Studium/FSS/SoftEvo/DataCollection/FFS_SoftEvo/go-ipfs/core/corehttp/logs.go', 'top_nesting_level': 0, 'length': 7, 'fan_in': 0, 'fan_out': 0, 'general_fan_out': 0}, {'cyclomatic_complexity': 1, 'nloc': 4, 'token_count': 41, 'name': '', 'long_name': '(n*core.IpfsNode,_net.Listener,mux*http.ServeMux)(*http.ServeMux,error)', 'start_line': 48, 'end_line': 57, 'full_parameters': [], 'filename': '/home/dimi/Documents/Informatik_Studium/FSS/SoftEvo/DataCollection/FFS_SoftEvo/go-ipfs/core/corehttp/logs.go', 'top_nesting_level': 0, 'length': 10, 'fan_in': 0, 'fan_out': 0, 'general_fan_out': 0}, {'cyclomatic_complexity': 1, 'nloc': 3, 'token_count': 9, 'name': 'LogOption', 'long_name': 'LogOption', 'start_line': 47, 'end_line': 58, 'full_parameters': [], 'filename': '/home/dimi/Documents/Informatik_Studium/FSS/SoftEvo/DataCollection/FFS_SoftEvo/go-ipfs/core/corehttp/logs.go', 'top_nesting_level': 0, 'length': 12, 'fan_in': 0, 'fan_out': 0, 'general_fan_out': 0}]",0,0,0,10,10,"[{'timestamp': 1517453697.0, 'added_lines': 1, 'deleted_lines': 1, 'nloc': 51}, {'timestamp': 1525408792.0, 'added_lines': 1, 'deleted_lines': 1, 'nloc': 51}, {'timestamp': 1528520460.0, 'added_lines': 2, 'deleted_lines': 2, 'nloc': 51}, {'timestamp': 1529984485.0, 'added_lines': 1, 'deleted_lines': 1, 'nloc': 51}, {'timestamp': 1533779477.0, 'added_lines': 1, 'deleted_lines': 1, 'nloc': 51}, {'timestamp': 1537792589.0, 'added_lines': 1, 'deleted_lines': 1, 'nloc': 51}, {'timestamp': 1541204121.0, 'added_lines': 1, 'deleted_lines': 1, 'nloc': 51}, {'timestamp': 1550507829.0, 'added_lines': 1, 'deleted_lines': 1, 'nloc': 51}, {'timestamp': 1551551196.0, 'added_lines': 1, 'deleted_lines': 1, 'nloc': 51}, {'timestamp': 1579220333.0, 'added_lines': 1, 'deleted_lines': 1, 'nloc': 51}]","{'blocks/blockstore/blockstore.go': 1, 'blockservice/blockservice.go': 4, 'cmd/ipfs/daemon.go': 9, 'cmd/ipfs/ipfs.go': 9, 'cmd/ipfs/main.go': 9, 'cmd/ipfs/util/ulimit.go': 9, 'cmd/seccat/seccat.go': 9, 'cmd/seccat/util.go': 9, 'commands/command.go': 7, 'commands/command_test.go': 1, 'commands/legacy/command.go': 7, 'commands/legacy/legacy.go': 7, 'commands/legacy/legacy_test.go': 7, 'commands/legacy/request.go': 7, 'commands/legacy/response.go': 7, 'commands/request.go': 7, 'commands/response.go': 2, 'commands/response_test.go': 1, 'core/bootstrap.go': 9, 'core/bootstrap_test.go': 9, 'core/builder.go': 9, 'core/commands/add.go': 9, 'core/commands/bitswap.go': 9, 'core/commands/block.go': 9, 'core/commands/cat.go': 9, 'core/commands/commands.go': 9, 'core/commands/commands_test.go': 9, 'core/commands/dag/dag.go': 7, 'core/commands/dht.go': 9, 'core/commands/dht_test.go': 9, 'core/commands/files/files.go': 1, 'core/commands/filestore.go': 9, 'core/commands/get.go': 9, 'core/commands/get_test.go': 9, 'core/commands/helptext_test.go': 9, 'core/commands/id.go': 9, 'core/commands/keystore.go': 9, 'core/commands/log.go': 9, 'core/commands/object/patch.go': 9, 'core/commands/ping.go': 9, 'core/commands/publish.go': 5, 'core/commands/pubsub.go': 9, 'core/commands/repo.go': 9, 'core/commands/root.go': 9, 'core/commands/stat.go': 9, 'core/commands/swarm.go': 9, 'core/core.go': 9, 'core/coreapi/key.go': 9, 'core/coreapi/name.go': 9, 'core/coreapi/unixfs_test.go': 7, 'core/corehttp/commands.go': 9, 'core/corehttp/corehttp.go': 9, 'core/corehttp/gateway.go': 9, 'core/corehttp/gateway_handler.go': 9, 'core/corehttp/gateway_test.go': 9, 'core/corehttp/metrics_test.go': 9, 'core/corerepo/gc.go': 10, 'core/coreunix/add.go': 9, 'core/mock/mock.go': 9, 'core/pathresolver.go': 9, 'exchange/bitswap/bitswap.go': 4, 'exchange/bitswap/bitswap_test.go': 4, 'exchange/bitswap/decision/bench_test.go': 4, 'exchange/bitswap/decision/engine.go': 4, 'exchange/bitswap/decision/engine_test.go': 4, 'exchange/bitswap/decision/ledger.go': 4, 'exchange/bitswap/decision/peer_request_queue.go': 4, 'exchange/bitswap/decision/peer_request_queue_test.go': 4, 'exchange/bitswap/message/message.go': 4, 'exchange/bitswap/network/interface.go': 4, 'exchange/bitswap/network/ipfs_impl.go': 4, 'exchange/bitswap/session.go': 4, 'exchange/bitswap/testnet/interface.go': 4, 'exchange/bitswap/testnet/network_test.go': 4, 'exchange/bitswap/testnet/peernet.go': 4, 'exchange/bitswap/testnet/virtual.go': 4, 'exchange/bitswap/testutils.go': 4, 'exchange/bitswap/wantmanager.go': 4, 'exchange/bitswap/workers.go': 4, 'exchange/reprovide/reprovide.go': 9, 'exchange/reprovide/reprovide_test.go': 9, 'filestore/filestore.go': 9, 'fuse/ipns/ipns_test.go': 9, 'fuse/ipns/ipns_unix.go': 9, 'fuse/mount/mount.go': 9, 'fuse/node/mount_test.go': 9, 'fuse/node/mount_unix.go': 9, 'fuse/readonly/ipfs_test.go': 9, 'fuse/readonly/readonly_unix.go': 10, 'importer/chunk/splitting.go': 1, 'mfs/repub_test.go': 5, 'mfs/system.go': 5, 'namesys/ipns_validate_test.go': 3, 'namesys/namesys.go': 9, 'namesys/publisher.go': 9, 'namesys/publisher_test.go': 9, 'namesys/pubsub.go': 2, 'namesys/pubsub_test.go': 2, 'namesys/republisher/repub.go': 9, 'namesys/republisher/repub_test.go': 9, 'namesys/resolve_test.go': 9, 'namesys/routing.go': 9, 'p2p/p2p.go': 9, 'p2p/registry.go': 5, 'package.json': 8, 'path/resolver.go': 1, 'pin/gc/gc.go': 9, 'pin/pin.go': 9, 'plugin/loader/load.go': 7, 'repo/config/bootstrap_peers.go': 5, 'repo/config/init.go': 5, 'repo/fsrepo/datastores.go': 9, 'repo/fsrepo/fsrepo.go': 9, 'repo/fsrepo/lock/lock.go': 1, 'routing/mock/centralized_client.go': 1, 'routing/mock/centralized_server.go': 1, 'routing/mock/centralized_test.go': 1, 'routing/mock/interface.go': 1, 'routing/none/none_client.go': 1, 'routing/offline/offline.go': 1, 'routing/offline/offline_test.go': 1, 'tar/format.go': 9, 'test/integration/addcat_test.go': 9, 'test/integration/bench_cat_test.go': 9, 'test/integration/bench_test.go': 9, 'test/integration/bitswap_wo_routing_test.go': 9, 'test/integration/three_legged_cat_test.go': 9, 'thirdparty/pollEndpoint/main.go': 9, 'blocks/blockstoreutil/remove.go': 8, 'blockservice/blockservice_test.go': 3, 'blockservice/test/blocks_test.go': 3, 'blockservice/test/mock.go': 3, 'cmd/ipfs/init.go': 8, 'core/commands/files.go': 8, 'core/commands/ipns.go': 4, 'core/commands/ls.go': 8, 'core/commands/object/object.go': 8, 'core/commands/pin.go': 8, 'core/core_test.go': 5, 'core/coreapi/pin.go': 8, 'core/coreunix/add_test.go': 8, 'core/coreunix/metadata_test.go': 8, 'exchange/bitswap/get.go': 3, 'exchange/bitswap/session_test.go': 3, 'exchange/reprovide/providers.go': 8, 'filestore/filestore_test.go': 8, 'filestore/fsrefstore.go': 8, 'filestore/util.go': 8, 'fuse/ipns/common.go': 6, 'importer/balanced/balanced_test.go': 3, 'importer/helpers/dagbuilder.go': 3, 'importer/importer.go': 3, 'importer/importer_test.go': 3, 'importer/trickle/trickle_test.go': 3, 'keystore/keystore.go': 8, 'keystore/keystore_test.go': 5, 'keystore/memkeystore.go': 5, 'merkledag/merkledag_test.go': 3, 'merkledag/test/utils.go': 3, 'merkledag/utils/utils.go': 3, 'mfs/file.go': 4, 'mfs/mfs_test.go': 4, 'namesys/interface.go': 6, 'namesys/ipns_select_test.go': 2, 'namesys/namesys_test.go': 8, 'namesys/validator.go': 2, 'path/resolver/resolver.go': 3, 'pin/pin_test.go': 8, 'pin/set_test.go': 8, 'repo/config/identity.go': 2, 'repo/fsrepo/fsrepo_test.go': 5, 'repo/repo.go': 7, 'thirdparty/verifbs/verifbs.go': 8, 'unixfs/mod/dagmodifier.go': 3, 'unixfs/test/utils.go': 3, 'assets/assets.go': 6, 'cmd/ipfs/util/ulimit_freebsd.go': 2, 'cmd/ipfs/util/ulimit_unix.go': 2, 'cmd/ipfswatch/main.go': 5, 'core/commands/active.go': 3, 'core/commands/bootstrap.go': 5, 'core/commands/config.go': 5, 'core/commands/diag.go': 3, 'core/commands/dns.go': 4, 'core/commands/external.go': 3, 'core/commands/ipnsps.go': 3, 'core/commands/mount_nofuse.go': 3, 'core/commands/mount_unix.go': 5, 'core/commands/mount_windows.go': 3, 'core/commands/name.go': 1, 'core/commands/object/diff.go': 4, 'core/commands/p2p.go': 6, 'core/commands/refs.go': 6, 'core/commands/resolve.go': 6, 'core/commands/shutdown.go': 6, 'core/commands/sysdiag.go': 5, 'core/commands/tar.go': 6, 'core/commands/unixfs/ls.go': 6, 'core/commands/unixfs/unixfs.go': 3, 'core/commands/version.go': 4, 'core/coreapi/block.go': 4, 'core/coreapi/block_test.go': 2, 'core/coreapi/coreapi.go': 4, 'core/coreapi/dag.go': 3, 'core/coreapi/dag_test.go': 2, 'core/coreapi/interface/coreapi.go': 2, 'core/coreapi/interface/dag.go': 2, 'core/coreapi/interface/object.go': 2, 'core/coreapi/interface/options/block.go': 2, 'core/coreapi/interface/options/dag.go': 2, 'core/coreapi/interface/path.go': 4, 'core/coreapi/interface/unixfs.go': 2, 'core/coreapi/object.go': 6, 'core/coreapi/unixfs.go': 6, 'core/coredag/cbor.go': 4, 'core/coredag/dagpb.go': 6, 'core/coredag/dagtransl.go': 3, 'core/coredag/raw.go': 6, 'core/corerepo/pinning.go': 4, 'core/coreunix/metadata.go': 6, 'exchange/bitswap/message/message_test.go': 1, 'exchange/bitswap/notifications/notifications.go': 1, 'exchange/bitswap/notifications/notifications_test.go': 1, 'exchange/bitswap/stat.go': 1, 'exchange/bitswap/wantlist/wantlist.go': 1, 'exchange/bitswap/wantlist/wantlist_test.go': 1, 'fuse/ipns/link_unix.go': 2, 'fuse/mount/fuse.go': 2, 'fuse/node/mount_darwin.go': 2, 'importer/balanced/builder.go': 1, 'importer/helpers/helpers.go': 1, 'importer/trickle/trickledag.go': 1, 'merkledag/coding.go': 1, 'merkledag/errservice.go': 1, 'merkledag/merkledag.go': 1, 'merkledag/node.go': 1, 'merkledag/node_test.go': 1, 'merkledag/raw.go': 1, 'merkledag/readonly.go': 1, 'merkledag/readonly_test.go': 1, 'merkledag/rwservice.go': 1, 'merkledag/session.go': 1, 'merkledag/traverse/traverse.go': 1, 'merkledag/traverse/traverse_test.go': 1, 'merkledag/utils/diff.go': 1, 'merkledag/utils/diffenum.go': 1, 'merkledag/utils/diffenum_test.go': 1, 'merkledag/utils/utils_test.go': 1, 'mfs/dir.go': 2, 'mfs/ops.go': 2, 'path/path.go': 1, 'path/resolver/resolver_test.go': 1, 'pin/set.go': 6, 'plugin/ipld.go': 3, 'plugin/loader/initializer.go': 2, 'plugin/plugins/git/git.go': 3, 'repo/fsrepo/serialize/serialize.go': 1, 'repo/mock.go': 6, 'test/dependencies/ma-pipe-unidir/main.go': 4, 'thirdparty/verifcid/validate.go': 1, 'thirdparty/verifcid/validate_test.go': 1, 'unixfs/archive/archive.go': 1, 'unixfs/archive/tar/writer.go': 1, 'unixfs/hamt/hamt.go': 1, 'unixfs/hamt/hamt_stress_test.go': 1, 'unixfs/hamt/hamt_test.go': 1, 'unixfs/io/dagreader.go': 1, 'unixfs/io/dirbuilder.go': 1, 'unixfs/io/pbdagreader.go': 1, 'unixfs/io/resolve.go': 1, 'unixfs/mod/dagmodifier_test.go': 1, 'namesys/ipns_resolver_validation_test.go': 6, 'test/sharness/t0170-dht.sh': 1, 'core/commands/env.go': 1, 'core/commands/urlstore.go': 5, 'core/coreapi/interface/key.go': 3, 'core/coreapi/name_test.go': 3, 'core/coreapi/path.go': 5, 'core/coreunix/cat.go': 2, 'core/pathresolver_test.go': 5, 'dagutils/diff.go': 5, 'dagutils/diffenum.go': 5, 'dagutils/diffenum_test.go': 5, 'dagutils/utils.go': 5, 'dagutils/utils_test.go': 5, 'filestore/pb/dataobj.pb.go': 3, 'mfs/fd.go': 1, 'namesys/base.go': 5, 'namesys/cache.go': 5, 'namesys/dns.go': 5, 'namesys/proquint.go': 5, 'pin/internal/pb/header.pb.go': 3, 'thirdparty/cidv0v1/blockstore.go': 5, 'core/commands/cmdenv/env.go': 4, 'core/commands/name/ipns.go': 4, 'core/commands/name/ipnsps.go': 4, 'core/commands/name/name.go': 4, 'core/commands/name/publish.go': 4, 'core/coreapi/dht.go': 4, 'core/coreapi/dht_test.go': 2, 'core/coreapi/interface/dht.go': 2, 'p2p/listener.go': 4, 'p2p/local.go': 4, 'p2p/remote.go': 4, 'p2p/stream.go': 4, 'repo/fsrepo/config_test.go': 4, 'repo/fsrepo/misc.go': 4, 'test/bench/bench_cli_ipfs_add/main.go': 4, 'test/bench/offline_add/main.go': 4, 'cmd/ipfs/dnsresolve_test.go': 2, 'core/commands/cid.go': 3, 'core/coreapi/interface/options/unixfs.go': 1, 'core/coreapi/interface/pubsub.go': 1, 'core/coreapi/interface/swarm.go': 1, 'core/coreapi/pubsub.go': 3, 'core/coreapi/swarm.go': 3, 'core/coreapi/unixfile.go': 1, 'test/dependencies/iptb/iptb.go': 3, 'commands/context.go': 2, 'core/commands/cmdenv/cidbase.go': 2, 'core/coreapi/test/api_test.go': 2, 'core/corehttp/ipns_hostname.go': 2, 'core/corehttp/proxy.go': 2, 'namesys/dns_test.go': 2, 'plugin/daemon.go': 2, 'plugin/loader/loader.go': 2, 'plugin/plugins/badgerds/badgerds.go': 2, 'plugin/plugins/flatfs/flatfs.go': 2, 'plugin/plugins/levelds/levelds.go': 2, 'core/commands/cmdenv/cidbase_test.go': 1, 'core/commands/cmdenv/file.go': 1, 'core/corehttp/metrics.go': 1, 'core/corehttp/proxy_test.go': 1, 'core/corerepo/stat.go': 1, 'plugin/tracer.go': 1, 'thirdparty/notifier/notifier.go': 1, 'core/bootstrap/bootstrap.go': 1, 'gc/gc.go': 1, 'go.sum': 1, 'namesys/resolve/resolve.go': 1}","('core/corerepo/gc.go', 1.0, 0.1694915254237288)"
core/corehttp/metrics.go,55,342,7,"[{'cyclomatic_complexity': 1, 'nloc': 4, 'token_count': 45, 'name': '', 'long_name': '(n*core.IpfsNode,_net.Listener,mux*http.ServeMux)(*http.ServeMux,error)', 'start_line': 14, 'end_line': 17, 'full_parameters': [], 'filename': '/home/dimi/Documents/Informatik_Studium/FSS/SoftEvo/DataCollection/FFS_SoftEvo/go-ipfs/core/corehttp/metrics.go', 'top_nesting_level': 0, 'length': 4, 'fan_in': 0, 'fan_out': 0, 'general_fan_out': 0}, {'cyclomatic_complexity': 1, 'nloc': 3, 'token_count': 11, 'name': 'MetricsScrapingOption', 'long_name': 'MetricsScrapingOption path string', 'start_line': 13, 'end_line': 18, 'full_parameters': ['path string'], 'filename': '/home/dimi/Documents/Informatik_Studium/FSS/SoftEvo/DataCollection/FFS_SoftEvo/go-ipfs/core/corehttp/metrics.go', 'top_nesting_level': 0, 'length': 6, 'fan_in': 0, 'fan_out': 0, 'general_fan_out': 0}, {'cyclomatic_complexity': 1, 'nloc': 5, 'token_count': 55, 'name': '', 'long_name': '(_*core.IpfsNode,_net.Listener,mux*http.ServeMux)(*http.ServeMux,error)', 'start_line': 22, 'end_line': 26, 'full_parameters': [], 'filename': '/home/dimi/Documents/Informatik_Studium/FSS/SoftEvo/DataCollection/FFS_SoftEvo/go-ipfs/core/corehttp/metrics.go', 'top_nesting_level': 0, 'length': 5, 'fan_in': 0, 'fan_out': 0, 'general_fan_out': 0}, {'cyclomatic_complexity': 1, 'nloc': 3, 'token_count': 11, 'name': 'MetricsCollectionOption', 'long_name': 'MetricsCollectionOption handlerName string', 'start_line': 21, 'end_line': 27, 'full_parameters': ['handlerName string'], 'filename': '/home/dimi/Documents/Informatik_Studium/FSS/SoftEvo/DataCollection/FFS_SoftEvo/go-ipfs/core/corehttp/metrics.go', 'top_nesting_level': 0, 'length': 7, 'fan_in': 0, 'fan_out': 0, 'general_fan_out': 0}, {'cyclomatic_complexity': 1, 'nloc': 3, 'token_count': 22, 'name': 'Describe', 'long_name': '(_IpfsNodeCollector)Describe ch chan < - * prometheus . Desc', 'start_line': 39, 'end_line': 41, 'full_parameters': ['ch chan < - * prometheus . Desc'], 'filename': '/home/dimi/Documents/Informatik_Studium/FSS/SoftEvo/DataCollection/FFS_SoftEvo/go-ipfs/core/corehttp/metrics.go', 'top_nesting_level': 0, 'length': 3, 'fan_in': 0, 'fan_out': 0, 'general_fan_out': 0}, {'cyclomatic_complexity': 2, 'nloc': 10, 'token_count': 48, 'name': 'Collect', 'long_name': '(c IpfsNodeCollector)Collect ch chan < - prometheus . Metric', 'start_line': 43, 'end_line': 52, 'full_parameters': ['ch chan < - prometheus . Metric'], 'filename': '/home/dimi/Documents/Informatik_Studium/FSS/SoftEvo/DataCollection/FFS_SoftEvo/go-ipfs/core/corehttp/metrics.go', 'top_nesting_level': 0, 'length': 10, 'fan_in': 0, 'fan_out': 0, 'general_fan_out': 0}, {'cyclomatic_complexity': 4, 'nloc': 14, 'token_count': 100, 'name': 'PeersTotalValues', 'long_name': '(c IpfsNodeCollector)PeersTotalValues', 'start_line': 54, 'end_line': 67, 'full_parameters': [], 'filename': '/home/dimi/Documents/Informatik_Studium/FSS/SoftEvo/DataCollection/FFS_SoftEvo/go-ipfs/core/corehttp/metrics.go', 'top_nesting_level': 0, 'length': 14, 'fan_in': 0, 'fan_out': 0, 'general_fan_out': 0}]",142,904,10,"[{'cyclomatic_complexity': 1, 'nloc': 4, 'token_count': 54, 'name': '', 'long_name': '(n*core.IpfsNode,_net.Listener,mux*http.ServeMux)(*http.ServeMux,error)', 'start_line': 19, 'end_line': 22, 'full_parameters': [], 'filename': '/home/dimi/Documents/Informatik_Studium/FSS/SoftEvo/DataCollection/FFS_SoftEvo/go-ipfs/core/corehttp/metrics.go', 'top_nesting_level': 0, 'length': 4, 'fan_in': 0, 'fan_out': 0, 'general_fan_out': 0}, {'cyclomatic_complexity': 1, 'nloc': 3, 'token_count': 11, 'name': 'MetricsScrapingOption', 'long_name': 'MetricsScrapingOption path string', 'start_line': 18, 'end_line': 23, 'full_parameters': ['path string'], 'filename': '/home/dimi/Documents/Informatik_Studium/FSS/SoftEvo/DataCollection/FFS_SoftEvo/go-ipfs/core/corehttp/metrics.go', 'top_nesting_level': 0, 'length': 6, 'fan_in': 0, 'fan_out': 0, 'general_fan_out': 0}, {'cyclomatic_complexity': 1, 'nloc': 3, 'token_count': 17, 'name': '', 'long_name': '(err error)', 'start_line': 34, 'end_line': 36, 'full_parameters': [], 'filename': '/home/dimi/Documents/Informatik_Studium/FSS/SoftEvo/DataCollection/FFS_SoftEvo/go-ipfs/core/corehttp/metrics.go', 'top_nesting_level': 0, 'length': 3, 'fan_in': 0, 'fan_out': 0, 'general_fan_out': 0}, {'cyclomatic_complexity': 2, 'nloc': 17, 'token_count': 114, 'name': '', 'long_name': '(_*core.IpfsNode,_net.Listener,mux*http.ServeMux)(*http.ServeMux,error)', 'start_line': 27, 'end_line': 51, 'full_parameters': [], 'filename': '/home/dimi/Documents/Informatik_Studium/FSS/SoftEvo/DataCollection/FFS_SoftEvo/go-ipfs/core/corehttp/metrics.go', 'top_nesting_level': 0, 'length': 25, 'fan_in': 0, 'fan_out': 0, 'general_fan_out': 0}, {'cyclomatic_complexity': 1, 'nloc': 3, 'token_count': 9, 'name': 'MetricsOpenCensusCollectionOption', 'long_name': 'MetricsOpenCensusCollectionOption', 'start_line': 26, 'end_line': 52, 'full_parameters': [], 'filename': '/home/dimi/Documents/Informatik_Studium/FSS/SoftEvo/DataCollection/FFS_SoftEvo/go-ipfs/core/corehttp/metrics.go', 'top_nesting_level': 0, 'length': 27, 'fan_in': 0, 'fan_out': 0, 'general_fan_out': 0}, {'cyclomatic_complexity': 9, 'nloc': 63, 'token_count': 462, 'name': '', 'long_name': '(_*core.IpfsNode,_net.Listener,mux*http.ServeMux)(*http.ServeMux,error)', 'start_line': 56, 'end_line': 127, 'full_parameters': [], 'filename': '/home/dimi/Documents/Informatik_Studium/FSS/SoftEvo/DataCollection/FFS_SoftEvo/go-ipfs/core/corehttp/metrics.go', 'top_nesting_level': 0, 'length': 72, 'fan_in': 0, 'fan_out': 0, 'general_fan_out': 0}, {'cyclomatic_complexity': 1, 'nloc': 3, 'token_count': 11, 'name': 'MetricsCollectionOption', 'long_name': 'MetricsCollectionOption handlerName string', 'start_line': 55, 'end_line': 128, 'full_parameters': ['handlerName string'], 'filename': '/home/dimi/Documents/Informatik_Studium/FSS/SoftEvo/DataCollection/FFS_SoftEvo/go-ipfs/core/corehttp/metrics.go', 'top_nesting_level': 0, 'length': 74, 'fan_in': 0, 'fan_out': 0, 'general_fan_out': 0}, {'cyclomatic_complexity': 1, 'nloc': 3, 'token_count': 22, 'name': 'Describe', 'long_name': '(_IpfsNodeCollector)Describe ch chan < - * prometheus . Desc', 'start_line': 143, 'end_line': 145, 'full_parameters': ['ch chan < - * prometheus . Desc'], 'filename': '/home/dimi/Documents/Informatik_Studium/FSS/SoftEvo/DataCollection/FFS_SoftEvo/go-ipfs/core/corehttp/metrics.go', 'top_nesting_level': 0, 'length': 3, 'fan_in': 0, 'fan_out': 0, 'general_fan_out': 0}, {'cyclomatic_complexity': 2, 'nloc': 10, 'token_count': 48, 'name': 'Collect', 'long_name': '(c IpfsNodeCollector)Collect ch chan < - prometheus . Metric', 'start_line': 147, 'end_line': 156, 'full_parameters': ['ch chan < - prometheus . Metric'], 'filename': '/home/dimi/Documents/Informatik_Studium/FSS/SoftEvo/DataCollection/FFS_SoftEvo/go-ipfs/core/corehttp/metrics.go', 'top_nesting_level': 0, 'length': 10, 'fan_in': 0, 'fan_out': 0, 'general_fan_out': 0}, {'cyclomatic_complexity': 4, 'nloc': 14, 'token_count': 100, 'name': 'PeersTotalValues', 'long_name': '(c IpfsNodeCollector)PeersTotalValues', 'start_line': 158, 'end_line': 171, 'full_parameters': [], 'filename': '/home/dimi/Documents/Informatik_Studium/FSS/SoftEvo/DataCollection/FFS_SoftEvo/go-ipfs/core/corehttp/metrics.go', 'top_nesting_level': 0, 'length': 14, 'fan_in': 0, 'fan_out': 0, 'general_fan_out': 0}]",87,562,3,15,15,"[{'timestamp': 1532146078.0, 'added_lines': 1, 'deleted_lines': 1, 'nloc': 55}, {'timestamp': 1540939129.0, 'added_lines': 70, 'deleted_lines': 3, 'nloc': 113}, {'timestamp': 1540987955.0, 'added_lines': 2, 'deleted_lines': 2, 'nloc': 113}, {'timestamp': 1551551196.0, 'added_lines': 2, 'deleted_lines': 2, 'nloc': 113}, {'timestamp': 1559692105.0, 'added_lines': 3, 'deleted_lines': 0, 'nloc': 116}, {'timestamp': 1559693988.0, 'added_lines': 5, 'deleted_lines': 1, 'nloc': 119}, {'timestamp': 1559694893.0, 'added_lines': 2, 'deleted_lines': 2, 'nloc': 119}, {'timestamp': 1568509671.0, 'added_lines': 1, 'deleted_lines': 1, 'nloc': 119}, {'timestamp': 1571791571.0, 'added_lines': 1, 'deleted_lines': 0, 'nloc': 120}, {'timestamp': 1595559566.0, 'added_lines': 43, 'deleted_lines': 4, 'nloc': 150}, {'timestamp': 1601339707.0, 'added_lines': 2, 'deleted_lines': 2, 'nloc': 150}, {'timestamp': 1607482009.0, 'added_lines': 1, 'deleted_lines': 1, 'nloc': 150}, {'timestamp': 1615940142.0, 'added_lines': 4, 'deleted_lines': 5, 'nloc': 149}, {'timestamp': 1616216076.0, 'added_lines': 0, 'deleted_lines': 5, 'nloc': 145}, {'timestamp': 1564463657.0, 'added_lines': 6, 'deleted_lines': 10, 'nloc': 142}]","{'blocks/blockstoreutil/remove.go': 2, 'blockservice/blockservice.go': 1, 'blockservice/blockservice_test.go': 1, 'blockservice/test/blocks_test.go': 1, 'cmd/ipfs/daemon.go': 4, 'core/builder.go': 2, 'core/commands/add.go': 2, 'core/commands/files.go': 2, 'core/commands/id.go': 2, 'core/commands/ls.go': 2, 'core/commands/pin.go': 2, 'core/commands/pubsub.go': 2, 'core/commands/repo.go': 2, 'core/commands/swarm.go': 2, 'core/core.go': 2, 'core/coreapi/pin.go': 2, 'core/corehttp/gateway.go': 2, 'core/corehttp/gateway_test.go': 2, 'core/corehttp/metrics_test.go': 2, 'core/coreunix/add.go': 2, 'core/coreunix/add_test.go': 2, 'core/coreunix/metadata_test.go': 2, 'core/mock/mock.go': 2, 'exchange/bitswap/bitswap.go': 1, 'exchange/bitswap/bitswap_test.go': 1, 'exchange/bitswap/decision/engine.go': 1, 'exchange/bitswap/decision/engine_test.go': 1, 'exchange/bitswap/get.go': 1, 'exchange/bitswap/testnet/peernet.go': 1, 'exchange/bitswap/testutils.go': 1, 'exchange/bitswap/wantmanager.go': 1, 'exchange/reprovide/providers.go': 2, 'exchange/reprovide/reprovide_test.go': 2, 'filestore/filestore.go': 2, 'filestore/filestore_test.go': 2, 'filestore/fsrefstore.go': 2, 'filestore/util.go': 2, 'merkledag/merkledag_test.go': 1, 'merkledag/test/utils.go': 1, 'merkledag/utils/utils.go': 1, 'mfs/mfs_test.go': 1, 'namesys/republisher/repub_test.go': 2, 'namesys/routing.go': 2, 'package.json': 2, 'pin/gc/gc.go': 2, 'pin/pin_test.go': 2, 'pin/set_test.go': 2, 'repo/config/bootstrap_peers.go': 1, 'repo/fsrepo/datastores.go': 2, 'repo/fsrepo/fsrepo.go': 2, 'test/integration/addcat_test.go': 2, 'test/integration/bench_cat_test.go': 2, 'test/integration/bitswap_wo_routing_test.go': 2, 'test/integration/three_legged_cat_test.go': 2, 'thirdparty/verifbs/verifbs.go': 2, 'assets/assets.go': 1, 'cmd/ipfs/dnsresolve_test.go': 1, 'cmd/ipfs/init.go': 1, 'cmd/ipfs/ipfs.go': 1, 'cmd/ipfs/main.go': 1, 'cmd/ipfs/util/ulimit.go': 1, 'cmd/ipfs/util/ulimit_freebsd.go': 1, 'cmd/ipfs/util/ulimit_unix.go': 1, 'cmd/ipfswatch/main.go': 1, 'cmd/seccat/seccat.go': 1, 'cmd/seccat/util.go': 1, 'commands/context.go': 1, 'core/bootstrap.go': 1, 'core/bootstrap_test.go': 1, 'core/commands/active.go': 1, 'core/commands/bitswap.go': 1, 'core/commands/block.go': 1, 'core/commands/bootstrap.go': 1, 'core/commands/cat.go': 1, 'core/commands/cid.go': 1, 'core/commands/cmdenv/cidbase.go': 1, 'core/commands/cmdenv/cidbase_test.go': 1, 'core/commands/cmdenv/env.go': 1, 'core/commands/cmdenv/file.go': 1, 'core/commands/commands.go': 1, 'core/commands/commands_test.go': 1, 'core/commands/config.go': 1, 'core/commands/dag/dag.go': 1, 'core/commands/dht.go': 1, 'core/commands/dht_test.go': 1, 'core/commands/diag.go': 1, 'core/commands/dns.go': 1, 'core/commands/external.go': 1, 'core/commands/filestore.go': 1, 'core/commands/get.go': 1, 'core/commands/get_test.go': 1, 'core/commands/helptext_test.go': 1, 'core/commands/keystore.go': 1, 'core/commands/log.go': 1, 'core/commands/mount_nofuse.go': 1, 'core/commands/mount_unix.go': 1, 'core/commands/mount_windows.go': 1, 'core/commands/name/ipns.go': 1, 'core/commands/name/ipnsps.go': 1, 'core/commands/name/name.go': 1, 'core/commands/name/publish.go': 1, 'core/commands/object/diff.go': 1, 'core/commands/object/object.go': 1, 'core/commands/object/patch.go': 1, 'core/commands/p2p.go': 1, 'core/commands/ping.go': 1, 'core/commands/refs.go': 1, 'core/commands/resolve.go': 1, 'core/commands/root.go': 1, 'core/commands/shutdown.go': 1, 'core/commands/stat.go': 1, 'core/commands/sysdiag.go': 1, 'core/commands/tar.go': 1, 'core/commands/unixfs/ls.go': 1, 'core/commands/unixfs/unixfs.go': 1, 'core/commands/urlstore.go': 1, 'core/commands/version.go': 1, 'core/core_test.go': 1, 'core/coreapi/block.go': 1, 'core/coreapi/coreapi.go': 1, 'core/coreapi/dag.go': 1, 'core/coreapi/dht.go': 1, 'core/coreapi/key.go': 1, 'core/coreapi/name.go': 1, 'core/coreapi/object.go': 1, 'core/coreapi/path.go': 1, 'core/coreapi/pubsub.go': 1, 'core/coreapi/swarm.go': 1, 'core/coreapi/test/api_test.go': 1, 'core/coreapi/unixfs.go': 1, 'core/coredag/cbor.go': 1, 'core/coredag/dagpb.go': 1, 'core/coredag/dagtransl.go': 1, 'core/coredag/raw.go': 1, 'core/corehttp/commands.go': 1, 'core/corehttp/corehttp.go': 1, 'core/corehttp/gateway_handler.go': 4, 'core/corehttp/ipns_hostname.go': 1, 'core/corehttp/logs.go': 1, 'core/corehttp/proxy.go': 1, 'core/corehttp/proxy_test.go': 1, 'core/corerepo/gc.go': 1, 'core/corerepo/stat.go': 1, 'core/coreunix/metadata.go': 1, 'core/pathresolver.go': 1, 'core/pathresolver_test.go': 1, 'dagutils/diff.go': 1, 'dagutils/diffenum.go': 1, 'dagutils/diffenum_test.go': 1, 'dagutils/utils.go': 1, 'dagutils/utils_test.go': 1, 'exchange/reprovide/reprovide.go': 1, 'filestore/pb/dataobj.pb.go': 1, 'fuse/ipns/common.go': 1, 'fuse/ipns/ipns_test.go': 1, 'fuse/ipns/ipns_unix.go': 1, 'fuse/ipns/link_unix.go': 1, 'fuse/mount/fuse.go': 1, 'fuse/mount/mount.go': 1, 'fuse/node/mount_darwin.go': 1, 'fuse/node/mount_test.go': 1, 'fuse/node/mount_unix.go': 1, 'fuse/readonly/ipfs_test.go': 1, 'fuse/readonly/readonly_unix.go': 1, 'keystore/keystore.go': 1, 'keystore/keystore_test.go': 1, 'keystore/memkeystore.go': 1, 'namesys/base.go': 1, 'namesys/cache.go': 1, 'namesys/dns.go': 1, 'namesys/dns_test.go': 1, 'namesys/interface.go': 1, 'namesys/ipns_resolver_validation_test.go': 1, 'namesys/namesys.go': 1, 'namesys/namesys_test.go': 1, 'namesys/proquint.go': 1, 'namesys/publisher.go': 1, 'namesys/publisher_test.go': 1, 'namesys/republisher/repub.go': 1, 'namesys/resolve_test.go': 1, 'p2p/listener.go': 1, 'p2p/local.go': 1, 'p2p/p2p.go': 1, 'p2p/remote.go': 1, 'p2p/stream.go': 1, 'pin/internal/pb/header.pb.go': 1, 'pin/pin.go': 1, 'pin/set.go': 1, 'plugin/daemon.go': 1, 'plugin/ipld.go': 1, 'plugin/loader/loader.go': 1, 'plugin/plugins/badgerds/badgerds.go': 1, 'plugin/plugins/flatfs/flatfs.go': 1, 'plugin/plugins/git/git.go': 1, 'plugin/plugins/levelds/levelds.go': 1, 'plugin/tracer.go': 1, 'repo/fsrepo/config_test.go': 1, 'repo/fsrepo/fsrepo_test.go': 1, 'repo/fsrepo/misc.go': 1, 'repo/mock.go': 1, 'repo/repo.go': 1, 'tar/format.go': 1, 'test/bench/bench_cli_ipfs_add/main.go': 1, 'test/bench/offline_add/main.go': 1, 'test/dependencies/iptb/iptb.go': 1, 'test/dependencies/ma-pipe-unidir/main.go': 1, 'test/integration/bench_test.go': 1, 'thirdparty/cidv0v1/blockstore.go': 1, 'thirdparty/notifier/notifier.go': 1, 'thirdparty/pollEndpoint/main.go': 1, 'go.mod': 2, 'go.sum': 2, 'plugin/loader/preload.sh': 1, 'test/sharness/t0116-prometheus-data/prometheus_metrics': 1}","('cmd/ipfs/daemon.go', 0.26666666666666666, 0.026143790849673203)"
core/corehttp/metrics_test.go,36,274,2,"[{'cyclomatic_complexity': 2, 'nloc': 6, 'token_count': 50, 'name': '', 'long_name': '(a,b inet.Network)', 'start_line': 26, 'end_line': 31, 'full_parameters': [], 'filename': '/home/dimi/Documents/Informatik_Studium/FSS/SoftEvo/DataCollection/FFS_SoftEvo/go-ipfs/core/corehttp/metrics_test.go', 'top_nesting_level': 0, 'length': 6, 'fan_in': 0, 'fan_out': 0, 'general_fan_out': 0}, {'cyclomatic_complexity': 4, 'nloc': 21, 'token_count': 209, 'name': 'TestPeersTotal', 'long_name': 'TestPeersTotal t * testing . T', 'start_line': 18, 'end_line': 50, 'full_parameters': ['t * testing . T'], 'filename': '/home/dimi/Documents/Informatik_Studium/FSS/SoftEvo/DataCollection/FFS_SoftEvo/go-ipfs/core/corehttp/metrics_test.go', 'top_nesting_level': 0, 'length': 33, 'fan_in': 0, 'fan_out': 0, 'general_fan_out': 0}]",40,294,2,"[{'cyclomatic_complexity': 2, 'nloc': 6, 'token_count': 50, 'name': '', 'long_name': '(a,b inet.Network)', 'start_line': 30, 'end_line': 35, 'full_parameters': [], 'filename': '/home/dimi/Documents/Informatik_Studium/FSS/SoftEvo/DataCollection/FFS_SoftEvo/go-ipfs/core/corehttp/metrics_test.go', 'top_nesting_level': 0, 'length': 6, 'fan_in': 0, 'fan_out': 0, 'general_fan_out': 0}, {'cyclomatic_complexity': 5, 'nloc': 25, 'token_count': 230, 'name': 'TestPeersTotal', 'long_name': 'TestPeersTotal t * testing . T', 'start_line': 18, 'end_line': 54, 'full_parameters': ['t * testing . T'], 'filename': '/home/dimi/Documents/Informatik_Studium/FSS/SoftEvo/DataCollection/FFS_SoftEvo/go-ipfs/core/corehttp/metrics_test.go', 'top_nesting_level': 0, 'length': 37, 'fan_in': 0, 'fan_out': 0, 'general_fan_out': 0}]",4,20,0,41,41,"[{'timestamp': 1507304579.0, 'added_lines': 1, 'deleted_lines': 1, 'nloc': 36}, {'timestamp': 1508424715.0, 'added_lines': 2, 'deleted_lines': 2, 'nloc': 36}, {'timestamp': 1511223906.0, 'added_lines': 3, 'deleted_lines': 3, 'nloc': 36}, {'timestamp': 1512365669.0, 'added_lines': 3, 'deleted_lines': 3, 'nloc': 36}, {'timestamp': 1516838128.0, 'added_lines': 3, 'deleted_lines': 3, 'nloc': 36}, {'timestamp': 1517105039.0, 'added_lines': 2, 'deleted_lines': 2, 'nloc': 36}, {'timestamp': 1517453697.0, 'added_lines': 3, 'deleted_lines': 3, 'nloc': 36}, {'timestamp': 1519177055.0, 'added_lines': 1, 'deleted_lines': 1, 'nloc': 36}, {'timestamp': 1525408792.0, 'added_lines': 3, 'deleted_lines': 3, 'nloc': 36}, {'timestamp': 1528131220.0, 'added_lines': 2, 'deleted_lines': 2, 'nloc': 36}, {'timestamp': 1520489177.0, 'added_lines': 3, 'deleted_lines': 3, 'nloc': 36}, {'timestamp': 1528268108.0, 'added_lines': 3, 'deleted_lines': 3, 'nloc': 36}, {'timestamp': 1528520460.0, 'added_lines': 3, 'deleted_lines': 3, 'nloc': 36}, {'timestamp': 1529984485.0, 'added_lines': 3, 'deleted_lines': 3, 'nloc': 36}, {'timestamp': 1532146078.0, 'added_lines': 2, 'deleted_lines': 2, 'nloc': 36}, {'timestamp': 1533779477.0, 'added_lines': 3, 'deleted_lines': 3, 'nloc': 36}, {'timestamp': 1534896611.0, 'added_lines': 3, 'deleted_lines': 3, 'nloc': 36}, {'timestamp': 1535601896.0, 'added_lines': 3, 'deleted_lines': 3, 'nloc': 36}, {'timestamp': 1536388808.0, 'added_lines': 3, 'deleted_lines': 3, 'nloc': 36}, {'timestamp': 1537792589.0, 'added_lines': 3, 'deleted_lines': 3, 'nloc': 36}, {'timestamp': 1538544957.0, 'added_lines': 3, 'deleted_lines': 3, 'nloc': 36}, {'timestamp': 1538695953.0, 'added_lines': 2, 'deleted_lines': 2, 'nloc': 36}, {'timestamp': 1538773916.0, 'added_lines': 3, 'deleted_lines': 3, 'nloc': 36}, {'timestamp': 1539176817.0, 'added_lines': 3, 'deleted_lines': 3, 'nloc': 36}, {'timestamp': 1539357340.0, 'added_lines': 2, 'deleted_lines': 2, 'nloc': 36}, {'timestamp': 1540400358.0, 'added_lines': 3, 'deleted_lines': 3, 'nloc': 36}, {'timestamp': 1540410565.0, 'added_lines': 1, 'deleted_lines': 1, 'nloc': 36}, {'timestamp': 1540418491.0, 'added_lines': 2, 'deleted_lines': 2, 'nloc': 36}, {'timestamp': 1541204121.0, 'added_lines': 3, 'deleted_lines': 3, 'nloc': 36}, {'timestamp': 1541903826.0, 'added_lines': 3, 'deleted_lines': 3, 'nloc': 36}, {'timestamp': 1544225843.0, 'added_lines': 3, 'deleted_lines': 3, 'nloc': 36}, {'timestamp': 1547003974.0, 'added_lines': 3, 'deleted_lines': 3, 'nloc': 36}, {'timestamp': 1549588289.0, 'added_lines': 3, 'deleted_lines': 3, 'nloc': 36}, {'timestamp': 1550185115.0, 'added_lines': 1, 'deleted_lines': 1, 'nloc': 36}, {'timestamp': 1550507829.0, 'added_lines': 3, 'deleted_lines': 3, 'nloc': 36}, {'timestamp': 1550723346.0, 'added_lines': 1, 'deleted_lines': 1, 'nloc': 36}, {'timestamp': 1551229859.0, 'added_lines': 3, 'deleted_lines': 3, 'nloc': 36}, {'timestamp': 1551299964.0, 'added_lines': 2, 'deleted_lines': 2, 'nloc': 36}, {'timestamp': 1551551196.0, 'added_lines': 3, 'deleted_lines': 3, 'nloc': 36}, {'timestamp': 1559060517.0, 'added_lines': 1, 'deleted_lines': 1, 'nloc': 36}, {'timestamp': 1629304396.0, 'added_lines': 6, 'deleted_lines': 2, 'nloc': 40}]","{'core/bootstrap.go': 28, 'core/bootstrap_test.go': 26, 'core/commands/dht.go': 37, 'core/commands/dht_test.go': 25, 'core/commands/id.go': 38, 'core/commands/pubsub.go': 27, 'core/core.go': 40, 'core/corehttp/gateway.go': 37, 'core/corehttp/gateway_test.go': 38, 'core/mock/mock.go': 39, 'exchange/bitswap/bitswap_test.go': 13, 'exchange/bitswap/decision/bench_test.go': 8, 'exchange/bitswap/decision/engine_test.go': 9, 'exchange/bitswap/decision/peer_request_queue_test.go': 8, 'exchange/bitswap/network/ipfs_impl.go': 11, 'exchange/bitswap/testnet/interface.go': 8, 'exchange/bitswap/testnet/network_test.go': 10, 'exchange/bitswap/testnet/peernet.go': 13, 'exchange/bitswap/testnet/virtual.go': 10, 'exchange/bitswap/testutils.go': 13, 'exchange/reprovide/reprovide_test.go': 29, 'fuse/ipns/ipns_test.go': 28, 'fuse/node/mount_test.go': 28, 'fuse/readonly/ipfs_test.go': 33, 'mfs/repub_test.go': 9, 'namesys/publisher_test.go': 29, 'namesys/republisher/repub_test.go': 38, 'namesys/resolve_test.go': 35, 'p2p/p2p.go': 28, 'package.json': 37, 'routing/mock/centralized_client.go': 5, 'routing/mock/centralized_server.go': 5, 'routing/mock/centralized_test.go': 5, 'routing/mock/interface.go': 5, 'routing/none/none_client.go': 5, 'routing/offline/offline_test.go': 5, 'test/integration/addcat_test.go': 38, 'test/integration/bench_cat_test.go': 38, 'test/integration/bench_test.go': 20, 'test/integration/bitswap_wo_routing_test.go': 37, 'test/integration/three_legged_cat_test.go': 38, 'thirdparty/ipfsaddr/ipfsaddr.go': 2, 'core/commands/swarm.go': 35, 'cmd/ipfs/daemon.go': 21, 'cmd/ipfs/init.go': 20, 'cmd/ipfs/ipfs.go': 15, 'cmd/ipfs/main.go': 24, 'cmd/ipfs/main_test.go': 2, 'cmd/ipfswatch/main.go': 16, 'cmd/seccat/seccat.go': 28, 'commands/cli/helptext.go': 1, 'commands/cli/helptext_test.go': 1, 'commands/cli/parse.go': 1, 'commands/cli/parse_test.go': 1, 'commands/command.go': 12, 'commands/command_test.go': 5, 'commands/http/client.go': 1, 'commands/http/handler.go': 1, 'commands/http/multifilereader.go': 1, 'commands/http/multifilereader_test.go': 1, 'commands/http/parse.go': 1, 'commands/request.go': 17, 'commands/response.go': 7, 'commands/response_test.go': 5, 'core/commands/active.go': 7, 'core/commands/add.go': 23, 'core/commands/bitswap.go': 33, 'core/commands/block.go': 18, 'core/commands/bootstrap.go': 17, 'core/commands/cat.go': 18, 'core/commands/commands.go': 15, 'core/commands/config.go': 17, 'core/commands/dag/dag.go': 29, 'core/commands/diag.go': 7, 'core/commands/dns.go': 12, 'core/commands/external.go': 7, 'core/commands/files/files.go': 4, 'core/commands/filestore.go': 16, 'core/commands/get.go': 32, 'core/commands/get_test.go': 15, 'core/commands/helptext_test.go': 15, 'core/commands/ipns.go': 9, 'core/commands/keystore.go': 17, 'core/commands/log.go': 13, 'core/commands/ls.go': 30, 'core/commands/mount_nofuse.go': 7, 'core/commands/mount_unix.go': 17, 'core/commands/name.go': 4, 'core/commands/object/diff.go': 11, 'core/commands/object/object.go': 30, 'core/commands/object/patch.go': 16, 'core/commands/p2p.go': 21, 'core/commands/pin.go': 31, 'core/commands/ping.go': 28, 'core/commands/publish.go': 9, 'core/commands/refs.go': 28, 'core/commands/repo.go': 27, 'core/commands/resolve.go': 27, 'core/commands/root.go': 15, 'core/commands/shutdown.go': 10, 'core/commands/stat.go': 21, 'core/commands/sysdiag.go': 14, 'core/commands/tar.go': 27, 'core/commands/unixfs/ls.go': 27, 'core/commands/unixfs/unixfs.go': 7, 'core/commands/version.go': 8, 'core/corehttp/commands.go': 32, 'core/coreunix/add.go': 32, 'core/coreunix/add_test.go': 31, 'exchange/bitswap/message/message.go': 8, 'exchange/bitswap/network/interface.go': 8, 'importer/helpers/dagbuilder.go': 6, 'importer/importer.go': 6, 'p2p/registry.go': 12, 'repo/config/bootstrap_peers.go': 12, 'assets/assets.go': 26, 'blocks/blockstore/arc_cache.go': 2, 'blocks/blockstore/arc_cache_test.go': 2, 'blocks/blockstore/blockstore.go': 3, 'blocks/blockstore/blockstore_test.go': 2, 'blocks/blockstore/bloom_cache.go': 2, 'blocks/blockstore/bloom_cache_test.go': 2, 'blocks/blockstore/util/remove.go': 2, 'blocks/blocksutil/block_generator.go': 2, 'blockservice/blockservice.go': 7, 'blockservice/blockservice_test.go': 6, 'blockservice/test/blocks_test.go': 6, 'core/builder.go': 33, 'core/commands/ipnsps.go': 5, 'core/commands/mount_windows.go': 6, 'core/coreapi/coreapi.go': 18, 'core/coreapi/interface/interface.go': 2, 'core/coreapi/unixfs.go': 28, 'core/coreapi/unixfs_test.go': 22, 'core/coredag/cbor.go': 9, 'core/coredag/dagpb.go': 27, 'core/coredag/dagtransl.go': 7, 'core/coredag/raw.go': 27, 'core/corehttp/corehttp.go': 16, 'core/corehttp/gateway_handler.go': 32, 'core/corerepo/gc.go': 30, 'core/corerepo/pinning.go': 9, 'core/coreunix/metadata.go': 27, 'core/coreunix/metadata_test.go': 30, 'core/pathresolver.go': 30, 'exchange/bitswap/bitswap.go': 7, 'exchange/bitswap/decision/engine.go': 7, 'exchange/bitswap/decision/ledger.go': 6, 'exchange/bitswap/decision/peer_request_queue.go': 6, 'exchange/bitswap/get.go': 6, 'exchange/bitswap/message/message_test.go': 3, 'exchange/bitswap/notifications/notifications.go': 3, 'exchange/bitswap/notifications/notifications_test.go': 3, 'exchange/bitswap/session.go': 7, 'exchange/bitswap/session_test.go': 5, 'exchange/bitswap/stat.go': 3, 'exchange/bitswap/wantlist/wantlist.go': 3, 'exchange/bitswap/wantlist/wantlist_test.go': 3, 'exchange/bitswap/wantmanager.go': 7, 'exchange/bitswap/workers.go': 6, 'exchange/interface.go': 2, 'exchange/offline/offline.go': 2, 'exchange/offline/offline_test.go': 2, 'exchange/reprovide/providers.go': 30, 'exchange/reprovide/reprovide.go': 24, 'filestore/filestore.go': 18, 'filestore/filestore_test.go': 30, 'filestore/fsrefstore.go': 17, 'filestore/util.go': 17, 'fuse/ipns/ipns_unix.go': 31, 'fuse/readonly/readonly_unix.go': 31, 'importer/balanced/balanced_test.go': 5, 'importer/balanced/builder.go': 3, 'importer/chunk/rabin_test.go': 2, 'importer/chunk/splitting_test.go': 2, 'importer/helpers/helpers.go': 3, 'importer/importer_test.go': 5, 'importer/trickle/trickle_test.go': 5, 'importer/trickle/trickledag.go': 3, 'merkledag/batch.go': 2, 'merkledag/coding.go': 3, 'merkledag/merkledag.go': 3, 'merkledag/merkledag_test.go': 6, 'merkledag/node.go': 3, 'merkledag/node_test.go': 3, 'merkledag/raw.go': 3, 'merkledag/traverse/traverse.go': 3, 'merkledag/traverse/traverse_test.go': 3, 'merkledag/utils/diff.go': 3, 'merkledag/utils/diffenum.go': 3, 'merkledag/utils/diffenum_test.go': 3, 'merkledag/utils/utils.go': 6, 'merkledag/utils/utils_test.go': 3, 'mfs/dir.go': 4, 'mfs/file.go': 6, 'mfs/mfs_test.go': 7, 'mfs/ops.go': 4, 'mfs/system.go': 7, 'namesys/ipns_select_test.go': 4, 'namesys/namesys.go': 33, 'namesys/publisher.go': 32, 'namesys/pubsub.go': 5, 'namesys/pubsub_test.go': 5, 'namesys/republisher/repub.go': 31, 'namesys/routing.go': 34, 'path/path.go': 3, 'path/resolver.go': 3, 'path/resolver_test.go': 2, 'pin/gc/gc.go': 31, 'pin/pin.go': 30, 'pin/pin_test.go': 30, 'pin/set.go': 27, 'pin/set_test.go': 30, 'plugin/ipld.go': 7, 'plugin/loader/initializer.go': 5, 'plugin/plugins/git/git.go': 7, 'repo/config/init.go': 7, 'repo/fsrepo/fsrepo.go': 23, 'repo/fsrepo/lock/lock.go': 3, 'repo/fsrepo/serialize/serialize.go': 3, 'repo/mock.go': 17, 'repo/repo.go': 20, 'routing/offline/offline.go': 3, 'tar/format.go': 30, 'test/dependencies/ma-pipe-unidir/main.go': 10, 'thirdparty/ds-help/key.go': 2, 'thirdparty/pollEndpoint/main.go': 15, 'thirdparty/posinfo/posinfo.go': 2, 'unixfs/archive/archive.go': 3, 'unixfs/archive/tar/writer.go': 3, 'unixfs/hamt/hamt.go': 3, 'unixfs/io/dagreader.go': 3, 'unixfs/io/dirbuilder.go': 3, 'unixfs/io/resolve.go': 3, 'unixfs/mod/dagmodifier.go': 5, 'unixfs/mod/dagmodifier_test.go': 3, 'unixfs/test/utils.go': 5, 'commands/legacy/command.go': 10, 'commands/legacy/legacy.go': 10, 'commands/legacy/legacy_test.go': 10, 'commands/legacy/request.go': 11, 'commands/legacy/response.go': 11, 'core/commands/commands_test.go': 13, 'core/coreapi/dag.go': 6, 'core/coreapi/dag_test.go': 3, 'core/coreapi/interface/options/dag.go': 4, 'core/coreapi/key.go': 30, 'core/coreapi/name.go': 32, 'merkledag/test/utils.go': 5, 'namesys/namesys_test.go': 31, 'repo/fsrepo/datastores.go': 15, 'repo/fsrepo/fsrepo_test.go': 17, 'thirdparty/datastore2/datastore_closer.go': 1, 'thirdparty/datastore2/delayed.go': 1, 'thirdparty/datastore2/threadsafe.go': 1, 'unixfs/io/pbdagreader.go': 2, 'cmd/ipfs/util/ulimit.go': 9, 'cmd/seccat/util.go': 10, 'core/corehttp/logs.go': 9, 'fuse/mount/mount.go': 9, 'fuse/node/mount_unix.go': 9, 'importer/chunk/splitting.go': 1, 'namesys/ipns_validate_test.go': 5, 'plugin/loader/load.go': 7, 'core/coreapi/block.go': 10, 'core/coreapi/object_test.go': 1, 'blocks/blockstoreutil/remove.go': 15, 'blockservice/test/mock.go': 5, 'core/commands/files.go': 28, 'core/core_test.go': 16, 'core/coreapi/pin.go': 28, 'fuse/ipns/common.go': 26, 'keystore/keystore.go': 9, 'keystore/keystore_test.go': 6, 'keystore/memkeystore.go': 6, 'namesys/interface.go': 26, 'namesys/validator.go': 3, 'path/resolver/resolver.go': 3, 'repo/config/identity.go': 2, 'thirdparty/verifbs/verifbs.go': 15, 'cmd/ipfs/util/ulimit_freebsd.go': 2, 'cmd/ipfs/util/ulimit_unix.go': 2, 'core/coreapi/block_test.go': 2, 'core/coreapi/interface/coreapi.go': 3, 'core/coreapi/interface/dag.go': 3, 'core/coreapi/interface/object.go': 3, 'core/coreapi/interface/options/block.go': 2, 'core/coreapi/interface/path.go': 19, 'core/coreapi/interface/unixfs.go': 4, 'core/coreapi/object.go': 25, 'fuse/ipns/link_unix.go': 2, 'fuse/mount/fuse.go': 2, 'fuse/node/mount_darwin.go': 2, 'merkledag/errservice.go': 1, 'merkledag/readonly.go': 1, 'merkledag/readonly_test.go': 1, 'merkledag/rwservice.go': 1, 'merkledag/session.go': 1, 'path/resolver/resolver_test.go': 1, 'thirdparty/verifcid/validate.go': 1, 'thirdparty/verifcid/validate_test.go': 1, 'unixfs/hamt/hamt_stress_test.go': 1, 'unixfs/hamt/hamt_test.go': 1, 'namesys/ipns_resolver_validation_test.go': 26, 'test/sharness/t0170-dht.sh': 1, 'core/corehttp/metrics.go': 2, 'core/commands/env.go': 2, 'core/commands/urlstore.go': 24, 'core/coreapi/interface/key.go': 7, 'core/coreapi/name_test.go': 16, 'core/coreapi/path.go': 24, 'core/coreunix/cat.go': 5, 'core/pathresolver_test.go': 24, 'dagutils/diff.go': 24, 'dagutils/diffenum.go': 24, 'dagutils/diffenum_test.go': 24, 'dagutils/utils.go': 24, 'dagutils/utils_test.go': 24, 'filestore/pb/dataobj.pb.go': 3, 'mfs/fd.go': 1, 'namesys/base.go': 24, 'namesys/cache.go': 24, 'namesys/dns.go': 24, 'namesys/proquint.go': 24, 'pin/internal/pb/header.pb.go': 3, 'thirdparty/cidv0v1/blockstore.go': 11, 'repo/fsrepo/config_test.go': 13, 'repo/fsrepo/misc.go': 13, 'test/bench/bench_cli_ipfs_add/main.go': 13, 'test/bench/offline_add/main.go': 13, 'core/commands/cmdenv/env.go': 15, 'core/commands/name/ipns.go': 22, 'core/commands/name/publish.go': 11, 'core/commands/name/ipnsps.go': 10, 'core/commands/name/name.go': 5, 'core/coreapi/dht.go': 21, 'core/coreapi/dht_test.go': 4, 'core/coreapi/interface/dht.go': 10, 'p2p/listener.go': 14, 'p2p/local.go': 14, 'p2p/remote.go': 14, 'p2p/stream.go': 14, 'core/coreapi/interface/swarm.go': 9, 'core/coreapi/swarm.go': 19, 'core/coreapi/interface/options/unixfs.go': 11, 'core/coreapi/pubsub.go': 17, 'core/coreapi/unixfile.go': 10, 'cmd/ipfs/dnsresolve_test.go': 5, 'core/coreapi/interface/pubsub.go': 4, 'core/commands/cid.go': 5, 'test/dependencies/iptb/iptb.go': 11, 'plugin/plugins/badgerds/badgerds.go': 3, 'plugin/plugins/flatfs/flatfs.go': 3, 'plugin/plugins/levelds/levelds.go': 3, 'commands/context.go': 9, 'core/corehttp/proxy.go': 10, 'core/coreapi/interface/tests/name.go': 2, 'core/coreapi/interface/tests/unixfs.go': 2, 'core/coreapi/test/api_test.go': 9, 'core/corehttp/ipns_hostname.go': 6, 'namesys/dns_test.go': 6, 'plugin/daemon.go': 6, 'plugin/loader/loader.go': 6, 'core/commands/cmdenv/cidbase.go': 4, 'core/commands/cmdenv/cidbase_test.go': 2, 'core/commands/cmdenv/file.go': 1, 'core/corehttp/proxy_test.go': 2, 'core/corerepo/stat.go': 1, 'plugin/tracer.go': 1, 'thirdparty/notifier/notifier.go': 1, 'core/bootstrap/bootstrap.go': 1, 'core/bootstrap/bootstrap_test.go': 1, 'core/node/builder.go': 1, 'core/node/core.go': 1, 'core/node/groups.go': 1, 'core/node/identity.go': 1, 'core/node/ipns.go': 1, 'core/node/libp2p/addrs.go': 1, 'core/node/libp2p/discovery.go': 2, 'core/node/libp2p/host.go': 1, 'core/node/libp2p/hostopt.go': 1, 'core/node/libp2p/libp2p.go': 1, 'core/node/libp2p/nat.go': 1, 'core/node/libp2p/pnet.go': 1, 'core/node/libp2p/pubsub.go': 1, 'core/node/libp2p/routing.go': 1, 'core/node/libp2p/routingopt.go': 1, 'core/node/libp2p/smux.go': 1, 'core/node/libp2p/transport.go': 2, 'core/node/provider.go': 1, 'go.mod': 2, 'go.sum': 2, 'provider/simple/provider.go': 1, 'provider/simple/provider_test.go': 1, 'provider/simple/reprovide.go': 1, 'provider/simple/reprovide_test.go': 1}","('core/core.go', 0.975609756097561, 0.22346368715083798)"
core/corehttp/redirect.go,19,116,3,"[{'cyclomatic_complexity': 1, 'nloc': 4, 'token_count': 45, 'name': '', 'long_name': '(n*core.IpfsNode,_net.Listener,mux*http.ServeMux)(*http.ServeMux,error)', 'start_line': 12, 'end_line': 15, 'full_parameters': [], 'filename': '/home/dimi/Documents/Informatik_Studium/FSS/SoftEvo/DataCollection/FFS_SoftEvo/go-ipfs/core/corehttp/redirect.go', 'top_nesting_level': 0, 'length': 4, 'fan_in': 0, 'fan_out': 0, 'general_fan_out': 0}, {'cyclomatic_complexity': 1, 'nloc': 4, 'token_count': 21, 'name': 'RedirectOption', 'long_name': 'RedirectOption path string , redirect string', 'start_line': 10, 'end_line': 16, 'full_parameters': ['path string', ' redirect string'], 'filename': '/home/dimi/Documents/Informatik_Studium/FSS/SoftEvo/DataCollection/FFS_SoftEvo/go-ipfs/core/corehttp/redirect.go', 'top_nesting_level': 0, 'length': 7, 'fan_in': 0, 'fan_out': 0, 'general_fan_out': 0}, {'cyclomatic_complexity': 1, 'nloc': 3, 'token_count': 35, 'name': 'ServeHTTP', 'long_name': '(i*redirectHandler)ServeHTTP w http . ResponseWriter , r * http . Request', 'start_line': 22, 'end_line': 24, 'full_parameters': ['w http . ResponseWriter', ' r * http . Request'], 'filename': '/home/dimi/Documents/Informatik_Studium/FSS/SoftEvo/DataCollection/FFS_SoftEvo/go-ipfs/core/corehttp/redirect.go', 'top_nesting_level': 0, 'length': 3, 'fan_in': 0, 'fan_out': 0, 'general_fan_out': 0}]",23,136,3,"[{'cyclomatic_complexity': 2, 'nloc': 8, 'token_count': 65, 'name': '', 'long_name': '(n*core.IpfsNode,_net.Listener,mux*http.ServeMux)(*http.ServeMux,error)', 'start_line': 12, 'end_line': 19, 'full_parameters': [], 'filename': '/home/dimi/Documents/Informatik_Studium/FSS/SoftEvo/DataCollection/FFS_SoftEvo/go-ipfs/core/corehttp/redirect.go', 'top_nesting_level': 0, 'length': 8, 'fan_in': 0, 'fan_out': 0, 'general_fan_out': 0}, {'cyclomatic_complexity': 1, 'nloc': 4, 'token_count': 21, 'name': 'RedirectOption', 'long_name': 'RedirectOption path string , redirect string', 'start_line': 10, 'end_line': 20, 'full_parameters': ['path string', ' redirect string'], 'filename': '/home/dimi/Documents/Informatik_Studium/FSS/SoftEvo/DataCollection/FFS_SoftEvo/go-ipfs/core/corehttp/redirect.go', 'top_nesting_level': 0, 'length': 11, 'fan_in': 0, 'fan_out': 0, 'general_fan_out': 0}, {'cyclomatic_complexity': 1, 'nloc': 3, 'token_count': 35, 'name': 'ServeHTTP', 'long_name': '(i*redirectHandler)ServeHTTP w http . ResponseWriter , r * http . Request', 'start_line': 26, 'end_line': 28, 'full_parameters': ['w http . ResponseWriter', ' r * http . Request'], 'filename': '/home/dimi/Documents/Informatik_Studium/FSS/SoftEvo/DataCollection/FFS_SoftEvo/go-ipfs/core/corehttp/redirect.go', 'top_nesting_level': 0, 'length': 3, 'fan_in': 0, 'fan_out': 0, 'general_fan_out': 0}]",4,20,0,1,1,"[{'timestamp': 1555297179.0, 'added_lines': 5, 'deleted_lines': 1, 'nloc': 23}]",{},"('core/core.go', 0.0, 0.0)"
core/corehttp/webui.go,15,43,0,[],45,103,0,[],30,60,0,45,45,"[{'timestamp': 1512215523.0, 'added_lines': 2, 'deleted_lines': 1, 'nloc': 16}, {'timestamp': 1512216355.0, 'added_lines': 1, 'deleted_lines': 1, 'nloc': 16}, {'timestamp': 1539885911.0, 'added_lines': 2, 'deleted_lines': 1, 'nloc': 17}, {'timestamp': 1540225341.0, 'added_lines': 2, 'deleted_lines': 1, 'nloc': 18}, {'timestamp': 1545156024.0, 'added_lines': 2, 'deleted_lines': 1, 'nloc': 19}, {'timestamp': 1546871063.0, 'added_lines': 2, 'deleted_lines': 1, 'nloc': 20}, {'timestamp': 1547644372.0, 'added_lines': 2, 'deleted_lines': 1, 'nloc': 21}, {'timestamp': 1551112732.0, 'added_lines': 2, 'deleted_lines': 1, 'nloc': 22}, {'timestamp': 1551197563.0, 'added_lines': 1, 'deleted_lines': 2, 'nloc': 21}, {'timestamp': 1554288225.0, 'added_lines': 2, 'deleted_lines': 1, 'nloc': 22}, {'timestamp': 1554294513.0, 'added_lines': 1, 'deleted_lines': 1, 'nloc': 22}, {'timestamp': 1559317868.0, 'added_lines': 2, 'deleted_lines': 1, 'nloc': 23}, {'timestamp': 1565706013.0, 'added_lines': 2, 'deleted_lines': 1, 'nloc': 24}, {'timestamp': 1567757061.0, 'added_lines': 2, 'deleted_lines': 1, 'nloc': 25}, {'timestamp': 1568279184.0, 'added_lines': 3, 'deleted_lines': 1, 'nloc': 27}, {'timestamp': 1569249861.0, 'added_lines': 2, 'deleted_lines': 1, 'nloc': 28}, {'timestamp': 1570520038.0, 'added_lines': 2, 'deleted_lines': 1, 'nloc': 29}, {'timestamp': 1571643093.0, 'added_lines': 2, 'deleted_lines': 1, 'nloc': 30}, {'timestamp': 1571685855.0, 'added_lines': 1, 'deleted_lines': 1, 'nloc': 30}, {'timestamp': 1572457829.0, 'added_lines': 2, 'deleted_lines': 1, 'nloc': 31}, {'timestamp': 1573601860.0, 'added_lines': 2, 'deleted_lines': 1, 'nloc': 32}, {'timestamp': 1575447358.0, 'added_lines': 2, 'deleted_lines': 1, 'nloc': 33}, {'timestamp': 1575447358.0, 'added_lines': 12, 'deleted_lines': 1, 'nloc': 33}, {'timestamp': 1585958136.0, 'added_lines': 2, 'deleted_lines': 1, 'nloc': 34}, {'timestamp': 1586879485.0, 'added_lines': 1, 'deleted_lines': 1, 'nloc': 34}, {'timestamp': 1587150621.0, 'added_lines': 1, 'deleted_lines': 1, 'nloc': 34}, {'timestamp': 1590630805.0, 'added_lines': 2, 'deleted_lines': 1, 'nloc': 35}, {'timestamp': 1590699875.0, 'added_lines': 2, 'deleted_lines': 1, 'nloc': 36}, {'timestamp': 1590630805.0, 'added_lines': 2, 'deleted_lines': 1, 'nloc': 35}, {'timestamp': 1590699875.0, 'added_lines': 2, 'deleted_lines': 1, 'nloc': 36}, {'timestamp': 1592843970.0, 'added_lines': 2, 'deleted_lines': 1, 'nloc': 37}, {'timestamp': 1592926118.0, 'added_lines': 2, 'deleted_lines': 1, 'nloc': 38}, {'timestamp': 1594923877.0, 'added_lines': 2, 'deleted_lines': 1, 'nloc': 39}, {'timestamp': 1599763664.0, 'added_lines': 3, 'deleted_lines': 1, 'nloc': 41}, {'timestamp': 1599763664.0, 'added_lines': 3, 'deleted_lines': 1, 'nloc': 41}, {'timestamp': 1601313023.0, 'added_lines': 2, 'deleted_lines': 1, 'nloc': 42}, {'timestamp': 1602007038.0, 'added_lines': 1, 'deleted_lines': 1, 'nloc': 42}, {'timestamp': 1602075692.0, 'added_lines': 1, 'deleted_lines': 1, 'nloc': 42}, {'timestamp': 1619632777.0, 'added_lines': 2, 'deleted_lines': 1, 'nloc': 43}, {'timestamp': 1619791941.0, 'added_lines': 1, 'deleted_lines': 1, 'nloc': 43}, {'timestamp': 1621616494.0, 'added_lines': 1, 'deleted_lines': 1, 'nloc': 43}, {'timestamp': 1621616494.0, 'added_lines': 1, 'deleted_lines': 1, 'nloc': 43}, {'timestamp': 1625489715.0, 'added_lines': 2, 'deleted_lines': 1, 'nloc': 44}, {'timestamp': 1625489715.0, 'added_lines': 2, 'deleted_lines': 1, 'nloc': 44}, {'timestamp': 1632249387.0, 'added_lines': 2, 'deleted_lines': 1, 'nloc': 45}]","{'core/corehttp/commands.go': 1, 'go.mod': 1, 'go.sum': 1, 'test/dependencies/go.mod': 1, 'test/dependencies/go.sum': 1, 'test/sharness/t0051-object.sh': 1, 'test/sharness/t0060-daemon.sh': 1, 'test/sharness/t0090-get.sh': 1, 'test/sharness/t0100-name.sh': 1, 'test/sharness/t0110-gateway.sh': 1, 'test/sharness/t0230-channel-streaming-http-content-type.sh': 1, 'test/sharness/t0600-issues-and-regressions-online.sh': 1}","('core/corehttp/commands.go', 0.022222222222222223, 0.008547008547008548)"
core/corerepo/gc.go,181,1024,10,"[{'cyclomatic_complexity': 6, 'nloc': 31, 'token_count': 174, 'name': 'NewGC', 'long_name': 'NewGC n * core . IpfsNode', 'start_line': 32, 'end_line': 71, 'full_parameters': ['n * core . IpfsNode'], 'filename': '/home/dimi/Documents/Informatik_Studium/FSS/SoftEvo/DataCollection/FFS_SoftEvo/go-ipfs/core/corerepo/gc.go', 'top_nesting_level': 0, 'length': 40, 'fan_in': 0, 'fan_out': 0, 'general_fan_out': 0}, {'cyclomatic_complexity': 2, 'nloc': 7, 'token_count': 60, 'name': 'BestEffortRoots', 'long_name': 'BestEffortRoots filesRoot * mfs . Root', 'start_line': 73, 'end_line': 80, 'full_parameters': ['filesRoot * mfs . Root'], 'filename': '/home/dimi/Documents/Informatik_Studium/FSS/SoftEvo/DataCollection/FFS_SoftEvo/go-ipfs/core/corerepo/gc.go', 'top_nesting_level': 0, 'length': 8, 'fan_in': 0, 'fan_out': 0, 'general_fan_out': 0}, {'cyclomatic_complexity': 2, 'nloc': 10, 'token_count': 80, 'name': 'GarbageCollect', 'long_name': 'GarbageCollect n * core . IpfsNode , ctx context . Context', 'start_line': 82, 'end_line': 92, 'full_parameters': ['n * core . IpfsNode', ' ctx context . Context'], 'filename': '/home/dimi/Documents/Informatik_Studium/FSS/SoftEvo/DataCollection/FFS_SoftEvo/go-ipfs/core/corerepo/gc.go', 'top_nesting_level': 0, 'length': 11, 'fan_in': 0, 'fan_out': 0, 'general_fan_out': 0}, {'cyclomatic_complexity': 10, 'nloc': 28, 'token_count': 145, 'name': 'CollectResult', 'long_name': 'CollectResult ctx context . Context , gcOut < - chan gc . Result , cb func * cid . Cid', 'start_line': 97, 'end_line': 125, 'full_parameters': ['ctx context . Context', ' gcOut < - chan gc . Result', ' cb func * cid . Cid'], 'filename': '/home/dimi/Documents/Informatik_Studium/FSS/SoftEvo/DataCollection/FFS_SoftEvo/go-ipfs/core/corerepo/gc.go', 'top_nesting_level': 0, 'length': 29, 'fan_in': 0, 'fan_out': 0, 'general_fan_out': 0}, {'cyclomatic_complexity': 1, 'nloc': 3, 'token_count': 36, 'name': 'NewMultiError', 'long_name': 'NewMultiError errs ... error', 'start_line': 128, 'end_line': 130, 'full_parameters': ['errs ... error'], 'filename': '/home/dimi/Documents/Informatik_Studium/FSS/SoftEvo/DataCollection/FFS_SoftEvo/go-ipfs/core/corerepo/gc.go', 'top_nesting_level': 0, 'length': 3, 'fan_in': 0, 'fan_out': 0, 'general_fan_out': 0}, {'cyclomatic_complexity': 2, 'nloc': 9, 'token_count': 62, 'name': 'Error', 'long_name': '(e*MultiError)Error', 'start_line': 138, 'end_line': 146, 'full_parameters': [], 'filename': '/home/dimi/Documents/Informatik_Studium/FSS/SoftEvo/DataCollection/FFS_SoftEvo/go-ipfs/core/corerepo/gc.go', 'top_nesting_level': 0, 'length': 9, 'fan_in': 0, 'fan_out': 0, 'general_fan_out': 0}, {'cyclomatic_complexity': 2, 'nloc': 10, 'token_count': 85, 'name': 'GarbageCollectAsync', 'long_name': 'GarbageCollectAsync n * core . IpfsNode , ctx context . Context', 'start_line': 148, 'end_line': 158, 'full_parameters': ['n * core . IpfsNode', ' ctx context . Context'], 'filename': '/home/dimi/Documents/Informatik_Studium/FSS/SoftEvo/DataCollection/FFS_SoftEvo/go-ipfs/core/corerepo/gc.go', 'top_nesting_level': 0, 'length': 11, 'fan_in': 0, 'fan_out': 0, 'general_fan_out': 0}, {'cyclomatic_complexity': 10, 'nloc': 30, 'token_count': 152, 'name': 'PeriodicGC', 'long_name': 'PeriodicGC ctx context . Context , node * core . IpfsNode', 'start_line': 160, 'end_line': 195, 'full_parameters': ['ctx context . Context', ' node * core . IpfsNode'], 'filename': '/home/dimi/Documents/Informatik_Studium/FSS/SoftEvo/DataCollection/FFS_SoftEvo/go-ipfs/core/corerepo/gc.go', 'top_nesting_level': 0, 'length': 36, 'fan_in': 0, 'fan_out': 0, 'general_fan_out': 0}, {'cyclomatic_complexity': 2, 'nloc': 7, 'token_count': 45, 'name': 'ConditionalGC', 'long_name': 'ConditionalGC ctx context . Context , node * core . IpfsNode , offset uint64', 'start_line': 197, 'end_line': 203, 'full_parameters': ['ctx context . Context', ' node * core . IpfsNode', ' offset uint64'], 'filename': '/home/dimi/Documents/Informatik_Studium/FSS/SoftEvo/DataCollection/FFS_SoftEvo/go-ipfs/core/corerepo/gc.go', 'top_nesting_level': 0, 'length': 7, 'fan_in': 0, 'fan_out': 0, 'general_fan_out': 0}, {'cyclomatic_complexity': 5, 'nloc': 18, 'token_count': 112, 'name': 'maybeGC', 'long_name': '(gc*GC)maybeGC ctx context . Context , offset uint64', 'start_line': 205, 'end_line': 226, 'full_parameters': ['ctx context . Context', ' offset uint64'], 'filename': '/home/dimi/Documents/Informatik_Studium/FSS/SoftEvo/DataCollection/FFS_SoftEvo/go-ipfs/core/corerepo/gc.go', 'top_nesting_level': 0, 'length': 22, 'fan_in': 0, 'fan_out': 0, 'general_fan_out': 0}]",182,1025,10,"[{'cyclomatic_complexity': 8, 'nloc': 35, 'token_count': 200, 'name': 'NewGC', 'long_name': 'NewGC n * core . IpfsNode', 'start_line': 32, 'end_line': 75, 'full_parameters': ['n * core . IpfsNode'], 'filename': '/home/dimi/Documents/Informatik_Studium/FSS/SoftEvo/DataCollection/FFS_SoftEvo/go-ipfs/core/corerepo/gc.go', 'top_nesting_level': 0, 'length': 44, 'fan_in': 0, 'fan_out': 0, 'general_fan_out': 0}, {'cyclomatic_complexity': 2, 'nloc': 7, 'token_count': 58, 'name': 'BestEffortRoots', 'long_name': 'BestEffortRoots filesRoot * mfs . Root', 'start_line': 77, 'end_line': 84, 'full_parameters': ['filesRoot * mfs . Root'], 'filename': '/home/dimi/Documents/Informatik_Studium/FSS/SoftEvo/DataCollection/FFS_SoftEvo/go-ipfs/core/corerepo/gc.go', 'top_nesting_level': 0, 'length': 8, 'fan_in': 0, 'fan_out': 0, 'general_fan_out': 0}, {'cyclomatic_complexity': 2, 'nloc': 8, 'token_count': 70, 'name': 'GarbageCollect', 'long_name': 'GarbageCollect n * core . IpfsNode , ctx context . Context', 'start_line': 86, 'end_line': 94, 'full_parameters': ['n * core . IpfsNode', ' ctx context . Context'], 'filename': '/home/dimi/Documents/Informatik_Studium/FSS/SoftEvo/DataCollection/FFS_SoftEvo/go-ipfs/core/corerepo/gc.go', 'top_nesting_level': 0, 'length': 9, 'fan_in': 0, 'fan_out': 0, 'general_fan_out': 0}, {'cyclomatic_complexity': 10, 'nloc': 28, 'token_count': 146, 'name': 'CollectResult', 'long_name': 'CollectResult ctx context . Context , gcOut < - chan gc . Result , cb func cid . Cid', 'start_line': 99, 'end_line': 127, 'full_parameters': ['ctx context . Context', ' gcOut < - chan gc . Result', ' cb func cid . Cid'], 'filename': '/home/dimi/Documents/Informatik_Studium/FSS/SoftEvo/DataCollection/FFS_SoftEvo/go-ipfs/core/corerepo/gc.go', 'top_nesting_level': 0, 'length': 29, 'fan_in': 0, 'fan_out': 0, 'general_fan_out': 0}, {'cyclomatic_complexity': 1, 'nloc': 3, 'token_count': 36, 'name': 'NewMultiError', 'long_name': 'NewMultiError errs ... error', 'start_line': 130, 'end_line': 132, 'full_parameters': ['errs ... error'], 'filename': '/home/dimi/Documents/Informatik_Studium/FSS/SoftEvo/DataCollection/FFS_SoftEvo/go-ipfs/core/corerepo/gc.go', 'top_nesting_level': 0, 'length': 3, 'fan_in': 0, 'fan_out': 0, 'general_fan_out': 0}, {'cyclomatic_complexity': 2, 'nloc': 9, 'token_count': 62, 'name': 'Error', 'long_name': '(e*MultiError)Error', 'start_line': 140, 'end_line': 148, 'full_parameters': [], 'filename': '/home/dimi/Documents/Informatik_Studium/FSS/SoftEvo/DataCollection/FFS_SoftEvo/go-ipfs/core/corerepo/gc.go', 'top_nesting_level': 0, 'length': 9, 'fan_in': 0, 'fan_out': 0, 'general_fan_out': 0}, {'cyclomatic_complexity': 2, 'nloc': 10, 'token_count': 89, 'name': 'GarbageCollectAsync', 'long_name': 'GarbageCollectAsync n * core . IpfsNode , ctx context . Context', 'start_line': 150, 'end_line': 160, 'full_parameters': ['n * core . IpfsNode', ' ctx context . Context'], 'filename': '/home/dimi/Documents/Informatik_Studium/FSS/SoftEvo/DataCollection/FFS_SoftEvo/go-ipfs/core/corerepo/gc.go', 'top_nesting_level': 0, 'length': 11, 'fan_in': 0, 'fan_out': 0, 'general_fan_out': 0}, {'cyclomatic_complexity': 10, 'nloc': 30, 'token_count': 152, 'name': 'PeriodicGC', 'long_name': 'PeriodicGC ctx context . Context , node * core . IpfsNode', 'start_line': 162, 'end_line': 197, 'full_parameters': ['ctx context . Context', ' node * core . IpfsNode'], 'filename': '/home/dimi/Documents/Informatik_Studium/FSS/SoftEvo/DataCollection/FFS_SoftEvo/go-ipfs/core/corerepo/gc.go', 'top_nesting_level': 0, 'length': 36, 'fan_in': 0, 'fan_out': 0, 'general_fan_out': 0}, {'cyclomatic_complexity': 2, 'nloc': 7, 'token_count': 45, 'name': 'ConditionalGC', 'long_name': 'ConditionalGC ctx context . Context , node * core . IpfsNode , offset uint64', 'start_line': 199, 'end_line': 205, 'full_parameters': ['ctx context . Context', ' node * core . IpfsNode', ' offset uint64'], 'filename': '/home/dimi/Documents/Informatik_Studium/FSS/SoftEvo/DataCollection/FFS_SoftEvo/go-ipfs/core/corerepo/gc.go', 'top_nesting_level': 0, 'length': 7, 'fan_in': 0, 'fan_out': 0, 'general_fan_out': 0}, {'cyclomatic_complexity': 5, 'nloc': 17, 'token_count': 99, 'name': 'maybeGC', 'long_name': '(gc*GC)maybeGC ctx context . Context , offset uint64', 'start_line': 207, 'end_line': 227, 'full_parameters': ['ctx context . Context', ' offset uint64'], 'filename': '/home/dimi/Documents/Informatik_Studium/FSS/SoftEvo/DataCollection/FFS_SoftEvo/go-ipfs/core/corerepo/gc.go', 'top_nesting_level': 0, 'length': 21, 'fan_in': 0, 'fan_out': 0, 'general_fan_out': 0}]",1,1,0,59,59,"[{'timestamp': 1512365669.0, 'added_lines': 1, 'deleted_lines': 1, 'nloc': 181}, {'timestamp': 1516838128.0, 'added_lines': 1, 'deleted_lines': 1, 'nloc': 181}, {'timestamp': 1516911711.0, 'added_lines': 2, 'deleted_lines': 2, 'nloc': 181}, {'timestamp': 1517453697.0, 'added_lines': 1, 'deleted_lines': 1, 'nloc': 181}, {'timestamp': 1517487614.0, 'added_lines': 2, 'deleted_lines': 2, 'nloc': 181}, {'timestamp': 1521399286.0, 'added_lines': 1, 'deleted_lines': 1, 'nloc': 181}, {'timestamp': 1525408792.0, 'added_lines': 1, 'deleted_lines': 1, 'nloc': 181}, {'timestamp': 1528520460.0, 'added_lines': 2, 'deleted_lines': 2, 'nloc': 181}, {'timestamp': 1529984485.0, 'added_lines': 1, 'deleted_lines': 1, 'nloc': 181}, {'timestamp': 1530280654.0, 'added_lines': 1, 'deleted_lines': 1, 'nloc': 181}, {'timestamp': 1531779409.0, 'added_lines': 1, 'deleted_lines': 1, 'nloc': 181}, {'timestamp': 1533779477.0, 'added_lines': 1, 'deleted_lines': 1, 'nloc': 181}, {'timestamp': 1534115707.0, 'added_lines': 1, 'deleted_lines': 1, 'nloc': 181}, {'timestamp': 1534347022.0, 'added_lines': 1, 'deleted_lines': 1, 'nloc': 181}, {'timestamp': 1534771694.0, 'added_lines': 1, 'deleted_lines': 1, 'nloc': 181}, {'timestamp': 1534896611.0, 'added_lines': 2, 'deleted_lines': 2, 'nloc': 181}, {'timestamp': 1535601896.0, 'added_lines': 1, 'deleted_lines': 1, 'nloc': 181}, {'timestamp': 1536388808.0, 'added_lines': 1, 'deleted_lines': 1, 'nloc': 181}, {'timestamp': 1536718784.0, 'added_lines': 6, 'deleted_lines': 6, 'nloc': 181}, {'timestamp': 1536723292.0, 'added_lines': 1, 'deleted_lines': 1, 'nloc': 181}, {'timestamp': 1537790637.0, 'added_lines': 1, 'deleted_lines': 1, 'nloc': 181}, {'timestamp': 1537792589.0, 'added_lines': 2, 'deleted_lines': 2, 'nloc': 181}, {'timestamp': 1538544957.0, 'added_lines': 1, 'deleted_lines': 1, 'nloc': 181}, {'timestamp': 1538694687.0, 'added_lines': 1, 'deleted_lines': 1, 'nloc': 181}, {'timestamp': 1538695953.0, 'added_lines': 1, 'deleted_lines': 1, 'nloc': 181}, {'timestamp': 1538773916.0, 'added_lines': 1, 'deleted_lines': 1, 'nloc': 181}, {'timestamp': 1539176817.0, 'added_lines': 1, 'deleted_lines': 1, 'nloc': 181}, {'timestamp': 1539357340.0, 'added_lines': 1, 'deleted_lines': 1, 'nloc': 181}, {'timestamp': 1539850591.0, 'added_lines': 1, 'deleted_lines': 1, 'nloc': 181}, {'timestamp': 1540400358.0, 'added_lines': 1, 'deleted_lines': 1, 'nloc': 181}, {'timestamp': 1540410565.0, 'added_lines': 1, 'deleted_lines': 1, 'nloc': 181}, {'timestamp': 1540418491.0, 'added_lines': 1, 'deleted_lines': 1, 'nloc': 181}, {'timestamp': 1540603818.0, 'added_lines': 1, 'deleted_lines': 1, 'nloc': 181}, {'timestamp': 1540916861.0, 'added_lines': 1, 'deleted_lines': 1, 'nloc': 181}, {'timestamp': 1541106379.0, 'added_lines': 1, 'deleted_lines': 1, 'nloc': 181}, {'timestamp': 1541189794.0, 'added_lines': 1, 'deleted_lines': 1, 'nloc': 181}, {'timestamp': 1541204121.0, 'added_lines': 3, 'deleted_lines': 3, 'nloc': 181}, {'timestamp': 1541903826.0, 'added_lines': 1, 'deleted_lines': 1, 'nloc': 181}, {'timestamp': 1543443696.0, 'added_lines': 1, 'deleted_lines': 1, 'nloc': 181}, {'timestamp': 1544225843.0, 'added_lines': 1, 'deleted_lines': 1, 'nloc': 181}, {'timestamp': 1540556089.0, 'added_lines': 1, 'deleted_lines': 1, 'nloc': 181}, {'timestamp': 1547003974.0, 'added_lines': 1, 'deleted_lines': 1, 'nloc': 181}, {'timestamp': 1547499910.0, 'added_lines': 1, 'deleted_lines': 1, 'nloc': 181}, {'timestamp': 1548866534.0, 'added_lines': 1, 'deleted_lines': 1, 'nloc': 181}, {'timestamp': 1549588289.0, 'added_lines': 1, 'deleted_lines': 1, 'nloc': 181}, {'timestamp': 1549903582.0, 'added_lines': 1, 'deleted_lines': 1, 'nloc': 181}, {'timestamp': 1550185115.0, 'added_lines': 1, 'deleted_lines': 1, 'nloc': 181}, {'timestamp': 1550507829.0, 'added_lines': 2, 'deleted_lines': 2, 'nloc': 181}, {'timestamp': 1550610741.0, 'added_lines': 1, 'deleted_lines': 1, 'nloc': 181}, {'timestamp': 1550711994.0, 'added_lines': 1, 'deleted_lines': 1, 'nloc': 181}, {'timestamp': 1550723346.0, 'added_lines': 2, 'deleted_lines': 2, 'nloc': 181}, {'timestamp': 1551229859.0, 'added_lines': 1, 'deleted_lines': 1, 'nloc': 181}, {'timestamp': 1551299964.0, 'added_lines': 1, 'deleted_lines': 1, 'nloc': 181}, {'timestamp': 1551551196.0, 'added_lines': 4, 'deleted_lines': 4, 'nloc': 181}, {'timestamp': 1553697989.0, 'added_lines': 6, 'deleted_lines': 2, 'nloc': 185}, {'timestamp': 1556649241.0, 'added_lines': 0, 'deleted_lines': 2, 'nloc': 183}, {'timestamp': 1574264289.0, 'added_lines': 5, 'deleted_lines': 5, 'nloc': 183}, {'timestamp': 1579218500.0, 'added_lines': 1, 'deleted_lines': 1, 'nloc': 183}, {'timestamp': 1579220333.0, 'added_lines': 0, 'deleted_lines': 1, 'nloc': 182}]","{'assets/assets.go': 43, 'blocks/blockstore/arc_cache.go': 2, 'blocks/blockstore/arc_cache_test.go': 2, 'blocks/blockstore/blockstore.go': 3, 'blocks/blockstore/blockstore_test.go': 2, 'blocks/blockstore/bloom_cache.go': 2, 'blocks/blockstore/bloom_cache_test.go': 2, 'blocks/blockstore/util/remove.go': 2, 'blocks/blocksutil/block_generator.go': 2, 'blockservice/blockservice.go': 8, 'blockservice/blockservice_test.go': 6, 'blockservice/test/blocks_test.go': 7, 'cmd/ipfs/daemon.go': 23, 'cmd/ipfs/init.go': 25, 'cmd/ipfs/ipfs.go': 18, 'cmd/ipfs/main.go': 27, 'cmd/ipfs/main_test.go': 1, 'cmd/ipfswatch/main.go': 18, 'cmd/seccat/seccat.go': 26, 'commands/command.go': 11, 'commands/command_test.go': 3, 'commands/request.go': 15, 'commands/response.go': 6, 'commands/response_test.go': 3, 'core/bootstrap.go': 23, 'core/bootstrap_test.go': 23, 'core/builder.go': 49, 'core/commands/active.go': 11, 'core/commands/add.go': 36, 'core/commands/bitswap.go': 44, 'core/commands/block.go': 26, 'core/commands/bootstrap.go': 21, 'core/commands/cat.go': 24, 'core/commands/commands.go': 19, 'core/commands/config.go': 23, 'core/commands/dag/dag.go': 47, 'core/commands/dht.go': 50, 'core/commands/dht_test.go': 22, 'core/commands/diag.go': 11, 'core/commands/dns.go': 16, 'core/commands/external.go': 11, 'core/commands/files/files.go': 4, 'core/commands/filestore.go': 23, 'core/commands/get.go': 49, 'core/commands/get_test.go': 18, 'core/commands/helptext_test.go': 18, 'core/commands/id.go': 36, 'core/commands/ipns.go': 9, 'core/commands/ipnsps.go': 5, 'core/commands/keystore.go': 22, 'core/commands/log.go': 17, 'core/commands/ls.go': 47, 'core/commands/mount_nofuse.go': 11, 'core/commands/mount_unix.go': 21, 'core/commands/mount_windows.go': 11, 'core/commands/name.go': 3, 'core/commands/object/diff.go': 17, 'core/commands/object/object.go': 48, 'core/commands/object/patch.go': 22, 'core/commands/p2p.go': 25, 'core/commands/pin.go': 49, 'core/commands/ping.go': 30, 'core/commands/publish.go': 11, 'core/commands/pubsub.go': 33, 'core/commands/refs.go': 46, 'core/commands/repo.go': 35, 'core/commands/resolve.go': 43, 'core/commands/root.go': 18, 'core/commands/shutdown.go': 14, 'core/commands/stat.go': 22, 'core/commands/swarm.go': 33, 'core/commands/sysdiag.go': 17, 'core/commands/tar.go': 44, 'core/commands/unixfs/ls.go': 43, 'core/commands/unixfs/unixfs.go': 11, 'core/commands/version.go': 12, 'core/core.go': 54, 'core/coreapi/coreapi.go': 25, 'core/coreapi/interface/interface.go': 2, 'core/coreapi/unixfs.go': 45, 'core/coreapi/unixfs_test.go': 36, 'core/coredag/cbor.go': 17, 'core/coredag/dagpb.go': 39, 'core/coredag/dagtransl.go': 13, 'core/coredag/raw.go': 39, 'core/corehttp/commands.go': 48, 'core/corehttp/corehttp.go': 14, 'core/corehttp/gateway.go': 32, 'core/corehttp/gateway_handler.go': 51, 'core/corehttp/gateway_test.go': 46, 'core/corehttp/metrics_test.go': 30, 'core/corerepo/pinning.go': 15, 'core/coreunix/add.go': 52, 'core/coreunix/add_test.go': 49, 'core/coreunix/metadata.go': 45, 'core/coreunix/metadata_test.go': 48, 'core/mock/mock.go': 30, 'core/pathresolver.go': 43, 'exchange/bitswap/bitswap.go': 7, 'exchange/bitswap/bitswap_test.go': 7, 'exchange/bitswap/decision/bench_test.go': 7, 'exchange/bitswap/decision/engine.go': 7, 'exchange/bitswap/decision/engine_test.go': 7, 'exchange/bitswap/decision/ledger.go': 7, 'exchange/bitswap/decision/peer_request_queue.go': 7, 'exchange/bitswap/decision/peer_request_queue_test.go': 7, 'exchange/bitswap/get.go': 6, 'exchange/bitswap/message/message.go': 7, 'exchange/bitswap/message/message_test.go': 4, 'exchange/bitswap/network/interface.go': 7, 'exchange/bitswap/network/ipfs_impl.go': 7, 'exchange/bitswap/notifications/notifications.go': 4, 'exchange/bitswap/notifications/notifications_test.go': 4, 'exchange/bitswap/session.go': 7, 'exchange/bitswap/session_test.go': 6, 'exchange/bitswap/stat.go': 4, 'exchange/bitswap/testnet/interface.go': 6, 'exchange/bitswap/testnet/network_test.go': 7, 'exchange/bitswap/testnet/peernet.go': 7, 'exchange/bitswap/testnet/virtual.go': 8, 'exchange/bitswap/testutils.go': 7, 'exchange/bitswap/wantlist/wantlist.go': 4, 'exchange/bitswap/wantlist/wantlist_test.go': 4, 'exchange/bitswap/wantmanager.go': 7, 'exchange/bitswap/workers.go': 7, 'exchange/interface.go': 2, 'exchange/offline/offline.go': 2, 'exchange/offline/offline_test.go': 2, 'exchange/reprovide/providers.go': 42, 'exchange/reprovide/reprovide.go': 29, 'exchange/reprovide/reprovide_test.go': 31, 'filestore/filestore.go': 24, 'filestore/filestore_test.go': 41, 'filestore/fsrefstore.go': 23, 'filestore/util.go': 21, 'fuse/ipns/ipns_test.go': 30, 'fuse/ipns/ipns_unix.go': 52, 'fuse/node/mount_test.go': 29, 'fuse/readonly/ipfs_test.go': 50, 'fuse/readonly/readonly_unix.go': 52, 'importer/balanced/balanced_test.go': 8, 'importer/balanced/builder.go': 4, 'importer/chunk/rabin_test.go': 2, 'importer/chunk/splitting_test.go': 2, 'importer/helpers/dagbuilder.go': 7, 'importer/helpers/helpers.go': 5, 'importer/importer.go': 7, 'importer/importer_test.go': 7, 'importer/trickle/trickle_test.go': 8, 'importer/trickle/trickledag.go': 5, 'merkledag/batch.go': 2, 'merkledag/coding.go': 5, 'merkledag/merkledag.go': 6, 'merkledag/merkledag_test.go': 8, 'merkledag/node.go': 5, 'merkledag/node_test.go': 5, 'merkledag/raw.go': 4, 'merkledag/traverse/traverse.go': 4, 'merkledag/traverse/traverse_test.go': 5, 'merkledag/utils/diff.go': 5, 'merkledag/utils/diffenum.go': 4, 'merkledag/utils/diffenum_test.go': 5, 'merkledag/utils/utils.go': 7, 'merkledag/utils/utils_test.go': 5, 'mfs/dir.go': 8, 'mfs/file.go': 10, 'mfs/mfs_test.go': 12, 'mfs/ops.go': 8, 'mfs/repub_test.go': 10, 'mfs/system.go': 12, 'namesys/ipns_select_test.go': 4, 'namesys/namesys.go': 45, 'namesys/publisher.go': 49, 'namesys/publisher_test.go': 30, 'namesys/pubsub.go': 5, 'namesys/pubsub_test.go': 4, 'namesys/republisher/repub.go': 42, 'namesys/republisher/repub_test.go': 43, 'namesys/resolve_test.go': 44, 'namesys/routing.go': 45, 'p2p/p2p.go': 23, 'p2p/registry.go': 10, 'package.json': 49, 'path/path.go': 4, 'path/resolver.go': 4, 'path/resolver_test.go': 3, 'pin/gc/gc.go': 45, 'pin/pin.go': 44, 'pin/pin_test.go': 43, 'pin/set.go': 40, 'pin/set_test.go': 41, 'plugin/ipld.go': 13, 'plugin/loader/initializer.go': 10, 'plugin/plugins/git/git.go': 13, 'repo/config/bootstrap_peers.go': 7, 'repo/config/init.go': 8, 'repo/fsrepo/fsrepo.go': 24, 'repo/fsrepo/lock/lock.go': 3, 'repo/fsrepo/serialize/serialize.go': 4, 'repo/mock.go': 17, 'repo/repo.go': 20, 'routing/mock/centralized_client.go': 3, 'routing/mock/centralized_server.go': 3, 'routing/mock/centralized_test.go': 3, 'routing/mock/interface.go': 3, 'routing/none/none_client.go': 3, 'routing/offline/offline.go': 3, 'routing/offline/offline_test.go': 3, 'tar/format.go': 50, 'test/dependencies/ma-pipe-unidir/main.go': 10, 'test/integration/addcat_test.go': 34, 'test/integration/bench_cat_test.go': 33, 'test/integration/bench_test.go': 17, 'test/integration/bitswap_wo_routing_test.go': 35, 'test/integration/three_legged_cat_test.go': 33, 'thirdparty/ds-help/key.go': 2, 'thirdparty/pollEndpoint/main.go': 15, 'thirdparty/posinfo/posinfo.go': 2, 'unixfs/archive/archive.go': 5, 'unixfs/archive/tar/writer.go': 5, 'unixfs/hamt/hamt.go': 5, 'unixfs/io/dagreader.go': 5, 'unixfs/io/dirbuilder.go': 4, 'unixfs/io/resolve.go': 5, 'unixfs/mod/dagmodifier.go': 7, 'unixfs/mod/dagmodifier_test.go': 3, 'unixfs/test/utils.go': 8, 'commands/legacy/command.go': 10, 'commands/legacy/legacy.go': 10, 'commands/legacy/legacy_test.go': 10, 'commands/legacy/request.go': 11, 'commands/legacy/response.go': 10, 'core/commands/commands_test.go': 17, 'core/coreapi/dag.go': 14, 'core/coreapi/dag_test.go': 3, 'core/coreapi/interface/options/dag.go': 8, 'core/coreapi/key.go': 42, 'core/coreapi/name.go': 43, 'merkledag/test/utils.go': 6, 'namesys/namesys_test.go': 48, 'repo/fsrepo/datastores.go': 14, 'repo/fsrepo/fsrepo_test.go': 17, 'thirdparty/datastore2/datastore_closer.go': 1, 'thirdparty/datastore2/delayed.go': 1, 'thirdparty/datastore2/threadsafe.go': 1, 'unixfs/io/pbdagreader.go': 5, None: 21, 'mfs/fd.go': 4, 'unixfs/hamt/hamt_stress_test.go': 3, 'unixfs/hamt/hamt_test.go': 3, 'unixfs/io/dagreader_test.go': 1, 'unixfs/io/dirbuilder_test.go': 1, 'cmd/ipfs/util/ulimit.go': 9, 'cmd/seccat/util.go': 9, 'core/corehttp/logs.go': 10, 'fuse/mount/mount.go': 11, 'fuse/node/mount_unix.go': 10, 'importer/chunk/splitting.go': 1, 'namesys/ipns_validate_test.go': 3, 'plugin/loader/load.go': 7, 'core/coreapi/object.go': 44, 'fuse/mount/fuse.go': 5, 'keystore/keystore_test.go': 7, 'namesys/dns_test.go': 9, 'namesys/interface.go': 39, 'repo/config/config.go': 1, 'unixfs/unixfs.go': 1, 'blocks/blockstoreutil/remove.go': 20, 'blockservice/test/mock.go': 4, 'core/commands/files.go': 48, 'core/core_test.go': 16, 'core/coreapi/pin.go': 41, 'fuse/ipns/common.go': 42, 'keystore/keystore.go': 9, 'keystore/memkeystore.go': 5, 'namesys/validator.go': 2, 'path/resolver/resolver.go': 4, 'repo/config/identity.go': 2, 'thirdparty/verifbs/verifbs.go': 19, 'cmd/ipfs/util/ulimit_freebsd.go': 2, 'cmd/ipfs/util/ulimit_unix.go': 2, 'core/coreapi/block.go': 16, 'core/coreapi/block_test.go': 2, 'core/coreapi/interface/coreapi.go': 9, 'core/coreapi/interface/dag.go': 9, 'core/coreapi/interface/object.go': 9, 'core/coreapi/interface/options/block.go': 3, 'core/coreapi/interface/path.go': 31, 'core/coreapi/interface/unixfs.go': 13, 'fuse/ipns/link_unix.go': 2, 'fuse/node/mount_darwin.go': 2, 'merkledag/errservice.go': 2, 'merkledag/readonly.go': 2, 'merkledag/readonly_test.go': 2, 'merkledag/rwservice.go': 2, 'merkledag/session.go': 2, 'path/resolver/resolver_test.go': 2, 'thirdparty/verifcid/validate.go': 2, 'thirdparty/verifcid/validate_test.go': 2, 'namesys/ipns_resolver_validation_test.go': 39, 'test/sharness/t0170-dht.sh': 1, 'core/commands/urlstore.go': 42, 'unixfs/io/directory.go': 1, 'core/commands/env.go': 2, 'core/coreapi/interface/key.go': 7, 'core/coreapi/name_test.go': 28, 'core/coreapi/path.go': 41, 'core/coreunix/cat.go': 10, 'core/pathresolver_test.go': 36, 'dagutils/diff.go': 37, 'dagutils/diffenum.go': 35, 'dagutils/diffenum_test.go': 35, 'dagutils/utils.go': 37, 'dagutils/utils_test.go': 36, 'filestore/pb/dataobj.pb.go': 3, 'namesys/base.go': 37, 'namesys/cache.go': 36, 'namesys/dns.go': 37, 'namesys/proquint.go': 37, 'pin/internal/pb/header.pb.go': 3, 'thirdparty/cidv0v1/blockstore.go': 15, 'repo/fsrepo/config_test.go': 13, 'repo/fsrepo/misc.go': 13, 'test/bench/bench_cli_ipfs_add/main.go': 15, 'test/bench/offline_add/main.go': 15, 'core/commands/cmdenv/env.go': 21, 'core/commands/name/ipns.go': 37, 'core/commands/name/publish.go': 20, 'core/coreapi/dht.go': 30, 'core/coreapi/dht_test.go': 5, 'test/sharness/t0275-cid-security.sh': 1, 'core/commands/name/ipnsps.go': 14, 'core/commands/name/name.go': 10, 'core/coreapi/interface/dht.go': 10, 'p2p/listener.go': 13, 'p2p/local.go': 14, 'p2p/remote.go': 14, 'p2p/stream.go': 14, 'core/coreapi/interface/swarm.go': 9, 'core/coreapi/swarm.go': 21, 'core/coreapi/interface/options/unixfs.go': 15, 'core/coreapi/pubsub.go': 19, 'core/coreapi/unixfile.go': 17, 'core/commands/cid.go': 11, 'cmd/ipfs/dnsresolve_test.go': 5, 'core/coreapi/interface/pubsub.go': 4, 'test/dependencies/iptb/iptb.go': 12, 'plugin/plugins/badgerds/badgerds.go': 4, 'plugin/plugins/flatfs/flatfs.go': 3, 'plugin/plugins/levelds/levelds.go': 3, 'commands/context.go': 14, 'core/corehttp/proxy.go': 9, 'core/coreapi/interface/tests/name.go': 4, 'core/coreapi/interface/tests/unixfs.go': 4, 'core/coreapi/test/api_test.go': 10, 'plugin/loader/loader.go': 10, 'core/commands/cmdenv/cidbase.go': 7, 'core/commands/cmdenv/file.go': 3, 'core/corehttp/ipns_hostname.go': 8, 'plugin/daemon.go': 8, 'core/corerepo/stat.go': 2, 'core/commands/cmdenv/cidbase_test.go': 2, 'core/corehttp/metrics.go': 1, 'core/corehttp/proxy_test.go': 1, 'plugin/tracer.go': 1, 'thirdparty/notifier/notifier.go': 1, 'commands/reqlog.go': 1, 'core/corehttp/mutex_profile.go': 1, 'core/corehttp/option_test.go': 1, 'provider/queue.go': 1, 'provider/queue_test.go': 1, 'Rules.mk': 1, 'core/node/core.go': 1, 'core/node/provider.go': 1, 'gc/gc.go': 2, 'go.mod': 1, 'go.sum': 2, 'core/bootstrap/bootstrap.go': 2, 'core/node/libp2p/discovery.go': 1, 'core/node/libp2p/pnet.go': 1, 'core/node/libp2p/smux.go': 1, 'core/node/libp2p/transport.go': 1, 'plugin/loader/load_unix.go': 1, 'namesys/resolve/resolve.go': 1}","('core/core.go', 0.9152542372881356, 0.3016759776536313)"
core/corerepo/stat.go,49,207,1,"[{'cyclomatic_complexity': 7, 'nloc': 34, 'token_count': 179, 'name': 'RepoStat', 'long_name': 'RepoStat n * core . IpfsNode , ctx context . Context', 'start_line': 21, 'end_line': 61, 'full_parameters': ['n * core . IpfsNode', ' ctx context . Context'], 'filename': '/home/dimi/Documents/Informatik_Studium/FSS/SoftEvo/DataCollection/FFS_SoftEvo/go-ipfs/core/corerepo/stat.go', 'top_nesting_level': 0, 'length': 41, 'fan_in': 0, 'fan_out': 0, 'general_fan_out': 0}]",69,309,2,"[{'cyclomatic_complexity': 5, 'nloc': 27, 'token_count': 146, 'name': 'RepoStat', 'long_name': 'RepoStat ctx context . Context , n * core . IpfsNode', 'start_line': 33, 'end_line': 63, 'full_parameters': ['ctx context . Context', ' n * core . IpfsNode'], 'filename': '/home/dimi/Documents/Informatik_Studium/FSS/SoftEvo/DataCollection/FFS_SoftEvo/go-ipfs/core/corerepo/stat.go', 'top_nesting_level': 0, 'length': 31, 'fan_in': 0, 'fan_out': 0, 'general_fan_out': 0}, {'cyclomatic_complexity': 5, 'nloc': 22, 'token_count': 121, 'name': 'RepoSize', 'long_name': 'RepoSize ctx context . Context , n * core . IpfsNode', 'start_line': 66, 'end_line': 91, 'full_parameters': ['ctx context . Context', ' n * core . IpfsNode'], 'filename': '/home/dimi/Documents/Informatik_Studium/FSS/SoftEvo/DataCollection/FFS_SoftEvo/go-ipfs/core/corerepo/stat.go', 'top_nesting_level': 0, 'length': 26, 'fan_in': 0, 'fan_out': 0, 'general_fan_out': 0}]",20,102,1,4,4,"[{'timestamp': 1515171178.0, 'added_lines': 25, 'deleted_lines': 9, 'nloc': 64}, {'timestamp': 1528974765.0, 'added_lines': 21, 'deleted_lines': 14, 'nloc': 69}, {'timestamp': 1550610741.0, 'added_lines': 1, 'deleted_lines': 1, 'nloc': 69}, {'timestamp': 1551551196.0, 'added_lines': 1, 'deleted_lines': 1, 'nloc': 69}]","{'core/commands/repo.go': 4, 'repo/fsrepo/fsrepo.go': 2, 'cmd/ipfs/daemon.go': 2, 'cmd/ipfs/init.go': 2, 'cmd/ipfs/ipfs.go': 2, 'cmd/ipfs/main.go': 2, 'commands/context.go': 2, 'core/commands/active.go': 2, 'core/commands/add.go': 2, 'core/commands/bitswap.go': 2, 'core/commands/block.go': 2, 'core/commands/bootstrap.go': 2, 'core/commands/cat.go': 2, 'core/commands/cid.go': 2, 'core/commands/cmdenv/cidbase.go': 2, 'core/commands/cmdenv/env.go': 2, 'core/commands/commands.go': 2, 'core/commands/commands_test.go': 2, 'core/commands/config.go': 2, 'core/commands/dag/dag.go': 2, 'core/commands/dht.go': 2, 'core/commands/diag.go': 2, 'core/commands/dns.go': 2, 'core/commands/external.go': 2, 'core/commands/files.go': 2, 'core/commands/filestore.go': 2, 'core/commands/get.go': 2, 'core/commands/get_test.go': 2, 'core/commands/helptext_test.go': 2, 'core/commands/id.go': 2, 'core/commands/keystore.go': 2, 'core/commands/log.go': 2, 'core/commands/ls.go': 2, 'core/commands/mount_nofuse.go': 2, 'core/commands/mount_unix.go': 2, 'core/commands/mount_windows.go': 2, 'core/commands/name/ipns.go': 2, 'core/commands/name/ipnsps.go': 2, 'core/commands/name/name.go': 2, 'core/commands/name/publish.go': 2, 'core/commands/object/diff.go': 2, 'core/commands/object/object.go': 2, 'core/commands/object/patch.go': 2, 'core/commands/p2p.go': 2, 'core/commands/pin.go': 2, 'core/commands/ping.go': 2, 'core/commands/pubsub.go': 2, 'core/commands/refs.go': 2, 'core/commands/resolve.go': 2, 'core/commands/root.go': 2, 'core/commands/shutdown.go': 2, 'core/commands/stat.go': 2, 'core/commands/swarm.go': 2, 'core/commands/sysdiag.go': 2, 'core/commands/tar.go': 2, 'core/commands/unixfs/ls.go': 2, 'core/commands/unixfs/unixfs.go': 2, 'core/commands/urlstore.go': 2, 'core/commands/version.go': 2, 'core/corehttp/commands.go': 2, 'core/corehttp/gateway_handler.go': 2, 'core/corerepo/gc.go': 2, 'package.json': 1, 'plugin/plugins/badgerds/badgerds.go': 2, 'test/bench/bench_cli_ipfs_add/main.go': 2, 'test/bench/offline_add/main.go': 2, 'test/integration/addcat_test.go': 2, 'assets/assets.go': 1, 'blocks/blockstoreutil/remove.go': 1, 'cmd/ipfs/dnsresolve_test.go': 1, 'cmd/ipfs/util/ulimit.go': 1, 'cmd/ipfs/util/ulimit_freebsd.go': 1, 'cmd/ipfs/util/ulimit_unix.go': 1, 'cmd/ipfswatch/main.go': 1, 'cmd/seccat/seccat.go': 1, 'cmd/seccat/util.go': 1, 'core/bootstrap.go': 1, 'core/bootstrap_test.go': 1, 'core/builder.go': 1, 'core/commands/cmdenv/cidbase_test.go': 1, 'core/commands/cmdenv/file.go': 1, 'core/commands/dht_test.go': 1, 'core/core.go': 1, 'core/core_test.go': 1, 'core/coreapi/block.go': 1, 'core/coreapi/coreapi.go': 1, 'core/coreapi/dag.go': 1, 'core/coreapi/dht.go': 1, 'core/coreapi/key.go': 1, 'core/coreapi/name.go': 1, 'core/coreapi/object.go': 1, 'core/coreapi/path.go': 1, 'core/coreapi/pin.go': 1, 'core/coreapi/pubsub.go': 1, 'core/coreapi/swarm.go': 1, 'core/coreapi/test/api_test.go': 1, 'core/coreapi/unixfs.go': 1, 'core/coredag/cbor.go': 1, 'core/coredag/dagpb.go': 1, 'core/coredag/dagtransl.go': 1, 'core/coredag/raw.go': 1, 'core/corehttp/corehttp.go': 1, 'core/corehttp/gateway.go': 1, 'core/corehttp/gateway_test.go': 1, 'core/corehttp/ipns_hostname.go': 1, 'core/corehttp/logs.go': 1, 'core/corehttp/metrics.go': 1, 'core/corehttp/metrics_test.go': 1, 'core/corehttp/proxy.go': 1, 'core/corehttp/proxy_test.go': 1, 'core/coreunix/add.go': 1, 'core/coreunix/add_test.go': 1, 'core/coreunix/metadata.go': 1, 'core/coreunix/metadata_test.go': 1, 'core/mock/mock.go': 1, 'core/pathresolver.go': 1, 'core/pathresolver_test.go': 1, 'dagutils/diff.go': 1, 'dagutils/diffenum.go': 1, 'dagutils/diffenum_test.go': 1, 'dagutils/utils.go': 1, 'dagutils/utils_test.go': 1, 'exchange/reprovide/providers.go': 1, 'exchange/reprovide/reprovide.go': 1, 'exchange/reprovide/reprovide_test.go': 1, 'filestore/filestore.go': 1, 'filestore/filestore_test.go': 1, 'filestore/fsrefstore.go': 1, 'filestore/pb/dataobj.pb.go': 1, 'filestore/util.go': 1, 'fuse/ipns/common.go': 1, 'fuse/ipns/ipns_test.go': 1, 'fuse/ipns/ipns_unix.go': 1, 'fuse/ipns/link_unix.go': 1, 'fuse/mount/fuse.go': 1, 'fuse/mount/mount.go': 1, 'fuse/node/mount_darwin.go': 1, 'fuse/node/mount_test.go': 1, 'fuse/node/mount_unix.go': 1, 'fuse/readonly/ipfs_test.go': 1, 'fuse/readonly/readonly_unix.go': 1, 'keystore/keystore.go': 1, 'keystore/keystore_test.go': 1, 'keystore/memkeystore.go': 1, 'namesys/base.go': 1, 'namesys/cache.go': 1, 'namesys/dns.go': 1, 'namesys/dns_test.go': 1, 'namesys/interface.go': 1, 'namesys/ipns_resolver_validation_test.go': 1, 'namesys/namesys.go': 1, 'namesys/namesys_test.go': 1, 'namesys/proquint.go': 1, 'namesys/publisher.go': 1, 'namesys/publisher_test.go': 1, 'namesys/republisher/repub.go': 1, 'namesys/republisher/repub_test.go': 1, 'namesys/resolve_test.go': 1, 'namesys/routing.go': 1, 'p2p/listener.go': 1, 'p2p/local.go': 1, 'p2p/p2p.go': 1, 'p2p/remote.go': 1, 'p2p/stream.go': 1, 'pin/gc/gc.go': 1, 'pin/internal/pb/header.pb.go': 1, 'pin/pin.go': 1, 'pin/pin_test.go': 1, 'pin/set.go': 1, 'pin/set_test.go': 1, 'plugin/daemon.go': 1, 'plugin/ipld.go': 1, 'plugin/loader/loader.go': 1, 'plugin/plugins/flatfs/flatfs.go': 1, 'plugin/plugins/git/git.go': 1, 'plugin/plugins/levelds/levelds.go': 1, 'plugin/tracer.go': 1, 'repo/fsrepo/config_test.go': 1, 'repo/fsrepo/datastores.go': 1, 'repo/fsrepo/fsrepo_test.go': 1, 'repo/fsrepo/misc.go': 1, 'repo/mock.go': 1, 'repo/repo.go': 1, 'tar/format.go': 1, 'test/dependencies/iptb/iptb.go': 1, 'test/dependencies/ma-pipe-unidir/main.go': 1, 'test/integration/bench_cat_test.go': 1, 'test/integration/bench_test.go': 1, 'test/integration/bitswap_wo_routing_test.go': 1, 'test/integration/three_legged_cat_test.go': 1, 'thirdparty/cidv0v1/blockstore.go': 1, 'thirdparty/notifier/notifier.go': 1, 'thirdparty/pollEndpoint/main.go': 1, 'thirdparty/verifbs/verifbs.go': 1}","('core/commands/repo.go', 1.0, 0.037383177570093455)"
core/coreunix/add.go,490,2744,24,"[{'cyclomatic_complexity': 1, 'nloc': 3, 'token_count': 23, 'name': 'Error', 'long_name': '(e*hiddenFileError)Error', 'start_line': 57, 'end_line': 59, 'full_parameters': [], 'filename': '/home/dimi/Documents/Informatik_Studium/FSS/SoftEvo/DataCollection/FFS_SoftEvo/go-ipfs/core/coreunix/add.go', 'top_nesting_level': 0, 'length': 3, 'fan_in': 0, 'fan_out': 0, 'general_fan_out': 0}, {'cyclomatic_complexity': 1, 'nloc': 3, 'token_count': 23, 'name': 'Error', 'long_name': '(e*ignoreFileError)Error', 'start_line': 65, 'end_line': 67, 'full_parameters': [], 'filename': '/home/dimi/Documents/Informatik_Studium/FSS/SoftEvo/DataCollection/FFS_SoftEvo/go-ipfs/core/coreunix/add.go', 'top_nesting_level': 0, 'length': 3, 'fan_in': 0, 'fan_out': 0, 'general_fan_out': 0}, {'cyclomatic_complexity': 1, 'nloc': 14, 'token_count': 78, 'name': 'NewAdder', 'long_name': 'NewAdder ctx context . Context , p pin . Pinner , bs bstore . GCBlockstore , ds dag . DAGService', 'start_line': 76, 'end_line': 89, 'full_parameters': ['ctx context . Context', ' p pin . Pinner', ' bs bstore . GCBlockstore', ' ds dag . DAGService'], 'filename': '/home/dimi/Documents/Informatik_Studium/FSS/SoftEvo/DataCollection/FFS_SoftEvo/go-ipfs/core/coreunix/add.go', 'top_nesting_level': 0, 'length': 14, 'fan_in': 0, 'fan_out': 0, 'general_fan_out': 0}, {'cyclomatic_complexity': 3, 'nloc': 14, 'token_count': 96, 'name': 'mfsRoot', 'long_name': '(adder*Adder)mfsRoot', 'start_line': 115, 'end_line': 128, 'full_parameters': [], 'filename': '/home/dimi/Documents/Informatik_Studium/FSS/SoftEvo/DataCollection/FFS_SoftEvo/go-ipfs/core/coreunix/add.go', 'top_nesting_level': 0, 'length': 14, 'fan_in': 0, 'fan_out': 0, 'general_fan_out': 0}, {'cyclomatic_complexity': 1, 'nloc': 3, 'token_count': 21, 'name': 'SetMfsRoot', 'long_name': '(adder*Adder)SetMfsRoot r * mfs . Root', 'start_line': 130, 'end_line': 132, 'full_parameters': ['r * mfs . Root'], 'filename': '/home/dimi/Documents/Informatik_Studium/FSS/SoftEvo/DataCollection/FFS_SoftEvo/go-ipfs/core/coreunix/add.go', 'top_nesting_level': 0, 'length': 3, 'fan_in': 0, 'fan_out': 0, 'general_fan_out': 0}, {'cyclomatic_complexity': 3, 'nloc': 17, 'token_count': 112, 'name': 'add', 'long_name': '(adder Adder)add reader io . Reader', 'start_line': 135, 'end_line': 154, 'full_parameters': ['reader io . Reader'], 'filename': '/home/dimi/Documents/Informatik_Studium/FSS/SoftEvo/DataCollection/FFS_SoftEvo/go-ipfs/core/coreunix/add.go', 'top_nesting_level': 0, 'length': 20, 'fan_in': 0, 'fan_out': 0, 'general_fan_out': 0}, {'cyclomatic_complexity': 7, 'nloc': 22, 'token_count': 137, 'name': 'RootNode', 'long_name': '(adder*Adder)RootNode', 'start_line': 156, 'end_line': 183, 'full_parameters': [], 'filename': '/home/dimi/Documents/Informatik_Studium/FSS/SoftEvo/DataCollection/FFS_SoftEvo/go-ipfs/core/coreunix/add.go', 'top_nesting_level': 0, 'length': 28, 'fan_in': 0, 'fan_out': 0, 'general_fan_out': 0}, {'cyclomatic_complexity': 6, 'nloc': 22, 'token_count': 117, 'name': 'PinRoot', 'long_name': '(adder*Adder)PinRoot', 'start_line': 185, 'end_line': 209, 'full_parameters': [], 'filename': '/home/dimi/Documents/Informatik_Studium/FSS/SoftEvo/DataCollection/FFS_SoftEvo/go-ipfs/core/coreunix/add.go', 'top_nesting_level': 0, 'length': 25, 'fan_in': 0, 'fan_out': 0, 'general_fan_out': 0}, {'cyclomatic_complexity': 11, 'nloc': 43, 'token_count': 236, 'name': 'Finalize', 'long_name': '(adder*Adder)Finalize', 'start_line': 211, 'end_line': 263, 'full_parameters': [], 'filename': '/home/dimi/Documents/Informatik_Studium/FSS/SoftEvo/DataCollection/FFS_SoftEvo/go-ipfs/core/coreunix/add.go', 'top_nesting_level': 0, 'length': 53, 'fan_in': 0, 'fan_out': 0, 'general_fan_out': 0}, {'cyclomatic_complexity': 8, 'nloc': 30, 'token_count': 163, 'name': 'outputDirs', 'long_name': '(adder*Adder)outputDirs path string , fsn mfs . FSNode', 'start_line': 265, 'end_line': 298, 'full_parameters': ['path string', ' fsn mfs . FSNode'], 'filename': '/home/dimi/Documents/Informatik_Studium/FSS/SoftEvo/DataCollection/FFS_SoftEvo/go-ipfs/core/coreunix/add.go', 'top_nesting_level': 0, 'length': 34, 'fan_in': 0, 'fan_out': 0, 'general_fan_out': 0}, {'cyclomatic_complexity': 1, 'nloc': 3, 'token_count': 34, 'name': 'Add', 'long_name': 'Add n * core . IpfsNode , r io . Reader', 'start_line': 303, 'end_line': 305, 'full_parameters': ['n * core . IpfsNode', ' r io . Reader'], 'filename': '/home/dimi/Documents/Informatik_Studium/FSS/SoftEvo/DataCollection/FFS_SoftEvo/go-ipfs/core/coreunix/add.go', 'top_nesting_level': 0, 'length': 3, 'fan_in': 0, 'fan_out': 0, 'general_fan_out': 0}, {'cyclomatic_complexity': 3, 'nloc': 12, 'token_count': 104, 'name': 'AddWithContext', 'long_name': 'AddWithContext ctx context . Context , n * core . IpfsNode , r io . Reader', 'start_line': 308, 'end_line': 322, 'full_parameters': ['ctx context . Context', ' n * core . IpfsNode', ' r io . Reader'], 'filename': '/home/dimi/Documents/Informatik_Studium/FSS/SoftEvo/DataCollection/FFS_SoftEvo/go-ipfs/core/coreunix/add.go', 'top_nesting_level': 0, 'length': 15, 'fan_in': 0, 'fan_out': 0, 'general_fan_out': 0}, {'cyclomatic_complexity': 6, 'nloc': 25, 'token_count': 163, 'name': 'AddR', 'long_name': 'AddR n * core . IpfsNode , root string', 'start_line': 325, 'end_line': 355, 'full_parameters': ['n * core . IpfsNode', ' root string'], 'filename': '/home/dimi/Documents/Informatik_Studium/FSS/SoftEvo/DataCollection/FFS_SoftEvo/go-ipfs/core/coreunix/add.go', 'top_nesting_level': 0, 'length': 31, 'fan_in': 0, 'fan_out': 0, 'general_fan_out': 0}, {'cyclomatic_complexity': 4, 'nloc': 19, 'token_count': 165, 'name': 'AddWrapped', 'long_name': 'AddWrapped n * core . IpfsNode , r io . Reader , filename string', 'start_line': 361, 'end_line': 383, 'full_parameters': ['n * core . IpfsNode', ' r io . Reader', ' filename string'], 'filename': '/home/dimi/Documents/Informatik_Studium/FSS/SoftEvo/DataCollection/FFS_SoftEvo/go-ipfs/core/coreunix/add.go', 'top_nesting_level': 0, 'length': 23, 'fan_in': 0, 'fan_out': 0, 'general_fan_out': 0}, {'cyclomatic_complexity': 8, 'nloc': 25, 'token_count': 153, 'name': 'addNode', 'long_name': '(adder*Adder)addNode node node . Node , path string', 'start_line': 385, 'end_line': 414, 'full_parameters': ['node node . Node', ' path string'], 'filename': '/home/dimi/Documents/Informatik_Studium/FSS/SoftEvo/DataCollection/FFS_SoftEvo/go-ipfs/core/coreunix/add.go', 'top_nesting_level': 0, 'length': 30, 'fan_in': 0, 'fan_out': 0, 'general_fan_out': 0}, {'cyclomatic_complexity': 2, 'nloc': 5, 'token_count': 20, 'name': '', 'long_name': '()', 'start_line': 421, 'end_line': 425, 'full_parameters': [], 'filename': '/home/dimi/Documents/Informatik_Studium/FSS/SoftEvo/DataCollection/FFS_SoftEvo/go-ipfs/core/coreunix/add.go', 'top_nesting_level': 0, 'length': 5, 'fan_in': 0, 'fan_out': 0, 'general_fan_out': 0}, {'cyclomatic_complexity': 2, 'nloc': 7, 'token_count': 44, 'name': 'AddFile', 'long_name': '(adder*Adder)AddFile file files . File', 'start_line': 417, 'end_line': 428, 'full_parameters': ['file files . File'], 'filename': '/home/dimi/Documents/Informatik_Studium/FSS/SoftEvo/DataCollection/FFS_SoftEvo/go-ipfs/core/coreunix/add.go', 'top_nesting_level': 0, 'length': 12, 'fan_in': 0, 'fan_out': 0, 'general_fan_out': 0}, {'cyclomatic_complexity': 12, 'nloc': 47, 'token_count': 272, 'name': 'addFile', 'long_name': '(adder*Adder)addFile file files . File', 'start_line': 430, 'end_line': 490, 'full_parameters': ['file files . File'], 'filename': '/home/dimi/Documents/Informatik_Studium/FSS/SoftEvo/DataCollection/FFS_SoftEvo/go-ipfs/core/coreunix/add.go', 'top_nesting_level': 0, 'length': 61, 'fan_in': 0, 'fan_out': 0, 'general_fan_out': 0}, {'cyclomatic_complexity': 10, 'nloc': 29, 'token_count': 149, 'name': 'addDir', 'long_name': '(adder*Adder)addDir dir files . File', 'start_line': 492, 'end_line': 525, 'full_parameters': ['dir files . File'], 'filename': '/home/dimi/Documents/Informatik_Studium/FSS/SoftEvo/DataCollection/FFS_SoftEvo/go-ipfs/core/coreunix/add.go', 'top_nesting_level': 0, 'length': 34, 'fan_in': 0, 'fan_out': 0, 'general_fan_out': 0}, {'cyclomatic_complexity': 4, 'nloc': 11, 'token_count': 63, 'name': 'maybePauseForGC', 'long_name': '(adder*Adder)maybePauseForGC', 'start_line': 527, 'end_line': 538, 'full_parameters': [], 'filename': '/home/dimi/Documents/Informatik_Studium/FSS/SoftEvo/DataCollection/FFS_SoftEvo/go-ipfs/core/coreunix/add.go', 'top_nesting_level': 0, 'length': 12, 'fan_in': 0, 'fan_out': 0, 'general_fan_out': 0}, {'cyclomatic_complexity': 3, 'nloc': 15, 'token_count': 69, 'name': 'outputDagnode', 'long_name': 'outputDagnode out chan interface { } , name string , dn node . Node', 'start_line': 541, 'end_line': 558, 'full_parameters': ['out chan interface { }', ' name string', ' dn node . Node'], 'filename': '/home/dimi/Documents/Informatik_Studium/FSS/SoftEvo/DataCollection/FFS_SoftEvo/go-ipfs/core/coreunix/add.go', 'top_nesting_level': 0, 'length': 18, 'fan_in': 0, 'fan_out': 0, 'general_fan_out': 0}, {'cyclomatic_complexity': 1, 'nloc': 5, 'token_count': 48, 'name': 'NewMemoryDagService', 'long_name': 'NewMemoryDagService', 'start_line': 560, 'end_line': 565, 'full_parameters': [], 'filename': '/home/dimi/Documents/Informatik_Studium/FSS/SoftEvo/DataCollection/FFS_SoftEvo/go-ipfs/core/coreunix/add.go', 'top_nesting_level': 0, 'length': 6, 'fan_in': 0, 'fan_out': 0, 'general_fan_out': 0}, {'cyclomatic_complexity': 3, 'nloc': 19, 'token_count': 124, 'name': 'getOutput', 'long_name': 'getOutput dagnode node . Node', 'start_line': 568, 'end_line': 589, 'full_parameters': ['dagnode node . Node'], 'filename': '/home/dimi/Documents/Informatik_Studium/FSS/SoftEvo/DataCollection/FFS_SoftEvo/go-ipfs/core/coreunix/add.go', 'top_nesting_level': 0, 'length': 22, 'fan_in': 0, 'fan_out': 0, 'general_fan_out': 0}, {'cyclomatic_complexity': 3, 'nloc': 12, 'token_count': 94, 'name': 'Read', 'long_name': '(i*progressReader)Read p [ ] byte', 'start_line': 598, 'end_line': 611, 'full_parameters': ['p [ ] byte'], 'filename': '/home/dimi/Documents/Informatik_Studium/FSS/SoftEvo/DataCollection/FFS_SoftEvo/go-ipfs/core/coreunix/add.go', 'top_nesting_level': 0, 'length': 14, 'fan_in': 0, 'fan_out': 0, 'general_fan_out': 0}]",422,2287,19,"[{'cyclomatic_complexity': 1, 'nloc': 14, 'token_count': 84, 'name': 'NewAdder', 'long_name': 'NewAdder ctx context . Context , p pin . Pinner , bs bstore . GCLocker , ds ipld . DAGService', 'start_line': 46, 'end_line': 60, 'full_parameters': ['ctx context . Context', ' p pin . Pinner', ' bs bstore . GCLocker', ' ds ipld . DAGService'], 'filename': '/home/dimi/Documents/Informatik_Studium/FSS/SoftEvo/DataCollection/FFS_SoftEvo/go-ipfs/core/coreunix/add.go', 'top_nesting_level': 0, 'length': 15, 'fan_in': 0, 'fan_out': 0, 'general_fan_out': 0}, {'cyclomatic_complexity': 3, 'nloc': 13, 'token_count': 89, 'name': 'mfsRoot', 'long_name': '(adder*Adder)mfsRoot', 'start_line': 84, 'end_line': 96, 'full_parameters': [], 'filename': '/home/dimi/Documents/Informatik_Studium/FSS/SoftEvo/DataCollection/FFS_SoftEvo/go-ipfs/core/coreunix/add.go', 'top_nesting_level': 0, 'length': 13, 'fan_in': 0, 'fan_out': 0, 'general_fan_out': 0}, {'cyclomatic_complexity': 1, 'nloc': 3, 'token_count': 21, 'name': 'SetMfsRoot', 'long_name': '(adder*Adder)SetMfsRoot r * mfs . Root', 'start_line': 99, 'end_line': 101, 'full_parameters': ['r * mfs . Root'], 'filename': '/home/dimi/Documents/Informatik_Studium/FSS/SoftEvo/DataCollection/FFS_SoftEvo/go-ipfs/core/coreunix/add.go', 'top_nesting_level': 0, 'length': 3, 'fan_in': 0, 'fan_out': 0, 'general_fan_out': 0}, {'cyclomatic_complexity': 5, 'nloc': 27, 'token_count': 157, 'name': 'add', 'long_name': '(adder*Adder)add reader io . Reader', 'start_line': 104, 'end_line': 133, 'full_parameters': ['reader io . Reader'], 'filename': '/home/dimi/Documents/Informatik_Studium/FSS/SoftEvo/DataCollection/FFS_SoftEvo/go-ipfs/core/coreunix/add.go', 'top_nesting_level': 0, 'length': 30, 'fan_in': 0, 'fan_out': 0, 'general_fan_out': 0}, {'cyclomatic_complexity': 5, 'nloc': 18, 'token_count': 113, 'name': 'curRootNode', 'long_name': '(adder*Adder)curRootNode', 'start_line': 136, 'end_line': 157, 'full_parameters': [], 'filename': '/home/dimi/Documents/Informatik_Studium/FSS/SoftEvo/DataCollection/FFS_SoftEvo/go-ipfs/core/coreunix/add.go', 'top_nesting_level': 0, 'length': 22, 'fan_in': 0, 'fan_out': 0, 'general_fan_out': 0}, {'cyclomatic_complexity': 5, 'nloc': 19, 'token_count': 118, 'name': 'PinRoot', 'long_name': '(adder*Adder)PinRoot root ipld . Node', 'start_line': 161, 'end_line': 183, 'full_parameters': ['root ipld . Node'], 'filename': '/home/dimi/Documents/Informatik_Studium/FSS/SoftEvo/DataCollection/FFS_SoftEvo/go-ipfs/core/coreunix/add.go', 'top_nesting_level': 0, 'length': 23, 'fan_in': 0, 'fan_out': 0, 'general_fan_out': 0}, {'cyclomatic_complexity': 8, 'nloc': 30, 'token_count': 163, 'name': 'outputDirs', 'long_name': '(adder*Adder)outputDirs path string , fsn mfs . FSNode', 'start_line': 185, 'end_line': 218, 'full_parameters': ['path string', ' fsn mfs . FSNode'], 'filename': '/home/dimi/Documents/Informatik_Studium/FSS/SoftEvo/DataCollection/FFS_SoftEvo/go-ipfs/core/coreunix/add.go', 'top_nesting_level': 0, 'length': 34, 'fan_in': 0, 'fan_out': 0, 'general_fan_out': 0}, {'cyclomatic_complexity': 8, 'nloc': 30, 'token_count': 172, 'name': 'addNode', 'long_name': '(adder*Adder)addNode node ipld . Node , path string', 'start_line': 220, 'end_line': 254, 'full_parameters': ['node ipld . Node', ' path string'], 'filename': '/home/dimi/Documents/Informatik_Studium/FSS/SoftEvo/DataCollection/FFS_SoftEvo/go-ipfs/core/coreunix/add.go', 'top_nesting_level': 0, 'length': 35, 'fan_in': 0, 'fan_out': 0, 'general_fan_out': 0}, {'cyclomatic_complexity': 2, 'nloc': 5, 'token_count': 20, 'name': '', 'long_name': '()', 'start_line': 261, 'end_line': 265, 'full_parameters': [], 'filename': '/home/dimi/Documents/Informatik_Studium/FSS/SoftEvo/DataCollection/FFS_SoftEvo/go-ipfs/core/coreunix/add.go', 'top_nesting_level': 0, 'length': 5, 'fan_in': 0, 'fan_out': 0, 'general_fan_out': 0}, {'cyclomatic_complexity': 15, 'nloc': 58, 'token_count': 311, 'name': 'AddAllAndPin', 'long_name': '(adder*Adder)AddAllAndPin file files . Node', 'start_line': 257, 'end_line': 334, 'full_parameters': ['file files . Node'], 'filename': '/home/dimi/Documents/Informatik_Studium/FSS/SoftEvo/DataCollection/FFS_SoftEvo/go-ipfs/core/coreunix/add.go', 'top_nesting_level': 0, 'length': 78, 'fan_in': 0, 'fan_out': 0, 'general_fan_out': 0}, {'cyclomatic_complexity': 8, 'nloc': 28, 'token_count': 160, 'name': 'addFileNode', 'long_name': '(adder*Adder)addFileNode path string , file files . Node , toplevel bool', 'start_line': 336, 'end_line': 368, 'full_parameters': ['path string', ' file files . Node', ' toplevel bool'], 'filename': '/home/dimi/Documents/Informatik_Studium/FSS/SoftEvo/DataCollection/FFS_SoftEvo/go-ipfs/core/coreunix/add.go', 'top_nesting_level': 0, 'length': 33, 'fan_in': 0, 'fan_out': 0, 'general_fan_out': 0}, {'cyclomatic_complexity': 3, 'nloc': 13, 'token_count': 87, 'name': 'addSymlink', 'long_name': '(adder*Adder)addSymlink path string , l * files . Symlink', 'start_line': 370, 'end_line': 384, 'full_parameters': ['path string', ' l * files . Symlink'], 'filename': '/home/dimi/Documents/Informatik_Studium/FSS/SoftEvo/DataCollection/FFS_SoftEvo/go-ipfs/core/coreunix/add.go', 'top_nesting_level': 0, 'length': 15, 'fan_in': 0, 'fan_out': 0, 'general_fan_out': 0}, {'cyclomatic_complexity': 4, 'nloc': 16, 'token_count': 109, 'name': 'addFile', 'long_name': '(adder*Adder)addFile path string , file files . File', 'start_line': 386, 'end_line': 406, 'full_parameters': ['path string', ' file files . File'], 'filename': '/home/dimi/Documents/Informatik_Studium/FSS/SoftEvo/DataCollection/FFS_SoftEvo/go-ipfs/core/coreunix/add.go', 'top_nesting_level': 0, 'length': 21, 'fan_in': 0, 'fan_out': 0, 'general_fan_out': 0}, {'cyclomatic_complexity': 7, 'nloc': 26, 'token_count': 155, 'name': 'addDir', 'long_name': '(adder*Adder)addDir path string , dir files . Directory , toplevel bool', 'start_line': 408, 'end_line': 436, 'full_parameters': ['path string', ' dir files . Directory', ' toplevel bool'], 'filename': '/home/dimi/Documents/Informatik_Studium/FSS/SoftEvo/DataCollection/FFS_SoftEvo/go-ipfs/core/coreunix/add.go', 'top_nesting_level': 0, 'length': 29, 'fan_in': 0, 'fan_out': 0, 'general_fan_out': 0}, {'cyclomatic_complexity': 5, 'nloc': 15, 'token_count': 81, 'name': 'maybePauseForGC', 'long_name': '(adder*Adder)maybePauseForGC', 'start_line': 438, 'end_line': 454, 'full_parameters': [], 'filename': '/home/dimi/Documents/Informatik_Studium/FSS/SoftEvo/DataCollection/FFS_SoftEvo/go-ipfs/core/coreunix/add.go', 'top_nesting_level': 0, 'length': 17, 'fan_in': 0, 'fan_out': 0, 'general_fan_out': 0}, {'cyclomatic_complexity': 3, 'nloc': 15, 'token_count': 73, 'name': 'outputDagnode', 'long_name': 'outputDagnode out chan < - interface { } , name string , dn ipld . Node', 'start_line': 457, 'end_line': 474, 'full_parameters': ['out chan < - interface { }', ' name string', ' dn ipld . Node'], 'filename': '/home/dimi/Documents/Informatik_Studium/FSS/SoftEvo/DataCollection/FFS_SoftEvo/go-ipfs/core/coreunix/add.go', 'top_nesting_level': 0, 'length': 18, 'fan_in': 0, 'fan_out': 0, 'general_fan_out': 0}, {'cyclomatic_complexity': 2, 'nloc': 12, 'token_count': 76, 'name': 'getOutput', 'long_name': 'getOutput dagnode ipld . Node', 'start_line': 477, 'end_line': 490, 'full_parameters': ['dagnode ipld . Node'], 'filename': '/home/dimi/Documents/Informatik_Studium/FSS/SoftEvo/DataCollection/FFS_SoftEvo/go-ipfs/core/coreunix/add.go', 'top_nesting_level': 0, 'length': 14, 'fan_in': 0, 'fan_out': 0, 'general_fan_out': 0}, {'cyclomatic_complexity': 3, 'nloc': 12, 'token_count': 92, 'name': 'Read', 'long_name': '(i*progressReader)Read p [ ] byte', 'start_line': 500, 'end_line': 513, 'full_parameters': ['p [ ] byte'], 'filename': '/home/dimi/Documents/Informatik_Studium/FSS/SoftEvo/DataCollection/FFS_SoftEvo/go-ipfs/core/coreunix/add.go', 'top_nesting_level': 0, 'length': 14, 'fan_in': 0, 'fan_out': 0, 'general_fan_out': 0}, {'cyclomatic_complexity': 1, 'nloc': 3, 'token_count': 29, 'name': 'Read', 'long_name': '(i*progressReader2)Read p [ ] byte', 'start_line': 520, 'end_line': 522, 'full_parameters': ['p [ ] byte'], 'filename': '/home/dimi/Documents/Informatik_Studium/FSS/SoftEvo/DataCollection/FFS_SoftEvo/go-ipfs/core/coreunix/add.go', 'top_nesting_level': 0, 'length': 3, 'fan_in': 0, 'fan_out': 0, 'general_fan_out': 0}]",-68,-457,-5,126,126,"[{'timestamp': 1504918855.0, 'added_lines': 11, 'deleted_lines': 3, 'nloc': 498}, {'timestamp': 1491058697.0, 'added_lines': 1, 'deleted_lines': 1, 'nloc': 498}, {'timestamp': 1511223906.0, 'added_lines': 1, 'deleted_lines': 1, 'nloc': 498}, {'timestamp': 1511892047.0, 'added_lines': 1, 'deleted_lines': 1, 'nloc': 498}, {'timestamp': 1511062375.0, 'added_lines': 2, 'deleted_lines': 2, 'nloc': 498}, {'timestamp': 1512365669.0, 'added_lines': 3, 'deleted_lines': 3, 'nloc': 498}, {'timestamp': 1513724336.0, 'added_lines': 1, 'deleted_lines': 1, 'nloc': 498}, {'timestamp': 1513749182.0, 'added_lines': 2, 'deleted_lines': 1, 'nloc': 498}, {'timestamp': 1515393231.0, 'added_lines': 1, 'deleted_lines': 1, 'nloc': 498}, {'timestamp': 1511187070.0, 'added_lines': 1, 'deleted_lines': 1, 'nloc': 498}, {'timestamp': 1513436097.0, 'added_lines': 1, 'deleted_lines': 1, 'nloc': 498}, {'timestamp': 1513612261.0, 'added_lines': 1, 'deleted_lines': 1, 'nloc': 498}, {'timestamp': 1515277696.0, 'added_lines': 1, 'deleted_lines': 1, 'nloc': 498}, {'timestamp': 1516661303.0, 'added_lines': 7, 'deleted_lines': 0, 'nloc': 498}, {'timestamp': 1516838128.0, 'added_lines': 4, 'deleted_lines': 4, 'nloc': 498}, {'timestamp': 1516911711.0, 'added_lines': 7, 'deleted_lines': 5, 'nloc': 499}, {'timestamp': 1517255734.0, 'added_lines': 12, 'deleted_lines': 12, 'nloc': 499}, {'timestamp': 1517453697.0, 'added_lines': 1, 'deleted_lines': 1, 'nloc': 499}, {'timestamp': 1517524783.0, 'added_lines': 2, 'deleted_lines': 2, 'nloc': 499}, {'timestamp': 1518007047.0, 'added_lines': 1, 'deleted_lines': 1, 'nloc': 499}, {'timestamp': 1517858907.0, 'added_lines': 1, 'deleted_lines': 1, 'nloc': 499}, {'timestamp': 1517996381.0, 'added_lines': 1, 'deleted_lines': 1, 'nloc': 499}, {'timestamp': 1518090209.0, 'added_lines': 1, 'deleted_lines': 1, 'nloc': 499}, {'timestamp': 1518090579.0, 'added_lines': 2, 'deleted_lines': 2, 'nloc': 499}, {'timestamp': 1518714221.0, 'added_lines': 3, 'deleted_lines': 4, 'nloc': 498}, {'timestamp': 1521421769.0, 'added_lines': 0, 'deleted_lines': 28, 'nloc': 477}, {'timestamp': 1519761835.0, 'added_lines': 3, 'deleted_lines': 3, 'nloc': 498}, {'timestamp': 1522765832.0, 'added_lines': 1, 'deleted_lines': 1, 'nloc': 498}, {'timestamp': 1524235989.0, 'added_lines': 0, 'deleted_lines': 3, 'nloc': 477}, {'timestamp': 1525408792.0, 'added_lines': 3, 'deleted_lines': 3, 'nloc': 477}, {'timestamp': 1528520460.0, 'added_lines': 7, 'deleted_lines': 7, 'nloc': 477}, {'timestamp': 1529984485.0, 'added_lines': 3, 'deleted_lines': 3, 'nloc': 477}, {'timestamp': 1522838342.0, 'added_lines': 2, 'deleted_lines': 1, 'nloc': 478}, {'timestamp': 1530280654.0, 'added_lines': 4, 'deleted_lines': 6, 'nloc': 475}, {'timestamp': 1507288650.0, 'added_lines': 1, 'deleted_lines': 1, 'nloc': 478}, {'timestamp': 1529717955.0, 'added_lines': 1, 'deleted_lines': 1, 'nloc': 478}, {'timestamp': 1531779409.0, 'added_lines': 5, 'deleted_lines': 5, 'nloc': 476}, {'timestamp': 1532146078.0, 'added_lines': 1, 'deleted_lines': 1, 'nloc': 476}, {'timestamp': 1532764253.0, 'added_lines': 1, 'deleted_lines': 1, 'nloc': 476}, {'timestamp': 1532986515.0, 'added_lines': 4, 'deleted_lines': 4, 'nloc': 476}, {'timestamp': 1533500571.0, 'added_lines': 5, 'deleted_lines': 5, 'nloc': 476}, {'timestamp': 1533618653.0, 'added_lines': 6, 'deleted_lines': 6, 'nloc': 476}, {'timestamp': 1533779477.0, 'added_lines': 9, 'deleted_lines': 9, 'nloc': 476}, {'timestamp': 1533946888.0, 'added_lines': 5, 'deleted_lines': 5, 'nloc': 476}, {'timestamp': 1534115707.0, 'added_lines': 18, 'deleted_lines': 18, 'nloc': 476}, {'timestamp': 1534121389.0, 'added_lines': 10, 'deleted_lines': 10, 'nloc': 476}, {'timestamp': 1534195762.0, 'added_lines': 6, 'deleted_lines': 6, 'nloc': 476}, {'timestamp': 1533768494.0, 'added_lines': 5, 'deleted_lines': 11, 'nloc': 472}, {'timestamp': 1534347022.0, 'added_lines': 10, 'deleted_lines': 10, 'nloc': 472}, {'timestamp': 1534771694.0, 'added_lines': 1, 'deleted_lines': 1, 'nloc': 472}, {'timestamp': 1534896611.0, 'added_lines': 13, 'deleted_lines': 13, 'nloc': 472}, {'timestamp': 1535023055.0, 'added_lines': 5, 'deleted_lines': 0, 'nloc': 477}, {'timestamp': 1535601896.0, 'added_lines': 6, 'deleted_lines': 6, 'nloc': 472}, {'timestamp': 1535943422.0, 'added_lines': 6, 'deleted_lines': 5, 'nloc': 478}, {'timestamp': 1536110744.0, 'added_lines': 1, 'deleted_lines': 1, 'nloc': 478}, {'timestamp': 1536155423.0, 'added_lines': 2, 'deleted_lines': 1, 'nloc': 479}, {'timestamp': 1536388808.0, 'added_lines': 7, 'deleted_lines': 7, 'nloc': 472}, {'timestamp': 1536702894.0, 'added_lines': 6, 'deleted_lines': 4, 'nloc': 481}, {'timestamp': 1536718784.0, 'added_lines': 14, 'deleted_lines': 14, 'nloc': 472}, {'timestamp': 1536723292.0, 'added_lines': 7, 'deleted_lines': 7, 'nloc': 472}, {'timestamp': 1537790637.0, 'added_lines': 6, 'deleted_lines': 6, 'nloc': 481}, {'timestamp': 1537792589.0, 'added_lines': 9, 'deleted_lines': 9, 'nloc': 481}, {'timestamp': 1537512915.0, 'added_lines': 38, 'deleted_lines': 3, 'nloc': 509}, {'timestamp': 1537712792.0, 'added_lines': 1, 'deleted_lines': 2, 'nloc': 508}, {'timestamp': 1538525337.0, 'added_lines': 8, 'deleted_lines': 8, 'nloc': 508}, {'timestamp': 1538597195.0, 'added_lines': 2, 'deleted_lines': 2, 'nloc': 508}, {'timestamp': 1538607626.0, 'added_lines': 11, 'deleted_lines': 17, 'nloc': 503}, {'timestamp': 1538544957.0, 'added_lines': 7, 'deleted_lines': 7, 'nloc': 508}, {'timestamp': 1538694687.0, 'added_lines': 6, 'deleted_lines': 6, 'nloc': 508}, {'timestamp': 1538695953.0, 'added_lines': 6, 'deleted_lines': 6, 'nloc': 508}, {'timestamp': 1538773916.0, 'added_lines': 8, 'deleted_lines': 8, 'nloc': 503}, {'timestamp': 1539176817.0, 'added_lines': 7, 'deleted_lines': 7, 'nloc': 503}, {'timestamp': 1539357340.0, 'added_lines': 6, 'deleted_lines': 6, 'nloc': 503}, {'timestamp': 1539850591.0, 'added_lines': 6, 'deleted_lines': 6, 'nloc': 503}, {'timestamp': 1540400358.0, 'added_lines': 6, 'deleted_lines': 6, 'nloc': 503}, {'timestamp': 1540410565.0, 'added_lines': 6, 'deleted_lines': 6, 'nloc': 503}, {'timestamp': 1540418491.0, 'added_lines': 6, 'deleted_lines': 6, 'nloc': 503}, {'timestamp': 1540603818.0, 'added_lines': 8, 'deleted_lines': 8, 'nloc': 503}, {'timestamp': 1540568776.0, 'added_lines': 8, 'deleted_lines': 1, 'nloc': 507}, {'timestamp': 1540916861.0, 'added_lines': 1, 'deleted_lines': 1, 'nloc': 507}, {'timestamp': 1541106379.0, 'added_lines': 5, 'deleted_lines': 5, 'nloc': 507}, {'timestamp': 1541189794.0, 'added_lines': 6, 'deleted_lines': 6, 'nloc': 507}, {'timestamp': 1541204121.0, 'added_lines': 12, 'deleted_lines': 12, 'nloc': 507}, {'timestamp': 1541903826.0, 'added_lines': 7, 'deleted_lines': 7, 'nloc': 507}, {'timestamp': 1543443696.0, 'added_lines': 6, 'deleted_lines': 6, 'nloc': 507}, {'timestamp': 1544225843.0, 'added_lines': 6, 'deleted_lines': 6, 'nloc': 507}, {'timestamp': 1540556089.0, 'added_lines': 6, 'deleted_lines': 6, 'nloc': 507}, {'timestamp': 1540562190.0, 'added_lines': 28, 'deleted_lines': 22, 'nloc': 511}, {'timestamp': 1542594282.0, 'added_lines': 31, 'deleted_lines': 31, 'nloc': 513}, {'timestamp': 1543031503.0, 'added_lines': 2, 'deleted_lines': 5, 'nloc': 510}, {'timestamp': 1544084986.0, 'added_lines': 1, 'deleted_lines': 0, 'nloc': 511}, {'timestamp': 1544737281.0, 'added_lines': 9, 'deleted_lines': 11, 'nloc': 509}, {'timestamp': 1544785510.0, 'added_lines': 1, 'deleted_lines': 4, 'nloc': 506}, {'timestamp': 1544787886.0, 'added_lines': 31, 'deleted_lines': 27, 'nloc': 512}, {'timestamp': 1544126440.0, 'added_lines': 6, 'deleted_lines': 6, 'nloc': 512}, {'timestamp': 1545139435.0, 'added_lines': 5, 'deleted_lines': 19, 'nloc': 500}, {'timestamp': 1547003974.0, 'added_lines': 6, 'deleted_lines': 6, 'nloc': 500}, {'timestamp': 1547499657.0, 'added_lines': 6, 'deleted_lines': 2, 'nloc': 504}, {'timestamp': 1547499910.0, 'added_lines': 8, 'deleted_lines': 8, 'nloc': 504}, {'timestamp': 1548165641.0, 'added_lines': 0, 'deleted_lines': 86, 'nloc': 444}, {'timestamp': 1548866534.0, 'added_lines': 6, 'deleted_lines': 6, 'nloc': 444}, {'timestamp': 1549588289.0, 'added_lines': 6, 'deleted_lines': 6, 'nloc': 444}, {'timestamp': 1549672857.0, 'added_lines': 1, 'deleted_lines': 1, 'nloc': 444}, {'timestamp': 1549673846.0, 'added_lines': 1, 'deleted_lines': 1, 'nloc': 444}, {'timestamp': 1549903582.0, 'added_lines': 7, 'deleted_lines': 7, 'nloc': 444}, {'timestamp': 1550185115.0, 'added_lines': 7, 'deleted_lines': 7, 'nloc': 444}, {'timestamp': 1550507829.0, 'added_lines': 10, 'deleted_lines': 10, 'nloc': 444}, {'timestamp': 1550576884.0, 'added_lines': 1, 'deleted_lines': 1, 'nloc': 444}, {'timestamp': 1550711994.0, 'added_lines': 7, 'deleted_lines': 7, 'nloc': 444}, {'timestamp': 1550723346.0, 'added_lines': 12, 'deleted_lines': 12, 'nloc': 444}, {'timestamp': 1551229859.0, 'added_lines': 7, 'deleted_lines': 7, 'nloc': 444}, {'timestamp': 1551299964.0, 'added_lines': 7, 'deleted_lines': 7, 'nloc': 444}, {'timestamp': 1551551196.0, 'added_lines': 14, 'deleted_lines': 14, 'nloc': 444}, {'timestamp': 1551111996.0, 'added_lines': 98, 'deleted_lines': 81, 'nloc': 457}, {'timestamp': 1551709270.0, 'added_lines': 5, 'deleted_lines': 1, 'nloc': 461}, {'timestamp': 1552254637.0, 'added_lines': 4, 'deleted_lines': 33, 'nloc': 439}, {'timestamp': 1552316561.0, 'added_lines': 0, 'deleted_lines': 9, 'nloc': 430}, {'timestamp': 1552319843.0, 'added_lines': 16, 'deleted_lines': 10, 'nloc': 430}, {'timestamp': 1553536851.0, 'added_lines': 3, 'deleted_lines': 24, 'nloc': 414}, {'timestamp': 1553794990.0, 'added_lines': 8, 'deleted_lines': 5, 'nloc': 419}, {'timestamp': 1554818312.0, 'added_lines': 1, 'deleted_lines': 3, 'nloc': 417}, {'timestamp': 1553608614.0, 'added_lines': 2, 'deleted_lines': 1, 'nloc': 418}, {'timestamp': 1556744629.0, 'added_lines': 0, 'deleted_lines': 7, 'nloc': 413}, {'timestamp': 1568549682.0, 'added_lines': 1, 'deleted_lines': 1, 'nloc': 413}, {'timestamp': 1574264289.0, 'added_lines': 1, 'deleted_lines': 2, 'nloc': 413}, {'timestamp': 1575569793.0, 'added_lines': 11, 'deleted_lines': 0, 'nloc': 422}]","{'core/commands/files/files.go': 12, 'mfs/mfs_test.go': 28, 'mfs/ops.go': 14, 'mfs/system.go': 21, 'blocks/blockstore/caching.go': 1, 'blocks/blockstore/util/remove.go': 4, 'cmd/ipfs/daemon.go': 28, 'cmd/ipfs/init.go': 34, 'cmd/ipfs/ipfs.go': 23, 'cmd/ipfs/main.go': 33, 'cmd/ipfs/main_test.go': 4, 'cmd/ipfswatch/main.go': 21, 'cmd/seccat/seccat.go': 26, None: 70, 'commands/channelmarshaler.go': 1, 'commands/cli/cmd_suggestion.go': 1, 'commands/cli/helptext.go': 2, 'commands/cli/helptext_test.go': 2, 'commands/cli/parse.go': 2, 'commands/cli/parse_test.go': 2, 'commands/command.go': 18, 'commands/command_test.go': 9, 'commands/http/client.go': 2, 'commands/http/handler.go': 2, 'commands/http/multifilereader.go': 2, 'commands/http/multifilereader_test.go': 2, 'commands/http/parse.go': 2, 'commands/reqlog.go': 1, 'commands/request.go': 22, 'commands/response.go': 13, 'commands/response_test.go': 9, 'core/bootstrap.go': 25, 'core/commands/active.go': 17, 'core/commands/add.go': 66, 'core/commands/bitswap.go': 53, 'core/commands/block.go': 42, 'core/commands/bootstrap.go': 27, 'core/commands/cat.go': 33, 'core/commands/commands.go': 24, 'core/commands/config.go': 31, 'core/commands/dag/dag.go': 68, 'core/commands/dht.go': 62, 'core/commands/diag.go': 17, 'core/commands/dns.go': 24, 'core/commands/e/error.go': 1, 'core/commands/external.go': 17, 'core/commands/filestore.go': 30, 'core/commands/get.go': 62, 'core/commands/helptext_test.go': 23, 'core/commands/id.go': 42, 'core/commands/ipns.go': 18, 'core/commands/keystore.go': 31, 'core/commands/log.go': 23, 'core/commands/ls.go': 65, 'core/commands/mount_nofuse.go': 17, 'core/commands/mount_unix.go': 27, 'core/commands/mount_windows.go': 16, 'core/commands/name.go': 10, 'core/commands/object/diff.go': 27, 'core/commands/object/object.go': 69, 'core/commands/object/patch.go': 39, 'core/commands/p2p.go': 30, 'core/commands/pin.go': 68, 'core/commands/ping.go': 36, 'core/commands/publish.go': 20, 'core/commands/pubsub.go': 42, 'core/commands/refs.go': 56, 'core/commands/repo.go': 45, 'core/commands/resolve.go': 56, 'core/commands/root.go': 25, 'core/commands/shutdown.go': 20, 'core/commands/stat.go': 28, 'core/commands/swarm.go': 39, 'core/commands/sysdiag.go': 23, 'core/commands/tar.go': 61, 'core/commands/unixfs/ls.go': 58, 'core/commands/unixfs/unixfs.go': 17, 'core/commands/version.go': 18, 'core/core_test.go': 18, 'core/corehttp/commands.go': 56, 'core/corehttp/gateway.go': 38, 'core/coreunix/add_test.go': 77, 'core/coreunix/metadata_test.go': 64, 'exchange/bitswap/bitswap_test.go': 12, 'exchange/bitswap/decision/engine_test.go': 13, 'exchange/bitswap/message/message_test.go': 5, 'exchange/bitswap/message/pb/Makefile': 1, 'exchange/bitswap/testnet/network_test.go': 10, 'exchange/bitswap/testnet/peernet.go': 12, 'exchange/reprovide/reprovide_test.go': 38, 'fuse/ipns/common.go': 49, 'fuse/node/mount_test.go': 33, 'importer/balanced/balanced_test.go': 14, 'importer/chunk/rabin_test.go': 4, 'importer/helpers/dagbuilder.go': 22, 'importer/importer.go': 20, 'merkledag/utils/utils_test.go': 7, 'mfs/repub_test.go': 12, 'namesys/dns.go': 44, 'namesys/interface.go': 45, 'namesys/ipns_select_test.go': 5, 'namesys/proquint.go': 44, 'namesys/republisher/repub_test.go': 48, 'package.json': 72, 'repo/config/identity.go': 3, 'routing/offline/offline_test.go': 6, 'test/integration/addcat_test.go': 37, 'test/integration/bench_cat_test.go': 37, 'test/integration/bitswap_wo_routing_test.go': 37, 'test/integration/three_legged_cat_test.go': 37, 'core/bootstrap_test.go': 24, 'core/commands/dht_test.go': 23, 'core/commands/get_test.go': 23, 'core/core.go': 64, 'core/corehttp/gateway_test.go': 57, 'core/corehttp/metrics_test.go': 32, 'core/mock/mock.go': 33, 'exchange/bitswap/decision/bench_test.go': 8, 'exchange/bitswap/decision/peer_request_queue_test.go': 8, 'exchange/bitswap/message/message.go': 8, 'exchange/bitswap/network/interface.go': 8, 'exchange/bitswap/network/ipfs_impl.go': 8, 'exchange/bitswap/testnet/interface.go': 7, 'exchange/bitswap/testnet/virtual.go': 9, 'exchange/bitswap/testutils.go': 13, 'fuse/ipns/ipns_test.go': 32, 'fuse/readonly/ipfs_test.go': 65, 'namesys/publisher_test.go': 35, 'namesys/resolve_test.go': 50, 'p2p/p2p.go': 24, 'p2p/registry.go': 11, 'repo/config/bootstrap_peers.go': 9, 'routing/mock/centralized_client.go': 5, 'routing/mock/centralized_server.go': 5, 'routing/mock/centralized_test.go': 4, 'routing/mock/interface.go': 5, 'routing/none/none_client.go': 4, 'test/integration/bench_test.go': 18, 'blocks/blockstore/arc_cache.go': 3, 'blocks/blockstore/arc_cache_test.go': 3, 'blocks/blockstore/blockstore.go': 4, 'blocks/blockstore/blockstore_test.go': 3, 'blocks/blockstore/bloom_cache_test.go': 3, 'blockservice/blockservice_test.go': 11, 'blockservice/test/blocks_test.go': 12, 'core/builder.go': 59, 'exchange/offline/offline_test.go': 5, 'filestore/filestore.go': 33, 'filestore/filestore_test.go': 52, 'filestore/fsrefstore.go': 32, 'filestore/util.go': 27, 'merkledag/test/utils.go': 12, 'merkledag/utils/utils.go': 13, 'namesys/namesys.go': 52, 'namesys/namesys_test.go': 56, 'namesys/publisher.go': 59, 'namesys/pubsub.go': 6, 'namesys/pubsub_test.go': 6, 'namesys/republisher/repub.go': 47, 'pin/pin.go': 51, 'pin/pin_test.go': 52, 'pin/set_test.go': 50, 'repo/fsrepo/datastores.go': 18, 'repo/fsrepo/fsrepo.go': 26, 'repo/fsrepo/fsrepo_test.go': 20, 'repo/repo.go': 23, 'routing/offline/offline.go': 4, 'thirdparty/datastore2/datastore_closer.go': 3, 'thirdparty/datastore2/delayed.go': 3, 'thirdparty/datastore2/threadsafe.go': 3, 'thirdparty/ds-help/key.go': 3, 'assets/assets.go': 53, 'blocks/blockstore/bloom_cache.go': 2, 'blocks/blocksutil/block_generator.go': 2, 'blockservice/blockservice.go': 11, 'core/commands/ipnsps.go': 9, 'core/coreapi/coreapi.go': 29, 'core/coreapi/interface/interface.go': 2, 'core/coreapi/unixfs.go': 66, 'core/coreapi/unixfs_test.go': 50, 'core/coredag/cbor.go': 18, 'core/coredag/dagpb.go': 44, 'core/coredag/dagtransl.go': 14, 'core/coredag/raw.go': 44, 'core/corehttp/corehttp.go': 14, 'core/corehttp/gateway_handler.go': 67, 'core/corerepo/gc.go': 52, 'core/corerepo/pinning.go': 21, 'core/coreunix/metadata.go': 51, 'core/pathresolver.go': 47, 'exchange/bitswap/bitswap.go': 11, 'exchange/bitswap/decision/engine.go': 10, 'exchange/bitswap/decision/ledger.go': 7, 'exchange/bitswap/decision/peer_request_queue.go': 7, 'exchange/bitswap/get.go': 9, 'exchange/bitswap/notifications/notifications.go': 4, 'exchange/bitswap/notifications/notifications_test.go': 4, 'exchange/bitswap/session.go': 7, 'exchange/bitswap/session_test.go': 6, 'exchange/bitswap/stat.go': 4, 'exchange/bitswap/wantlist/wantlist.go': 4, 'exchange/bitswap/wantlist/wantlist_test.go': 4, 'exchange/bitswap/wantmanager.go': 8, 'exchange/bitswap/workers.go': 7, 'exchange/interface.go': 2, 'exchange/offline/offline.go': 4, 'exchange/reprovide/providers.go': 50, 'exchange/reprovide/reprovide.go': 28, 'fuse/ipns/ipns_unix.go': 56, 'fuse/readonly/readonly_unix.go': 56, 'importer/balanced/builder.go': 6, 'importer/chunk/splitting_test.go': 2, 'importer/helpers/helpers.go': 12, 'importer/importer_test.go': 13, 'importer/trickle/trickle_test.go': 14, 'importer/trickle/trickledag.go': 7, 'merkledag/batch.go': 2, 'merkledag/coding.go': 5, 'merkledag/merkledag.go': 7, 'merkledag/merkledag_test.go': 14, 'merkledag/node.go': 6, 'merkledag/node_test.go': 6, 'merkledag/raw.go': 5, 'merkledag/traverse/traverse.go': 5, 'merkledag/traverse/traverse_test.go': 6, 'merkledag/utils/diff.go': 6, 'merkledag/utils/diffenum.go': 5, 'merkledag/utils/diffenum_test.go': 6, 'mfs/dir.go': 16, 'mfs/file.go': 21, 'namesys/routing.go': 51, 'path/path.go': 5, 'path/resolver.go': 5, 'path/resolver_test.go': 4, 'pin/gc/gc.go': 53, 'pin/set.go': 45, 'plugin/ipld.go': 14, 'plugin/loader/initializer.go': 11, 'plugin/plugins/git/git.go': 13, 'repo/config/init.go': 7, 'repo/fsrepo/lock/lock.go': 3, 'repo/fsrepo/serialize/serialize.go': 3, 'repo/mock.go': 17, 'tar/format.go': 61, 'test/dependencies/ma-pipe-unidir/main.go': 9, 'thirdparty/pollEndpoint/main.go': 14, 'thirdparty/posinfo/posinfo.go': 3, 'unixfs/archive/archive.go': 8, 'unixfs/archive/tar/writer.go': 9, 'unixfs/hamt/hamt.go': 8, 'unixfs/io/dagreader.go': 8, 'unixfs/io/dirbuilder.go': 5, 'unixfs/io/resolve.go': 8, 'unixfs/mod/dagmodifier.go': 15, 'unixfs/mod/dagmodifier_test.go': 4, 'unixfs/test/utils.go': 15, 'commands/legacy/command.go': 14, 'commands/legacy/legacy.go': 14, 'commands/legacy/legacy_test.go': 15, 'commands/legacy/request.go': 15, 'commands/legacy/response.go': 15, 'commands/legacy/responseemitter.go': 4, 'core/commands/env.go': 4, 'TODO.md': 2, 'core/commands/commands_test.go': 20, 'test/sharness/t0110-gateway.sh': 1, 'test/sharness/t0410-api-add.sh': 1, 'core/coreapi/dag.go': 15, 'core/coreapi/dag_test.go': 3, 'core/coreapi/interface/options/dag.go': 8, 'core/coreapi/key.go': 50, 'core/coreapi/name.go': 52, 'unixfs/io/pbdagreader.go': 7, 'mfs/fd.go': 9, 'unixfs/hamt/hamt_stress_test.go': 6, 'unixfs/hamt/hamt_test.go': 6, 'unixfs/io/dagreader_test.go': 3, 'unixfs/io/dirbuilder_test.go': 1, 'cmd/ipfs/util/ulimit.go': 9, 'cmd/seccat/util.go': 9, 'core/corehttp/logs.go': 9, 'fuse/mount/mount.go': 9, 'fuse/node/mount_unix.go': 9, 'importer/chunk/splitting.go': 2, 'namesys/ipns_validate_test.go': 4, 'plugin/loader/load.go': 7, 'importer/chunk/parse.go': 1, 'importer/chunk/rabin.go': 1, 'unixfs/format.go': 1, 'blocks/blockstoreutil/remove.go': 26, 'core/coreapi/block.go': 23, 'path/path_test.go': 1, 'test/api-startup/main.go': 1, 'blockservice/test/mock.go': 5, 'namesys/validator.go': 3, 'core/commands/files.go': 64, 'core/coreapi/pin.go': 53, 'keystore/keystore.go': 8, 'keystore/keystore_test.go': 5, 'keystore/memkeystore.go': 5, 'path/resolver/resolver.go': 5, 'thirdparty/verifbs/verifbs.go': 22, 'cmd/ipfs/util/ulimit_freebsd.go': 2, 'cmd/ipfs/util/ulimit_unix.go': 2, 'core/coreapi/block_test.go': 2, 'core/coreapi/interface/coreapi.go': 9, 'core/coreapi/interface/dag.go': 9, 'core/coreapi/interface/object.go': 9, 'core/coreapi/interface/options/block.go': 3, 'core/coreapi/interface/path.go': 35, 'core/coreapi/interface/unixfs.go': 17, 'core/coreapi/object.go': 55, 'fuse/ipns/link_unix.go': 2, 'fuse/mount/fuse.go': 2, 'fuse/node/mount_darwin.go': 2, 'merkledag/errservice.go': 2, 'merkledag/readonly.go': 2, 'merkledag/readonly_test.go': 2, 'merkledag/rwservice.go': 2, 'merkledag/session.go': 2, 'path/resolver/resolver_test.go': 3, 'thirdparty/verifcid/validate.go': 2, 'thirdparty/verifcid/validate_test.go': 2, 'namesys/ipns_resolver_validation_test.go': 45, 'test/sharness/t0170-dht.sh': 1, 'core/coreunix/test/data/colors/orange': 1, 'core/coreunix/test/data/corps/apple': 1, 'core/coreunix/test/data/fruits/apple': 1, 'core/coreunix/test/data/fruits/orange': 1, 'core/commands/urlstore.go': 48, 'filestore/pb/Makefile': 2, 'filestore/pb/dataobj.pb.go': 5, 'filestore/pb/dataobj.proto': 2, 'unixfs/io/directory.go': 3, 'core/corehttp/metrics.go': 2, 'Rules.mk': 2, 'dagutils/diff.go': 43, 'dagutils/diffenum.go': 39, 'dagutils/diffenum_test.go': 39, 'dagutils/utils.go': 40, 'dagutils/utils_test.go': 40, 'unixfs/io/directory_test.go': 2, 'unixfs/unixfs.go': 2, 'core/coreapi/path.go': 51, 'core/coreunix/cat.go': 15, 'unixfs/importer/balanced/balanced_test.go': 1, 'unixfs/importer/balanced/builder.go': 1, 'unixfs/importer/helpers/dagbuilder.go': 1, 'unixfs/importer/helpers/helpers.go': 1, 'unixfs/importer/importer.go': 1, 'unixfs/importer/importer_test.go': 1, 'unixfs/importer/trickle/trickle_test.go': 1, 'unixfs/importer/trickle/trickledag.go': 1, 'unixfs/unixfs_test.go': 1, 'core/coreapi/name_test.go': 33, 'core/pathresolver_test.go': 39, 'namesys/base.go': 43, 'namesys/cache.go': 39, 'core/coreapi/interface/key.go': 7, 'pin/internal/pb/header.pb.go': 3, 'thirdparty/cidv0v1/blockstore.go': 16, 'repo/fsrepo/config_test.go': 13, 'repo/fsrepo/misc.go': 13, 'test/bench/bench_cli_ipfs_add/main.go': 13, 'test/bench/offline_add/main.go': 13, 'core/commands/cmdenv/env.go': 23, 'core/commands/name/ipns.go': 39, 'core/commands/name/publish.go': 23, 'core/coreapi/dht.go': 35, 'core/coreapi/dht_test.go': 5, 'test/sharness/t0275-cid-security.sh': 1, 'core/commands/name/ipnsps.go': 13, 'core/commands/name/name.go': 9, 'core/coreapi/interface/dht.go': 10, 'p2p/listener.go': 13, 'p2p/local.go': 13, 'p2p/remote.go': 13, 'p2p/stream.go': 13, 'core/coreapi/unixfile.go': 21, 'core/coreapi/interface/options/unixfs.go': 16, 'core/coreapi/interface/swarm.go': 9, 'core/coreapi/swarm.go': 24, 'core/coreapi/pubsub.go': 22, 'core/commands/cid.go': 9, 'cmd/ipfs/dnsresolve_test.go': 5, 'core/coreapi/interface/pubsub.go': 4, 'test/dependencies/iptb/iptb.go': 12, 'plugin/plugins/badgerds/badgerds.go': 3, 'plugin/plugins/flatfs/flatfs.go': 3, 'plugin/plugins/levelds/levelds.go': 3, 'commands/context.go': 16, 'core/corehttp/proxy.go': 9, 'core/commands/cmdenv/file.go': 4, 'core/coreapi/interface/tests/name.go': 4, 'core/coreapi/interface/tests/unixfs.go': 5, 'core/coreapi/test/api_test.go': 13, 'plugin/loader/loader.go': 12, 'core/commands/cmdenv/cidbase.go': 6, 'core/corehttp/ipns_hostname.go': 11, 'namesys/dns_test.go': 10, 'plugin/daemon.go': 10, 'core/commands/cmdenv/cidbase_test.go': 2, 'core/corehttp/proxy_test.go': 1, 'core/corerepo/stat.go': 1, 'plugin/tracer.go': 1, 'thirdparty/notifier/notifier.go': 1, 'go.mod': 4, 'go.sum': 4, 'core/node/core.go': 2, 'core/node/provider.go': 1, 'gc/gc.go': 1}","('core/coreunix/add_test.go', 0.6111111111111112, 0.7938144329896907)"
core/coreunix/add_test.go,225,1429,17,"[{'cyclomatic_complexity': 4, 'nloc': 19, 'token_count': 121, 'name': 'TestAddRecursive', 'long_name': 'TestAddRecursive t * testing . T', 'start_line': 28, 'end_line': 46, 'full_parameters': ['t * testing . T'], 'filename': '/home/dimi/Documents/Informatik_Studium/FSS/SoftEvo/DataCollection/FFS_SoftEvo/go-ipfs/core/coreunix/add_test.go', 'top_nesting_level': 0, 'length': 19, 'fan_in': 0, 'fan_out': 0, 'general_fan_out': 0}, {'cyclomatic_complexity': 2, 'nloc': 8, 'token_count': 35, 'name': '', 'long_name': '()', 'start_line': 82, 'end_line': 91, 'full_parameters': [], 'filename': '/home/dimi/Documents/Informatik_Studium/FSS/SoftEvo/DataCollection/FFS_SoftEvo/go-ipfs/core/coreunix/add_test.go', 'top_nesting_level': 0, 'length': 10, 'fan_in': 0, 'fan_out': 0, 'general_fan_out': 0}, {'cyclomatic_complexity': 1, 'nloc': 4, 'token_count': 36, 'name': '', 'long_name': '()', 'start_line': 103, 'end_line': 106, 'full_parameters': [], 'filename': '/home/dimi/Documents/Informatik_Studium/FSS/SoftEvo/DataCollection/FFS_SoftEvo/go-ipfs/core/coreunix/add_test.go', 'top_nesting_level': 0, 'length': 4, 'fan_in': 0, 'fan_out': 0, 'general_fan_out': 0}, {'cyclomatic_complexity': 12, 'nloc': 73, 'token_count': 538, 'name': 'TestAddGCLive', 'long_name': 'TestAddGCLive t * testing . T', 'start_line': 48, 'end_line': 155, 'full_parameters': ['t * testing . T'], 'filename': '/home/dimi/Documents/Informatik_Studium/FSS/SoftEvo/DataCollection/FFS_SoftEvo/go-ipfs/core/coreunix/add_test.go', 'top_nesting_level': 0, 'length': 108, 'fan_in': 0, 'fan_out': 0, 'general_fan_out': 0}, {'cyclomatic_complexity': 2, 'nloc': 7, 'token_count': 32, 'name': '', 'long_name': '()', 'start_line': 189, 'end_line': 195, 'full_parameters': [], 'filename': '/home/dimi/Documents/Informatik_Studium/FSS/SoftEvo/DataCollection/FFS_SoftEvo/go-ipfs/core/coreunix/add_test.go', 'top_nesting_level': 0, 'length': 7, 'fan_in': 0, 'fan_out': 0, 'general_fan_out': 0}, {'cyclomatic_complexity': 7, 'nloc': 45, 'token_count': 328, 'name': 'testAddWPosInfo', 'long_name': 'testAddWPosInfo t * testing . T , rawLeaves bool', 'start_line': 157, 'end_line': 212, 'full_parameters': ['t * testing . T', ' rawLeaves bool'], 'filename': '/home/dimi/Documents/Informatik_Studium/FSS/SoftEvo/DataCollection/FFS_SoftEvo/go-ipfs/core/coreunix/add_test.go', 'top_nesting_level': 0, 'length': 56, 'fan_in': 0, 'fan_out': 0, 'general_fan_out': 0}, {'cyclomatic_complexity': 1, 'nloc': 3, 'token_count': 17, 'name': 'TestAddWPosInfo', 'long_name': 'TestAddWPosInfo t * testing . T', 'start_line': 214, 'end_line': 216, 'full_parameters': ['t * testing . T'], 'filename': '/home/dimi/Documents/Informatik_Studium/FSS/SoftEvo/DataCollection/FFS_SoftEvo/go-ipfs/core/coreunix/add_test.go', 'top_nesting_level': 0, 'length': 3, 'fan_in': 0, 'fan_out': 0, 'general_fan_out': 0}, {'cyclomatic_complexity': 1, 'nloc': 3, 'token_count': 17, 'name': 'TestAddWPosInfoAndRawLeafs', 'long_name': 'TestAddWPosInfoAndRawLeafs t * testing . T', 'start_line': 218, 'end_line': 220, 'full_parameters': ['t * testing . T'], 'filename': '/home/dimi/Documents/Informatik_Studium/FSS/SoftEvo/DataCollection/FFS_SoftEvo/go-ipfs/core/coreunix/add_test.go', 'top_nesting_level': 0, 'length': 3, 'fan_in': 0, 'fan_out': 0, 'general_fan_out': 0}, {'cyclomatic_complexity': 1, 'nloc': 4, 'token_count': 31, 'name': 'Put', 'long_name': '(bs*testBlockstore)Put block blocks . Block', 'start_line': 230, 'end_line': 233, 'full_parameters': ['block blocks . Block'], 'filename': '/home/dimi/Documents/Informatik_Studium/FSS/SoftEvo/DataCollection/FFS_SoftEvo/go-ipfs/core/coreunix/add_test.go', 'top_nesting_level': 0, 'length': 4, 'fan_in': 0, 'fan_out': 0, 'general_fan_out': 0}, {'cyclomatic_complexity': 2, 'nloc': 6, 'token_count': 42, 'name': 'PutMany', 'long_name': '(bs*testBlockstore)PutMany blocks [ ] blocks . Block', 'start_line': 235, 'end_line': 240, 'full_parameters': ['blocks [ ] blocks . Block'], 'filename': '/home/dimi/Documents/Informatik_Studium/FSS/SoftEvo/DataCollection/FFS_SoftEvo/go-ipfs/core/coreunix/add_test.go', 'top_nesting_level': 0, 'length': 6, 'fan_in': 0, 'fan_out': 0, 'general_fan_out': 0}, {'cyclomatic_complexity': 4, 'nloc': 15, 'token_count': 78, 'name': 'CheckForPosInfo', 'long_name': '(bs*testBlockstore)CheckForPosInfo block blocks . Block', 'start_line': 242, 'end_line': 256, 'full_parameters': ['block blocks . Block'], 'filename': '/home/dimi/Documents/Informatik_Studium/FSS/SoftEvo/DataCollection/FFS_SoftEvo/go-ipfs/core/coreunix/add_test.go', 'top_nesting_level': 0, 'length': 15, 'fan_in': 0, 'fan_out': 0, 'general_fan_out': 0}, {'cyclomatic_complexity': 1, 'nloc': 1, 'token_count': 16, 'name': 'Name', 'long_name': '(fi*dummyFileInfo)Name', 'start_line': 264, 'end_line': 264, 'full_parameters': [], 'filename': '/home/dimi/Documents/Informatik_Studium/FSS/SoftEvo/DataCollection/FFS_SoftEvo/go-ipfs/core/coreunix/add_test.go', 'top_nesting_level': 0, 'length': 1, 'fan_in': 0, 'fan_out': 0, 'general_fan_out': 0}, {'cyclomatic_complexity': 1, 'nloc': 1, 'token_count': 16, 'name': 'Size', 'long_name': '(fi*dummyFileInfo)Size', 'start_line': 265, 'end_line': 265, 'full_parameters': [], 'filename': '/home/dimi/Documents/Informatik_Studium/FSS/SoftEvo/DataCollection/FFS_SoftEvo/go-ipfs/core/coreunix/add_test.go', 'top_nesting_level': 0, 'length': 1, 'fan_in': 0, 'fan_out': 0, 'general_fan_out': 0}, {'cyclomatic_complexity': 1, 'nloc': 1, 'token_count': 16, 'name': 'Mode', 'long_name': '(fi*dummyFileInfo)Mode', 'start_line': 266, 'end_line': 266, 'full_parameters': [], 'filename': '/home/dimi/Documents/Informatik_Studium/FSS/SoftEvo/DataCollection/FFS_SoftEvo/go-ipfs/core/coreunix/add_test.go', 'top_nesting_level': 0, 'length': 1, 'fan_in': 0, 'fan_out': 0, 'general_fan_out': 0}, {'cyclomatic_complexity': 1, 'nloc': 1, 'token_count': 18, 'name': 'ModTime', 'long_name': '(fi*dummyFileInfo)ModTime', 'start_line': 267, 'end_line': 267, 'full_parameters': [], 'filename': '/home/dimi/Documents/Informatik_Studium/FSS/SoftEvo/DataCollection/FFS_SoftEvo/go-ipfs/core/coreunix/add_test.go', 'top_nesting_level': 0, 'length': 1, 'fan_in': 0, 'fan_out': 0, 'general_fan_out': 0}, {'cyclomatic_complexity': 1, 'nloc': 1, 'token_count': 14, 'name': 'IsDir', 'long_name': '(fi*dummyFileInfo)IsDir', 'start_line': 268, 'end_line': 268, 'full_parameters': [], 'filename': '/home/dimi/Documents/Informatik_Studium/FSS/SoftEvo/DataCollection/FFS_SoftEvo/go-ipfs/core/coreunix/add_test.go', 'top_nesting_level': 0, 'length': 1, 'fan_in': 0, 'fan_out': 0, 'general_fan_out': 0}, {'cyclomatic_complexity': 1, 'nloc': 1, 'token_count': 12, 'name': 'Sys', 'long_name': '(fi*dummyFileInfo)Sys', 'start_line': 269, 'end_line': 269, 'full_parameters': [], 'filename': '/home/dimi/Documents/Informatik_Studium/FSS/SoftEvo/DataCollection/FFS_SoftEvo/go-ipfs/core/coreunix/add_test.go', 'top_nesting_level': 0, 'length': 1, 'fan_in': 0, 'fan_out': 0, 'general_fan_out': 0}]",298,1968,20,"[{'cyclomatic_complexity': 1, 'nloc': 4, 'token_count': 20, 'name': '', 'long_name': '()', 'start_line': 69, 'end_line': 73, 'full_parameters': [], 'filename': '/home/dimi/Documents/Informatik_Studium/FSS/SoftEvo/DataCollection/FFS_SoftEvo/go-ipfs/core/coreunix/add_test.go', 'top_nesting_level': 0, 'length': 5, 'fan_in': 0, 'fan_out': 0, 'general_fan_out': 0}, {'cyclomatic_complexity': 1, 'nloc': 4, 'token_count': 40, 'name': '', 'long_name': '()', 'start_line': 82, 'end_line': 85, 'full_parameters': [], 'filename': '/home/dimi/Documents/Informatik_Studium/FSS/SoftEvo/DataCollection/FFS_SoftEvo/go-ipfs/core/coreunix/add_test.go', 'top_nesting_level': 0, 'length': 4, 'fan_in': 0, 'fan_out': 0, 'general_fan_out': 0}, {'cyclomatic_complexity': 1, 'nloc': 4, 'token_count': 40, 'name': '', 'long_name': '()', 'start_line': 114, 'end_line': 117, 'full_parameters': [], 'filename': '/home/dimi/Documents/Informatik_Studium/FSS/SoftEvo/DataCollection/FFS_SoftEvo/go-ipfs/core/coreunix/add_test.go', 'top_nesting_level': 0, 'length': 4, 'fan_in': 0, 'fan_out': 0, 'general_fan_out': 0}, {'cyclomatic_complexity': 13, 'nloc': 75, 'token_count': 494, 'name': 'TestAddMultipleGCLive', 'long_name': 'TestAddMultipleGCLive t * testing . T', 'start_line': 33, 'end_line': 141, 'full_parameters': ['t * testing . T'], 'filename': '/home/dimi/Documents/Informatik_Studium/FSS/SoftEvo/DataCollection/FFS_SoftEvo/go-ipfs/core/coreunix/add_test.go', 'top_nesting_level': 0, 'length': 109, 'fan_in': 0, 'fan_out': 0, 'general_fan_out': 0}, {'cyclomatic_complexity': 2, 'nloc': 8, 'token_count': 37, 'name': '', 'long_name': '()', 'start_line': 179, 'end_line': 188, 'full_parameters': [], 'filename': '/home/dimi/Documents/Informatik_Studium/FSS/SoftEvo/DataCollection/FFS_SoftEvo/go-ipfs/core/coreunix/add_test.go', 'top_nesting_level': 0, 'length': 10, 'fan_in': 0, 'fan_out': 0, 'general_fan_out': 0}, {'cyclomatic_complexity': 1, 'nloc': 4, 'token_count': 40, 'name': '', 'long_name': '()', 'start_line': 200, 'end_line': 203, 'full_parameters': [], 'filename': '/home/dimi/Documents/Informatik_Studium/FSS/SoftEvo/DataCollection/FFS_SoftEvo/go-ipfs/core/coreunix/add_test.go', 'top_nesting_level': 0, 'length': 4, 'fan_in': 0, 'fan_out': 0, 'general_fan_out': 0}, {'cyclomatic_complexity': 13, 'nloc': 77, 'token_count': 563, 'name': 'TestAddGCLive', 'long_name': 'TestAddGCLive t * testing . T', 'start_line': 143, 'end_line': 254, 'full_parameters': ['t * testing . T'], 'filename': '/home/dimi/Documents/Informatik_Studium/FSS/SoftEvo/DataCollection/FFS_SoftEvo/go-ipfs/core/coreunix/add_test.go', 'top_nesting_level': 0, 'length': 112, 'fan_in': 0, 'fan_out': 0, 'general_fan_out': 0}, {'cyclomatic_complexity': 2, 'nloc': 7, 'token_count': 34, 'name': '', 'long_name': '()', 'start_line': 289, 'end_line': 295, 'full_parameters': [], 'filename': '/home/dimi/Documents/Informatik_Studium/FSS/SoftEvo/DataCollection/FFS_SoftEvo/go-ipfs/core/coreunix/add_test.go', 'top_nesting_level': 0, 'length': 7, 'fan_in': 0, 'fan_out': 0, 'general_fan_out': 0}, {'cyclomatic_complexity': 7, 'nloc': 46, 'token_count': 356, 'name': 'testAddWPosInfo', 'long_name': 'testAddWPosInfo t * testing . T , rawLeaves bool', 'start_line': 256, 'end_line': 312, 'full_parameters': ['t * testing . T', ' rawLeaves bool'], 'filename': '/home/dimi/Documents/Informatik_Studium/FSS/SoftEvo/DataCollection/FFS_SoftEvo/go-ipfs/core/coreunix/add_test.go', 'top_nesting_level': 0, 'length': 57, 'fan_in': 0, 'fan_out': 0, 'general_fan_out': 0}, {'cyclomatic_complexity': 1, 'nloc': 3, 'token_count': 17, 'name': 'TestAddWPosInfo', 'long_name': 'TestAddWPosInfo t * testing . T', 'start_line': 314, 'end_line': 316, 'full_parameters': ['t * testing . T'], 'filename': '/home/dimi/Documents/Informatik_Studium/FSS/SoftEvo/DataCollection/FFS_SoftEvo/go-ipfs/core/coreunix/add_test.go', 'top_nesting_level': 0, 'length': 3, 'fan_in': 0, 'fan_out': 0, 'general_fan_out': 0}, {'cyclomatic_complexity': 1, 'nloc': 3, 'token_count': 17, 'name': 'TestAddWPosInfoAndRawLeafs', 'long_name': 'TestAddWPosInfoAndRawLeafs t * testing . T', 'start_line': 318, 'end_line': 320, 'full_parameters': ['t * testing . T'], 'filename': '/home/dimi/Documents/Informatik_Studium/FSS/SoftEvo/DataCollection/FFS_SoftEvo/go-ipfs/core/coreunix/add_test.go', 'top_nesting_level': 0, 'length': 3, 'fan_in': 0, 'fan_out': 0, 'general_fan_out': 0}, {'cyclomatic_complexity': 1, 'nloc': 4, 'token_count': 31, 'name': 'Put', 'long_name': '(bs*testBlockstore)Put block blocks . Block', 'start_line': 330, 'end_line': 333, 'full_parameters': ['block blocks . Block'], 'filename': '/home/dimi/Documents/Informatik_Studium/FSS/SoftEvo/DataCollection/FFS_SoftEvo/go-ipfs/core/coreunix/add_test.go', 'top_nesting_level': 0, 'length': 4, 'fan_in': 0, 'fan_out': 0, 'general_fan_out': 0}, {'cyclomatic_complexity': 2, 'nloc': 6, 'token_count': 42, 'name': 'PutMany', 'long_name': '(bs*testBlockstore)PutMany blocks [ ] blocks . Block', 'start_line': 335, 'end_line': 340, 'full_parameters': ['blocks [ ] blocks . Block'], 'filename': '/home/dimi/Documents/Informatik_Studium/FSS/SoftEvo/DataCollection/FFS_SoftEvo/go-ipfs/core/coreunix/add_test.go', 'top_nesting_level': 0, 'length': 6, 'fan_in': 0, 'fan_out': 0, 'general_fan_out': 0}, {'cyclomatic_complexity': 4, 'nloc': 14, 'token_count': 75, 'name': 'CheckForPosInfo', 'long_name': '(bs*testBlockstore)CheckForPosInfo block blocks . Block', 'start_line': 342, 'end_line': 355, 'full_parameters': ['block blocks . Block'], 'filename': '/home/dimi/Documents/Informatik_Studium/FSS/SoftEvo/DataCollection/FFS_SoftEvo/go-ipfs/core/coreunix/add_test.go', 'top_nesting_level': 0, 'length': 14, 'fan_in': 0, 'fan_out': 0, 'general_fan_out': 0}, {'cyclomatic_complexity': 1, 'nloc': 1, 'token_count': 16, 'name': 'Name', 'long_name': '(fi*dummyFileInfo)Name', 'start_line': 363, 'end_line': 363, 'full_parameters': [], 'filename': '/home/dimi/Documents/Informatik_Studium/FSS/SoftEvo/DataCollection/FFS_SoftEvo/go-ipfs/core/coreunix/add_test.go', 'top_nesting_level': 0, 'length': 1, 'fan_in': 0, 'fan_out': 0, 'general_fan_out': 0}, {'cyclomatic_complexity': 1, 'nloc': 1, 'token_count': 16, 'name': 'Size', 'long_name': '(fi*dummyFileInfo)Size', 'start_line': 364, 'end_line': 364, 'full_parameters': [], 'filename': '/home/dimi/Documents/Informatik_Studium/FSS/SoftEvo/DataCollection/FFS_SoftEvo/go-ipfs/core/coreunix/add_test.go', 'top_nesting_level': 0, 'length': 1, 'fan_in': 0, 'fan_out': 0, 'general_fan_out': 0}, {'cyclomatic_complexity': 1, 'nloc': 1, 'token_count': 16, 'name': 'Mode', 'long_name': '(fi*dummyFileInfo)Mode', 'start_line': 365, 'end_line': 365, 'full_parameters': [], 'filename': '/home/dimi/Documents/Informatik_Studium/FSS/SoftEvo/DataCollection/FFS_SoftEvo/go-ipfs/core/coreunix/add_test.go', 'top_nesting_level': 0, 'length': 1, 'fan_in': 0, 'fan_out': 0, 'general_fan_out': 0}, {'cyclomatic_complexity': 1, 'nloc': 1, 'token_count': 18, 'name': 'ModTime', 'long_name': '(fi*dummyFileInfo)ModTime', 'start_line': 366, 'end_line': 366, 'full_parameters': [], 'filename': '/home/dimi/Documents/Informatik_Studium/FSS/SoftEvo/DataCollection/FFS_SoftEvo/go-ipfs/core/coreunix/add_test.go', 'top_nesting_level': 0, 'length': 1, 'fan_in': 0, 'fan_out': 0, 'general_fan_out': 0}, {'cyclomatic_complexity': 1, 'nloc': 1, 'token_count': 14, 'name': 'IsDir', 'long_name': '(fi*dummyFileInfo)IsDir', 'start_line': 367, 'end_line': 367, 'full_parameters': [], 'filename': '/home/dimi/Documents/Informatik_Studium/FSS/SoftEvo/DataCollection/FFS_SoftEvo/go-ipfs/core/coreunix/add_test.go', 'top_nesting_level': 0, 'length': 1, 'fan_in': 0, 'fan_out': 0, 'general_fan_out': 0}, {'cyclomatic_complexity': 1, 'nloc': 1, 'token_count': 12, 'name': 'Sys', 'long_name': '(fi*dummyFileInfo)Sys', 'start_line': 368, 'end_line': 368, 'full_parameters': [], 'filename': '/home/dimi/Documents/Informatik_Studium/FSS/SoftEvo/DataCollection/FFS_SoftEvo/go-ipfs/core/coreunix/add_test.go', 'top_nesting_level': 0, 'length': 1, 'fan_in': 0, 'fan_out': 0, 'general_fan_out': 0}]",73,539,3,97,97,"[{'timestamp': 1491058697.0, 'added_lines': 1, 'deleted_lines': 1, 'nloc': 225}, {'timestamp': 1511223906.0, 'added_lines': 1, 'deleted_lines': 1, 'nloc': 225}, {'timestamp': 1512365669.0, 'added_lines': 3, 'deleted_lines': 3, 'nloc': 225}, {'timestamp': 1511187070.0, 'added_lines': 2, 'deleted_lines': 2, 'nloc': 225}, {'timestamp': 1513436097.0, 'added_lines': 1, 'deleted_lines': 1, 'nloc': 225}, {'timestamp': 1513612261.0, 'added_lines': 1, 'deleted_lines': 1, 'nloc': 225}, {'timestamp': 1515277696.0, 'added_lines': 1, 'deleted_lines': 1, 'nloc': 225}, {'timestamp': 1516838128.0, 'added_lines': 2, 'deleted_lines': 2, 'nloc': 225}, {'timestamp': 1516919560.0, 'added_lines': 5, 'deleted_lines': 3, 'nloc': 226}, {'timestamp': 1516911711.0, 'added_lines': 2, 'deleted_lines': 2, 'nloc': 226}, {'timestamp': 1517487614.0, 'added_lines': 1, 'deleted_lines': 1, 'nloc': 226}, {'timestamp': 1518007047.0, 'added_lines': 1, 'deleted_lines': 1, 'nloc': 226}, {'timestamp': 1518714221.0, 'added_lines': 4, 'deleted_lines': 4, 'nloc': 226}, {'timestamp': 1519761835.0, 'added_lines': 1, 'deleted_lines': 1, 'nloc': 226}, {'timestamp': 1519765635.0, 'added_lines': 5, 'deleted_lines': 4, 'nloc': 227}, {'timestamp': 1525408792.0, 'added_lines': 3, 'deleted_lines': 3, 'nloc': 227}, {'timestamp': 1528520460.0, 'added_lines': 5, 'deleted_lines': 5, 'nloc': 227}, {'timestamp': 1529984485.0, 'added_lines': 1, 'deleted_lines': 1, 'nloc': 227}, {'timestamp': 1522838342.0, 'added_lines': 1, 'deleted_lines': 1, 'nloc': 227}, {'timestamp': 1507288650.0, 'added_lines': 1, 'deleted_lines': 1, 'nloc': 227}, {'timestamp': 1529717955.0, 'added_lines': 1, 'deleted_lines': 1, 'nloc': 227}, {'timestamp': 1531779409.0, 'added_lines': 4, 'deleted_lines': 4, 'nloc': 227}, {'timestamp': 1532146078.0, 'added_lines': 1, 'deleted_lines': 1, 'nloc': 227}, {'timestamp': 1532740866.0, 'added_lines': 1, 'deleted_lines': 1, 'nloc': 227}, {'timestamp': 1532764253.0, 'added_lines': 1, 'deleted_lines': 1, 'nloc': 227}, {'timestamp': 1533500571.0, 'added_lines': 2, 'deleted_lines': 2, 'nloc': 227}, {'timestamp': 1533618653.0, 'added_lines': 3, 'deleted_lines': 3, 'nloc': 227}, {'timestamp': 1533779477.0, 'added_lines': 3, 'deleted_lines': 3, 'nloc': 227}, {'timestamp': 1532365899.0, 'added_lines': 2, 'deleted_lines': 2, 'nloc': 227}, {'timestamp': 1532388583.0, 'added_lines': 1, 'deleted_lines': 1, 'nloc': 227}, {'timestamp': 1533809170.0, 'added_lines': 3, 'deleted_lines': 3, 'nloc': 227}, {'timestamp': 1533946888.0, 'added_lines': 1, 'deleted_lines': 1, 'nloc': 227}, {'timestamp': 1534115707.0, 'added_lines': 6, 'deleted_lines': 6, 'nloc': 227}, {'timestamp': 1534195762.0, 'added_lines': 5, 'deleted_lines': 5, 'nloc': 227}, {'timestamp': 1534347022.0, 'added_lines': 6, 'deleted_lines': 6, 'nloc': 227}, {'timestamp': 1534072974.0, 'added_lines': 1, 'deleted_lines': 1, 'nloc': 227}, {'timestamp': 1534896611.0, 'added_lines': 8, 'deleted_lines': 8, 'nloc': 227}, {'timestamp': 1535255498.0, 'added_lines': 1, 'deleted_lines': 1, 'nloc': 227}, {'timestamp': 1535601896.0, 'added_lines': 3, 'deleted_lines': 3, 'nloc': 227}, {'timestamp': 1536388808.0, 'added_lines': 6, 'deleted_lines': 6, 'nloc': 227}, {'timestamp': 1536718784.0, 'added_lines': 7, 'deleted_lines': 7, 'nloc': 227}, {'timestamp': 1536723292.0, 'added_lines': 3, 'deleted_lines': 3, 'nloc': 227}, {'timestamp': 1537790637.0, 'added_lines': 2, 'deleted_lines': 2, 'nloc': 227}, {'timestamp': 1537792589.0, 'added_lines': 6, 'deleted_lines': 6, 'nloc': 227}, {'timestamp': 1537512915.0, 'added_lines': 2, 'deleted_lines': 2, 'nloc': 227}, {'timestamp': 1538525337.0, 'added_lines': 2, 'deleted_lines': 2, 'nloc': 227}, {'timestamp': 1538607626.0, 'added_lines': 7, 'deleted_lines': 5, 'nloc': 229}, {'timestamp': 1538544957.0, 'added_lines': 6, 'deleted_lines': 6, 'nloc': 227}, {'timestamp': 1538547366.0, 'added_lines': 1, 'deleted_lines': 1, 'nloc': 227}, {'timestamp': 1538694687.0, 'added_lines': 2, 'deleted_lines': 2, 'nloc': 227}, {'timestamp': 1538695953.0, 'added_lines': 2, 'deleted_lines': 2, 'nloc': 227}, {'timestamp': 1538773916.0, 'added_lines': 5, 'deleted_lines': 5, 'nloc': 229}, {'timestamp': 1539176817.0, 'added_lines': 2, 'deleted_lines': 2, 'nloc': 229}, {'timestamp': 1539357340.0, 'added_lines': 2, 'deleted_lines': 2, 'nloc': 229}, {'timestamp': 1539850591.0, 'added_lines': 1, 'deleted_lines': 1, 'nloc': 229}, {'timestamp': 1540400358.0, 'added_lines': 3, 'deleted_lines': 3, 'nloc': 229}, {'timestamp': 1540410565.0, 'added_lines': 2, 'deleted_lines': 2, 'nloc': 229}, {'timestamp': 1540418491.0, 'added_lines': 2, 'deleted_lines': 2, 'nloc': 229}, {'timestamp': 1540489644.0, 'added_lines': 1, 'deleted_lines': 1, 'nloc': 229}, {'timestamp': 1540603818.0, 'added_lines': 2, 'deleted_lines': 2, 'nloc': 229}, {'timestamp': 1541189794.0, 'added_lines': 1, 'deleted_lines': 1, 'nloc': 229}, {'timestamp': 1541204121.0, 'added_lines': 7, 'deleted_lines': 7, 'nloc': 229}, {'timestamp': 1541903826.0, 'added_lines': 5, 'deleted_lines': 5, 'nloc': 229}, {'timestamp': 1543282933.0, 'added_lines': 1, 'deleted_lines': 1, 'nloc': 229}, {'timestamp': 1543443696.0, 'added_lines': 1, 'deleted_lines': 1, 'nloc': 229}, {'timestamp': 1544225843.0, 'added_lines': 3, 'deleted_lines': 3, 'nloc': 229}, {'timestamp': 1540556089.0, 'added_lines': 1, 'deleted_lines': 1, 'nloc': 229}, {'timestamp': 1540562190.0, 'added_lines': 9, 'deleted_lines': 5, 'nloc': 233}, {'timestamp': 1541435621.0, 'added_lines': 4, 'deleted_lines': 3, 'nloc': 234}, {'timestamp': 1542594282.0, 'added_lines': 4, 'deleted_lines': 4, 'nloc': 234}, {'timestamp': 1543868676.0, 'added_lines': 7, 'deleted_lines': 9, 'nloc': 232}, {'timestamp': 1544737281.0, 'added_lines': 4, 'deleted_lines': 4, 'nloc': 232}, {'timestamp': 1545323704.0, 'added_lines': 1, 'deleted_lines': 1, 'nloc': 232}, {'timestamp': 1545139435.0, 'added_lines': 3, 'deleted_lines': 3, 'nloc': 232}, {'timestamp': 1546553605.0, 'added_lines': 1, 'deleted_lines': 1, 'nloc': 232}, {'timestamp': 1547003974.0, 'added_lines': 3, 'deleted_lines': 3, 'nloc': 232}, {'timestamp': 1547499910.0, 'added_lines': 3, 'deleted_lines': 3, 'nloc': 232}, {'timestamp': 1548165641.0, 'added_lines': 0, 'deleted_lines': 20, 'nloc': 213}, {'timestamp': 1548866534.0, 'added_lines': 1, 'deleted_lines': 1, 'nloc': 213}, {'timestamp': 1549588289.0, 'added_lines': 3, 'deleted_lines': 3, 'nloc': 213}, {'timestamp': 1549672857.0, 'added_lines': 1, 'deleted_lines': 1, 'nloc': 213}, {'timestamp': 1549673846.0, 'added_lines': 1, 'deleted_lines': 1, 'nloc': 213}, {'timestamp': 1549903582.0, 'added_lines': 2, 'deleted_lines': 2, 'nloc': 213}, {'timestamp': 1550185115.0, 'added_lines': 3, 'deleted_lines': 3, 'nloc': 213}, {'timestamp': 1550507829.0, 'added_lines': 7, 'deleted_lines': 7, 'nloc': 213}, {'timestamp': 1550576884.0, 'added_lines': 1, 'deleted_lines': 1, 'nloc': 213}, {'timestamp': 1550711994.0, 'added_lines': 3, 'deleted_lines': 3, 'nloc': 213}, {'timestamp': 1550723346.0, 'added_lines': 7, 'deleted_lines': 7, 'nloc': 213}, {'timestamp': 1551229859.0, 'added_lines': 4, 'deleted_lines': 4, 'nloc': 213}, {'timestamp': 1551299964.0, 'added_lines': 3, 'deleted_lines': 3, 'nloc': 213}, {'timestamp': 1551551196.0, 'added_lines': 11, 'deleted_lines': 11, 'nloc': 213}, {'timestamp': 1553697989.0, 'added_lines': 6, 'deleted_lines': 5, 'nloc': 214}, {'timestamp': 1556744629.0, 'added_lines': 110, 'deleted_lines': 0, 'nloc': 298}, {'timestamp': 1557557624.0, 'added_lines': 1, 'deleted_lines': 1, 'nloc': 298}, {'timestamp': 1562894485.0, 'added_lines': 1, 'deleted_lines': 1, 'nloc': 298}, {'timestamp': 1574264289.0, 'added_lines': 3, 'deleted_lines': 3, 'nloc': 298}, {'timestamp': 1587221101.0, 'added_lines': 5, 'deleted_lines': 5, 'nloc': 298}]","{'blocks/blockstore/caching.go': 1, 'blocks/blockstore/util/remove.go': 3, 'cmd/ipfs/daemon.go': 29, 'cmd/ipfs/init.go': 44, 'cmd/ipfs/ipfs.go': 22, 'cmd/ipfs/main.go': 42, 'cmd/ipfs/main_test.go': 4, 'cmd/ipfswatch/main.go': 32, 'cmd/seccat/seccat.go': 26, None: 62, 'commands/channelmarshaler.go': 1, 'commands/cli/cmd_suggestion.go': 1, 'commands/cli/helptext.go': 2, 'commands/cli/helptext_test.go': 2, 'commands/cli/parse.go': 2, 'commands/cli/parse_test.go': 2, 'commands/command.go': 17, 'commands/command_test.go': 8, 'commands/http/client.go': 2, 'commands/http/handler.go': 2, 'commands/http/multifilereader.go': 2, 'commands/http/multifilereader_test.go': 2, 'commands/http/parse.go': 2, 'commands/reqlog.go': 2, 'commands/request.go': 29, 'commands/response.go': 12, 'commands/response_test.go': 8, 'core/bootstrap.go': 34, 'core/commands/active.go': 17, 'core/commands/add.go': 56, 'core/commands/bitswap.go': 52, 'core/commands/block.go': 40, 'core/commands/bootstrap.go': 37, 'core/commands/cat.go': 31, 'core/commands/commands.go': 25, 'core/commands/config.go': 41, 'core/commands/dag/dag.go': 62, 'core/commands/dht.go': 59, 'core/commands/diag.go': 17, 'core/commands/dns.go': 24, 'core/commands/e/error.go': 1, 'core/commands/external.go': 17, 'core/commands/files/files.go': 9, 'core/commands/filestore.go': 28, 'core/commands/get.go': 59, 'core/commands/helptext_test.go': 22, 'core/commands/id.go': 41, 'core/commands/ipns.go': 18, 'core/commands/keystore.go': 30, 'core/commands/log.go': 22, 'core/commands/ls.go': 61, 'core/commands/mount_nofuse.go': 17, 'core/commands/mount_unix.go': 37, 'core/commands/mount_windows.go': 16, 'core/commands/name.go': 10, 'core/commands/object/diff.go': 26, 'core/commands/object/object.go': 64, 'core/commands/object/patch.go': 35, 'core/commands/p2p.go': 31, 'core/commands/pin.go': 65, 'core/commands/ping.go': 35, 'core/commands/publish.go': 19, 'core/commands/pubsub.go': 41, 'core/commands/refs.go': 54, 'core/commands/repo.go': 55, 'core/commands/resolve.go': 54, 'core/commands/root.go': 24, 'core/commands/shutdown.go': 20, 'core/commands/stat.go': 27, 'core/commands/swarm.go': 49, 'core/commands/sysdiag.go': 24, 'core/commands/tar.go': 59, 'core/commands/unixfs/ls.go': 55, 'core/commands/unixfs/unixfs.go': 17, 'core/commands/version.go': 19, 'core/core_test.go': 29, 'core/corehttp/commands.go': 65, 'core/corehttp/gateway.go': 38, 'core/coreunix/add.go': 77, 'core/coreunix/metadata_test.go': 57, 'exchange/bitswap/bitswap_test.go': 11, 'exchange/bitswap/decision/engine_test.go': 11, 'exchange/bitswap/message/message_test.go': 5, 'exchange/bitswap/message/pb/Makefile': 1, 'exchange/bitswap/testnet/network_test.go': 9, 'exchange/bitswap/testnet/peernet.go': 10, 'exchange/reprovide/reprovide_test.go': 37, 'fuse/ipns/common.go': 45, 'fuse/node/mount_test.go': 32, 'importer/balanced/balanced_test.go': 9, 'importer/chunk/rabin_test.go': 3, 'importer/helpers/dagbuilder.go': 16, 'importer/importer.go': 13, 'merkledag/utils/utils_test.go': 6, 'mfs/repub_test.go': 11, 'namesys/dns.go': 43, 'namesys/interface.go': 44, 'namesys/ipns_select_test.go': 5, 'namesys/proquint.go': 43, 'namesys/republisher/repub_test.go': 48, 'package.json': 73, 'repo/config/identity.go': 3, 'routing/offline/offline_test.go': 4, 'test/integration/addcat_test.go': 37, 'test/integration/bench_cat_test.go': 37, 'test/integration/bitswap_wo_routing_test.go': 37, 'test/integration/three_legged_cat_test.go': 37, 'core/bootstrap_test.go': 33, 'core/commands/dht_test.go': 22, 'core/commands/get_test.go': 22, 'core/core.go': 68, 'core/corehttp/gateway_test.go': 66, 'core/corehttp/metrics_test.go': 31, 'core/mock/mock.go': 43, 'exchange/bitswap/decision/bench_test.go': 7, 'exchange/bitswap/decision/peer_request_queue_test.go': 7, 'exchange/bitswap/message/message.go': 7, 'exchange/bitswap/network/interface.go': 7, 'exchange/bitswap/network/ipfs_impl.go': 7, 'exchange/bitswap/testnet/interface.go': 6, 'exchange/bitswap/testnet/virtual.go': 8, 'exchange/bitswap/testutils.go': 10, 'fuse/ipns/ipns_test.go': 33, 'fuse/readonly/ipfs_test.go': 57, 'namesys/publisher_test.go': 32, 'namesys/resolve_test.go': 47, 'p2p/p2p.go': 23, 'p2p/registry.go': 10, 'repo/config/bootstrap_peers.go': 8, 'routing/mock/centralized_client.go': 3, 'routing/mock/centralized_server.go': 3, 'routing/mock/centralized_test.go': 3, 'routing/mock/interface.go': 3, 'routing/none/none_client.go': 3, 'test/integration/bench_test.go': 17, 'assets/assets.go': 50, 'blocks/blockstore/arc_cache.go': 2, 'blocks/blockstore/arc_cache_test.go': 2, 'blocks/blockstore/blockstore.go': 2, 'blocks/blockstore/blockstore_test.go': 2, 'blocks/blockstore/bloom_cache.go': 2, 'blocks/blockstore/bloom_cache_test.go': 2, 'blocks/blocksutil/block_generator.go': 2, 'blockservice/blockservice.go': 10, 'blockservice/blockservice_test.go': 9, 'blockservice/test/blocks_test.go': 10, 'core/builder.go': 66, 'core/commands/ipnsps.go': 9, 'core/coreapi/coreapi.go': 28, 'core/coreapi/interface/interface.go': 2, 'core/coreapi/unixfs.go': 54, 'core/coreapi/unixfs_test.go': 56, 'core/coredag/cbor.go': 17, 'core/coredag/dagpb.go': 43, 'core/coredag/dagtransl.go': 13, 'core/coredag/raw.go': 43, 'core/corehttp/corehttp.go': 14, 'core/corehttp/gateway_handler.go': 58, 'core/corerepo/gc.go': 49, 'core/corerepo/pinning.go': 19, 'core/coreunix/metadata.go': 49, 'core/pathresolver.go': 44, 'exchange/bitswap/bitswap.go': 9, 'exchange/bitswap/decision/engine.go': 9, 'exchange/bitswap/decision/ledger.go': 6, 'exchange/bitswap/decision/peer_request_queue.go': 6, 'exchange/bitswap/get.go': 9, 'exchange/bitswap/notifications/notifications.go': 4, 'exchange/bitswap/notifications/notifications_test.go': 4, 'exchange/bitswap/session.go': 6, 'exchange/bitswap/session_test.go': 6, 'exchange/bitswap/stat.go': 4, 'exchange/bitswap/wantlist/wantlist.go': 4, 'exchange/bitswap/wantlist/wantlist_test.go': 4, 'exchange/bitswap/wantmanager.go': 7, 'exchange/bitswap/workers.go': 6, 'exchange/interface.go': 2, 'exchange/offline/offline.go': 4, 'exchange/offline/offline_test.go': 4, 'exchange/reprovide/providers.go': 49, 'exchange/reprovide/reprovide.go': 28, 'filestore/filestore.go': 31, 'filestore/filestore_test.go': 51, 'filestore/fsrefstore.go': 32, 'filestore/util.go': 26, 'fuse/ipns/ipns_unix.go': 50, 'fuse/readonly/readonly_unix.go': 52, 'importer/balanced/builder.go': 4, 'importer/chunk/splitting_test.go': 2, 'importer/helpers/helpers.go': 9, 'importer/importer_test.go': 8, 'importer/trickle/trickle_test.go': 8, 'importer/trickle/trickledag.go': 5, 'merkledag/batch.go': 2, 'merkledag/coding.go': 4, 'merkledag/merkledag.go': 6, 'merkledag/merkledag_test.go': 9, 'merkledag/node.go': 5, 'merkledag/node_test.go': 5, 'merkledag/raw.go': 4, 'merkledag/traverse/traverse.go': 4, 'merkledag/traverse/traverse_test.go': 5, 'merkledag/utils/diff.go': 5, 'merkledag/utils/diffenum.go': 4, 'merkledag/utils/diffenum_test.go': 5, 'merkledag/utils/utils.go': 11, 'mfs/dir.go': 13, 'mfs/file.go': 15, 'mfs/mfs_test.go': 19, 'mfs/ops.go': 10, 'mfs/system.go': 15, 'namesys/namesys.go': 51, 'namesys/publisher.go': 52, 'namesys/pubsub.go': 4, 'namesys/pubsub_test.go': 4, 'namesys/republisher/repub.go': 44, 'namesys/routing.go': 50, 'path/path.go': 4, 'path/resolver.go': 3, 'path/resolver_test.go': 3, 'pin/gc/gc.go': 52, 'pin/pin.go': 47, 'pin/pin_test.go': 51, 'pin/set.go': 44, 'pin/set_test.go': 49, 'plugin/ipld.go': 13, 'plugin/loader/initializer.go': 10, 'plugin/plugins/git/git.go': 13, 'repo/config/init.go': 6, 'repo/fsrepo/fsrepo.go': 34, 'repo/fsrepo/lock/lock.go': 2, 'repo/fsrepo/serialize/serialize.go': 3, 'repo/mock.go': 27, 'repo/repo.go': 32, 'routing/offline/offline.go': 2, 'tar/format.go': 52, 'test/dependencies/ma-pipe-unidir/main.go': 10, 'thirdparty/ds-help/key.go': 2, 'thirdparty/pollEndpoint/main.go': 13, 'thirdparty/posinfo/posinfo.go': 2, 'unixfs/archive/archive.go': 5, 'unixfs/archive/tar/writer.go': 6, 'unixfs/hamt/hamt.go': 6, 'unixfs/io/dagreader.go': 6, 'unixfs/io/dirbuilder.go': 4, 'unixfs/io/resolve.go': 6, 'unixfs/mod/dagmodifier.go': 8, 'unixfs/mod/dagmodifier_test.go': 3, 'unixfs/test/utils.go': 8, 'commands/legacy/command.go': 13, 'commands/legacy/legacy.go': 13, 'commands/legacy/legacy_test.go': 14, 'commands/legacy/request.go': 14, 'commands/legacy/response.go': 14, 'commands/legacy/responseemitter.go': 4, 'core/commands/env.go': 8, 'TODO.md': 2, 'core/commands/commands_test.go': 19, 'test/sharness/t0110-gateway.sh': 2, 'test/sharness/t0410-api-add.sh': 2, 'core/coreapi/dag.go': 14, 'core/coreapi/dag_test.go': 3, 'core/coreapi/interface/options/dag.go': 8, 'core/coreapi/key.go': 46, 'core/coreapi/name.go': 48, 'merkledag/test/utils.go': 10, 'namesys/namesys_test.go': 53, 'repo/fsrepo/datastores.go': 16, 'repo/fsrepo/fsrepo_test.go': 29, 'thirdparty/datastore2/datastore_closer.go': 2, 'thirdparty/datastore2/delayed.go': 2, 'thirdparty/datastore2/threadsafe.go': 2, 'unixfs/io/pbdagreader.go': 5, 'core/coreapi/key_test.go': 1, 'mfs/fd.go': 8, 'unixfs/hamt/hamt_stress_test.go': 4, 'unixfs/hamt/hamt_test.go': 4, 'unixfs/io/dagreader_test.go': 2, 'unixfs/io/dirbuilder_test.go': 1, 'blocks/blockstoreutil/remove.go': 26, 'core/coreapi/block.go': 20, 'blockservice/test/mock.go': 5, 'namesys/ipns_validate_test.go': 3, 'namesys/validator.go': 3, 'repo/fsrepo/config_test.go': 24, 'cmd/ipfs/util/ulimit.go': 9, 'cmd/seccat/util.go': 8, 'core/commands/files.go': 59, 'core/coreapi/pin.go': 51, 'core/corehttp/logs.go': 8, 'fuse/mount/mount.go': 8, 'fuse/node/mount_unix.go': 9, 'keystore/keystore.go': 9, 'keystore/keystore_test.go': 7, 'keystore/memkeystore.go': 6, 'path/resolver/resolver.go': 5, 'plugin/loader/load.go': 6, 'thirdparty/verifbs/verifbs.go': 23, 'cmd/ipfs/util/ulimit_freebsd.go': 2, 'cmd/ipfs/util/ulimit_unix.go': 2, 'core/coreapi/block_test.go': 2, 'core/coreapi/interface/coreapi.go': 9, 'core/coreapi/interface/dag.go': 9, 'core/coreapi/interface/object.go': 9, 'core/coreapi/interface/options/block.go': 3, 'core/coreapi/interface/path.go': 34, 'core/coreapi/interface/unixfs.go': 17, 'core/coreapi/object.go': 50, 'fuse/ipns/link_unix.go': 2, 'fuse/mount/fuse.go': 3, 'fuse/node/mount_darwin.go': 3, 'merkledag/errservice.go': 2, 'merkledag/readonly.go': 2, 'merkledag/readonly_test.go': 2, 'merkledag/rwservice.go': 2, 'merkledag/session.go': 2, 'path/resolver/resolver_test.go': 3, 'thirdparty/verifcid/validate.go': 2, 'thirdparty/verifcid/validate_test.go': 2, 'namesys/ipns_resolver_validation_test.go': 44, 'test/sharness/t0170-dht.sh': 1, 'core/coreunix/test/data/colors/orange': 1, 'core/coreunix/test/data/corps/apple': 1, 'core/coreunix/test/data/fruits/apple': 1, 'core/coreunix/test/data/fruits/orange': 1, 'core/commands/urlstore.go': 45, 'filestore/pb/Makefile': 2, 'filestore/pb/dataobj.pb.go': 5, 'filestore/pb/dataobj.proto': 2, 'unixfs/io/directory.go': 2, 'core/corehttp/metrics.go': 2, 'Rules.mk': 2, 'dagutils/diff.go': 44, 'dagutils/diffenum.go': 40, 'dagutils/diffenum_test.go': 39, 'dagutils/utils.go': 40, 'dagutils/utils_test.go': 39, 'unixfs/io/directory_test.go': 1, 'unixfs/unixfs.go': 1, 'core/coreapi/name_test.go': 33, 'core/coreapi/path.go': 46, 'core/coreunix/cat.go': 14, 'core/pathresolver_test.go': 38, 'namesys/base.go': 42, 'namesys/cache.go': 38, 'core/coreapi/interface/key.go': 7, 'pin/internal/pb/header.pb.go': 3, 'thirdparty/cidv0v1/blockstore.go': 16, 'cmd/ipfs/Rules.mk': 1, 'core/corehttp/option_test.go': 2, 'docs/releases.md': 1, 'docs/windows.md': 1, 'repo/fsrepo/misc.go': 23, 'repo/version.go': 1, 'test/bench/bench_cli_ipfs_add/main.go': 24, 'test/bench/offline_add/main.go': 24, 'core/commands/cmdenv/env.go': 29, 'core/commands/name/ipns.go': 38, 'core/commands/name/publish.go': 22, 'core/coreapi/dht.go': 34, 'core/coreapi/dht_test.go': 5, 'test/sharness/t0275-cid-security.sh': 1, 'core/commands/name/ipnsps.go': 13, 'core/commands/name/name.go': 9, 'core/coreapi/interface/dht.go': 10, 'p2p/listener.go': 13, 'p2p/local.go': 13, 'p2p/remote.go': 14, 'p2p/stream.go': 14, 'core/coreapi/interface/options/unixfs.go': 16, 'core/coreapi/interface/swarm.go': 9, 'core/coreapi/swarm.go': 24, 'core/coreapi/pubsub.go': 23, 'core/coreapi/unixfile.go': 19, 'core/commands/cid.go': 11, 'cmd/ipfs/dnsresolve_test.go': 5, 'core/coreapi/interface/pubsub.go': 4, 'test/sharness/t0180-pubsub.sh': 1, 'test/dependencies/iptb/iptb.go': 15, 'plugin/plugins/badgerds/badgerds.go': 3, 'plugin/plugins/flatfs/flatfs.go': 3, 'plugin/plugins/levelds/levelds.go': 3, 'commands/context.go': 18, 'core/corehttp/proxy.go': 9, 'core/coreapi/test/api_test.go': 14, 'core/coreapi/interface/tests/name.go': 4, 'core/coreapi/interface/tests/unixfs.go': 4, 'plugin/loader/loader.go': 13, 'core/commands/cmdenv/cidbase.go': 6, 'core/commands/cmdenv/file.go': 3, 'core/corehttp/ipns_hostname.go': 11, 'namesys/dns_test.go': 10, 'plugin/daemon.go': 10, 'core/commands/cmdenv/cidbase_test.go': 2, 'core/corehttp/proxy_test.go': 1, 'core/corerepo/stat.go': 1, 'plugin/tracer.go': 1, 'thirdparty/notifier/notifier.go': 2, 'core/corehttp/mutex_profile.go': 1, 'provider/queue.go': 1, 'provider/queue_test.go': 1, 'cmd/ipfs/util/ulimit_test.go': 1, 'core/node/builder.go': 1, 'core/node/storage.go': 1, 'go.mod': 2, 'go.sum': 2, 'core/node/core.go': 1, 'core/node/provider.go': 1, 'gc/gc.go': 2, 'CHANGELOG.md': 1, 'Dockerfile': 1, 'README.md': 1, 'bin/check_go_version': 1, 'coverage/Rules.mk': 1, 'docs/config.md': 1, 'docs/debug-guide.md': 1, 'docs/environment-variables.md': 1, 'keystore/memkeystore_test.go': 1, 'misc/completion/ipfs-completion.bash': 1, 'plugin/plugins/gen_main.sh': 1, 'repo/fsrepo/migrations/migrations.go': 1, 'repo/onlyone.go': 1, 'test/3nodetest/run-test-on-img.sh': 1, 'test/ipfs-test-lib.sh': 1, 'test/sharness/README.md': 1, 'test/sharness/lib/iptb-lib.sh': 1, 'test/sharness/t0010-basic-commands.sh': 1, 'test/sharness/t0020-init.sh': 1, 'test/sharness/t0030-mount.sh': 1, 'test/sharness/t0031-mount-publish.sh': 1, 'test/sharness/t0040-add-and-cat.sh': 1, 'test/sharness/t0050-block.sh': 1, 'test/sharness/t0051-object.sh': 1, 'test/sharness/t0053-dag.sh': 1, 'test/sharness/t0060-daemon.sh': 1, 'test/sharness/t0062-daemon-api.sh': 1, 'test/sharness/t0080-repo.sh': 1, 'test/sharness/t0087-repo-robust-gc.sh': 1, 'test/sharness/t0090-get.sh': 1, 'test/sharness/t0114-gateway-subdomains.sh': 1, 'test/sharness/t0131-multinode-client-routing.sh': 1, 'test/sharness/t0140-swarm.sh': 1, 'test/sharness/t0183-namesys-pubsub.sh': 1, 'test/sharness/t0250-files-api.sh': 1, 'test/sharness/t0270-filestore.sh': 1, 'test/sharness/t0272-urlstore.sh': 1, 'test/sharness/t0600-issues-and-regressions-online.sh': 1, 'test/sharness_test_coverage_helper.sh': 1, 'thirdparty/README.md': 1}","('core/coreunix/add.go', 0.7938144329896907, 0.6111111111111112)"
core/coreunix/metadata.go,46,275,2,"[{'cyclomatic_complexity': 6, 'nloc': 24, 'token_count': 158, 'name': 'AddMetadataTo', 'long_name': 'AddMetadataTo n * core . IpfsNode , skey string , m * ft . Metadata', 'start_line': 10, 'end_line': 38, 'full_parameters': ['n * core . IpfsNode', ' skey string', ' m * ft . Metadata'], 'filename': '/home/dimi/Documents/Informatik_Studium/FSS/SoftEvo/DataCollection/FFS_SoftEvo/go-ipfs/core/coreunix/metadata.go', 'top_nesting_level': 0, 'length': 29, 'fan_in': 0, 'fan_out': 0, 'general_fan_out': 0}, {'cyclomatic_complexity': 4, 'nloc': 15, 'token_count': 104, 'name': 'Metadata', 'long_name': 'Metadata n * core . IpfsNode , skey string', 'start_line': 40, 'end_line': 57, 'full_parameters': ['n * core . IpfsNode', ' skey string'], 'filename': '/home/dimi/Documents/Informatik_Studium/FSS/SoftEvo/DataCollection/FFS_SoftEvo/go-ipfs/core/coreunix/metadata.go', 'top_nesting_level': 0, 'length': 18, 'fan_in': 0, 'fan_out': 0, 'general_fan_out': 0}]",46,283,2,"[{'cyclomatic_complexity': 6, 'nloc': 24, 'token_count': 166, 'name': 'AddMetadataTo', 'long_name': 'AddMetadataTo n * core . IpfsNode , skey string , m * ft . Metadata', 'start_line': 10, 'end_line': 38, 'full_parameters': ['n * core . IpfsNode', ' skey string', ' m * ft . Metadata'], 'filename': '/home/dimi/Documents/Informatik_Studium/FSS/SoftEvo/DataCollection/FFS_SoftEvo/go-ipfs/core/coreunix/metadata.go', 'top_nesting_level': 0, 'length': 29, 'fan_in': 0, 'fan_out': 0, 'general_fan_out': 0}, {'cyclomatic_complexity': 4, 'nloc': 15, 'token_count': 104, 'name': 'Metadata', 'long_name': 'Metadata n * core . IpfsNode , skey string', 'start_line': 40, 'end_line': 57, 'full_parameters': ['n * core . IpfsNode', ' skey string'], 'filename': '/home/dimi/Documents/Informatik_Studium/FSS/SoftEvo/DataCollection/FFS_SoftEvo/go-ipfs/core/coreunix/metadata.go', 'top_nesting_level': 0, 'length': 18, 'fan_in': 0, 'fan_out': 0, 'general_fan_out': 0}]",0,8,0,53,53,"[{'timestamp': 1512365669.0, 'added_lines': 1, 'deleted_lines': 1, 'nloc': 46}, {'timestamp': 1516838128.0, 'added_lines': 1, 'deleted_lines': 1, 'nloc': 46}, {'timestamp': 1516911711.0, 'added_lines': 2, 'deleted_lines': 2, 'nloc': 46}, {'timestamp': 1523911794.0, 'added_lines': 1, 'deleted_lines': 1, 'nloc': 46}, {'timestamp': 1524132813.0, 'added_lines': 1, 'deleted_lines': 1, 'nloc': 46}, {'timestamp': 1528520460.0, 'added_lines': 1, 'deleted_lines': 1, 'nloc': 46}, {'timestamp': 1531779409.0, 'added_lines': 1, 'deleted_lines': 1, 'nloc': 46}, {'timestamp': 1532764253.0, 'added_lines': 1, 'deleted_lines': 1, 'nloc': 46}, {'timestamp': 1532986515.0, 'added_lines': 1, 'deleted_lines': 1, 'nloc': 46}, {'timestamp': 1533500571.0, 'added_lines': 2, 'deleted_lines': 2, 'nloc': 46}, {'timestamp': 1533618653.0, 'added_lines': 2, 'deleted_lines': 2, 'nloc': 46}, {'timestamp': 1533779477.0, 'added_lines': 2, 'deleted_lines': 2, 'nloc': 46}, {'timestamp': 1533946888.0, 'added_lines': 1, 'deleted_lines': 1, 'nloc': 46}, {'timestamp': 1534115707.0, 'added_lines': 3, 'deleted_lines': 3, 'nloc': 46}, {'timestamp': 1534195762.0, 'added_lines': 2, 'deleted_lines': 2, 'nloc': 46}, {'timestamp': 1534347022.0, 'added_lines': 3, 'deleted_lines': 3, 'nloc': 46}, {'timestamp': 1534896611.0, 'added_lines': 3, 'deleted_lines': 3, 'nloc': 46}, {'timestamp': 1535601896.0, 'added_lines': 2, 'deleted_lines': 2, 'nloc': 46}, {'timestamp': 1536388808.0, 'added_lines': 2, 'deleted_lines': 2, 'nloc': 46}, {'timestamp': 1536718784.0, 'added_lines': 3, 'deleted_lines': 3, 'nloc': 46}, {'timestamp': 1536723292.0, 'added_lines': 2, 'deleted_lines': 2, 'nloc': 46}, {'timestamp': 1537790637.0, 'added_lines': 2, 'deleted_lines': 2, 'nloc': 46}, {'timestamp': 1537792589.0, 'added_lines': 2, 'deleted_lines': 2, 'nloc': 46}, {'timestamp': 1538544957.0, 'added_lines': 2, 'deleted_lines': 2, 'nloc': 46}, {'timestamp': 1538694687.0, 'added_lines': 2, 'deleted_lines': 2, 'nloc': 46}, {'timestamp': 1538695953.0, 'added_lines': 2, 'deleted_lines': 2, 'nloc': 46}, {'timestamp': 1538773916.0, 'added_lines': 2, 'deleted_lines': 2, 'nloc': 46}, {'timestamp': 1539176817.0, 'added_lines': 2, 'deleted_lines': 2, 'nloc': 46}, {'timestamp': 1539357340.0, 'added_lines': 2, 'deleted_lines': 2, 'nloc': 46}, {'timestamp': 1539850591.0, 'added_lines': 1, 'deleted_lines': 1, 'nloc': 46}, {'timestamp': 1540400358.0, 'added_lines': 2, 'deleted_lines': 2, 'nloc': 46}, {'timestamp': 1540410565.0, 'added_lines': 2, 'deleted_lines': 2, 'nloc': 46}, {'timestamp': 1540418491.0, 'added_lines': 2, 'deleted_lines': 2, 'nloc': 46}, {'timestamp': 1540603818.0, 'added_lines': 2, 'deleted_lines': 2, 'nloc': 46}, {'timestamp': 1541106379.0, 'added_lines': 1, 'deleted_lines': 1, 'nloc': 46}, {'timestamp': 1541189794.0, 'added_lines': 2, 'deleted_lines': 2, 'nloc': 46}, {'timestamp': 1541204121.0, 'added_lines': 3, 'deleted_lines': 3, 'nloc': 46}, {'timestamp': 1541903826.0, 'added_lines': 2, 'deleted_lines': 2, 'nloc': 46}, {'timestamp': 1543443696.0, 'added_lines': 2, 'deleted_lines': 2, 'nloc': 46}, {'timestamp': 1544225843.0, 'added_lines': 2, 'deleted_lines': 2, 'nloc': 46}, {'timestamp': 1540556089.0, 'added_lines': 1, 'deleted_lines': 1, 'nloc': 46}, {'timestamp': 1547003974.0, 'added_lines': 2, 'deleted_lines': 2, 'nloc': 46}, {'timestamp': 1547499910.0, 'added_lines': 2, 'deleted_lines': 2, 'nloc': 46}, {'timestamp': 1548866534.0, 'added_lines': 1, 'deleted_lines': 1, 'nloc': 46}, {'timestamp': 1549588289.0, 'added_lines': 2, 'deleted_lines': 2, 'nloc': 46}, {'timestamp': 1549903582.0, 'added_lines': 1, 'deleted_lines': 1, 'nloc': 46}, {'timestamp': 1550185115.0, 'added_lines': 2, 'deleted_lines': 2, 'nloc': 46}, {'timestamp': 1550507829.0, 'added_lines': 2, 'deleted_lines': 2, 'nloc': 46}, {'timestamp': 1550711994.0, 'added_lines': 2, 'deleted_lines': 2, 'nloc': 46}, {'timestamp': 1550723346.0, 'added_lines': 3, 'deleted_lines': 3, 'nloc': 46}, {'timestamp': 1551229859.0, 'added_lines': 2, 'deleted_lines': 2, 'nloc': 46}, {'timestamp': 1551299964.0, 'added_lines': 2, 'deleted_lines': 2, 'nloc': 46}, {'timestamp': 1551551196.0, 'added_lines': 3, 'deleted_lines': 3, 'nloc': 46}]","{'assets/assets.go': 48, 'blocks/blockstore/arc_cache.go': 2, 'blocks/blockstore/arc_cache_test.go': 2, 'blocks/blockstore/blockstore.go': 2, 'blocks/blockstore/blockstore_test.go': 2, 'blocks/blockstore/bloom_cache.go': 2, 'blocks/blockstore/bloom_cache_test.go': 2, 'blocks/blockstore/util/remove.go': 2, 'blocks/blocksutil/block_generator.go': 2, 'blockservice/blockservice.go': 5, 'blockservice/blockservice_test.go': 4, 'blockservice/test/blocks_test.go': 5, 'cmd/ipfs/daemon.go': 18, 'cmd/ipfs/init.go': 22, 'cmd/ipfs/ipfs.go': 15, 'cmd/ipfs/main.go': 23, 'cmd/ipfs/main_test.go': 1, 'cmd/ipfswatch/main.go': 17, 'cmd/seccat/seccat.go': 21, 'commands/command.go': 9, 'commands/command_test.go': 2, 'commands/request.go': 13, 'commands/response.go': 6, 'commands/response_test.go': 2, 'core/bootstrap.go': 20, 'core/bootstrap_test.go': 20, 'core/builder.go': 50, 'core/commands/active.go': 11, 'core/commands/add.go': 35, 'core/commands/bitswap.go': 44, 'core/commands/block.go': 23, 'core/commands/bootstrap.go': 21, 'core/commands/cat.go': 19, 'core/commands/commands.go': 15, 'core/commands/config.go': 21, 'core/commands/dag/dag.go': 48, 'core/commands/dht.go': 49, 'core/commands/dht_test.go': 19, 'core/commands/diag.go': 11, 'core/commands/dns.go': 16, 'core/commands/external.go': 11, 'core/commands/files/files.go': 3, 'core/commands/filestore.go': 20, 'core/commands/get.go': 48, 'core/commands/get_test.go': 15, 'core/commands/helptext_test.go': 15, 'core/commands/id.go': 32, 'core/commands/ipns.go': 9, 'core/commands/ipnsps.go': 5, 'core/commands/keystore.go': 19, 'core/commands/log.go': 14, 'core/commands/ls.go': 50, 'core/commands/mount_nofuse.go': 11, 'core/commands/mount_unix.go': 21, 'core/commands/mount_windows.go': 11, 'core/commands/name.go': 4, 'core/commands/object/diff.go': 16, 'core/commands/object/object.go': 50, 'core/commands/object/patch.go': 21, 'core/commands/p2p.go': 23, 'core/commands/pin.go': 50, 'core/commands/ping.go': 27, 'core/commands/publish.go': 11, 'core/commands/pubsub.go': 29, 'core/commands/refs.go': 48, 'core/commands/repo.go': 33, 'core/commands/resolve.go': 45, 'core/commands/root.go': 15, 'core/commands/shutdown.go': 14, 'core/commands/stat.go': 19, 'core/commands/swarm.go': 29, 'core/commands/sysdiag.go': 16, 'core/commands/tar.go': 47, 'core/commands/unixfs/ls.go': 48, 'core/commands/unixfs/unixfs.go': 11, 'core/commands/version.go': 12, 'core/core.go': 51, 'core/coreapi/coreapi.go': 24, 'core/coreapi/interface/interface.go': 2, 'core/coreapi/unixfs.go': 49, 'core/coreapi/unixfs_test.go': 39, 'core/coredag/cbor.go': 17, 'core/coredag/dagpb.go': 43, 'core/coredag/dagtransl.go': 13, 'core/coredag/raw.go': 43, 'core/corehttp/commands.go': 46, 'core/corehttp/corehttp.go': 11, 'core/corehttp/gateway.go': 29, 'core/corehttp/gateway_handler.go': 51, 'core/corehttp/gateway_test.go': 45, 'core/corehttp/metrics_test.go': 27, 'core/corerepo/gc.go': 45, 'core/corerepo/pinning.go': 20, 'core/coreunix/add.go': 51, 'core/coreunix/add_test.go': 49, 'core/coreunix/metadata_test.go': 51, 'core/mock/mock.go': 28, 'core/pathresolver.go': 42, 'exchange/bitswap/bitswap.go': 4, 'exchange/bitswap/bitswap_test.go': 4, 'exchange/bitswap/decision/bench_test.go': 4, 'exchange/bitswap/decision/engine.go': 4, 'exchange/bitswap/decision/engine_test.go': 4, 'exchange/bitswap/decision/ledger.go': 4, 'exchange/bitswap/decision/peer_request_queue.go': 4, 'exchange/bitswap/decision/peer_request_queue_test.go': 4, 'exchange/bitswap/get.go': 4, 'exchange/bitswap/message/message.go': 4, 'exchange/bitswap/message/message_test.go': 4, 'exchange/bitswap/network/interface.go': 4, 'exchange/bitswap/network/ipfs_impl.go': 4, 'exchange/bitswap/notifications/notifications.go': 4, 'exchange/bitswap/notifications/notifications_test.go': 4, 'exchange/bitswap/session.go': 4, 'exchange/bitswap/session_test.go': 4, 'exchange/bitswap/stat.go': 4, 'exchange/bitswap/testnet/interface.go': 3, 'exchange/bitswap/testnet/network_test.go': 4, 'exchange/bitswap/testnet/peernet.go': 4, 'exchange/bitswap/testnet/virtual.go': 4, 'exchange/bitswap/testutils.go': 4, 'exchange/bitswap/wantlist/wantlist.go': 4, 'exchange/bitswap/wantlist/wantlist_test.go': 4, 'exchange/bitswap/wantmanager.go': 4, 'exchange/bitswap/workers.go': 4, 'exchange/interface.go': 2, 'exchange/offline/offline.go': 2, 'exchange/offline/offline_test.go': 2, 'exchange/reprovide/providers.go': 44, 'exchange/reprovide/reprovide.go': 25, 'exchange/reprovide/reprovide_test.go': 29, 'filestore/filestore.go': 23, 'filestore/filestore_test.go': 43, 'filestore/fsrefstore.go': 23, 'filestore/util.go': 21, 'fuse/ipns/ipns_test.go': 27, 'fuse/ipns/ipns_unix.go': 50, 'fuse/node/mount_test.go': 27, 'fuse/readonly/ipfs_test.go': 51, 'fuse/readonly/readonly_unix.go': 51, 'importer/balanced/balanced_test.go': 6, 'importer/balanced/builder.go': 4, 'importer/chunk/rabin_test.go': 2, 'importer/chunk/splitting_test.go': 2, 'importer/helpers/dagbuilder.go': 6, 'importer/helpers/helpers.go': 8, 'importer/importer.go': 5, 'importer/importer_test.go': 6, 'importer/trickle/trickle_test.go': 6, 'importer/trickle/trickledag.go': 5, 'merkledag/batch.go': 2, 'merkledag/coding.go': 4, 'merkledag/merkledag.go': 5, 'merkledag/merkledag_test.go': 7, 'merkledag/node.go': 7, 'merkledag/node_test.go': 5, 'merkledag/raw.go': 4, 'merkledag/traverse/traverse.go': 4, 'merkledag/traverse/traverse_test.go': 5, 'merkledag/utils/diff.go': 5, 'merkledag/utils/diffenum.go': 4, 'merkledag/utils/diffenum_test.go': 5, 'merkledag/utils/utils.go': 7, 'merkledag/utils/utils_test.go': 5, 'mfs/dir.go': 14, 'mfs/file.go': 14, 'mfs/mfs_test.go': 14, 'mfs/ops.go': 10, 'mfs/repub_test.go': 7, 'mfs/system.go': 14, 'namesys/ipns_select_test.go': 3, 'namesys/namesys.go': 43, 'namesys/publisher.go': 49, 'namesys/publisher_test.go': 28, 'namesys/pubsub.go': 2, 'namesys/pubsub_test.go': 2, 'namesys/republisher/repub.go': 41, 'namesys/republisher/repub_test.go': 41, 'namesys/resolve_test.go': 42, 'namesys/routing.go': 43, 'p2p/p2p.go': 20, 'p2p/registry.go': 7, 'package.json': 50, 'path/path.go': 4, 'path/resolver.go': 3, 'path/resolver_test.go': 3, 'pin/gc/gc.go': 44, 'pin/pin.go': 44, 'pin/pin_test.go': 46, 'pin/set.go': 44, 'pin/set_test.go': 45, 'plugin/ipld.go': 13, 'plugin/loader/initializer.go': 10, 'plugin/plugins/git/git.go': 13, 'repo/config/bootstrap_peers.go': 4, 'repo/config/init.go': 4, 'repo/fsrepo/fsrepo.go': 20, 'repo/fsrepo/lock/lock.go': 2, 'repo/fsrepo/serialize/serialize.go': 3, 'repo/mock.go': 16, 'repo/repo.go': 19, 'routing/mock/centralized_client.go': 2, 'routing/mock/centralized_server.go': 2, 'routing/mock/centralized_test.go': 2, 'routing/mock/interface.go': 2, 'routing/none/none_client.go': 2, 'routing/offline/offline.go': 2, 'routing/offline/offline_test.go': 2, 'tar/format.go': 53, 'test/dependencies/ma-pipe-unidir/main.go': 8, 'test/integration/addcat_test.go': 29, 'test/integration/bench_cat_test.go': 29, 'test/integration/bench_test.go': 14, 'test/integration/bitswap_wo_routing_test.go': 31, 'test/integration/three_legged_cat_test.go': 29, 'thirdparty/ds-help/key.go': 2, 'thirdparty/pollEndpoint/main.go': 11, 'thirdparty/posinfo/posinfo.go': 2, 'unixfs/archive/archive.go': 6, 'unixfs/archive/tar/writer.go': 7, 'unixfs/hamt/hamt.go': 7, 'unixfs/io/dagreader.go': 7, 'unixfs/io/dirbuilder.go': 6, 'unixfs/io/resolve.go': 7, 'unixfs/mod/dagmodifier.go': 9, 'unixfs/mod/dagmodifier_test.go': 4, 'unixfs/test/utils.go': 7, 'commands/legacy/command.go': 8, 'commands/legacy/legacy.go': 8, 'commands/legacy/legacy_test.go': 8, 'commands/legacy/request.go': 8, 'commands/legacy/response.go': 8, 'core/commands/commands_test.go': 14, 'core/coreapi/dag.go': 13, 'core/coreapi/dag_test.go': 3, 'core/coreapi/interface/options/dag.go': 8, 'core/coreapi/key.go': 41, 'core/coreapi/name.go': 42, 'merkledag/test/utils.go': 4, 'namesys/namesys_test.go': 48, 'repo/fsrepo/datastores.go': 12, 'repo/fsrepo/fsrepo_test.go': 17, 'thirdparty/datastore2/datastore_closer.go': 1, 'thirdparty/datastore2/delayed.go': 1, 'thirdparty/datastore2/threadsafe.go': 1, 'unixfs/io/pbdagreader.go': 6, None: 19, 'mfs/fd.go': 9, 'unixfs/hamt/hamt_stress_test.go': 5, 'unixfs/hamt/hamt_test.go': 5, 'unixfs/io/dagreader_test.go': 3, 'unixfs/io/dirbuilder_test.go': 1, 'blocks/blockstoreutil/remove.go': 19, 'blockservice/test/mock.go': 2, 'cmd/ipfs/util/ulimit.go': 6, 'cmd/ipfs/util/ulimit_freebsd.go': 2, 'cmd/ipfs/util/ulimit_unix.go': 2, 'cmd/seccat/util.go': 6, 'core/commands/files.go': 48, 'core/coreapi/block.go': 15, 'core/coreapi/block_test.go': 2, 'core/coreapi/interface/coreapi.go': 9, 'core/coreapi/interface/dag.go': 9, 'core/coreapi/interface/object.go': 9, 'core/coreapi/interface/options/block.go': 3, 'core/coreapi/interface/path.go': 33, 'core/coreapi/interface/unixfs.go': 13, 'core/coreapi/object.go': 48, 'core/coreapi/pin.go': 42, 'core/corehttp/logs.go': 6, 'fuse/ipns/link_unix.go': 2, 'fuse/mount/fuse.go': 2, 'fuse/mount/mount.go': 6, 'fuse/node/mount_darwin.go': 2, 'fuse/node/mount_unix.go': 6, 'keystore/keystore.go': 6, 'merkledag/errservice.go': 2, 'merkledag/readonly.go': 2, 'merkledag/readonly_test.go': 2, 'merkledag/rwservice.go': 2, 'merkledag/session.go': 2, 'namesys/ipns_validate_test.go': 1, 'namesys/validator.go': 1, 'path/resolver/resolver.go': 3, 'path/resolver/resolver_test.go': 3, 'plugin/loader/load.go': 4, 'thirdparty/verifbs/verifbs.go': 19, 'thirdparty/verifcid/validate.go': 2, 'thirdparty/verifcid/validate_test.go': 2, 'core/commands/urlstore.go': 46, 'namesys/ipns_resolver_validation_test.go': 40, 'unixfs/io/directory.go': 3, 'Rules.mk': 1, 'dagutils/diff.go': 40, 'dagutils/diffenum.go': 39, 'dagutils/diffenum_test.go': 39, 'dagutils/utils.go': 39, 'dagutils/utils_test.go': 39, 'unixfs/io/directory_test.go': 2, 'unixfs/unixfs.go': 2, 'core/coreapi/path.go': 45, 'core/coreunix/cat.go': 15, 'fuse/ipns/common.go': 45, 'unixfs/importer/balanced/balanced_test.go': 1, 'unixfs/importer/balanced/builder.go': 1, 'unixfs/importer/helpers/dagbuilder.go': 1, 'unixfs/importer/helpers/helpers.go': 1, 'unixfs/importer/importer.go': 1, 'unixfs/importer/importer_test.go': 1, 'unixfs/importer/trickle/trickle_test.go': 1, 'unixfs/importer/trickle/trickledag.go': 1, 'unixfs/unixfs_test.go': 1, 'core/coreapi/name_test.go': 30, 'core/pathresolver_test.go': 38, 'namesys/base.go': 39, 'namesys/cache.go': 38, 'namesys/dns.go': 39, 'namesys/interface.go': 39, 'namesys/proquint.go': 39, 'core/commands/env.go': 3, 'core/coreapi/interface/key.go': 7, 'filestore/pb/dataobj.pb.go': 3, 'keystore/keystore_test.go': 4, 'keystore/memkeystore.go': 4, 'pin/internal/pb/header.pb.go': 3, 'repo/config/identity.go': 1, 'thirdparty/cidv0v1/blockstore.go': 16, 'core/core_test.go': 16, 'repo/fsrepo/config_test.go': 13, 'repo/fsrepo/misc.go': 13, 'test/bench/bench_cli_ipfs_add/main.go': 13, 'test/bench/offline_add/main.go': 13, 'core/commands/cmdenv/env.go': 20, 'core/commands/name/ipns.go': 35, 'core/commands/name/publish.go': 19, 'core/coreapi/dht.go': 30, 'core/coreapi/dht_test.go': 5, 'test/sharness/t0275-cid-security.sh': 1, 'core/commands/name/ipnsps.go': 13, 'core/commands/name/name.go': 9, 'core/coreapi/interface/dht.go': 10, 'p2p/listener.go': 13, 'p2p/local.go': 13, 'p2p/remote.go': 13, 'p2p/stream.go': 13, 'core/coreapi/interface/swarm.go': 9, 'core/coreapi/swarm.go': 20, 'core/coreapi/interface/options/unixfs.go': 15, 'core/coreapi/pubsub.go': 18, 'core/coreapi/unixfile.go': 17, 'core/commands/cid.go': 9, 'cmd/ipfs/dnsresolve_test.go': 5, 'core/coreapi/interface/pubsub.go': 4, 'test/dependencies/iptb/iptb.go': 12, 'plugin/plugins/badgerds/badgerds.go': 3, 'plugin/plugins/flatfs/flatfs.go': 3, 'plugin/plugins/levelds/levelds.go': 3, 'commands/context.go': 13, 'core/corehttp/proxy.go': 9, 'core/coreapi/interface/tests/name.go': 4, 'core/coreapi/interface/tests/unixfs.go': 4, 'core/coreapi/test/api_test.go': 10, 'plugin/loader/loader.go': 9, 'core/commands/cmdenv/cidbase.go': 6, 'core/commands/cmdenv/file.go': 3, 'core/corehttp/ipns_hostname.go': 8, 'namesys/dns_test.go': 8, 'plugin/daemon.go': 8, 'core/commands/cmdenv/cidbase_test.go': 2, 'core/corehttp/metrics.go': 1, 'core/corehttp/proxy_test.go': 1, 'core/corerepo/stat.go': 1, 'plugin/tracer.go': 1, 'thirdparty/notifier/notifier.go': 1}","('tar/format.go', 1.0, 0.803030303030303)"
core/coreunix/metadata_test.go,75,413,2,"[{'cyclomatic_complexity': 1, 'nloc': 6, 'token_count': 56, 'name': 'getDagserv', 'long_name': 'getDagserv t * testing . T', 'start_line': 25, 'end_line': 30, 'full_parameters': ['t * testing . T'], 'filename': '/home/dimi/Documents/Informatik_Studium/FSS/SoftEvo/DataCollection/FFS_SoftEvo/go-ipfs/core/coreunix/metadata_test.go', 'top_nesting_level': 0, 'length': 6, 'fan_in': 0, 'fan_out': 0, 'general_fan_out': 0}, {'cyclomatic_complexity': 11, 'nloc': 49, 'token_count': 321, 'name': 'TestMetadata', 'long_name': 'TestMetadata t * testing . T', 'start_line': 32, 'end_line': 93, 'full_parameters': ['t * testing . T'], 'filename': '/home/dimi/Documents/Informatik_Studium/FSS/SoftEvo/DataCollection/FFS_SoftEvo/go-ipfs/core/coreunix/metadata_test.go', 'top_nesting_level': 0, 'length': 62, 'fan_in': 0, 'fan_out': 0, 'general_fan_out': 0}]",80,433,2,"[{'cyclomatic_complexity': 1, 'nloc': 6, 'token_count': 56, 'name': 'getDagserv', 'long_name': 'getDagserv t * testing . T', 'start_line': 27, 'end_line': 32, 'full_parameters': ['t * testing . T'], 'filename': '/home/dimi/Documents/Informatik_Studium/FSS/SoftEvo/DataCollection/FFS_SoftEvo/go-ipfs/core/coreunix/metadata_test.go', 'top_nesting_level': 0, 'length': 6, 'fan_in': 0, 'fan_out': 0, 'general_fan_out': 0}, {'cyclomatic_complexity': 12, 'nloc': 52, 'token_count': 339, 'name': 'TestMetadata', 'long_name': 'TestMetadata t * testing . T', 'start_line': 34, 'end_line': 98, 'full_parameters': ['t * testing . T'], 'filename': '/home/dimi/Documents/Informatik_Studium/FSS/SoftEvo/DataCollection/FFS_SoftEvo/go-ipfs/core/coreunix/metadata_test.go', 'top_nesting_level': 0, 'length': 65, 'fan_in': 0, 'fan_out': 0, 'general_fan_out': 0}]",5,20,0,66,66,"[{'timestamp': 1491058697.0, 'added_lines': 1, 'deleted_lines': 1, 'nloc': 75}, {'timestamp': 1511062375.0, 'added_lines': 2, 'deleted_lines': 2, 'nloc': 75}, {'timestamp': 1512365669.0, 'added_lines': 2, 'deleted_lines': 2, 'nloc': 75}, {'timestamp': 1516838128.0, 'added_lines': 4, 'deleted_lines': 4, 'nloc': 75}, {'timestamp': 1516911711.0, 'added_lines': 2, 'deleted_lines': 1, 'nloc': 76}, {'timestamp': 1517255734.0, 'added_lines': 2, 'deleted_lines': 2, 'nloc': 76}, {'timestamp': 1517858907.0, 'added_lines': 1, 'deleted_lines': 1, 'nloc': 76}, {'timestamp': 1517996381.0, 'added_lines': 1, 'deleted_lines': 1, 'nloc': 76}, {'timestamp': 1518090209.0, 'added_lines': 1, 'deleted_lines': 1, 'nloc': 76}, {'timestamp': 1518090579.0, 'added_lines': 2, 'deleted_lines': 2, 'nloc': 76}, {'timestamp': 1518714221.0, 'added_lines': 1, 'deleted_lines': 1, 'nloc': 76}, {'timestamp': 1519761835.0, 'added_lines': 3, 'deleted_lines': 3, 'nloc': 76}, {'timestamp': 1522765832.0, 'added_lines': 1, 'deleted_lines': 1, 'nloc': 76}, {'timestamp': 1525408792.0, 'added_lines': 5, 'deleted_lines': 5, 'nloc': 76}, {'timestamp': 1528520460.0, 'added_lines': 6, 'deleted_lines': 6, 'nloc': 76}, {'timestamp': 1529984485.0, 'added_lines': 3, 'deleted_lines': 3, 'nloc': 76}, {'timestamp': 1531779409.0, 'added_lines': 5, 'deleted_lines': 5, 'nloc': 76}, {'timestamp': 1532146078.0, 'added_lines': 2, 'deleted_lines': 2, 'nloc': 76}, {'timestamp': 1532740866.0, 'added_lines': 1, 'deleted_lines': 1, 'nloc': 76}, {'timestamp': 1532764253.0, 'added_lines': 1, 'deleted_lines': 1, 'nloc': 76}, {'timestamp': 1532986515.0, 'added_lines': 3, 'deleted_lines': 3, 'nloc': 76}, {'timestamp': 1533500571.0, 'added_lines': 5, 'deleted_lines': 5, 'nloc': 76}, {'timestamp': 1533618653.0, 'added_lines': 7, 'deleted_lines': 7, 'nloc': 76}, {'timestamp': 1533779477.0, 'added_lines': 8, 'deleted_lines': 8, 'nloc': 76}, {'timestamp': 1533946888.0, 'added_lines': 3, 'deleted_lines': 3, 'nloc': 76}, {'timestamp': 1534115707.0, 'added_lines': 10, 'deleted_lines': 10, 'nloc': 76}, {'timestamp': 1534195762.0, 'added_lines': 9, 'deleted_lines': 9, 'nloc': 76}, {'timestamp': 1534347022.0, 'added_lines': 10, 'deleted_lines': 10, 'nloc': 76}, {'timestamp': 1534896611.0, 'added_lines': 10, 'deleted_lines': 10, 'nloc': 76}, {'timestamp': 1535601896.0, 'added_lines': 5, 'deleted_lines': 5, 'nloc': 76}, {'timestamp': 1536388808.0, 'added_lines': 9, 'deleted_lines': 9, 'nloc': 76}, {'timestamp': 1536718784.0, 'added_lines': 10, 'deleted_lines': 10, 'nloc': 76}, {'timestamp': 1536723292.0, 'added_lines': 7, 'deleted_lines': 7, 'nloc': 76}, {'timestamp': 1537790637.0, 'added_lines': 5, 'deleted_lines': 5, 'nloc': 76}, {'timestamp': 1537792589.0, 'added_lines': 10, 'deleted_lines': 10, 'nloc': 76}, {'timestamp': 1538544957.0, 'added_lines': 9, 'deleted_lines': 9, 'nloc': 76}, {'timestamp': 1538694687.0, 'added_lines': 5, 'deleted_lines': 5, 'nloc': 76}, {'timestamp': 1538695953.0, 'added_lines': 5, 'deleted_lines': 5, 'nloc': 76}, {'timestamp': 1538773916.0, 'added_lines': 10, 'deleted_lines': 10, 'nloc': 76}, {'timestamp': 1539176817.0, 'added_lines': 6, 'deleted_lines': 6, 'nloc': 76}, {'timestamp': 1539357340.0, 'added_lines': 5, 'deleted_lines': 5, 'nloc': 76}, {'timestamp': 1539850591.0, 'added_lines': 3, 'deleted_lines': 3, 'nloc': 76}, {'timestamp': 1540400358.0, 'added_lines': 5, 'deleted_lines': 5, 'nloc': 76}, {'timestamp': 1540410565.0, 'added_lines': 5, 'deleted_lines': 5, 'nloc': 76}, {'timestamp': 1540418491.0, 'added_lines': 5, 'deleted_lines': 5, 'nloc': 76}, {'timestamp': 1540603818.0, 'added_lines': 5, 'deleted_lines': 5, 'nloc': 76}, {'timestamp': 1541106379.0, 'added_lines': 3, 'deleted_lines': 3, 'nloc': 76}, {'timestamp': 1541189794.0, 'added_lines': 4, 'deleted_lines': 4, 'nloc': 76}, {'timestamp': 1541204121.0, 'added_lines': 12, 'deleted_lines': 12, 'nloc': 76}, {'timestamp': 1541903826.0, 'added_lines': 9, 'deleted_lines': 9, 'nloc': 76}, {'timestamp': 1543443696.0, 'added_lines': 4, 'deleted_lines': 4, 'nloc': 76}, {'timestamp': 1544225843.0, 'added_lines': 5, 'deleted_lines': 5, 'nloc': 76}, {'timestamp': 1540556089.0, 'added_lines': 3, 'deleted_lines': 3, 'nloc': 76}, {'timestamp': 1547003974.0, 'added_lines': 5, 'deleted_lines': 5, 'nloc': 76}, {'timestamp': 1547499910.0, 'added_lines': 6, 'deleted_lines': 6, 'nloc': 76}, {'timestamp': 1548866534.0, 'added_lines': 3, 'deleted_lines': 3, 'nloc': 76}, {'timestamp': 1549588289.0, 'added_lines': 5, 'deleted_lines': 5, 'nloc': 76}, {'timestamp': 1549903582.0, 'added_lines': 3, 'deleted_lines': 3, 'nloc': 76}, {'timestamp': 1550185115.0, 'added_lines': 5, 'deleted_lines': 5, 'nloc': 76}, {'timestamp': 1550507829.0, 'added_lines': 10, 'deleted_lines': 10, 'nloc': 76}, {'timestamp': 1550711994.0, 'added_lines': 5, 'deleted_lines': 5, 'nloc': 76}, {'timestamp': 1550723346.0, 'added_lines': 10, 'deleted_lines': 10, 'nloc': 76}, {'timestamp': 1551229859.0, 'added_lines': 5, 'deleted_lines': 5, 'nloc': 76}, {'timestamp': 1551299964.0, 'added_lines': 5, 'deleted_lines': 5, 'nloc': 76}, {'timestamp': 1551551196.0, 'added_lines': 14, 'deleted_lines': 14, 'nloc': 76}, {'timestamp': 1553697989.0, 'added_lines': 5, 'deleted_lines': 1, 'nloc': 80}]","{'blocks/blockstore/caching.go': 1, 'blocks/blockstore/util/remove.go': 4, 'cmd/ipfs/daemon.go': 23, 'cmd/ipfs/init.go': 25, 'cmd/ipfs/ipfs.go': 18, 'cmd/ipfs/main.go': 27, 'cmd/ipfs/main_test.go': 2, 'cmd/ipfswatch/main.go': 19, 'cmd/seccat/seccat.go': 25, None: 52, 'commands/channelmarshaler.go': 1, 'commands/cli/cmd_suggestion.go': 1, 'commands/cli/helptext.go': 1, 'commands/cli/helptext_test.go': 1, 'commands/cli/parse.go': 1, 'commands/cli/parse_test.go': 1, 'commands/command.go': 12, 'commands/command_test.go': 3, 'commands/http/client.go': 1, 'commands/http/handler.go': 1, 'commands/http/multifilereader.go': 1, 'commands/http/multifilereader_test.go': 1, 'commands/http/parse.go': 1, 'commands/reqlog.go': 2, 'commands/request.go': 16, 'commands/response.go': 7, 'commands/response_test.go': 3, 'core/bootstrap.go': 23, 'core/commands/active.go': 12, 'core/commands/add.go': 44, 'core/commands/bitswap.go': 47, 'core/commands/block.go': 27, 'core/commands/bootstrap.go': 22, 'core/commands/cat.go': 22, 'core/commands/commands.go': 19, 'core/commands/config.go': 23, 'core/commands/dag/dag.go': 50, 'core/commands/dht.go': 55, 'core/commands/diag.go': 12, 'core/commands/dns.go': 17, 'core/commands/e/error.go': 1, 'core/commands/external.go': 12, 'core/commands/files/files.go': 5, 'core/commands/filestore.go': 23, 'core/commands/get.go': 52, 'core/commands/helptext_test.go': 18, 'core/commands/id.go': 36, 'core/commands/ipns.go': 13, 'core/commands/keystore.go': 22, 'core/commands/log.go': 17, 'core/commands/ls.go': 57, 'core/commands/mount_nofuse.go': 12, 'core/commands/mount_unix.go': 22, 'core/commands/mount_windows.go': 12, 'core/commands/name.go': 5, 'core/commands/object/diff.go': 17, 'core/commands/object/object.go': 54, 'core/commands/object/patch.go': 24, 'core/commands/p2p.go': 26, 'core/commands/pin.go': 56, 'core/commands/ping.go': 30, 'core/commands/publish.go': 14, 'core/commands/pubsub.go': 33, 'core/commands/refs.go': 50, 'core/commands/repo.go': 40, 'core/commands/resolve.go': 46, 'core/commands/root.go': 18, 'core/commands/shutdown.go': 15, 'core/commands/stat.go': 22, 'core/commands/swarm.go': 34, 'core/commands/sysdiag.go': 18, 'core/commands/tar.go': 48, 'core/commands/unixfs/ls.go': 49, 'core/commands/unixfs/unixfs.go': 12, 'core/commands/version.go': 13, 'core/core_test.go': 18, 'core/corehttp/commands.go': 49, 'core/corehttp/gateway.go': 33, 'core/coreunix/add.go': 64, 'core/coreunix/add_test.go': 57, 'exchange/bitswap/bitswap_test.go': 10, 'exchange/bitswap/decision/engine_test.go': 11, 'exchange/bitswap/message/message_test.go': 5, 'exchange/bitswap/message/pb/Makefile': 1, 'exchange/bitswap/testnet/network_test.go': 8, 'exchange/bitswap/testnet/peernet.go': 10, 'exchange/reprovide/reprovide_test.go': 37, 'fuse/ipns/common.go': 47, 'fuse/node/mount_test.go': 31, 'importer/balanced/balanced_test.go': 14, 'importer/chunk/rabin_test.go': 3, 'importer/helpers/dagbuilder.go': 14, 'importer/importer.go': 13, 'merkledag/utils/utils_test.go': 7, 'mfs/repub_test.go': 10, 'namesys/dns.go': 40, 'namesys/interface.go': 41, 'namesys/ipns_select_test.go': 5, 'namesys/proquint.go': 40, 'namesys/republisher/repub_test.go': 46, 'package.json': 61, 'repo/config/identity.go': 3, 'routing/offline/offline_test.go': 4, 'test/integration/addcat_test.go': 34, 'test/integration/bench_cat_test.go': 34, 'test/integration/bitswap_wo_routing_test.go': 36, 'test/integration/three_legged_cat_test.go': 34, 'blocks/blockstore/arc_cache.go': 3, 'blocks/blockstore/arc_cache_test.go': 3, 'blocks/blockstore/blockstore.go': 3, 'blocks/blockstore/blockstore_test.go': 3, 'blocks/blockstore/bloom_cache_test.go': 3, 'blockservice/blockservice_test.go': 11, 'blockservice/test/blocks_test.go': 12, 'core/builder.go': 59, 'core/core.go': 60, 'exchange/bitswap/testutils.go': 10, 'exchange/offline/offline_test.go': 5, 'filestore/filestore.go': 29, 'filestore/filestore_test.go': 49, 'filestore/fsrefstore.go': 29, 'filestore/util.go': 27, 'merkledag/test/utils.go': 13, 'merkledag/utils/utils.go': 14, 'mfs/mfs_test.go': 27, 'namesys/namesys.go': 48, 'namesys/namesys_test.go': 53, 'namesys/publisher.go': 53, 'namesys/publisher_test.go': 32, 'namesys/pubsub.go': 5, 'namesys/pubsub_test.go': 5, 'namesys/republisher/repub.go': 45, 'namesys/resolve_test.go': 46, 'pin/pin.go': 49, 'pin/pin_test.go': 53, 'pin/set_test.go': 51, 'repo/fsrepo/datastores.go': 17, 'repo/fsrepo/fsrepo.go': 25, 'repo/fsrepo/fsrepo_test.go': 20, 'repo/repo.go': 23, 'routing/mock/centralized_client.go': 3, 'routing/mock/centralized_server.go': 3, 'routing/mock/interface.go': 3, 'routing/offline/offline.go': 3, 'thirdparty/datastore2/datastore_closer.go': 3, 'thirdparty/datastore2/delayed.go': 3, 'thirdparty/datastore2/threadsafe.go': 3, 'thirdparty/ds-help/key.go': 3, 'assets/assets.go': 48, 'blocks/blockstore/bloom_cache.go': 2, 'blocks/blocksutil/block_generator.go': 2, 'blockservice/blockservice.go': 10, 'core/bootstrap_test.go': 22, 'core/commands/dht_test.go': 21, 'core/commands/get_test.go': 17, 'core/commands/ipnsps.go': 6, 'core/coreapi/coreapi.go': 24, 'core/coreapi/interface/interface.go': 2, 'core/coreapi/unixfs.go': 50, 'core/coreapi/unixfs_test.go': 41, 'core/coredag/cbor.go': 18, 'core/coredag/dagpb.go': 44, 'core/coredag/dagtransl.go': 14, 'core/coredag/raw.go': 44, 'core/corehttp/corehttp.go': 13, 'core/corehttp/gateway_handler.go': 58, 'core/corehttp/gateway_test.go': 49, 'core/corehttp/metrics_test.go': 30, 'core/corerepo/gc.go': 48, 'core/corerepo/pinning.go': 20, 'core/coreunix/metadata.go': 51, 'core/mock/mock.go': 31, 'core/pathresolver.go': 45, 'exchange/bitswap/bitswap.go': 9, 'exchange/bitswap/decision/bench_test.go': 6, 'exchange/bitswap/decision/engine.go': 9, 'exchange/bitswap/decision/ledger.go': 6, 'exchange/bitswap/decision/peer_request_queue.go': 6, 'exchange/bitswap/decision/peer_request_queue_test.go': 6, 'exchange/bitswap/get.go': 9, 'exchange/bitswap/message/message.go': 6, 'exchange/bitswap/network/interface.go': 6, 'exchange/bitswap/network/ipfs_impl.go': 6, 'exchange/bitswap/notifications/notifications.go': 4, 'exchange/bitswap/notifications/notifications_test.go': 4, 'exchange/bitswap/session.go': 6, 'exchange/bitswap/session_test.go': 6, 'exchange/bitswap/stat.go': 4, 'exchange/bitswap/testnet/interface.go': 5, 'exchange/bitswap/testnet/virtual.go': 7, 'exchange/bitswap/wantlist/wantlist.go': 4, 'exchange/bitswap/wantlist/wantlist_test.go': 4, 'exchange/bitswap/wantmanager.go': 7, 'exchange/bitswap/workers.go': 6, 'exchange/interface.go': 2, 'exchange/offline/offline.go': 4, 'exchange/reprovide/providers.go': 50, 'exchange/reprovide/reprovide.go': 28, 'fuse/ipns/ipns_test.go': 31, 'fuse/ipns/ipns_unix.go': 52, 'fuse/readonly/ipfs_test.go': 59, 'fuse/readonly/readonly_unix.go': 54, 'importer/balanced/builder.go': 5, 'importer/chunk/splitting_test.go': 2, 'importer/helpers/helpers.go': 7, 'importer/importer_test.go': 13, 'importer/trickle/trickle_test.go': 13, 'importer/trickle/trickledag.go': 6, 'merkledag/batch.go': 2, 'merkledag/coding.go': 5, 'merkledag/merkledag.go': 7, 'merkledag/merkledag_test.go': 15, 'merkledag/node.go': 6, 'merkledag/node_test.go': 6, 'merkledag/raw.go': 5, 'merkledag/traverse/traverse.go': 5, 'merkledag/traverse/traverse_test.go': 6, 'merkledag/utils/diff.go': 6, 'merkledag/utils/diffenum.go': 5, 'merkledag/utils/diffenum_test.go': 6, 'mfs/dir.go': 15, 'mfs/file.go': 21, 'mfs/ops.go': 11, 'mfs/system.go': 17, 'namesys/routing.go': 47, 'p2p/p2p.go': 22, 'p2p/registry.go': 9, 'path/path.go': 4, 'path/resolver.go': 4, 'path/resolver_test.go': 4, 'pin/gc/gc.go': 52, 'pin/set.go': 45, 'plugin/ipld.go': 14, 'plugin/loader/initializer.go': 11, 'plugin/plugins/git/git.go': 13, 'repo/config/bootstrap_peers.go': 7, 'repo/config/init.go': 6, 'repo/fsrepo/lock/lock.go': 2, 'repo/fsrepo/serialize/serialize.go': 3, 'repo/mock.go': 17, 'routing/mock/centralized_test.go': 2, 'routing/none/none_client.go': 2, 'tar/format.go': 58, 'test/dependencies/ma-pipe-unidir/main.go': 10, 'test/integration/bench_test.go': 16, 'thirdparty/pollEndpoint/main.go': 13, 'thirdparty/posinfo/posinfo.go': 3, 'unixfs/archive/archive.go': 7, 'unixfs/archive/tar/writer.go': 8, 'unixfs/hamt/hamt.go': 8, 'unixfs/io/dagreader.go': 8, 'unixfs/io/dirbuilder.go': 5, 'unixfs/io/resolve.go': 8, 'unixfs/mod/dagmodifier.go': 14, 'unixfs/mod/dagmodifier_test.go': 4, 'unixfs/test/utils.go': 14, 'commands/legacy/command.go': 10, 'commands/legacy/legacy.go': 10, 'commands/legacy/legacy_test.go': 10, 'commands/legacy/request.go': 10, 'commands/legacy/response.go': 10, 'core/commands/commands_test.go': 16, 'core/coreapi/dag.go': 13, 'core/coreapi/dag_test.go': 3, 'core/coreapi/interface/options/dag.go': 8, 'core/coreapi/key.go': 43, 'core/coreapi/name.go': 45, 'unixfs/io/pbdagreader.go': 7, 'mfs/fd.go': 9, 'unixfs/hamt/hamt_stress_test.go': 6, 'unixfs/hamt/hamt_test.go': 6, 'unixfs/io/dagreader_test.go': 3, 'unixfs/io/dirbuilder_test.go': 1, 'blocks/blockstoreutil/remove.go': 24, 'core/coreapi/block.go': 16, 'blockservice/test/mock.go': 5, 'namesys/ipns_validate_test.go': 3, 'namesys/validator.go': 3, 'core/commands/files.go': 54, 'core/coreapi/pin.go': 47, 'cmd/ipfs/util/ulimit.go': 8, 'cmd/seccat/util.go': 8, 'core/corehttp/logs.go': 8, 'fuse/mount/mount.go': 8, 'fuse/node/mount_unix.go': 9, 'keystore/keystore.go': 8, 'keystore/keystore_test.go': 6, 'keystore/memkeystore.go': 5, 'path/resolver/resolver.go': 5, 'plugin/loader/load.go': 6, 'thirdparty/verifbs/verifbs.go': 23, 'cmd/ipfs/util/ulimit_freebsd.go': 2, 'cmd/ipfs/util/ulimit_unix.go': 2, 'core/coreapi/block_test.go': 2, 'core/coreapi/interface/coreapi.go': 9, 'core/coreapi/interface/dag.go': 9, 'core/coreapi/interface/object.go': 9, 'core/coreapi/interface/options/block.go': 3, 'core/coreapi/interface/path.go': 33, 'core/coreapi/interface/unixfs.go': 13, 'core/coreapi/object.go': 48, 'fuse/ipns/link_unix.go': 2, 'fuse/mount/fuse.go': 3, 'fuse/node/mount_darwin.go': 2, 'merkledag/errservice.go': 2, 'merkledag/readonly.go': 2, 'merkledag/readonly_test.go': 2, 'merkledag/rwservice.go': 2, 'merkledag/session.go': 2, 'path/resolver/resolver_test.go': 3, 'thirdparty/verifcid/validate.go': 2, 'thirdparty/verifcid/validate_test.go': 2, 'namesys/ipns_resolver_validation_test.go': 41, 'test/sharness/t0170-dht.sh': 1, 'core/commands/urlstore.go': 46, 'unixfs/io/directory.go': 3, 'core/corehttp/metrics.go': 2, 'Rules.mk': 1, 'dagutils/diff.go': 41, 'dagutils/diffenum.go': 39, 'dagutils/diffenum_test.go': 39, 'dagutils/utils.go': 40, 'dagutils/utils_test.go': 39, 'unixfs/io/directory_test.go': 2, 'unixfs/unixfs.go': 2, 'core/coreapi/path.go': 45, 'core/coreunix/cat.go': 15, 'unixfs/importer/balanced/balanced_test.go': 1, 'unixfs/importer/balanced/builder.go': 1, 'unixfs/importer/helpers/dagbuilder.go': 1, 'unixfs/importer/helpers/helpers.go': 1, 'unixfs/importer/importer.go': 1, 'unixfs/importer/importer_test.go': 1, 'unixfs/importer/trickle/trickle_test.go': 1, 'unixfs/importer/trickle/trickledag.go': 1, 'unixfs/unixfs_test.go': 1, 'core/coreapi/name_test.go': 30, 'core/pathresolver_test.go': 38, 'namesys/base.go': 39, 'namesys/cache.go': 38, 'core/commands/env.go': 3, 'core/coreapi/interface/key.go': 7, 'filestore/pb/dataobj.pb.go': 3, 'pin/internal/pb/header.pb.go': 3, 'thirdparty/cidv0v1/blockstore.go': 16, 'repo/fsrepo/config_test.go': 13, 'repo/fsrepo/misc.go': 13, 'test/bench/bench_cli_ipfs_add/main.go': 14, 'test/bench/offline_add/main.go': 14, 'core/commands/cmdenv/env.go': 20, 'core/commands/name/ipns.go': 35, 'core/commands/name/publish.go': 19, 'core/coreapi/dht.go': 30, 'core/coreapi/dht_test.go': 5, 'test/sharness/t0275-cid-security.sh': 1, 'core/commands/name/ipnsps.go': 13, 'core/commands/name/name.go': 9, 'core/coreapi/interface/dht.go': 10, 'p2p/listener.go': 13, 'p2p/local.go': 13, 'p2p/remote.go': 14, 'p2p/stream.go': 14, 'core/coreapi/interface/swarm.go': 9, 'core/coreapi/swarm.go': 21, 'core/coreapi/interface/options/unixfs.go': 15, 'core/coreapi/pubsub.go': 19, 'core/coreapi/unixfile.go': 17, 'core/commands/cid.go': 10, 'cmd/ipfs/dnsresolve_test.go': 5, 'core/coreapi/interface/pubsub.go': 4, 'test/dependencies/iptb/iptb.go': 12, 'plugin/plugins/badgerds/badgerds.go': 3, 'plugin/plugins/flatfs/flatfs.go': 3, 'plugin/plugins/levelds/levelds.go': 3, 'commands/context.go': 13, 'core/corehttp/proxy.go': 9, 'core/coreapi/interface/tests/name.go': 4, 'core/coreapi/interface/tests/unixfs.go': 4, 'core/coreapi/test/api_test.go': 10, 'plugin/loader/loader.go': 10, 'core/commands/cmdenv/cidbase.go': 6, 'core/commands/cmdenv/file.go': 3, 'core/corehttp/ipns_hostname.go': 8, 'namesys/dns_test.go': 8, 'plugin/daemon.go': 8, 'core/commands/cmdenv/cidbase_test.go': 2, 'core/corehttp/proxy_test.go': 1, 'core/corerepo/stat.go': 1, 'plugin/tracer.go': 1, 'thirdparty/notifier/notifier.go': 1, 'core/corehttp/mutex_profile.go': 1, 'core/corehttp/option_test.go': 1, 'provider/queue.go': 1, 'provider/queue_test.go': 1}","('core/coreunix/add.go', 0.9696969696969697, 0.5079365079365079)"
core/mock/mock.go,62,345,6,"[{'cyclomatic_complexity': 1, 'nloc': 7, 'token_count': 51, 'name': 'NewMockNode', 'long_name': 'NewMockNode', 'start_line': 24, 'end_line': 32, 'full_parameters': [], 'filename': '/home/dimi/Documents/Informatik_Studium/FSS/SoftEvo/DataCollection/FFS_SoftEvo/go-ipfs/core/mock/mock.go', 'top_nesting_level': 0, 'length': 9, 'fan_in': 0, 'fan_out': 0, 'general_fan_out': 0}, {'cyclomatic_complexity': 1, 'nloc': 3, 'token_count': 64, 'name': '', 'long_name': '(ctx context.Context,id peer.ID,ps pstore.Peerstore,bwr metrics.Reporter,fs[]*net.IPNet,_smux.Transport,_ipnet.Protector,_*core.ConstructPeerHostOpts)(host.Host,error)', 'start_line': 35, 'end_line': 37, 'full_parameters': [], 'filename': '/home/dimi/Documents/Informatik_Studium/FSS/SoftEvo/DataCollection/FFS_SoftEvo/go-ipfs/core/mock/mock.go', 'top_nesting_level': 0, 'length': 3, 'fan_in': 0, 'fan_out': 0, 'general_fan_out': 0}, {'cyclomatic_complexity': 1, 'nloc': 3, 'token_count': 15, 'name': 'MockHostOption', 'long_name': 'MockHostOption mn mocknet . Mocknet', 'start_line': 34, 'end_line': 38, 'full_parameters': ['mn mocknet . Mocknet'], 'filename': '/home/dimi/Documents/Informatik_Studium/FSS/SoftEvo/DataCollection/FFS_SoftEvo/go-ipfs/core/mock/mock.go', 'top_nesting_level': 0, 'length': 5, 'fan_in': 0, 'fan_out': 0, 'general_fan_out': 0}, {'cyclomatic_complexity': 1, 'nloc': 3, 'token_count': 20, 'name': '', 'long_name': '(path string)(*config.Config,error)', 'start_line': 69, 'end_line': 71, 'full_parameters': [], 'filename': '/home/dimi/Documents/Informatik_Studium/FSS/SoftEvo/DataCollection/FFS_SoftEvo/go-ipfs/core/mock/mock.go', 'top_nesting_level': 0, 'length': 3, 'fan_in': 0, 'fan_out': 0, 'general_fan_out': 0}, {'cyclomatic_complexity': 1, 'nloc': 3, 'token_count': 17, 'name': '', 'long_name': '()(*core.IpfsNode,error)', 'start_line': 72, 'end_line': 74, 'full_parameters': [], 'filename': '/home/dimi/Documents/Informatik_Studium/FSS/SoftEvo/DataCollection/FFS_SoftEvo/go-ipfs/core/mock/mock.go', 'top_nesting_level': 0, 'length': 3, 'fan_in': 0, 'fan_out': 0, 'general_fan_out': 0}, {'cyclomatic_complexity': 3, 'nloc': 28, 'token_count': 149, 'name': 'MockCmdsCtx', 'long_name': 'MockCmdsCtx', 'start_line': 40, 'end_line': 76, 'full_parameters': [], 'filename': '/home/dimi/Documents/Informatik_Studium/FSS/SoftEvo/DataCollection/FFS_SoftEvo/go-ipfs/core/mock/mock.go', 'top_nesting_level': 0, 'length': 37, 'fan_in': 0, 'fan_out': 0, 'general_fan_out': 0}]",83,474,7,"[{'cyclomatic_complexity': 1, 'nloc': 7, 'token_count': 51, 'name': 'NewMockNode', 'long_name': 'NewMockNode', 'start_line': 28, 'end_line': 36, 'full_parameters': [], 'filename': '/home/dimi/Documents/Informatik_Studium/FSS/SoftEvo/DataCollection/FFS_SoftEvo/go-ipfs/core/mock/mock.go', 'top_nesting_level': 0, 'length': 9, 'fan_in': 0, 'fan_out': 0, 'general_fan_out': 0}, {'cyclomatic_complexity': 1, 'nloc': 3, 'token_count': 41, 'name': '', 'long_name': '(ctx context.Context,id peer.ID,ps pstore.Peerstore,_...libp2p.Option)(host.Host,error)', 'start_line': 39, 'end_line': 41, 'full_parameters': [], 'filename': '/home/dimi/Documents/Informatik_Studium/FSS/SoftEvo/DataCollection/FFS_SoftEvo/go-ipfs/core/mock/mock.go', 'top_nesting_level': 0, 'length': 3, 'fan_in': 0, 'fan_out': 0, 'general_fan_out': 0}, {'cyclomatic_complexity': 1, 'nloc': 3, 'token_count': 15, 'name': 'MockHostOption', 'long_name': 'MockHostOption mn mocknet . Mocknet', 'start_line': 38, 'end_line': 42, 'full_parameters': ['mn mocknet . Mocknet'], 'filename': '/home/dimi/Documents/Informatik_Studium/FSS/SoftEvo/DataCollection/FFS_SoftEvo/go-ipfs/core/mock/mock.go', 'top_nesting_level': 0, 'length': 5, 'fan_in': 0, 'fan_out': 0, 'general_fan_out': 0}, {'cyclomatic_complexity': 1, 'nloc': 3, 'token_count': 20, 'name': '', 'long_name': '(path string)(*config.Config,error)', 'start_line': 72, 'end_line': 74, 'full_parameters': [], 'filename': '/home/dimi/Documents/Informatik_Studium/FSS/SoftEvo/DataCollection/FFS_SoftEvo/go-ipfs/core/mock/mock.go', 'top_nesting_level': 0, 'length': 3, 'fan_in': 0, 'fan_out': 0, 'general_fan_out': 0}, {'cyclomatic_complexity': 1, 'nloc': 3, 'token_count': 17, 'name': '', 'long_name': '()(*core.IpfsNode,error)', 'start_line': 75, 'end_line': 77, 'full_parameters': [], 'filename': '/home/dimi/Documents/Informatik_Studium/FSS/SoftEvo/DataCollection/FFS_SoftEvo/go-ipfs/core/mock/mock.go', 'top_nesting_level': 0, 'length': 3, 'fan_in': 0, 'fan_out': 0, 'general_fan_out': 0}, {'cyclomatic_complexity': 3, 'nloc': 27, 'token_count': 150, 'name': 'MockCmdsCtx', 'long_name': 'MockCmdsCtx', 'start_line': 44, 'end_line': 79, 'full_parameters': [], 'filename': '/home/dimi/Documents/Informatik_Studium/FSS/SoftEvo/DataCollection/FFS_SoftEvo/go-ipfs/core/mock/mock.go', 'top_nesting_level': 0, 'length': 36, 'fan_in': 0, 'fan_out': 0, 'general_fan_out': 0}, {'cyclomatic_complexity': 2, 'nloc': 21, 'token_count': 154, 'name': 'MockPublicNode', 'long_name': 'MockPublicNode ctx context . Context , mn mocknet . Mocknet', 'start_line': 81, 'end_line': 101, 'full_parameters': ['ctx context . Context', ' mn mocknet . Mocknet'], 'filename': '/home/dimi/Documents/Informatik_Studium/FSS/SoftEvo/DataCollection/FFS_SoftEvo/go-ipfs/core/mock/mock.go', 'top_nesting_level': 0, 'length': 21, 'fan_in': 0, 'fan_out': 0, 'general_fan_out': 0}]",21,129,1,58,58,"[{'timestamp': 1507212616.0, 'added_lines': 1, 'deleted_lines': 1, 'nloc': 62}, {'timestamp': 1507304579.0, 'added_lines': 3, 'deleted_lines': 3, 'nloc': 62}, {'timestamp': 1508424715.0, 'added_lines': 1, 'deleted_lines': 1, 'nloc': 62}, {'timestamp': 1511223906.0, 'added_lines': 5, 'deleted_lines': 5, 'nloc': 62}, {'timestamp': 1512365669.0, 'added_lines': 7, 'deleted_lines': 7, 'nloc': 62}, {'timestamp': 1516838128.0, 'added_lines': 7, 'deleted_lines': 7, 'nloc': 62}, {'timestamp': 1517105039.0, 'added_lines': 1, 'deleted_lines': 1, 'nloc': 62}, {'timestamp': 1517453697.0, 'added_lines': 7, 'deleted_lines': 7, 'nloc': 62}, {'timestamp': 1519765635.0, 'added_lines': 5, 'deleted_lines': 3, 'nloc': 63}, {'timestamp': 1520599808.0, 'added_lines': 1, 'deleted_lines': 2, 'nloc': 63}, {'timestamp': 1525408792.0, 'added_lines': 9, 'deleted_lines': 9, 'nloc': 63}, {'timestamp': 1528131220.0, 'added_lines': 2, 'deleted_lines': 2, 'nloc': 63}, {'timestamp': 1520489177.0, 'added_lines': 2, 'deleted_lines': 5, 'nloc': 60}, {'timestamp': 1528268108.0, 'added_lines': 4, 'deleted_lines': 4, 'nloc': 60}, {'timestamp': 1528520460.0, 'added_lines': 6, 'deleted_lines': 6, 'nloc': 60}, {'timestamp': 1529984485.0, 'added_lines': 6, 'deleted_lines': 6, 'nloc': 60}, {'timestamp': 1532146078.0, 'added_lines': 2, 'deleted_lines': 2, 'nloc': 60}, {'timestamp': 1533779477.0, 'added_lines': 6, 'deleted_lines': 6, 'nloc': 60}, {'timestamp': 1532365899.0, 'added_lines': 1, 'deleted_lines': 1, 'nloc': 60}, {'timestamp': 1532388583.0, 'added_lines': 1, 'deleted_lines': 1, 'nloc': 60}, {'timestamp': 1533809170.0, 'added_lines': 1, 'deleted_lines': 1, 'nloc': 60}, {'timestamp': 1534195762.0, 'added_lines': 2, 'deleted_lines': 2, 'nloc': 60}, {'timestamp': 1534072974.0, 'added_lines': 1, 'deleted_lines': 1, 'nloc': 60}, {'timestamp': 1534896611.0, 'added_lines': 7, 'deleted_lines': 7, 'nloc': 60}, {'timestamp': 1535255498.0, 'added_lines': 1, 'deleted_lines': 1, 'nloc': 60}, {'timestamp': 1535601896.0, 'added_lines': 4, 'deleted_lines': 4, 'nloc': 60}, {'timestamp': 1536388808.0, 'added_lines': 7, 'deleted_lines': 7, 'nloc': 60}, {'timestamp': 1537792589.0, 'added_lines': 9, 'deleted_lines': 9, 'nloc': 60}, {'timestamp': 1538544957.0, 'added_lines': 7, 'deleted_lines': 7, 'nloc': 60}, {'timestamp': 1538547366.0, 'added_lines': 1, 'deleted_lines': 1, 'nloc': 60}, {'timestamp': 1538695953.0, 'added_lines': 2, 'deleted_lines': 2, 'nloc': 60}, {'timestamp': 1538773916.0, 'added_lines': 6, 'deleted_lines': 6, 'nloc': 60}, {'timestamp': 1539176817.0, 'added_lines': 4, 'deleted_lines': 4, 'nloc': 60}, {'timestamp': 1539357340.0, 'added_lines': 2, 'deleted_lines': 2, 'nloc': 60}, {'timestamp': 1540400358.0, 'added_lines': 7, 'deleted_lines': 7, 'nloc': 60}, {'timestamp': 1540410565.0, 'added_lines': 2, 'deleted_lines': 2, 'nloc': 60}, {'timestamp': 1540418491.0, 'added_lines': 2, 'deleted_lines': 2, 'nloc': 60}, {'timestamp': 1540489644.0, 'added_lines': 1, 'deleted_lines': 1, 'nloc': 60}, {'timestamp': 1541204121.0, 'added_lines': 7, 'deleted_lines': 7, 'nloc': 60}, {'timestamp': 1541903826.0, 'added_lines': 6, 'deleted_lines': 6, 'nloc': 60}, {'timestamp': 1543282933.0, 'added_lines': 1, 'deleted_lines': 1, 'nloc': 60}, {'timestamp': 1544225843.0, 'added_lines': 7, 'deleted_lines': 7, 'nloc': 60}, {'timestamp': 1545323704.0, 'added_lines': 1, 'deleted_lines': 1, 'nloc': 60}, {'timestamp': 1546553605.0, 'added_lines': 1, 'deleted_lines': 1, 'nloc': 60}, {'timestamp': 1547003974.0, 'added_lines': 6, 'deleted_lines': 6, 'nloc': 60}, {'timestamp': 1549588289.0, 'added_lines': 7, 'deleted_lines': 7, 'nloc': 60}, {'timestamp': 1550185115.0, 'added_lines': 2, 'deleted_lines': 2, 'nloc': 60}, {'timestamp': 1550507829.0, 'added_lines': 9, 'deleted_lines': 9, 'nloc': 60}, {'timestamp': 1550723346.0, 'added_lines': 2, 'deleted_lines': 2, 'nloc': 60}, {'timestamp': 1551229859.0, 'added_lines': 7, 'deleted_lines': 7, 'nloc': 60}, {'timestamp': 1551299964.0, 'added_lines': 2, 'deleted_lines': 2, 'nloc': 60}, {'timestamp': 1551754061.0, 'added_lines': 0, 'deleted_lines': 1, 'nloc': 59}, {'timestamp': 1551551196.0, 'added_lines': 9, 'deleted_lines': 9, 'nloc': 59}, {'timestamp': 1554255872.0, 'added_lines': 2, 'deleted_lines': 1, 'nloc': 60}, {'timestamp': 1556015751.0, 'added_lines': 7, 'deleted_lines': 7, 'nloc': 60}, {'timestamp': 1559060517.0, 'added_lines': 7, 'deleted_lines': 4, 'nloc': 60}, {'timestamp': 1584668316.0, 'added_lines': 23, 'deleted_lines': 0, 'nloc': 82}, {'timestamp': 1586493622.0, 'added_lines': 2, 'deleted_lines': 1, 'nloc': 83}]","{'core/bootstrap_test.go': 37, 'core/commands/dht_test.go': 26, 'exchange/bitswap/bitswap_test.go': 14, 'exchange/bitswap/decision/bench_test.go': 9, 'exchange/bitswap/decision/engine_test.go': 10, 'exchange/bitswap/decision/peer_request_queue_test.go': 9, 'exchange/bitswap/testnet/interface.go': 9, 'exchange/bitswap/testnet/network_test.go': 11, 'exchange/bitswap/testnet/peernet.go': 14, 'exchange/bitswap/testnet/virtual.go': 11, 'exchange/bitswap/testutils.go': 14, 'exchange/reprovide/reprovide_test.go': 31, 'fuse/ipns/ipns_test.go': 30, 'fuse/node/mount_test.go': 30, 'fuse/readonly/ipfs_test.go': 35, 'mfs/repub_test.go': 10, 'namesys/publisher_test.go': 31, 'namesys/resolve_test.go': 37, 'package.json': 49, 'routing/mock/centralized_client.go': 6, 'routing/mock/centralized_server.go': 6, 'routing/mock/centralized_test.go': 6, 'routing/mock/interface.go': 6, 'routing/offline/offline_test.go': 6, 'test/integration/addcat_test.go': 40, 'test/integration/bench_cat_test.go': 40, 'test/integration/bench_test.go': 21, 'test/integration/grandcentral_test.go': 1, 'test/integration/three_legged_cat_test.go': 41, 'core/bootstrap.go': 38, 'core/commands/dht.go': 38, 'core/commands/id.go': 38, 'core/commands/pubsub.go': 27, 'core/core.go': 52, 'core/corehttp/gateway.go': 38, 'core/corehttp/gateway_test.go': 50, 'core/corehttp/metrics_test.go': 39, 'exchange/bitswap/network/ipfs_impl.go': 11, 'namesys/republisher/repub_test.go': 41, 'p2p/p2p.go': 28, 'routing/none/none_client.go': 5, 'test/integration/bitswap_wo_routing_test.go': 39, 'thirdparty/ipfsaddr/ipfsaddr.go': 2, 'core/commands/swarm.go': 45, 'cmd/ipfs/daemon.go': 23, 'cmd/ipfs/init.go': 31, 'cmd/ipfs/ipfs.go': 15, 'cmd/ipfs/main.go': 34, 'cmd/ipfs/main_test.go': 2, 'cmd/ipfswatch/main.go': 27, 'cmd/seccat/seccat.go': 28, 'commands/cli/helptext.go': 1, 'commands/cli/helptext_test.go': 1, 'commands/cli/parse.go': 1, 'commands/cli/parse_test.go': 1, 'commands/command.go': 12, 'commands/command_test.go': 5, 'commands/http/client.go': 1, 'commands/http/handler.go': 1, 'commands/http/multifilereader.go': 1, 'commands/http/multifilereader_test.go': 1, 'commands/http/parse.go': 1, 'commands/request.go': 24, 'commands/response.go': 7, 'commands/response_test.go': 5, 'core/commands/active.go': 7, 'core/commands/add.go': 24, 'core/commands/bitswap.go': 34, 'core/commands/block.go': 18, 'core/commands/bootstrap.go': 27, 'core/commands/cat.go': 18, 'core/commands/commands.go': 15, 'core/commands/config.go': 27, 'core/commands/dag/dag.go': 30, 'core/commands/diag.go': 7, 'core/commands/dns.go': 12, 'core/commands/external.go': 8, 'core/commands/files/files.go': 4, 'core/commands/filestore.go': 16, 'core/commands/get.go': 32, 'core/commands/get_test.go': 15, 'core/commands/helptext_test.go': 15, 'core/commands/ipns.go': 10, 'core/commands/keystore.go': 17, 'core/commands/log.go': 13, 'core/commands/ls.go': 31, 'core/commands/mount_nofuse.go': 7, 'core/commands/mount_unix.go': 27, 'core/commands/name.go': 4, 'core/commands/object/diff.go': 11, 'core/commands/object/object.go': 31, 'core/commands/object/patch.go': 16, 'core/commands/p2p.go': 21, 'core/commands/pin.go': 32, 'core/commands/ping.go': 28, 'core/commands/publish.go': 10, 'core/commands/refs.go': 29, 'core/commands/repo.go': 38, 'core/commands/resolve.go': 28, 'core/commands/root.go': 15, 'core/commands/shutdown.go': 10, 'core/commands/stat.go': 21, 'core/commands/sysdiag.go': 15, 'core/commands/tar.go': 28, 'core/commands/unixfs/ls.go': 28, 'core/commands/unixfs/unixfs.go': 7, 'core/commands/version.go': 9, 'core/corehttp/commands.go': 43, 'core/coreunix/add.go': 33, 'core/coreunix/add_test.go': 43, 'exchange/bitswap/message/message.go': 8, 'exchange/bitswap/network/interface.go': 8, 'importer/helpers/dagbuilder.go': 6, 'importer/importer.go': 6, 'p2p/registry.go': 12, 'repo/config/bootstrap_peers.go': 12, 'assets/assets.go': 27, 'blocks/blockstore/arc_cache.go': 2, 'blocks/blockstore/arc_cache_test.go': 2, 'blocks/blockstore/blockstore.go': 3, 'blocks/blockstore/blockstore_test.go': 2, 'blocks/blockstore/bloom_cache.go': 2, 'blocks/blockstore/bloom_cache_test.go': 2, 'blocks/blockstore/util/remove.go': 2, 'blocks/blocksutil/block_generator.go': 2, 'blockservice/blockservice.go': 7, 'blockservice/blockservice_test.go': 6, 'blockservice/test/blocks_test.go': 6, 'core/builder.go': 45, 'core/commands/ipnsps.go': 5, 'core/commands/mount_windows.go': 6, 'core/coreapi/coreapi.go': 19, 'core/coreapi/interface/interface.go': 2, 'core/coreapi/unixfs.go': 28, 'core/coreapi/unixfs_test.go': 33, 'core/coredag/cbor.go': 9, 'core/coredag/dagpb.go': 28, 'core/coredag/dagtransl.go': 7, 'core/coredag/raw.go': 28, 'core/corehttp/corehttp.go': 16, 'core/corehttp/gateway_handler.go': 33, 'core/corerepo/gc.go': 30, 'core/corerepo/pinning.go': 10, 'core/coreunix/metadata.go': 28, 'core/coreunix/metadata_test.go': 31, 'core/pathresolver.go': 31, 'exchange/bitswap/bitswap.go': 7, 'exchange/bitswap/decision/engine.go': 7, 'exchange/bitswap/decision/ledger.go': 6, 'exchange/bitswap/decision/peer_request_queue.go': 6, 'exchange/bitswap/get.go': 6, 'exchange/bitswap/message/message_test.go': 3, 'exchange/bitswap/notifications/notifications.go': 3, 'exchange/bitswap/notifications/notifications_test.go': 3, 'exchange/bitswap/session.go': 7, 'exchange/bitswap/session_test.go': 5, 'exchange/bitswap/stat.go': 3, 'exchange/bitswap/wantlist/wantlist.go': 3, 'exchange/bitswap/wantlist/wantlist_test.go': 3, 'exchange/bitswap/wantmanager.go': 7, 'exchange/bitswap/workers.go': 6, 'exchange/interface.go': 2, 'exchange/offline/offline.go': 2, 'exchange/offline/offline_test.go': 2, 'exchange/reprovide/providers.go': 31, 'exchange/reprovide/reprovide.go': 24, 'filestore/filestore.go': 19, 'filestore/filestore_test.go': 31, 'filestore/fsrefstore.go': 18, 'filestore/util.go': 18, 'fuse/ipns/ipns_unix.go': 32, 'fuse/readonly/readonly_unix.go': 32, 'importer/balanced/balanced_test.go': 5, 'importer/balanced/builder.go': 3, 'importer/chunk/rabin_test.go': 2, 'importer/chunk/splitting_test.go': 2, 'importer/helpers/helpers.go': 3, 'importer/importer_test.go': 5, 'importer/trickle/trickle_test.go': 5, 'importer/trickle/trickledag.go': 3, 'merkledag/batch.go': 2, 'merkledag/coding.go': 3, 'merkledag/merkledag.go': 3, 'merkledag/merkledag_test.go': 6, 'merkledag/node.go': 3, 'merkledag/node_test.go': 3, 'merkledag/raw.go': 3, 'merkledag/traverse/traverse.go': 3, 'merkledag/traverse/traverse_test.go': 3, 'merkledag/utils/diff.go': 3, 'merkledag/utils/diffenum.go': 3, 'merkledag/utils/diffenum_test.go': 3, 'merkledag/utils/utils.go': 6, 'merkledag/utils/utils_test.go': 3, 'mfs/dir.go': 5, 'mfs/file.go': 7, 'mfs/mfs_test.go': 8, 'mfs/ops.go': 5, 'mfs/system.go': 8, 'namesys/ipns_select_test.go': 4, 'namesys/namesys.go': 34, 'namesys/publisher.go': 33, 'namesys/pubsub.go': 5, 'namesys/pubsub_test.go': 5, 'namesys/republisher/repub.go': 32, 'namesys/routing.go': 35, 'path/path.go': 3, 'path/resolver.go': 3, 'path/resolver_test.go': 2, 'pin/gc/gc.go': 32, 'pin/pin.go': 31, 'pin/pin_test.go': 31, 'pin/set.go': 28, 'pin/set_test.go': 31, 'plugin/ipld.go': 7, 'plugin/loader/initializer.go': 5, 'plugin/plugins/git/git.go': 7, 'repo/config/init.go': 7, 'repo/fsrepo/fsrepo.go': 34, 'repo/fsrepo/lock/lock.go': 3, 'repo/fsrepo/serialize/serialize.go': 3, 'repo/mock.go': 27, 'repo/repo.go': 31, 'routing/offline/offline.go': 3, 'tar/format.go': 31, 'test/dependencies/ma-pipe-unidir/main.go': 10, 'thirdparty/ds-help/key.go': 2, 'thirdparty/pollEndpoint/main.go': 15, 'thirdparty/posinfo/posinfo.go': 2, 'unixfs/archive/archive.go': 3, 'unixfs/archive/tar/writer.go': 3, 'unixfs/hamt/hamt.go': 3, 'unixfs/io/dagreader.go': 3, 'unixfs/io/dirbuilder.go': 3, 'unixfs/io/resolve.go': 3, 'unixfs/mod/dagmodifier.go': 5, 'unixfs/mod/dagmodifier_test.go': 3, 'unixfs/test/utils.go': 5, 'commands/legacy/command.go': 10, 'commands/legacy/legacy.go': 10, 'commands/legacy/legacy_test.go': 10, 'commands/legacy/request.go': 10, 'commands/legacy/response.go': 10, 'core/commands/commands_test.go': 13, 'core/coreapi/dag.go': 6, 'core/coreapi/dag_test.go': 3, 'core/coreapi/interface/options/dag.go': 4, 'core/coreapi/key.go': 31, 'core/coreapi/name.go': 33, 'merkledag/test/utils.go': 5, 'namesys/namesys_test.go': 32, 'repo/fsrepo/datastores.go': 16, 'repo/fsrepo/fsrepo_test.go': 28, 'thirdparty/datastore2/datastore_closer.go': 1, 'thirdparty/datastore2/delayed.go': 1, 'thirdparty/datastore2/threadsafe.go': 1, 'unixfs/io/pbdagreader.go': 2, 'cmd/ipfs/util/ulimit.go': 9, 'cmd/seccat/util.go': 10, 'core/corehttp/logs.go': 9, 'fuse/mount/mount.go': 9, 'fuse/node/mount_unix.go': 9, 'importer/chunk/splitting.go': 1, 'namesys/ipns_validate_test.go': 5, 'plugin/loader/load.go': 7, 'core/core_test.go': 28, 'repo/fsrepo/config_test.go': 24, None: 2, 'blocks/blockstoreutil/remove.go': 16, 'blockservice/test/mock.go': 5, 'core/commands/files.go': 29, 'core/coreapi/pin.go': 29, 'fuse/ipns/common.go': 27, 'keystore/keystore.go': 9, 'keystore/keystore_test.go': 6, 'keystore/memkeystore.go': 6, 'namesys/interface.go': 27, 'namesys/validator.go': 3, 'path/resolver/resolver.go': 3, 'repo/config/identity.go': 2, 'thirdparty/verifbs/verifbs.go': 16, 'cmd/ipfs/util/ulimit_freebsd.go': 2, 'cmd/ipfs/util/ulimit_unix.go': 2, 'core/coreapi/block.go': 9, 'core/coreapi/block_test.go': 2, 'core/coreapi/interface/coreapi.go': 3, 'core/coreapi/interface/dag.go': 3, 'core/coreapi/interface/object.go': 3, 'core/coreapi/interface/options/block.go': 2, 'core/coreapi/interface/path.go': 20, 'core/coreapi/interface/unixfs.go': 4, 'core/coreapi/object.go': 26, 'fuse/ipns/link_unix.go': 2, 'fuse/mount/fuse.go': 2, 'fuse/node/mount_darwin.go': 2, 'merkledag/errservice.go': 1, 'merkledag/readonly.go': 1, 'merkledag/readonly_test.go': 1, 'merkledag/rwservice.go': 1, 'merkledag/session.go': 1, 'path/resolver/resolver_test.go': 1, 'thirdparty/verifcid/validate.go': 1, 'thirdparty/verifcid/validate_test.go': 1, 'unixfs/hamt/hamt_stress_test.go': 1, 'unixfs/hamt/hamt_test.go': 1, 'namesys/ipns_resolver_validation_test.go': 27, 'test/sharness/t0170-dht.sh': 1, 'core/corehttp/metrics.go': 2, 'core/commands/env.go': 6, 'core/commands/urlstore.go': 25, 'core/coreapi/interface/key.go': 7, 'core/coreapi/name_test.go': 17, 'core/coreapi/path.go': 25, 'core/coreunix/cat.go': 6, 'core/pathresolver_test.go': 25, 'dagutils/diff.go': 25, 'dagutils/diffenum.go': 25, 'dagutils/diffenum_test.go': 25, 'dagutils/utils.go': 25, 'dagutils/utils_test.go': 25, 'filestore/pb/dataobj.pb.go': 3, 'mfs/fd.go': 2, 'namesys/base.go': 25, 'namesys/cache.go': 25, 'namesys/dns.go': 25, 'namesys/proquint.go': 25, 'pin/internal/pb/header.pb.go': 3, 'thirdparty/cidv0v1/blockstore.go': 12, 'cmd/ipfs/Rules.mk': 1, 'core/corehttp/option_test.go': 1, 'docs/releases.md': 1, 'docs/windows.md': 1, 'repo/fsrepo/misc.go': 23, 'repo/version.go': 1, 'test/bench/bench_cli_ipfs_add/main.go': 23, 'test/bench/offline_add/main.go': 23, 'core/commands/cmdenv/env.go': 21, 'core/commands/name/ipns.go': 22, 'core/commands/name/publish.go': 11, 'core/commands/name/ipnsps.go': 10, 'core/commands/name/name.go': 5, 'core/coreapi/dht.go': 21, 'core/coreapi/dht_test.go': 4, 'core/coreapi/interface/dht.go': 10, 'p2p/listener.go': 14, 'p2p/local.go': 14, 'p2p/remote.go': 14, 'p2p/stream.go': 14, 'core/coreapi/interface/swarm.go': 9, 'core/coreapi/swarm.go': 19, 'core/coreapi/interface/options/unixfs.go': 11, 'core/coreapi/pubsub.go': 18, 'core/coreapi/unixfile.go': 10, 'cmd/ipfs/dnsresolve_test.go': 5, 'core/coreapi/interface/pubsub.go': 4, 'test/sharness/t0180-pubsub.sh': 1, 'core/commands/cid.go': 5, 'test/dependencies/iptb/iptb.go': 14, 'plugin/plugins/badgerds/badgerds.go': 3, 'plugin/plugins/flatfs/flatfs.go': 3, 'plugin/plugins/levelds/levelds.go': 3, 'commands/context.go': 12, 'core/corehttp/proxy.go': 10, 'core/coreapi/test/api_test.go': 13, 'core/coreapi/interface/tests/name.go': 2, 'core/coreapi/interface/tests/unixfs.go': 2, 'core/corehttp/ipns_hostname.go': 6, 'namesys/dns_test.go': 6, 'plugin/daemon.go': 6, 'plugin/loader/loader.go': 6, 'core/commands/cmdenv/cidbase.go': 4, 'core/commands/cmdenv/cidbase_test.go': 2, 'core/commands/cmdenv/file.go': 1, 'core/corehttp/proxy_test.go': 2, 'core/corerepo/stat.go': 1, 'plugin/tracer.go': 1, 'thirdparty/notifier/notifier.go': 1, 'core/bootstrap/bootstrap.go': 2, 'core/bootstrap/bootstrap_test.go': 2, 'core/ncore.go': 1, 'core/node/builder.go': 3, 'core/node/core.go': 3, 'core/node/discovery.go': 1, 'core/node/groups.go': 3, 'core/node/helpers.go': 2, 'core/node/identity.go': 2, 'core/node/ipns.go': 2, 'core/node/libp2p.go': 1, 'core/node/provider.go': 3, 'core/node/storage.go': 2, 'core/node/helpers/helpers.go': 1, 'core/node/libp2p/discovery.go': 2, 'core/node/libp2p/libp2p.go': 2, 'core/node/libp2p/addrs.go': 1, 'core/node/libp2p/host.go': 1, 'core/node/libp2p/hostopt.go': 1, 'core/node/libp2p/nat.go': 1, 'core/node/libp2p/pnet.go': 1, 'core/node/libp2p/pubsub.go': 1, 'core/node/libp2p/routing.go': 1, 'core/node/libp2p/routingopt.go': 1, 'core/node/libp2p/smux.go': 1, 'core/node/libp2p/transport.go': 1, 'go.mod': 1, 'go.sum': 1, 'provider/simple/provider.go': 1, 'provider/simple/provider_test.go': 1, 'provider/simple/reprovide.go': 1, 'provider/simple/reprovide_test.go': 1}","('core/core.go', 0.896551724137931, 0.2905027932960894)"
coverage/main/main.go,61,382,2,"[{'cyclomatic_complexity': 2, 'nloc': 5, 'token_count': 18, 'name': '', 'long_name': '()', 'start_line': 47, 'end_line': 51, 'full_parameters': [], 'filename': '/home/dimi/Documents/Informatik_Studium/FSS/SoftEvo/DataCollection/FFS_SoftEvo/go-ipfs/coverage/main/main.go', 'top_nesting_level': 0, 'length': 5, 'fan_in': 0, 'fan_out': 0, 'general_fan_out': 0}, {'cyclomatic_complexity': 7, 'nloc': 47, 'token_count': 353, 'name': 'main', 'long_name': 'main', 'start_line': 15, 'end_line': 72, 'full_parameters': [], 'filename': '/home/dimi/Documents/Informatik_Studium/FSS/SoftEvo/DataCollection/FFS_SoftEvo/go-ipfs/coverage/main/main.go', 'top_nesting_level': 0, 'length': 58, 'fan_in': 0, 'fan_out': 0, 'general_fan_out': 0}]",69,427,2,"[{'cyclomatic_complexity': 2, 'nloc': 6, 'token_count': 21, 'name': '', 'long_name': '()', 'start_line': 48, 'end_line': 53, 'full_parameters': [], 'filename': '/home/dimi/Documents/Informatik_Studium/FSS/SoftEvo/DataCollection/FFS_SoftEvo/go-ipfs/coverage/main/main.go', 'top_nesting_level': 0, 'length': 6, 'fan_in': 0, 'fan_out': 0, 'general_fan_out': 0}, {'cyclomatic_complexity': 8, 'nloc': 54, 'token_count': 395, 'name': 'main', 'long_name': 'main', 'start_line': 15, 'end_line': 83, 'full_parameters': [], 'filename': '/home/dimi/Documents/Informatik_Studium/FSS/SoftEvo/DataCollection/FFS_SoftEvo/go-ipfs/coverage/main/main.go', 'top_nesting_level': 0, 'length': 69, 'fan_in': 0, 'fan_out': 0, 'general_fan_out': 0}]",8,45,0,1,1,"[{'timestamp': 1554401444.0, 'added_lines': 13, 'deleted_lines': 2, 'nloc': 69}]",{},"('core/core.go', 0.0, 0.0)"
fuse/ipns/common.go,28,151,1,"[{'cyclomatic_complexity': 4, 'nloc': 19, 'token_count': 135, 'name': 'InitializeKeyspace', 'long_name': 'InitializeKeyspace n * core . IpfsNode , key ci . PrivKey', 'start_line': 15, 'end_line': 38, 'full_parameters': ['n * core . IpfsNode', ' key ci . PrivKey'], 'filename': '/home/dimi/Documents/Informatik_Studium/FSS/SoftEvo/DataCollection/FFS_SoftEvo/go-ipfs/fuse/ipns/common.go', 'top_nesting_level': 0, 'length': 24, 'fan_in': 0, 'fan_out': 0, 'general_fan_out': 0}]",24,135,1,"[{'cyclomatic_complexity': 3, 'nloc': 15, 'token_count': 120, 'name': 'InitializeKeyspace', 'long_name': 'InitializeKeyspace n * core . IpfsNode , key ci . PrivKey', 'start_line': 15, 'end_line': 34, 'full_parameters': ['n * core . IpfsNode', ' key ci . PrivKey'], 'filename': '/home/dimi/Documents/Informatik_Studium/FSS/SoftEvo/DataCollection/FFS_SoftEvo/go-ipfs/fuse/ipns/common.go', 'top_nesting_level': 0, 'length': 20, 'fan_in': 0, 'fan_out': 0, 'general_fan_out': 0}]",-4,-16,0,54,54,"[{'timestamp': 1491058697.0, 'added_lines': 1, 'deleted_lines': 1, 'nloc': 28}, {'timestamp': 1512356285.0, 'added_lines': 4, 'deleted_lines': 8, 'nloc': 24}, {'timestamp': 1525408792.0, 'added_lines': 1, 'deleted_lines': 1, 'nloc': 24}, {'timestamp': 1525870558.0, 'added_lines': 1, 'deleted_lines': 1, 'nloc': 24}, {'timestamp': 1532847462.0, 'added_lines': 1, 'deleted_lines': 1, 'nloc': 24}, {'timestamp': 1532986515.0, 'added_lines': 1, 'deleted_lines': 1, 'nloc': 24}, {'timestamp': 1533500571.0, 'added_lines': 2, 'deleted_lines': 2, 'nloc': 24}, {'timestamp': 1533618653.0, 'added_lines': 2, 'deleted_lines': 2, 'nloc': 24}, {'timestamp': 1533779477.0, 'added_lines': 3, 'deleted_lines': 3, 'nloc': 24}, {'timestamp': 1533946888.0, 'added_lines': 1, 'deleted_lines': 1, 'nloc': 24}, {'timestamp': 1534115707.0, 'added_lines': 2, 'deleted_lines': 2, 'nloc': 24}, {'timestamp': 1534195762.0, 'added_lines': 2, 'deleted_lines': 2, 'nloc': 24}, {'timestamp': 1534347022.0, 'added_lines': 2, 'deleted_lines': 2, 'nloc': 24}, {'timestamp': 1534896611.0, 'added_lines': 2, 'deleted_lines': 2, 'nloc': 24}, {'timestamp': 1535601896.0, 'added_lines': 2, 'deleted_lines': 2, 'nloc': 24}, {'timestamp': 1536388808.0, 'added_lines': 2, 'deleted_lines': 2, 'nloc': 24}, {'timestamp': 1536718784.0, 'added_lines': 2, 'deleted_lines': 2, 'nloc': 24}, {'timestamp': 1536723292.0, 'added_lines': 2, 'deleted_lines': 2, 'nloc': 24}, {'timestamp': 1537790637.0, 'added_lines': 2, 'deleted_lines': 2, 'nloc': 24}, {'timestamp': 1537792589.0, 'added_lines': 2, 'deleted_lines': 2, 'nloc': 24}, {'timestamp': 1538544957.0, 'added_lines': 2, 'deleted_lines': 2, 'nloc': 24}, {'timestamp': 1538694687.0, 'added_lines': 2, 'deleted_lines': 2, 'nloc': 24}, {'timestamp': 1538695953.0, 'added_lines': 2, 'deleted_lines': 2, 'nloc': 24}, {'timestamp': 1538773916.0, 'added_lines': 2, 'deleted_lines': 2, 'nloc': 24}, {'timestamp': 1539176817.0, 'added_lines': 2, 'deleted_lines': 2, 'nloc': 24}, {'timestamp': 1539357340.0, 'added_lines': 2, 'deleted_lines': 2, 'nloc': 24}, {'timestamp': 1539850591.0, 'added_lines': 1, 'deleted_lines': 1, 'nloc': 24}, {'timestamp': 1540400358.0, 'added_lines': 2, 'deleted_lines': 2, 'nloc': 24}, {'timestamp': 1540410565.0, 'added_lines': 2, 'deleted_lines': 2, 'nloc': 24}, {'timestamp': 1540418491.0, 'added_lines': 2, 'deleted_lines': 2, 'nloc': 24}, {'timestamp': 1540603818.0, 'added_lines': 2, 'deleted_lines': 2, 'nloc': 24}, {'timestamp': 1540916861.0, 'added_lines': 1, 'deleted_lines': 1, 'nloc': 24}, {'timestamp': 1541106379.0, 'added_lines': 1, 'deleted_lines': 1, 'nloc': 24}, {'timestamp': 1541189794.0, 'added_lines': 2, 'deleted_lines': 2, 'nloc': 24}, {'timestamp': 1541204121.0, 'added_lines': 3, 'deleted_lines': 3, 'nloc': 24}, {'timestamp': 1541903826.0, 'added_lines': 2, 'deleted_lines': 2, 'nloc': 24}, {'timestamp': 1543443696.0, 'added_lines': 2, 'deleted_lines': 2, 'nloc': 24}, {'timestamp': 1544225843.0, 'added_lines': 2, 'deleted_lines': 2, 'nloc': 24}, {'timestamp': 1540556089.0, 'added_lines': 1, 'deleted_lines': 1, 'nloc': 24}, {'timestamp': 1547003974.0, 'added_lines': 2, 'deleted_lines': 2, 'nloc': 24}, {'timestamp': 1547499910.0, 'added_lines': 2, 'deleted_lines': 2, 'nloc': 24}, {'timestamp': 1548866534.0, 'added_lines': 1, 'deleted_lines': 1, 'nloc': 24}, {'timestamp': 1549588289.0, 'added_lines': 2, 'deleted_lines': 2, 'nloc': 24}, {'timestamp': 1549903582.0, 'added_lines': 1, 'deleted_lines': 1, 'nloc': 24}, {'timestamp': 1550185115.0, 'added_lines': 2, 'deleted_lines': 2, 'nloc': 24}, {'timestamp': 1550507829.0, 'added_lines': 3, 'deleted_lines': 3, 'nloc': 24}, {'timestamp': 1550711994.0, 'added_lines': 2, 'deleted_lines': 2, 'nloc': 24}, {'timestamp': 1550723346.0, 'added_lines': 2, 'deleted_lines': 2, 'nloc': 24}, {'timestamp': 1551229859.0, 'added_lines': 2, 'deleted_lines': 2, 'nloc': 24}, {'timestamp': 1551299964.0, 'added_lines': 2, 'deleted_lines': 2, 'nloc': 24}, {'timestamp': 1551551196.0, 'added_lines': 3, 'deleted_lines': 3, 'nloc': 24}, {'timestamp': 1559060517.0, 'added_lines': 1, 'deleted_lines': 1, 'nloc': 24}, {'timestamp': 1568549682.0, 'added_lines': 1, 'deleted_lines': 1, 'nloc': 24}, {'timestamp': 1613691223.0, 'added_lines': 1, 'deleted_lines': 1, 'nloc': 24}]","{'blocks/blockstore/caching.go': 1, 'blocks/blockstore/util/remove.go': 1, 'cmd/ipfs/daemon.go': 17, 'cmd/ipfs/init.go': 24, 'cmd/ipfs/ipfs.go': 14, 'cmd/ipfs/main.go': 22, 'cmd/ipfs/main_test.go': 1, 'cmd/ipfswatch/main.go': 16, 'cmd/seccat/seccat.go': 21, None: 36, 'commands/channelmarshaler.go': 1, 'commands/cli/cmd_suggestion.go': 1, 'commands/cli/helptext.go': 1, 'commands/cli/helptext_test.go': 1, 'commands/cli/parse.go': 1, 'commands/cli/parse_test.go': 1, 'commands/command.go': 8, 'commands/command_test.go': 1, 'commands/http/client.go': 1, 'commands/http/handler.go': 1, 'commands/http/multifilereader.go': 1, 'commands/http/multifilereader_test.go': 1, 'commands/http/parse.go': 1, 'commands/reqlog.go': 1, 'commands/request.go': 12, 'commands/response.go': 4, 'commands/response_test.go': 1, 'core/bootstrap.go': 19, 'core/commands/active.go': 10, 'core/commands/add.go': 32, 'core/commands/bitswap.go': 43, 'core/commands/block.go': 20, 'core/commands/bootstrap.go': 20, 'core/commands/cat.go': 18, 'core/commands/commands.go': 14, 'core/commands/config.go': 20, 'core/commands/dag/dag.go': 46, 'core/commands/dht.go': 48, 'core/commands/diag.go': 10, 'core/commands/dns.go': 17, 'core/commands/e/error.go': 1, 'core/commands/external.go': 10, 'core/commands/files/files.go': 1, 'core/commands/filestore.go': 18, 'core/commands/get.go': 48, 'core/commands/helptext_test.go': 14, 'core/commands/id.go': 32, 'core/commands/ipns.go': 9, 'core/commands/keystore.go': 18, 'core/commands/log.go': 14, 'core/commands/ls.go': 47, 'core/commands/mount_nofuse.go': 10, 'core/commands/mount_unix.go': 20, 'core/commands/mount_windows.go': 10, 'core/commands/name.go': 3, 'core/commands/object/diff.go': 16, 'core/commands/object/object.go': 47, 'core/commands/object/patch.go': 20, 'core/commands/p2p.go': 22, 'core/commands/pin.go': 48, 'core/commands/ping.go': 27, 'core/commands/publish.go': 11, 'core/commands/pubsub.go': 26, 'core/commands/refs.go': 46, 'core/commands/repo.go': 31, 'core/commands/resolve.go': 47, 'core/commands/root.go': 14, 'core/commands/shutdown.go': 13, 'core/commands/stat.go': 19, 'core/commands/swarm.go': 29, 'core/commands/sysdiag.go': 14, 'core/commands/tar.go': 46, 'core/commands/unixfs/ls.go': 47, 'core/commands/unixfs/unixfs.go': 10, 'core/commands/version.go': 11, 'core/core_test.go': 18, 'core/corehttp/commands.go': 47, 'core/corehttp/gateway.go': 28, 'core/coreunix/add.go': 49, 'core/coreunix/add_test.go': 45, 'core/coreunix/metadata_test.go': 47, 'exchange/bitswap/bitswap_test.go': 2, 'exchange/bitswap/decision/engine_test.go': 2, 'exchange/bitswap/message/message_test.go': 1, 'exchange/bitswap/message/pb/Makefile': 1, 'exchange/bitswap/testnet/network_test.go': 2, 'exchange/bitswap/testnet/peernet.go': 2, 'exchange/reprovide/reprovide_test.go': 27, 'fuse/node/mount_test.go': 26, 'importer/balanced/balanced_test.go': 2, 'importer/chunk/rabin_test.go': 1, 'importer/helpers/dagbuilder.go': 2, 'importer/importer.go': 2, 'merkledag/utils/utils_test.go': 1, 'mfs/repub_test.go': 5, 'namesys/dns.go': 43, 'namesys/interface.go': 44, 'namesys/ipns_select_test.go': 2, 'namesys/proquint.go': 43, 'namesys/republisher/repub_test.go': 44, 'package.json': 48, 'repo/config/identity.go': 3, 'routing/offline/offline_test.go': 1, 'test/integration/addcat_test.go': 29, 'test/integration/bench_cat_test.go': 29, 'test/integration/bitswap_wo_routing_test.go': 29, 'test/integration/three_legged_cat_test.go': 29, 'assets/assets.go': 45, 'namesys/publisher.go': 52, 'blocks/blockstoreutil/remove.go': 19, 'blockservice/blockservice.go': 1, 'blockservice/blockservice_test.go': 1, 'blockservice/test/blocks_test.go': 1, 'blockservice/test/mock.go': 1, 'cmd/ipfs/util/ulimit.go': 6, 'cmd/seccat/util.go': 6, 'commands/legacy/command.go': 7, 'commands/legacy/legacy.go': 7, 'commands/legacy/legacy_test.go': 7, 'commands/legacy/request.go': 7, 'commands/legacy/response.go': 7, 'core/bootstrap_test.go': 18, 'core/builder.go': 48, 'core/commands/commands_test.go': 13, 'core/commands/dht_test.go': 19, 'core/commands/files.go': 48, 'core/commands/get_test.go': 13, 'core/core.go': 50, 'core/coreapi/key.go': 43, 'core/coreapi/name.go': 45, 'core/coreapi/pin.go': 41, 'core/coreapi/unixfs_test.go': 34, 'core/corehttp/corehttp.go': 9, 'core/corehttp/gateway_handler.go': 49, 'core/corehttp/gateway_test.go': 45, 'core/corehttp/logs.go': 6, 'core/corehttp/metrics_test.go': 26, 'core/corerepo/gc.go': 42, 'core/mock/mock.go': 27, 'core/pathresolver.go': 41, 'exchange/bitswap/bitswap.go': 1, 'exchange/bitswap/decision/bench_test.go': 1, 'exchange/bitswap/decision/engine.go': 1, 'exchange/bitswap/decision/ledger.go': 1, 'exchange/bitswap/decision/peer_request_queue.go': 1, 'exchange/bitswap/decision/peer_request_queue_test.go': 1, 'exchange/bitswap/get.go': 1, 'exchange/bitswap/message/message.go': 1, 'exchange/bitswap/network/interface.go': 1, 'exchange/bitswap/network/ipfs_impl.go': 1, 'exchange/bitswap/session.go': 1, 'exchange/bitswap/session_test.go': 1, 'exchange/bitswap/testnet/interface.go': 1, 'exchange/bitswap/testnet/virtual.go': 1, 'exchange/bitswap/testutils.go': 1, 'exchange/bitswap/wantmanager.go': 1, 'exchange/bitswap/workers.go': 1, 'exchange/reprovide/providers.go': 39, 'exchange/reprovide/reprovide.go': 22, 'filestore/filestore.go': 20, 'filestore/filestore_test.go': 39, 'filestore/fsrefstore.go': 20, 'filestore/util.go': 18, 'fuse/ipns/ipns_test.go': 25, 'fuse/ipns/ipns_unix.go': 49, 'fuse/mount/mount.go': 6, 'fuse/node/mount_unix.go': 6, 'fuse/readonly/ipfs_test.go': 47, 'fuse/readonly/readonly_unix.go': 48, 'importer/importer_test.go': 1, 'importer/trickle/trickle_test.go': 1, 'keystore/keystore.go': 7, 'keystore/keystore_test.go': 6, 'keystore/memkeystore.go': 6, 'merkledag/merkledag_test.go': 1, 'merkledag/test/utils.go': 1, 'merkledag/utils/utils.go': 1, 'mfs/file.go': 9, 'mfs/mfs_test.go': 10, 'mfs/system.go': 9, 'namesys/ipns_validate_test.go': 2, 'namesys/namesys.go': 44, 'namesys/namesys_test.go': 50, 'namesys/publisher_test.go': 26, 'namesys/pubsub.go': 1, 'namesys/pubsub_test.go': 1, 'namesys/republisher/repub.go': 42, 'namesys/resolve_test.go': 43, 'namesys/routing.go': 44, 'namesys/validator.go': 1, 'p2p/p2p.go': 19, 'p2p/registry.go': 5, 'path/resolver/resolver.go': 1, 'pin/gc/gc.go': 40, 'pin/pin.go': 40, 'pin/pin_test.go': 40, 'pin/set_test.go': 39, 'plugin/loader/load.go': 4, 'repo/config/bootstrap_peers.go': 2, 'repo/config/init.go': 2, 'repo/fsrepo/datastores.go': 11, 'repo/fsrepo/fsrepo.go': 19, 'repo/fsrepo/fsrepo_test.go': 17, 'repo/repo.go': 18, 'tar/format.go': 48, 'test/integration/bench_test.go': 13, 'thirdparty/pollEndpoint/main.go': 9, 'thirdparty/verifbs/verifbs.go': 18, 'unixfs/mod/dagmodifier.go': 2, 'unixfs/test/utils.go': 2, 'namesys/base.go': 42, 'namesys/cache.go': 41, 'core/coreapi/interface/path.go': 33, 'core/coreapi/name_test.go': 32, 'core/coreapi/path.go': 48, 'core/corerepo/pinning.go': 17, 'core/coreunix/cat.go': 16, 'core/pathresolver_test.go': 40, 'dagutils/utils.go': 40, 'dagutils/utils_test.go': 40, 'mfs/ops.go': 7, 'namesys/ipns_resolver_validation_test.go': 42, 'core/commands/urlstore.go': 45, 'core/coreapi/object.go': 46, 'core/coreapi/unixfs.go': 46, 'core/coreunix/metadata.go': 45, 'mfs/dir.go': 8, 'mfs/fd.go': 8, 'unixfs/archive/archive.go': 1, 'unixfs/archive/tar/writer.go': 1, 'unixfs/hamt/hamt.go': 1, 'unixfs/hamt/hamt_stress_test.go': 1, 'unixfs/hamt/hamt_test.go': 1, 'unixfs/importer/balanced/balanced_test.go': 1, 'unixfs/importer/balanced/builder.go': 1, 'unixfs/importer/helpers/dagbuilder.go': 1, 'unixfs/importer/helpers/helpers.go': 1, 'unixfs/importer/importer.go': 1, 'unixfs/importer/importer_test.go': 1, 'unixfs/importer/trickle/trickle_test.go': 1, 'unixfs/importer/trickle/trickledag.go': 1, 'unixfs/io/dagreader.go': 1, 'unixfs/io/dagreader_test.go': 1, 'unixfs/io/directory.go': 1, 'unixfs/io/directory_test.go': 1, 'unixfs/io/pbdagreader.go': 1, 'unixfs/io/resolve.go': 1, 'unixfs/mod/dagmodifier_test.go': 1, 'unixfs/unixfs.go': 1, 'unixfs/unixfs_test.go': 1, 'core/coredag/dagpb.go': 38, 'core/coredag/raw.go': 38, 'dagutils/diff.go': 39, 'dagutils/diffenum.go': 38, 'dagutils/diffenum_test.go': 38, 'pin/set.go': 38, 'core/commands/env.go': 3, 'core/commands/ipnsps.go': 3, 'core/coreapi/interface/key.go': 7, 'filestore/pb/dataobj.pb.go': 3, 'pin/internal/pb/header.pb.go': 3, 'thirdparty/cidv0v1/blockstore.go': 16, 'core/coreapi/block.go': 14, 'core/coreapi/dag.go': 10, 'core/coreapi/interface/coreapi.go': 7, 'core/coreapi/interface/dag.go': 7, 'core/coreapi/interface/object.go': 7, 'core/coreapi/interface/options/dag.go': 5, 'core/coreapi/interface/unixfs.go': 11, 'core/coredag/cbor.go': 13, 'core/coredag/dagtransl.go': 9, 'plugin/ipld.go': 9, 'plugin/loader/initializer.go': 6, 'plugin/plugins/git/git.go': 9, 'repo/fsrepo/config_test.go': 13, 'repo/fsrepo/misc.go': 13, 'repo/mock.go': 14, 'test/bench/bench_cli_ipfs_add/main.go': 13, 'test/bench/offline_add/main.go': 13, 'core/commands/cmdenv/env.go': 20, 'core/commands/name/ipns.go': 37, 'core/commands/name/publish.go': 19, 'core/coreapi/dht.go': 31, 'core/coreapi/dht_test.go': 5, 'core/coreapi/interface/options/block.go': 2, 'test/sharness/t0275-cid-security.sh': 1, 'core/commands/name/ipnsps.go': 14, 'core/commands/name/name.go': 9, 'core/coreapi/interface/dht.go': 10, 'p2p/listener.go': 14, 'p2p/local.go': 14, 'p2p/remote.go': 14, 'p2p/stream.go': 14, 'core/coreapi/interface/swarm.go': 9, 'core/coreapi/swarm.go': 21, 'core/coreapi/interface/options/unixfs.go': 15, 'core/coreapi/pubsub.go': 19, 'core/coreapi/unixfile.go': 17, 'core/commands/cid.go': 9, 'cmd/ipfs/dnsresolve_test.go': 5, 'core/coreapi/coreapi.go': 22, 'core/coreapi/interface/pubsub.go': 4, 'test/dependencies/ma-pipe-unidir/main.go': 5, 'core/coreapi/block_test.go': 1, 'core/coreapi/dag_test.go': 1, 'test/dependencies/iptb/iptb.go': 12, 'plugin/plugins/badgerds/badgerds.go': 3, 'plugin/plugins/flatfs/flatfs.go': 3, 'plugin/plugins/levelds/levelds.go': 3, 'commands/context.go': 13, 'core/corehttp/proxy.go': 10, 'core/coreapi/interface/tests/name.go': 4, 'core/coreapi/interface/tests/unixfs.go': 4, 'core/coreapi/test/api_test.go': 12, 'plugin/loader/loader.go': 9, 'core/commands/cmdenv/cidbase.go': 6, 'core/commands/cmdenv/file.go': 3, 'core/corehttp/ipns_hostname.go': 8, 'namesys/dns_test.go': 8, 'plugin/daemon.go': 8, 'core/commands/cmdenv/cidbase_test.go': 2, 'cmd/ipfs/util/ulimit_freebsd.go': 1, 'cmd/ipfs/util/ulimit_unix.go': 1, 'core/corehttp/metrics.go': 1, 'core/corehttp/proxy_test.go': 2, 'core/corerepo/stat.go': 1, 'fuse/ipns/link_unix.go': 1, 'fuse/mount/fuse.go': 1, 'fuse/node/mount_darwin.go': 1, 'plugin/tracer.go': 1, 'thirdparty/notifier/notifier.go': 1, 'core/bootstrap/bootstrap.go': 1, 'core/bootstrap/bootstrap_test.go': 1, 'core/node/builder.go': 1, 'core/node/core.go': 1, 'core/node/groups.go': 1, 'core/node/identity.go': 1, 'core/node/ipns.go': 2, 'core/node/libp2p/addrs.go': 1, 'core/node/libp2p/discovery.go': 1, 'core/node/libp2p/host.go': 1, 'core/node/libp2p/hostopt.go': 1, 'core/node/libp2p/libp2p.go': 1, 'core/node/libp2p/nat.go': 1, 'core/node/libp2p/pnet.go': 1, 'core/node/libp2p/pubsub.go': 1, 'core/node/libp2p/routing.go': 1, 'core/node/libp2p/routingopt.go': 1, 'core/node/libp2p/smux.go': 1, 'core/node/libp2p/transport.go': 1, 'core/node/provider.go': 1, 'go.mod': 3, 'go.sum': 3, 'provider/simple/provider.go': 1, 'provider/simple/provider_test.go': 1, 'provider/simple/reprovide.go': 1, 'provider/simple/reprovide_test.go': 1, 'core/corehttp/hostname.go': 1}","('core/core.go', 0.9259259259259259, 0.27932960893854747)"
fuse/ipns/ipns_test.go,384,2408,23,"[{'cyclomatic_complexity': 2, 'nloc': 5, 'token_count': 25, 'name': 'maybeSkipFuseTests', 'long_name': 'maybeSkipFuseTests t * testing . T', 'start_line': 26, 'end_line': 30, 'full_parameters': ['t * testing . T'], 'filename': '/home/dimi/Documents/Informatik_Studium/FSS/SoftEvo/DataCollection/FFS_SoftEvo/go-ipfs/fuse/ipns/ipns_test.go', 'top_nesting_level': 0, 'length': 5, 'fan_in': 0, 'fan_out': 0, 'general_fan_out': 0}, {'cyclomatic_complexity': 1, 'nloc': 5, 'token_count': 33, 'name': 'randBytes', 'long_name': 'randBytes size int', 'start_line': 32, 'end_line': 36, 'full_parameters': ['size int'], 'filename': '/home/dimi/Documents/Informatik_Studium/FSS/SoftEvo/DataCollection/FFS_SoftEvo/go-ipfs/fuse/ipns/ipns_test.go', 'top_nesting_level': 0, 'length': 5, 'fan_in': 0, 'fan_out': 0, 'general_fan_out': 0}, {'cyclomatic_complexity': 2, 'nloc': 6, 'token_count': 38, 'name': 'mkdir', 'long_name': 'mkdir t * testing . T , path string', 'start_line': 38, 'end_line': 43, 'full_parameters': ['t * testing . T', ' path string'], 'filename': '/home/dimi/Documents/Informatik_Studium/FSS/SoftEvo/DataCollection/FFS_SoftEvo/go-ipfs/fuse/ipns/ipns_test.go', 'top_nesting_level': 0, 'length': 6, 'fan_in': 0, 'fan_out': 0, 'general_fan_out': 0}, {'cyclomatic_complexity': 1, 'nloc': 3, 'token_count': 32, 'name': 'writeFile', 'long_name': 'writeFile t * testing . T , size int , path string', 'start_line': 45, 'end_line': 47, 'full_parameters': ['t * testing . T', ' size int', ' path string'], 'filename': '/home/dimi/Documents/Informatik_Studium/FSS/SoftEvo/DataCollection/FFS_SoftEvo/go-ipfs/fuse/ipns/ipns_test.go', 'top_nesting_level': 0, 'length': 3, 'fan_in': 0, 'fan_out': 0, 'general_fan_out': 0}, {'cyclomatic_complexity': 5, 'nloc': 18, 'token_count': 102, 'name': 'writeFileData', 'long_name': 'writeFileData t * testing . T , data [ ] byte , path string', 'start_line': 49, 'end_line': 70, 'full_parameters': ['t * testing . T', ' data [ ] byte', ' path string'], 'filename': '/home/dimi/Documents/Informatik_Studium/FSS/SoftEvo/DataCollection/FFS_SoftEvo/go-ipfs/fuse/ipns/ipns_test.go', 'top_nesting_level': 0, 'length': 22, 'fan_in': 0, 'fan_out': 0, 'general_fan_out': 0}, {'cyclomatic_complexity': 4, 'nloc': 12, 'token_count': 77, 'name': 'verifyFile', 'long_name': 'verifyFile t * testing . T , path string , wantData [ ] byte', 'start_line': 72, 'end_line': 83, 'full_parameters': ['t * testing . T', ' path string', ' wantData [ ] byte'], 'filename': '/home/dimi/Documents/Informatik_Studium/FSS/SoftEvo/DataCollection/FFS_SoftEvo/go-ipfs/fuse/ipns/ipns_test.go', 'top_nesting_level': 0, 'length': 12, 'fan_in': 0, 'fan_out': 0, 'general_fan_out': 0}, {'cyclomatic_complexity': 2, 'nloc': 6, 'token_count': 36, 'name': 'checkExists', 'long_name': 'checkExists t * testing . T , path string', 'start_line': 85, 'end_line': 90, 'full_parameters': ['t * testing . T', ' path string'], 'filename': '/home/dimi/Documents/Informatik_Studium/FSS/SoftEvo/DataCollection/FFS_SoftEvo/go-ipfs/fuse/ipns/ipns_test.go', 'top_nesting_level': 0, 'length': 6, 'fan_in': 0, 'fan_out': 0, 'general_fan_out': 0}, {'cyclomatic_complexity': 2, 'nloc': 7, 'token_count': 38, 'name': 'closeMount', 'long_name': 'closeMount mnt * mountWrap', 'start_line': 92, 'end_line': 98, 'full_parameters': ['mnt * mountWrap'], 'filename': '/home/dimi/Documents/Informatik_Studium/FSS/SoftEvo/DataCollection/FFS_SoftEvo/go-ipfs/fuse/ipns/ipns_test.go', 'top_nesting_level': 0, 'length': 7, 'fan_in': 0, 'fan_out': 0, 'general_fan_out': 0}, {'cyclomatic_complexity': 1, 'nloc': 5, 'token_count': 28, 'name': 'Close', 'long_name': '(m*mountWrap)Close', 'start_line': 105, 'end_line': 109, 'full_parameters': [], 'filename': '/home/dimi/Documents/Informatik_Studium/FSS/SoftEvo/DataCollection/FFS_SoftEvo/go-ipfs/fuse/ipns/ipns_test.go', 'top_nesting_level': 0, 'length': 5, 'fan_in': 0, 'fan_out': 0, 'general_fan_out': 0}, {'cyclomatic_complexity': 7, 'nloc': 32, 'token_count': 219, 'name': 'setupIpnsTest', 'long_name': 'setupIpnsTest t * testing . T , node * core . IpfsNode', 'start_line': 111, 'end_line': 148, 'full_parameters': ['t * testing . T', ' node * core . IpfsNode'], 'filename': '/home/dimi/Documents/Informatik_Studium/FSS/SoftEvo/DataCollection/FFS_SoftEvo/go-ipfs/fuse/ipns/ipns_test.go', 'top_nesting_level': 0, 'length': 38, 'fan_in': 0, 'fan_out': 0, 'general_fan_out': 0}, {'cyclomatic_complexity': 3, 'nloc': 13, 'token_count': 80, 'name': 'TestIpnsLocalLink', 'long_name': 'TestIpnsLocalLink t * testing . T', 'start_line': 150, 'end_line': 165, 'full_parameters': ['t * testing . T'], 'filename': '/home/dimi/Documents/Informatik_Studium/FSS/SoftEvo/DataCollection/FFS_SoftEvo/go-ipfs/fuse/ipns/ipns_test.go', 'top_nesting_level': 0, 'length': 16, 'fan_in': 0, 'fan_out': 0, 'general_fan_out': 0}, {'cyclomatic_complexity': 4, 'nloc': 16, 'token_count': 96, 'name': 'TestIpnsBasicIO', 'long_name': 'TestIpnsBasicIO t * testing . T', 'start_line': 168, 'end_line': 186, 'full_parameters': ['t * testing . T'], 'filename': '/home/dimi/Documents/Informatik_Studium/FSS/SoftEvo/DataCollection/FFS_SoftEvo/go-ipfs/fuse/ipns/ipns_test.go', 'top_nesting_level': 0, 'length': 19, 'fan_in': 0, 'fan_out': 0, 'general_fan_out': 0}, {'cyclomatic_complexity': 4, 'nloc': 19, 'token_count': 132, 'name': 'TestFilePersistence', 'long_name': 'TestFilePersistence t * testing . T', 'start_line': 189, 'end_line': 212, 'full_parameters': ['t * testing . T'], 'filename': '/home/dimi/Documents/Informatik_Studium/FSS/SoftEvo/DataCollection/FFS_SoftEvo/go-ipfs/fuse/ipns/ipns_test.go', 'top_nesting_level': 0, 'length': 24, 'fan_in': 0, 'fan_out': 0, 'general_fan_out': 0}, {'cyclomatic_complexity': 1, 'nloc': 23, 'token_count': 216, 'name': 'TestMultipleDirs', 'long_name': 'TestMultipleDirs t * testing . T', 'start_line': 214, 'end_line': 249, 'full_parameters': ['t * testing . T'], 'filename': '/home/dimi/Documents/Informatik_Studium/FSS/SoftEvo/DataCollection/FFS_SoftEvo/go-ipfs/fuse/ipns/ipns_test.go', 'top_nesting_level': 0, 'length': 36, 'fan_in': 0, 'fan_out': 0, 'general_fan_out': 0}, {'cyclomatic_complexity': 4, 'nloc': 16, 'token_count': 101, 'name': 'TestFileSizeReporting', 'long_name': 'TestFileSizeReporting t * testing . T', 'start_line': 252, 'end_line': 270, 'full_parameters': ['t * testing . T'], 'filename': '/home/dimi/Documents/Informatik_Studium/FSS/SoftEvo/DataCollection/FFS_SoftEvo/go-ipfs/fuse/ipns/ipns_test.go', 'top_nesting_level': 0, 'length': 19, 'fan_in': 0, 'fan_out': 0, 'general_fan_out': 0}, {'cyclomatic_complexity': 4, 'nloc': 16, 'token_count': 91, 'name': 'TestDoubleEntryFailure', 'long_name': 'TestDoubleEntryFailure t * testing . T', 'start_line': 273, 'end_line': 290, 'full_parameters': ['t * testing . T'], 'filename': '/home/dimi/Documents/Informatik_Studium/FSS/SoftEvo/DataCollection/FFS_SoftEvo/go-ipfs/fuse/ipns/ipns_test.go', 'top_nesting_level': 0, 'length': 18, 'fan_in': 0, 'fan_out': 0, 'general_fan_out': 0}, {'cyclomatic_complexity': 8, 'nloc': 33, 'token_count': 200, 'name': 'TestAppendFile', 'long_name': 'TestAppendFile t * testing . T', 'start_line': 292, 'end_line': 331, 'full_parameters': ['t * testing . T'], 'filename': '/home/dimi/Documents/Informatik_Studium/FSS/SoftEvo/DataCollection/FFS_SoftEvo/go-ipfs/fuse/ipns/ipns_test.go', 'top_nesting_level': 0, 'length': 40, 'fan_in': 0, 'fan_out': 0, 'general_fan_out': 0}, {'cyclomatic_complexity': 2, 'nloc': 7, 'token_count': 58, 'name': '', 'long_name': '(n int)', 'start_line': 355, 'end_line': 361, 'full_parameters': [], 'filename': '/home/dimi/Documents/Informatik_Studium/FSS/SoftEvo/DataCollection/FFS_SoftEvo/go-ipfs/fuse/ipns/ipns_test.go', 'top_nesting_level': 0, 'length': 7, 'fan_in': 0, 'fan_out': 0, 'general_fan_out': 0}, {'cyclomatic_complexity': 6, 'nloc': 27, 'token_count': 181, 'name': 'TestConcurrentWrites', 'long_name': 'TestConcurrentWrites t * testing . T', 'start_line': 333, 'end_line': 370, 'full_parameters': ['t * testing . T'], 'filename': '/home/dimi/Documents/Informatik_Studium/FSS/SoftEvo/DataCollection/FFS_SoftEvo/go-ipfs/fuse/ipns/ipns_test.go', 'top_nesting_level': 0, 'length': 38, 'fan_in': 0, 'fan_out': 0, 'general_fan_out': 0}, {'cyclomatic_complexity': 3, 'nloc': 17, 'token_count': 109, 'name': '', 'long_name': '(worker int)', 'start_line': 397, 'end_line': 414, 'full_parameters': [], 'filename': '/home/dimi/Documents/Informatik_Studium/FSS/SoftEvo/DataCollection/FFS_SoftEvo/go-ipfs/fuse/ipns/ipns_test.go', 'top_nesting_level': 0, 'length': 18, 'fan_in': 0, 'fan_out': 0, 'general_fan_out': 0}, {'cyclomatic_complexity': 2, 'nloc': 14, 'token_count': 100, 'name': '', 'long_name': '(worker int)', 'start_line': 420, 'end_line': 435, 'full_parameters': [], 'filename': '/home/dimi/Documents/Informatik_Studium/FSS/SoftEvo/DataCollection/FFS_SoftEvo/go-ipfs/fuse/ipns/ipns_test.go', 'top_nesting_level': 0, 'length': 16, 'fan_in': 0, 'fan_out': 0, 'general_fan_out': 0}, {'cyclomatic_complexity': 7, 'nloc': 35, 'token_count': 202, 'name': 'TestFSThrash', 'long_name': 'TestFSThrash t * testing . T', 'start_line': 372, 'end_line': 449, 'full_parameters': ['t * testing . T'], 'filename': '/home/dimi/Documents/Informatik_Studium/FSS/SoftEvo/DataCollection/FFS_SoftEvo/go-ipfs/fuse/ipns/ipns_test.go', 'top_nesting_level': 0, 'length': 78, 'fan_in': 0, 'fan_out': 0, 'general_fan_out': 0}, {'cyclomatic_complexity': 8, 'nloc': 30, 'token_count': 177, 'name': 'TestMultiWrite', 'long_name': 'TestMultiWrite t * testing . T', 'start_line': 452, 'end_line': 487, 'full_parameters': ['t * testing . T'], 'filename': '/home/dimi/Documents/Informatik_Studium/FSS/SoftEvo/DataCollection/FFS_SoftEvo/go-ipfs/fuse/ipns/ipns_test.go', 'top_nesting_level': 0, 'length': 36, 'fan_in': 0, 'fan_out': 0, 'general_fan_out': 0}]",401,2466,23,"[{'cyclomatic_complexity': 2, 'nloc': 5, 'token_count': 25, 'name': 'maybeSkipFuseTests', 'long_name': 'maybeSkipFuseTests t * testing . T', 'start_line': 27, 'end_line': 31, 'full_parameters': ['t * testing . T'], 'filename': '/home/dimi/Documents/Informatik_Studium/FSS/SoftEvo/DataCollection/FFS_SoftEvo/go-ipfs/fuse/ipns/ipns_test.go', 'top_nesting_level': 0, 'length': 5, 'fan_in': 0, 'fan_out': 0, 'general_fan_out': 0}, {'cyclomatic_complexity': 2, 'nloc': 8, 'token_count': 49, 'name': 'randBytes', 'long_name': 'randBytes size int', 'start_line': 33, 'end_line': 40, 'full_parameters': ['size int'], 'filename': '/home/dimi/Documents/Informatik_Studium/FSS/SoftEvo/DataCollection/FFS_SoftEvo/go-ipfs/fuse/ipns/ipns_test.go', 'top_nesting_level': 0, 'length': 8, 'fan_in': 0, 'fan_out': 0, 'general_fan_out': 0}, {'cyclomatic_complexity': 2, 'nloc': 6, 'token_count': 38, 'name': 'mkdir', 'long_name': 'mkdir t * testing . T , path string', 'start_line': 42, 'end_line': 47, 'full_parameters': ['t * testing . T', ' path string'], 'filename': '/home/dimi/Documents/Informatik_Studium/FSS/SoftEvo/DataCollection/FFS_SoftEvo/go-ipfs/fuse/ipns/ipns_test.go', 'top_nesting_level': 0, 'length': 6, 'fan_in': 0, 'fan_out': 0, 'general_fan_out': 0}, {'cyclomatic_complexity': 2, 'nloc': 7, 'token_count': 44, 'name': 'writeFileOrFail', 'long_name': 'writeFileOrFail t * testing . T , size int , path string', 'start_line': 49, 'end_line': 55, 'full_parameters': ['t * testing . T', ' size int', ' path string'], 'filename': '/home/dimi/Documents/Informatik_Studium/FSS/SoftEvo/DataCollection/FFS_SoftEvo/go-ipfs/fuse/ipns/ipns_test.go', 'top_nesting_level': 0, 'length': 7, 'fan_in': 0, 'fan_out': 0, 'general_fan_out': 0}, {'cyclomatic_complexity': 1, 'nloc': 5, 'token_count': 40, 'name': 'writeFile', 'long_name': 'writeFile size int , path string', 'start_line': 57, 'end_line': 61, 'full_parameters': ['size int', ' path string'], 'filename': '/home/dimi/Documents/Informatik_Studium/FSS/SoftEvo/DataCollection/FFS_SoftEvo/go-ipfs/fuse/ipns/ipns_test.go', 'top_nesting_level': 0, 'length': 5, 'fan_in': 0, 'fan_out': 0, 'general_fan_out': 0}, {'cyclomatic_complexity': 4, 'nloc': 12, 'token_count': 77, 'name': 'verifyFile', 'long_name': 'verifyFile t * testing . T , path string , wantData [ ] byte', 'start_line': 63, 'end_line': 74, 'full_parameters': ['t * testing . T', ' path string', ' wantData [ ] byte'], 'filename': '/home/dimi/Documents/Informatik_Studium/FSS/SoftEvo/DataCollection/FFS_SoftEvo/go-ipfs/fuse/ipns/ipns_test.go', 'top_nesting_level': 0, 'length': 12, 'fan_in': 0, 'fan_out': 0, 'general_fan_out': 0}, {'cyclomatic_complexity': 2, 'nloc': 6, 'token_count': 36, 'name': 'checkExists', 'long_name': 'checkExists t * testing . T , path string', 'start_line': 76, 'end_line': 81, 'full_parameters': ['t * testing . T', ' path string'], 'filename': '/home/dimi/Documents/Informatik_Studium/FSS/SoftEvo/DataCollection/FFS_SoftEvo/go-ipfs/fuse/ipns/ipns_test.go', 'top_nesting_level': 0, 'length': 6, 'fan_in': 0, 'fan_out': 0, 'general_fan_out': 0}, {'cyclomatic_complexity': 2, 'nloc': 7, 'token_count': 38, 'name': 'closeMount', 'long_name': 'closeMount mnt * mountWrap', 'start_line': 83, 'end_line': 89, 'full_parameters': ['mnt * mountWrap'], 'filename': '/home/dimi/Documents/Informatik_Studium/FSS/SoftEvo/DataCollection/FFS_SoftEvo/go-ipfs/fuse/ipns/ipns_test.go', 'top_nesting_level': 0, 'length': 7, 'fan_in': 0, 'fan_out': 0, 'general_fan_out': 0}, {'cyclomatic_complexity': 1, 'nloc': 5, 'token_count': 28, 'name': 'Close', 'long_name': '(m*mountWrap)Close', 'start_line': 96, 'end_line': 100, 'full_parameters': [], 'filename': '/home/dimi/Documents/Informatik_Studium/FSS/SoftEvo/DataCollection/FFS_SoftEvo/go-ipfs/fuse/ipns/ipns_test.go', 'top_nesting_level': 0, 'length': 5, 'fan_in': 0, 'fan_out': 0, 'general_fan_out': 0}, {'cyclomatic_complexity': 8, 'nloc': 34, 'token_count': 208, 'name': 'setupIpnsTest', 'long_name': 'setupIpnsTest t * testing . T , node * core . IpfsNode', 'start_line': 102, 'end_line': 140, 'full_parameters': ['t * testing . T', ' node * core . IpfsNode'], 'filename': '/home/dimi/Documents/Informatik_Studium/FSS/SoftEvo/DataCollection/FFS_SoftEvo/go-ipfs/fuse/ipns/ipns_test.go', 'top_nesting_level': 0, 'length': 39, 'fan_in': 0, 'fan_out': 0, 'general_fan_out': 0}, {'cyclomatic_complexity': 3, 'nloc': 13, 'token_count': 80, 'name': 'TestIpnsLocalLink', 'long_name': 'TestIpnsLocalLink t * testing . T', 'start_line': 142, 'end_line': 157, 'full_parameters': ['t * testing . T'], 'filename': '/home/dimi/Documents/Informatik_Studium/FSS/SoftEvo/DataCollection/FFS_SoftEvo/go-ipfs/fuse/ipns/ipns_test.go', 'top_nesting_level': 0, 'length': 16, 'fan_in': 0, 'fan_out': 0, 'general_fan_out': 0}, {'cyclomatic_complexity': 6, 'nloc': 24, 'token_count': 153, 'name': 'TestIpnsBasicIO', 'long_name': 'TestIpnsBasicIO t * testing . T', 'start_line': 160, 'end_line': 188, 'full_parameters': ['t * testing . T'], 'filename': '/home/dimi/Documents/Informatik_Studium/FSS/SoftEvo/DataCollection/FFS_SoftEvo/go-ipfs/fuse/ipns/ipns_test.go', 'top_nesting_level': 0, 'length': 29, 'fan_in': 0, 'fan_out': 0, 'general_fan_out': 0}, {'cyclomatic_complexity': 4, 'nloc': 19, 'token_count': 132, 'name': 'TestFilePersistence', 'long_name': 'TestFilePersistence t * testing . T', 'start_line': 191, 'end_line': 214, 'full_parameters': ['t * testing . T'], 'filename': '/home/dimi/Documents/Informatik_Studium/FSS/SoftEvo/DataCollection/FFS_SoftEvo/go-ipfs/fuse/ipns/ipns_test.go', 'top_nesting_level': 0, 'length': 24, 'fan_in': 0, 'fan_out': 0, 'general_fan_out': 0}, {'cyclomatic_complexity': 1, 'nloc': 23, 'token_count': 216, 'name': 'TestMultipleDirs', 'long_name': 'TestMultipleDirs t * testing . T', 'start_line': 216, 'end_line': 251, 'full_parameters': ['t * testing . T'], 'filename': '/home/dimi/Documents/Informatik_Studium/FSS/SoftEvo/DataCollection/FFS_SoftEvo/go-ipfs/fuse/ipns/ipns_test.go', 'top_nesting_level': 0, 'length': 36, 'fan_in': 0, 'fan_out': 0, 'general_fan_out': 0}, {'cyclomatic_complexity': 4, 'nloc': 16, 'token_count': 101, 'name': 'TestFileSizeReporting', 'long_name': 'TestFileSizeReporting t * testing . T', 'start_line': 254, 'end_line': 272, 'full_parameters': ['t * testing . T'], 'filename': '/home/dimi/Documents/Informatik_Studium/FSS/SoftEvo/DataCollection/FFS_SoftEvo/go-ipfs/fuse/ipns/ipns_test.go', 'top_nesting_level': 0, 'length': 19, 'fan_in': 0, 'fan_out': 0, 'general_fan_out': 0}, {'cyclomatic_complexity': 4, 'nloc': 16, 'token_count': 91, 'name': 'TestDoubleEntryFailure', 'long_name': 'TestDoubleEntryFailure t * testing . T', 'start_line': 275, 'end_line': 292, 'full_parameters': ['t * testing . T'], 'filename': '/home/dimi/Documents/Informatik_Studium/FSS/SoftEvo/DataCollection/FFS_SoftEvo/go-ipfs/fuse/ipns/ipns_test.go', 'top_nesting_level': 0, 'length': 18, 'fan_in': 0, 'fan_out': 0, 'general_fan_out': 0}, {'cyclomatic_complexity': 8, 'nloc': 33, 'token_count': 200, 'name': 'TestAppendFile', 'long_name': 'TestAppendFile t * testing . T', 'start_line': 294, 'end_line': 333, 'full_parameters': ['t * testing . T'], 'filename': '/home/dimi/Documents/Informatik_Studium/FSS/SoftEvo/DataCollection/FFS_SoftEvo/go-ipfs/fuse/ipns/ipns_test.go', 'top_nesting_level': 0, 'length': 40, 'fan_in': 0, 'fan_out': 0, 'general_fan_out': 0}, {'cyclomatic_complexity': 3, 'nloc': 11, 'token_count': 71, 'name': '', 'long_name': '(n int)', 'start_line': 357, 'end_line': 367, 'full_parameters': [], 'filename': '/home/dimi/Documents/Informatik_Studium/FSS/SoftEvo/DataCollection/FFS_SoftEvo/go-ipfs/fuse/ipns/ipns_test.go', 'top_nesting_level': 0, 'length': 11, 'fan_in': 0, 'fan_out': 0, 'general_fan_out': 0}, {'cyclomatic_complexity': 7, 'nloc': 30, 'token_count': 194, 'name': 'TestConcurrentWrites', 'long_name': 'TestConcurrentWrites t * testing . T', 'start_line': 335, 'end_line': 380, 'full_parameters': ['t * testing . T'], 'filename': '/home/dimi/Documents/Informatik_Studium/FSS/SoftEvo/DataCollection/FFS_SoftEvo/go-ipfs/fuse/ipns/ipns_test.go', 'top_nesting_level': 0, 'length': 46, 'fan_in': 0, 'fan_out': 0, 'general_fan_out': 0}, {'cyclomatic_complexity': 3, 'nloc': 18, 'token_count': 110, 'name': '', 'long_name': '(worker int)', 'start_line': 407, 'end_line': 425, 'full_parameters': [], 'filename': '/home/dimi/Documents/Informatik_Studium/FSS/SoftEvo/DataCollection/FFS_SoftEvo/go-ipfs/fuse/ipns/ipns_test.go', 'top_nesting_level': 0, 'length': 19, 'fan_in': 0, 'fan_out': 0, 'general_fan_out': 0}, {'cyclomatic_complexity': 3, 'nloc': 18, 'token_count': 113, 'name': '', 'long_name': '(worker int)', 'start_line': 431, 'end_line': 450, 'full_parameters': [], 'filename': '/home/dimi/Documents/Informatik_Studium/FSS/SoftEvo/DataCollection/FFS_SoftEvo/go-ipfs/fuse/ipns/ipns_test.go', 'top_nesting_level': 0, 'length': 20, 'fan_in': 0, 'fan_out': 0, 'general_fan_out': 0}, {'cyclomatic_complexity': 7, 'nloc': 35, 'token_count': 208, 'name': 'TestFSThrash', 'long_name': 'TestFSThrash t * testing . T', 'start_line': 382, 'end_line': 464, 'full_parameters': ['t * testing . T'], 'filename': '/home/dimi/Documents/Informatik_Studium/FSS/SoftEvo/DataCollection/FFS_SoftEvo/go-ipfs/fuse/ipns/ipns_test.go', 'top_nesting_level': 0, 'length': 83, 'fan_in': 0, 'fan_out': 0, 'general_fan_out': 0}, {'cyclomatic_complexity': 8, 'nloc': 30, 'token_count': 177, 'name': 'TestMultiWrite', 'long_name': 'TestMultiWrite t * testing . T', 'start_line': 467, 'end_line': 502, 'full_parameters': ['t * testing . T'], 'filename': '/home/dimi/Documents/Informatik_Studium/FSS/SoftEvo/DataCollection/FFS_SoftEvo/go-ipfs/fuse/ipns/ipns_test.go', 'top_nesting_level': 0, 'length': 36, 'fan_in': 0, 'fan_out': 0, 'general_fan_out': 0}]",17,58,0,52,52,"[{'timestamp': 1507212616.0, 'added_lines': 1, 'deleted_lines': 1, 'nloc': 384}, {'timestamp': 1507304579.0, 'added_lines': 1, 'deleted_lines': 1, 'nloc': 384}, {'timestamp': 1511223906.0, 'added_lines': 1, 'deleted_lines': 1, 'nloc': 384}, {'timestamp': 1512365669.0, 'added_lines': 2, 'deleted_lines': 2, 'nloc': 384}, {'timestamp': 1516838128.0, 'added_lines': 2, 'deleted_lines': 2, 'nloc': 384}, {'timestamp': 1517453697.0, 'added_lines': 1, 'deleted_lines': 1, 'nloc': 384}, {'timestamp': 1518523447.0, 'added_lines': 2, 'deleted_lines': 3, 'nloc': 384}, {'timestamp': 1518185191.0, 'added_lines': 3, 'deleted_lines': 3, 'nloc': 384}, {'timestamp': 1519761835.0, 'added_lines': 1, 'deleted_lines': 1, 'nloc': 384}, {'timestamp': 1519999272.0, 'added_lines': 1, 'deleted_lines': 1, 'nloc': 384}, {'timestamp': 1525408792.0, 'added_lines': 2, 'deleted_lines': 2, 'nloc': 384}, {'timestamp': 1528006520.0, 'added_lines': 1, 'deleted_lines': 1, 'nloc': 384}, {'timestamp': 1528131220.0, 'added_lines': 1, 'deleted_lines': 1, 'nloc': 384}, {'timestamp': 1528268108.0, 'added_lines': 1, 'deleted_lines': 1, 'nloc': 384}, {'timestamp': 1528520460.0, 'added_lines': 4, 'deleted_lines': 4, 'nloc': 384}, {'timestamp': 1528945488.0, 'added_lines': 2, 'deleted_lines': 2, 'nloc': 384}, {'timestamp': 1529984485.0, 'added_lines': 2, 'deleted_lines': 2, 'nloc': 384}, {'timestamp': 1531779409.0, 'added_lines': 1, 'deleted_lines': 1, 'nloc': 384}, {'timestamp': 1533779477.0, 'added_lines': 2, 'deleted_lines': 2, 'nloc': 384}, {'timestamp': 1534115707.0, 'added_lines': 1, 'deleted_lines': 1, 'nloc': 384}, {'timestamp': 1534195762.0, 'added_lines': 1, 'deleted_lines': 1, 'nloc': 384}, {'timestamp': 1534347022.0, 'added_lines': 1, 'deleted_lines': 1, 'nloc': 384}, {'timestamp': 1534376007.0, 'added_lines': 11, 'deleted_lines': 1, 'nloc': 392}, {'timestamp': 1534896611.0, 'added_lines': 2, 'deleted_lines': 2, 'nloc': 392}, {'timestamp': 1535601896.0, 'added_lines': 1, 'deleted_lines': 1, 'nloc': 392}, {'timestamp': 1536388808.0, 'added_lines': 1, 'deleted_lines': 1, 'nloc': 392}, {'timestamp': 1536718784.0, 'added_lines': 1, 'deleted_lines': 1, 'nloc': 392}, {'timestamp': 1536723292.0, 'added_lines': 1, 'deleted_lines': 1, 'nloc': 392}, {'timestamp': 1537790637.0, 'added_lines': 1, 'deleted_lines': 1, 'nloc': 392}, {'timestamp': 1537792589.0, 'added_lines': 2, 'deleted_lines': 2, 'nloc': 392}, {'timestamp': 1538544957.0, 'added_lines': 1, 'deleted_lines': 1, 'nloc': 392}, {'timestamp': 1538773916.0, 'added_lines': 1, 'deleted_lines': 1, 'nloc': 392}, {'timestamp': 1539176817.0, 'added_lines': 1, 'deleted_lines': 1, 'nloc': 392}, {'timestamp': 1540400358.0, 'added_lines': 2, 'deleted_lines': 2, 'nloc': 392}, {'timestamp': 1541204121.0, 'added_lines': 3, 'deleted_lines': 3, 'nloc': 392}, {'timestamp': 1541903826.0, 'added_lines': 1, 'deleted_lines': 1, 'nloc': 392}, {'timestamp': 1544225843.0, 'added_lines': 2, 'deleted_lines': 2, 'nloc': 392}, {'timestamp': 1544667474.0, 'added_lines': 0, 'deleted_lines': 10, 'nloc': 384}, {'timestamp': 1547003974.0, 'added_lines': 1, 'deleted_lines': 1, 'nloc': 384}, {'timestamp': 1549588289.0, 'added_lines': 1, 'deleted_lines': 1, 'nloc': 384}, {'timestamp': 1550507829.0, 'added_lines': 1, 'deleted_lines': 1, 'nloc': 384}, {'timestamp': 1551229859.0, 'added_lines': 1, 'deleted_lines': 1, 'nloc': 384}, {'timestamp': 1551551196.0, 'added_lines': 4, 'deleted_lines': 4, 'nloc': 384}, {'timestamp': 1553654254.0, 'added_lines': 7, 'deleted_lines': 1, 'nloc': 389}, {'timestamp': 1553697989.0, 'added_lines': 37, 'deleted_lines': 33, 'nloc': 396}, {'timestamp': 1556839836.0, 'added_lines': 1, 'deleted_lines': 1, 'nloc': 396}, {'timestamp': 1559060517.0, 'added_lines': 1, 'deleted_lines': 1, 'nloc': 396}, {'timestamp': 1563668276.0, 'added_lines': 1, 'deleted_lines': 1, 'nloc': 396}, {'timestamp': 1563837872.0, 'added_lines': 1, 'deleted_lines': 1, 'nloc': 396}, {'timestamp': 1566440221.0, 'added_lines': 7, 'deleted_lines': 1, 'nloc': 401}, {'timestamp': 1587221101.0, 'added_lines': 2, 'deleted_lines': 2, 'nloc': 401}, {'timestamp': 1600726105.0, 'added_lines': 1, 'deleted_lines': 1, 'nloc': 401}]","{'core/bootstrap_test.go': 27, 'core/commands/dht_test.go': 27, 'core/mock/mock.go': 30, 'exchange/bitswap/bitswap_test.go': 16, 'exchange/bitswap/decision/bench_test.go': 10, 'exchange/bitswap/decision/engine_test.go': 11, 'exchange/bitswap/decision/peer_request_queue_test.go': 10, 'exchange/bitswap/testnet/interface.go': 9, 'exchange/bitswap/testnet/network_test.go': 16, 'exchange/bitswap/testnet/peernet.go': 16, 'exchange/bitswap/testnet/virtual.go': 16, 'exchange/bitswap/testutils.go': 13, 'exchange/reprovide/reprovide_test.go': 40, 'fuse/node/mount_test.go': 46, 'fuse/readonly/ipfs_test.go': 40, 'mfs/repub_test.go': 13, 'namesys/publisher_test.go': 40, 'namesys/resolve_test.go': 40, 'package.json': 39, 'routing/mock/centralized_client.go': 6, 'routing/mock/centralized_server.go': 6, 'routing/mock/centralized_test.go': 6, 'routing/mock/interface.go': 6, 'routing/offline/offline_test.go': 6, 'test/integration/addcat_test.go': 30, 'test/integration/bench_cat_test.go': 30, 'test/integration/bench_test.go': 21, 'test/integration/grandcentral_test.go': 1, 'test/integration/three_legged_cat_test.go': 30, 'core/bootstrap.go': 27, 'core/commands/dht.go': 37, 'core/commands/id.go': 29, 'core/commands/pubsub.go': 24, 'core/core.go': 41, 'core/corehttp/gateway.go': 27, 'core/corehttp/gateway_test.go': 35, 'core/corehttp/metrics_test.go': 28, 'exchange/bitswap/network/ipfs_impl.go': 11, 'namesys/republisher/repub_test.go': 36, 'p2p/p2p.go': 28, 'routing/none/none_client.go': 5, 'test/integration/bitswap_wo_routing_test.go': 32, 'thirdparty/ipfsaddr/ipfsaddr.go': 1, 'cmd/ipfs/daemon.go': 19, 'cmd/ipfs/init.go': 20, 'cmd/ipfs/ipfs.go': 13, 'cmd/ipfs/main.go': 23, 'cmd/ipfs/main_test.go': 2, 'cmd/ipfswatch/main.go': 19, 'cmd/seccat/seccat.go': 28, 'commands/cli/helptext.go': 1, 'commands/cli/helptext_test.go': 1, 'commands/cli/parse.go': 1, 'commands/cli/parse_test.go': 1, 'commands/command.go': 11, 'commands/command_test.go': 4, 'commands/http/client.go': 1, 'commands/http/handler.go': 1, 'commands/http/multifilereader.go': 1, 'commands/http/multifilereader_test.go': 1, 'commands/http/parse.go': 1, 'commands/request.go': 15, 'commands/response.go': 6, 'commands/response_test.go': 4, 'core/commands/active.go': 6, 'core/commands/add.go': 27, 'core/commands/bitswap.go': 32, 'core/commands/block.go': 17, 'core/commands/bootstrap.go': 16, 'core/commands/cat.go': 15, 'core/commands/commands.go': 15, 'core/commands/config.go': 17, 'core/commands/dag/dag.go': 31, 'core/commands/diag.go': 6, 'core/commands/dns.go': 9, 'core/commands/external.go': 6, 'core/commands/files/files.go': 4, 'core/commands/filestore.go': 17, 'core/commands/get.go': 32, 'core/commands/get_test.go': 13, 'core/commands/helptext_test.go': 13, 'core/commands/ipns.go': 17, 'core/commands/keystore.go': 14, 'core/commands/log.go': 12, 'core/commands/ls.go': 29, 'core/commands/mount_nofuse.go': 6, 'core/commands/mount_unix.go': 16, 'core/commands/name.go': 4, 'core/commands/object/diff.go': 8, 'core/commands/object/object.go': 30, 'core/commands/object/patch.go': 13, 'core/commands/p2p.go': 21, 'core/commands/pin.go': 31, 'core/commands/ping.go': 25, 'core/commands/publish.go': 12, 'core/commands/refs.go': 28, 'core/commands/repo.go': 31, 'core/commands/resolve.go': 27, 'core/commands/root.go': 13, 'core/commands/shutdown.go': 9, 'core/commands/stat.go': 19, 'core/commands/swarm.go': 28, 'core/commands/sysdiag.go': 13, 'core/commands/tar.go': 26, 'core/commands/unixfs/ls.go': 26, 'core/commands/unixfs/unixfs.go': 6, 'core/commands/version.go': 7, 'core/corehttp/commands.go': 30, 'core/coreunix/add.go': 32, 'core/coreunix/add_test.go': 33, 'exchange/bitswap/message/message.go': 9, 'exchange/bitswap/network/interface.go': 9, 'importer/helpers/dagbuilder.go': 7, 'importer/importer.go': 7, 'p2p/registry.go': 12, 'repo/config/bootstrap_peers.go': 10, 'assets/assets.go': 26, 'blocks/blockstore/arc_cache.go': 2, 'blocks/blockstore/arc_cache_test.go': 2, 'blocks/blockstore/blockstore.go': 3, 'blocks/blockstore/blockstore_test.go': 2, 'blocks/blockstore/bloom_cache.go': 2, 'blocks/blockstore/bloom_cache_test.go': 2, 'blocks/blockstore/util/remove.go': 2, 'blocks/blocksutil/block_generator.go': 2, 'blockservice/blockservice.go': 8, 'blockservice/blockservice_test.go': 7, 'blockservice/test/blocks_test.go': 7, 'core/builder.go': 35, 'core/commands/ipnsps.go': 5, 'core/commands/mount_windows.go': 5, 'core/coreapi/coreapi.go': 14, 'core/coreapi/interface/interface.go': 2, 'core/coreapi/unixfs.go': 27, 'core/coreapi/unixfs_test.go': 26, 'core/coredag/cbor.go': 11, 'core/coredag/dagpb.go': 27, 'core/coredag/dagtransl.go': 10, 'core/coredag/raw.go': 27, 'core/corehttp/corehttp.go': 16, 'core/corehttp/gateway_handler.go': 33, 'core/corerepo/gc.go': 30, 'core/corerepo/pinning.go': 16, 'core/coreunix/metadata.go': 27, 'core/coreunix/metadata_test.go': 31, 'core/pathresolver.go': 30, 'exchange/bitswap/bitswap.go': 8, 'exchange/bitswap/decision/engine.go': 8, 'exchange/bitswap/decision/ledger.go': 7, 'exchange/bitswap/decision/peer_request_queue.go': 7, 'exchange/bitswap/get.go': 7, 'exchange/bitswap/message/message_test.go': 4, 'exchange/bitswap/notifications/notifications.go': 4, 'exchange/bitswap/notifications/notifications_test.go': 4, 'exchange/bitswap/session.go': 7, 'exchange/bitswap/session_test.go': 6, 'exchange/bitswap/stat.go': 4, 'exchange/bitswap/wantlist/wantlist.go': 4, 'exchange/bitswap/wantlist/wantlist_test.go': 4, 'exchange/bitswap/wantmanager.go': 7, 'exchange/bitswap/workers.go': 7, 'exchange/interface.go': 2, 'exchange/offline/offline.go': 3, 'exchange/offline/offline_test.go': 3, 'exchange/reprovide/providers.go': 30, 'exchange/reprovide/reprovide.go': 28, 'filestore/filestore.go': 23, 'filestore/filestore_test.go': 30, 'filestore/fsrefstore.go': 22, 'filestore/util.go': 22, 'fuse/ipns/ipns_unix.go': 36, 'fuse/readonly/readonly_unix.go': 34, 'importer/balanced/balanced_test.go': 6, 'importer/balanced/builder.go': 4, 'importer/chunk/rabin_test.go': 2, 'importer/chunk/splitting_test.go': 2, 'importer/helpers/helpers.go': 4, 'importer/importer_test.go': 6, 'importer/trickle/trickle_test.go': 6, 'importer/trickle/trickledag.go': 4, 'merkledag/batch.go': 2, 'merkledag/coding.go': 4, 'merkledag/merkledag.go': 4, 'merkledag/merkledag_test.go': 6, 'merkledag/node.go': 4, 'merkledag/node_test.go': 4, 'merkledag/raw.go': 4, 'merkledag/traverse/traverse.go': 4, 'merkledag/traverse/traverse_test.go': 4, 'merkledag/utils/diff.go': 4, 'merkledag/utils/diffenum.go': 4, 'merkledag/utils/diffenum_test.go': 4, 'merkledag/utils/utils.go': 7, 'merkledag/utils/utils_test.go': 4, 'mfs/dir.go': 8, 'mfs/file.go': 10, 'mfs/mfs_test.go': 11, 'mfs/ops.go': 8, 'mfs/system.go': 11, 'namesys/ipns_select_test.go': 4, 'namesys/namesys.go': 35, 'namesys/publisher.go': 35, 'namesys/pubsub.go': 6, 'namesys/pubsub_test.go': 7, 'namesys/republisher/repub.go': 33, 'namesys/routing.go': 35, 'path/path.go': 4, 'path/resolver.go': 3, 'path/resolver_test.go': 2, 'pin/gc/gc.go': 31, 'pin/pin.go': 31, 'pin/pin_test.go': 31, 'pin/set.go': 27, 'pin/set_test.go': 30, 'plugin/ipld.go': 10, 'plugin/loader/initializer.go': 9, 'plugin/plugins/git/git.go': 10, 'repo/config/init.go': 7, 'repo/fsrepo/fsrepo.go': 24, 'repo/fsrepo/lock/lock.go': 3, 'repo/fsrepo/serialize/serialize.go': 3, 'repo/mock.go': 17, 'repo/repo.go': 22, 'routing/offline/offline.go': 3, 'tar/format.go': 30, 'test/dependencies/ma-pipe-unidir/main.go': 11, 'thirdparty/ds-help/key.go': 2, 'thirdparty/pollEndpoint/main.go': 15, 'thirdparty/posinfo/posinfo.go': 2, 'unixfs/archive/archive.go': 4, 'unixfs/archive/tar/writer.go': 4, 'unixfs/hamt/hamt.go': 4, 'unixfs/io/dagreader.go': 4, 'unixfs/io/dirbuilder.go': 3, 'unixfs/io/resolve.go': 4, 'unixfs/mod/dagmodifier.go': 6, 'unixfs/mod/dagmodifier_test.go': 3, 'unixfs/test/utils.go': 6, 'commands/legacy/command.go': 9, 'commands/legacy/legacy.go': 9, 'commands/legacy/legacy_test.go': 9, 'commands/legacy/request.go': 9, 'commands/legacy/response.go': 9, 'core/commands/commands_test.go': 11, 'core/coreapi/dag.go': 9, 'core/coreapi/dag_test.go': 3, 'core/coreapi/interface/options/dag.go': 8, 'core/coreapi/key.go': 29, 'core/coreapi/name.go': 37, 'merkledag/test/utils.go': 6, 'namesys/namesys_test.go': 36, 'repo/fsrepo/datastores.go': 16, 'repo/fsrepo/fsrepo_test.go': 19, 'thirdparty/datastore2/datastore_closer.go': 2, 'thirdparty/datastore2/delayed.go': 2, 'thirdparty/datastore2/threadsafe.go': 2, 'unixfs/io/pbdagreader.go': 3, 'cmd/ipfs/util/ulimit.go': 10, 'cmd/seccat/util.go': 9, 'core/corehttp/logs.go': 9, 'fuse/mount/mount.go': 9, 'fuse/node/mount_unix.go': 13, 'importer/chunk/splitting.go': 1, 'namesys/ipns_validate_test.go': 8, 'plugin/loader/load.go': 7, 'blockservice/test/mock.go': 10, None: 7, 'blocks/blockstoreutil/remove.go': 21, 'namesys/validator.go': 5, 'core/commands/files.go': 29, 'core/core_test.go': 17, 'core/coreapi/pin.go': 27, 'fuse/ipns/common.go': 25, 'keystore/keystore.go': 10, 'keystore/keystore_test.go': 8, 'keystore/memkeystore.go': 7, 'namesys/interface.go': 25, 'path/resolver/resolver.go': 4, 'repo/config/identity.go': 2, 'thirdparty/verifbs/verifbs.go': 19, 'fuse/ipns/link_unix.go': 6, 'fuse/mount/fuse.go': 7, 'cmd/ipfs/util/ulimit_freebsd.go': 2, 'cmd/ipfs/util/ulimit_unix.go': 2, 'core/coreapi/block.go': 10, 'core/coreapi/block_test.go': 2, 'core/coreapi/interface/coreapi.go': 7, 'core/coreapi/interface/dag.go': 7, 'core/coreapi/interface/object.go': 7, 'core/coreapi/interface/options/block.go': 3, 'core/coreapi/interface/path.go': 22, 'core/coreapi/interface/unixfs.go': 8, 'core/coreapi/object.go': 25, 'fuse/node/mount_darwin.go': 4, 'merkledag/errservice.go': 2, 'merkledag/readonly.go': 2, 'merkledag/readonly_test.go': 2, 'merkledag/rwservice.go': 2, 'merkledag/session.go': 2, 'path/resolver/resolver_test.go': 2, 'thirdparty/verifcid/validate.go': 2, 'thirdparty/verifcid/validate_test.go': 2, 'unixfs/hamt/hamt_stress_test.go': 2, 'unixfs/hamt/hamt_test.go': 2, 'namesys/ipns_resolver_validation_test.go': 27, 'test/sharness/t0170-dht.sh': 1, 'core/commands/urlstore.go': 24, 'unixfs/io/directory.go': 1, 'core/commands/env.go': 2, 'core/coreapi/interface/key.go': 7, 'core/coreapi/name_test.go': 18, 'core/coreapi/path.go': 23, 'core/coreunix/cat.go': 11, 'core/pathresolver_test.go': 23, 'dagutils/diff.go': 24, 'dagutils/diffenum.go': 23, 'dagutils/diffenum_test.go': 23, 'dagutils/utils.go': 24, 'dagutils/utils_test.go': 23, 'filestore/pb/dataobj.pb.go': 3, 'mfs/fd.go': 4, 'namesys/base.go': 23, 'namesys/cache.go': 23, 'namesys/dns.go': 23, 'namesys/proquint.go': 23, 'pin/internal/pb/header.pb.go': 3, 'thirdparty/cidv0v1/blockstore.go': 15, 'repo/fsrepo/config_test.go': 13, 'repo/fsrepo/misc.go': 13, 'test/bench/bench_cli_ipfs_add/main.go': 14, 'test/bench/offline_add/main.go': 14, 'core/commands/cmdenv/env.go': 12, 'core/commands/name/ipns.go': 18, 'core/commands/name/publish.go': 11, 'core/coreapi/dht.go': 17, 'core/coreapi/dht_test.go': 5, 'test/sharness/t0275-cid-security.sh': 1, 'core/commands/name/ipnsps.go': 9, 'core/commands/name/name.go': 4, 'core/coreapi/interface/dht.go': 10, 'p2p/listener.go': 14, 'p2p/local.go': 14, 'p2p/remote.go': 15, 'p2p/stream.go': 15, 'core/coreapi/interface/swarm.go': 9, 'core/coreapi/swarm.go': 14, 'core/coreapi/interface/options/unixfs.go': 8, 'core/coreapi/pubsub.go': 13, 'core/coreapi/unixfile.go': 7, 'cmd/ipfs/dnsresolve_test.go': 5, 'core/coreapi/interface/pubsub.go': 4, 'core/commands/cid.go': 5, 'test/dependencies/iptb/iptb.go': 8, 'plugin/plugins/badgerds/badgerds.go': 3, 'plugin/plugins/flatfs/flatfs.go': 3, 'plugin/plugins/levelds/levelds.go': 3, 'commands/context.go': 6, 'core/corehttp/proxy.go': 7, 'core/coreapi/interface/tests/name.go': 2, 'core/coreapi/interface/tests/unixfs.go': 2, 'core/coreapi/test/api_test.go': 6, 'core/commands/cmdenv/cidbase.go': 2, 'core/corehttp/ipns_hostname.go': 3, 'namesys/dns_test.go': 3, 'plugin/daemon.go': 3, 'plugin/loader/loader.go': 4, 'core/commands/cmdenv/cidbase_test.go': 1, 'core/commands/cmdenv/file.go': 1, 'core/corehttp/metrics.go': 1, 'core/corehttp/proxy_test.go': 2, 'core/corerepo/stat.go': 1, 'plugin/tracer.go': 1, 'thirdparty/notifier/notifier.go': 2, 'commands/reqlog.go': 1, 'core/corehttp/mutex_profile.go': 1, 'core/corehttp/option_test.go': 1, 'provider/queue.go': 1, 'provider/queue_test.go': 1, 'core/bootstrap/bootstrap.go': 1, 'core/bootstrap/bootstrap_test.go': 1, 'core/node/builder.go': 1, 'core/node/core.go': 1, 'core/node/groups.go': 1, 'core/node/identity.go': 1, 'core/node/ipns.go': 1, 'core/node/libp2p/addrs.go': 1, 'core/node/libp2p/discovery.go': 1, 'core/node/libp2p/host.go': 1, 'core/node/libp2p/hostopt.go': 1, 'core/node/libp2p/libp2p.go': 1, 'core/node/libp2p/nat.go': 1, 'core/node/libp2p/pnet.go': 1, 'core/node/libp2p/pubsub.go': 1, 'core/node/libp2p/routing.go': 1, 'core/node/libp2p/routingopt.go': 1, 'core/node/libp2p/smux.go': 1, 'core/node/libp2p/transport.go': 1, 'core/node/provider.go': 1, 'go.mod': 2, 'go.sum': 2, 'provider/simple/provider.go': 1, 'provider/simple/provider_test.go': 1, 'provider/simple/reprovide.go': 1, 'provider/simple/reprovide_test.go': 1, 'fuse/node/mount_openbsd.go': 1, 'fuse/readonly/mount_unix.go': 2, 'mk/util.mk': 2, 'fuse/node/mount_notsupp.go': 2, 'fuse/ipns/mount_unix.go': 1, 'CHANGELOG.md': 1, 'Dockerfile': 1, 'README.md': 1, 'bin/check_go_version': 1, 'coverage/Rules.mk': 1, 'docs/config.md': 1, 'docs/debug-guide.md': 1, 'docs/environment-variables.md': 1, 'gc/gc.go': 1, 'keystore/memkeystore_test.go': 1, 'misc/completion/ipfs-completion.bash': 1, 'plugin/plugins/gen_main.sh': 1, 'repo/fsrepo/migrations/migrations.go': 1, 'repo/onlyone.go': 1, 'test/3nodetest/run-test-on-img.sh': 1, 'test/ipfs-test-lib.sh': 1, 'test/sharness/README.md': 1, 'test/sharness/lib/iptb-lib.sh': 1, 'test/sharness/t0010-basic-commands.sh': 1, 'test/sharness/t0020-init.sh': 1, 'test/sharness/t0030-mount.sh': 1, 'test/sharness/t0031-mount-publish.sh': 1, 'test/sharness/t0040-add-and-cat.sh': 1, 'test/sharness/t0050-block.sh': 1, 'test/sharness/t0051-object.sh': 1, 'test/sharness/t0053-dag.sh': 1, 'test/sharness/t0060-daemon.sh': 1, 'test/sharness/t0062-daemon-api.sh': 1, 'test/sharness/t0080-repo.sh': 1, 'test/sharness/t0087-repo-robust-gc.sh': 1, 'test/sharness/t0090-get.sh': 1, 'test/sharness/t0110-gateway.sh': 1, 'test/sharness/t0114-gateway-subdomains.sh': 1, 'test/sharness/t0131-multinode-client-routing.sh': 1, 'test/sharness/t0140-swarm.sh': 1, 'test/sharness/t0183-namesys-pubsub.sh': 1, 'test/sharness/t0250-files-api.sh': 1, 'test/sharness/t0270-filestore.sh': 1, 'test/sharness/t0272-urlstore.sh': 1, 'test/sharness/t0410-api-add.sh': 1, 'test/sharness/t0600-issues-and-regressions-online.sh': 1, 'test/sharness_test_coverage_helper.sh': 1, 'thirdparty/README.md': 1, 'cmd/ipfs/util/ulimit_test.go': 1, 'cmd/ipfswatch/ipfswatch_test.go': 1, 'cmd/seccat/seccat_plan9.go': 1, 'cmd/seccat/seccat_posix.go': 1}","('fuse/node/mount_test.go', 0.8846153846153846, 0.92)"
fuse/ipns/ipns_unix.go,494,3060,11,"[{'cyclomatic_complexity': 1, 'nloc': 3, 'token_count': 15, 'name': '', 'long_name': '(msg interface{})', 'start_line': 31, 'end_line': 33, 'full_parameters': [], 'filename': '/home/dimi/Documents/Informatik_Studium/FSS/SoftEvo/DataCollection/FFS_SoftEvo/go-ipfs/fuse/ipns/ipns_unix.go', 'top_nesting_level': 0, 'length': 3, 'fan_in': 0, 'fan_out': 0, 'general_fan_out': 0}, {'cyclomatic_complexity': 2, 'nloc': 5, 'token_count': 22, 'name': 'init', 'long_name': 'init', 'start_line': 29, 'end_line': 35, 'full_parameters': [], 'filename': '/home/dimi/Documents/Informatik_Studium/FSS/SoftEvo/DataCollection/FFS_SoftEvo/go-ipfs/fuse/ipns/ipns_unix.go', 'top_nesting_level': 0, 'length': 7, 'fan_in': 0, 'fan_out': 0, 'general_fan_out': 0}, {'cyclomatic_complexity': 2, 'nloc': 10, 'token_count': 80, 'name': 'NewFileSystem', 'long_name': 'NewFileSystem ipfs * core . IpfsNode , sk ci . PrivKey , ipfspath , ipnspath string', 'start_line': 46, 'end_line': 57, 'full_parameters': ['ipfs * core . IpfsNode', ' sk ci . PrivKey', ' ipfspath', ' ipnspath string'], 'filename': '/home/dimi/Documents/Informatik_Studium/FSS/SoftEvo/DataCollection/FFS_SoftEvo/go-ipfs/fuse/ipns/ipns_unix.go', 'top_nesting_level': 0, 'length': 12, 'fan_in': 0, 'fan_out': 0, 'general_fan_out': 0}, {'cyclomatic_complexity': 1, 'nloc': 4, 'token_count': 30, 'name': 'Root', 'long_name': '(f*FileSystem)Root', 'start_line': 60, 'end_line': 63, 'full_parameters': [], 'filename': '/home/dimi/Documents/Informatik_Studium/FSS/SoftEvo/DataCollection/FFS_SoftEvo/go-ipfs/fuse/ipns/ipns_unix.go', 'top_nesting_level': 0, 'length': 4, 'fan_in': 0, 'fan_out': 0, 'general_fan_out': 0}, {'cyclomatic_complexity': 2, 'nloc': 6, 'token_count': 34, 'name': 'Destroy', 'long_name': '(f*FileSystem)Destroy', 'start_line': 65, 'end_line': 70, 'full_parameters': [], 'filename': '/home/dimi/Documents/Informatik_Studium/FSS/SoftEvo/DataCollection/FFS_SoftEvo/go-ipfs/fuse/ipns/ipns_unix.go', 'top_nesting_level': 0, 'length': 6, 'fan_in': 0, 'fan_out': 0, 'general_fan_out': 0}, {'cyclomatic_complexity': 1, 'nloc': 3, 'token_count': 34, 'name': 'error', 'long_name': '(ctx context.Context,c*cid.Cid)error', 'start_line': 87, 'end_line': 89, 'full_parameters': [], 'filename': '/home/dimi/Documents/Informatik_Studium/FSS/SoftEvo/DataCollection/FFS_SoftEvo/go-ipfs/fuse/ipns/ipns_unix.go', 'top_nesting_level': 0, 'length': 3, 'fan_in': 0, 'fan_out': 0, 'general_fan_out': 0}, {'cyclomatic_complexity': 8, 'nloc': 33, 'token_count': 237, 'name': 'loadRoot', 'long_name': 'loadRoot ctx context . Context , rt * keyRoot , ipfs * core . IpfsNode , name string', 'start_line': 92, 'end_line': 129, 'full_parameters': ['ctx context . Context', ' rt * keyRoot', ' ipfs * core . IpfsNode', ' name string'], 'filename': '/home/dimi/Documents/Informatik_Studium/FSS/SoftEvo/DataCollection/FFS_SoftEvo/go-ipfs/fuse/ipns/ipns_unix.go', 'top_nesting_level': 0, 'length': 38, 'fan_in': 0, 'fan_out': 0, 'general_fan_out': 0}, {'cyclomatic_complexity': 4, 'nloc': 31, 'token_count': 202, 'name': 'CreateRoot', 'long_name': 'CreateRoot ipfs * core . IpfsNode , keys map [ string ] ci . PrivKey , ipfspath , ipnspath string', 'start_line': 137, 'end_line': 172, 'full_parameters': ['ipfs * core . IpfsNode', ' keys map [ string ] ci . PrivKey', ' ipfspath', ' ipnspath string'], 'filename': '/home/dimi/Documents/Informatik_Studium/FSS/SoftEvo/DataCollection/FFS_SoftEvo/go-ipfs/fuse/ipns/ipns_unix.go', 'top_nesting_level': 0, 'length': 36, 'fan_in': 0, 'fan_out': 0, 'general_fan_out': 0}, {'cyclomatic_complexity': 1, 'nloc': 1, 'token_count': 2, 'name': '', 'long_name': '(', 'start_line': 175, 'end_line': 175, 'full_parameters': [], 'filename': '/home/dimi/Documents/Informatik_Studium/FSS/SoftEvo/DataCollection/FFS_SoftEvo/go-ipfs/fuse/ipns/ipns_unix.go', 'top_nesting_level': 0, 'length': 1, 'fan_in': 0, 'fan_out': 0, 'general_fan_out': 0}, {'cyclomatic_complexity': 1, 'nloc': 3, 'token_count': 15, 'name': '', 'long_name': '()', 'start_line': 384, 'end_line': 386, 'full_parameters': [], 'filename': '/home/dimi/Documents/Informatik_Studium/FSS/SoftEvo/DataCollection/FFS_SoftEvo/go-ipfs/fuse/ipns/ipns_unix.go', 'top_nesting_level': 0, 'length': 3, 'fan_in': 0, 'fan_out': 0, 'general_fan_out': 0}, {'cyclomatic_complexity': 1, 'nloc': 3, 'token_count': 15, 'name': '', 'long_name': '()', 'start_line': 415, 'end_line': 417, 'full_parameters': [], 'filename': '/home/dimi/Documents/Informatik_Studium/FSS/SoftEvo/DataCollection/FFS_SoftEvo/go-ipfs/fuse/ipns/ipns_unix.go', 'top_nesting_level': 0, 'length': 3, 'fan_in': 0, 'fan_out': 0, 'general_fan_out': 0}]",452,2912,11,"[{'cyclomatic_complexity': 1, 'nloc': 3, 'token_count': 15, 'name': '', 'long_name': '(msg interface{})', 'start_line': 30, 'end_line': 32, 'full_parameters': [], 'filename': '/home/dimi/Documents/Informatik_Studium/FSS/SoftEvo/DataCollection/FFS_SoftEvo/go-ipfs/fuse/ipns/ipns_unix.go', 'top_nesting_level': 0, 'length': 3, 'fan_in': 0, 'fan_out': 0, 'general_fan_out': 0}, {'cyclomatic_complexity': 2, 'nloc': 5, 'token_count': 22, 'name': 'init', 'long_name': 'init', 'start_line': 28, 'end_line': 34, 'full_parameters': [], 'filename': '/home/dimi/Documents/Informatik_Studium/FSS/SoftEvo/DataCollection/FFS_SoftEvo/go-ipfs/fuse/ipns/ipns_unix.go', 'top_nesting_level': 0, 'length': 7, 'fan_in': 0, 'fan_out': 0, 'general_fan_out': 0}, {'cyclomatic_complexity': 3, 'nloc': 11, 'token_count': 101, 'name': 'NewFileSystem', 'long_name': 'NewFileSystem ctx context . Context , ipfs iface . CoreAPI , ipfspath , ipnspath string', 'start_line': 45, 'end_line': 56, 'full_parameters': ['ctx context . Context', ' ipfs iface . CoreAPI', ' ipfspath', ' ipnspath string'], 'filename': '/home/dimi/Documents/Informatik_Studium/FSS/SoftEvo/DataCollection/FFS_SoftEvo/go-ipfs/fuse/ipns/ipns_unix.go', 'top_nesting_level': 0, 'length': 12, 'fan_in': 0, 'fan_out': 0, 'general_fan_out': 0}, {'cyclomatic_complexity': 1, 'nloc': 4, 'token_count': 30, 'name': 'Root', 'long_name': '(f*FileSystem)Root', 'start_line': 59, 'end_line': 62, 'full_parameters': [], 'filename': '/home/dimi/Documents/Informatik_Studium/FSS/SoftEvo/DataCollection/FFS_SoftEvo/go-ipfs/fuse/ipns/ipns_unix.go', 'top_nesting_level': 0, 'length': 4, 'fan_in': 0, 'fan_out': 0, 'general_fan_out': 0}, {'cyclomatic_complexity': 2, 'nloc': 6, 'token_count': 34, 'name': 'Destroy', 'long_name': '(f*FileSystem)Destroy', 'start_line': 64, 'end_line': 69, 'full_parameters': [], 'filename': '/home/dimi/Documents/Informatik_Studium/FSS/SoftEvo/DataCollection/FFS_SoftEvo/go-ipfs/fuse/ipns/ipns_unix.go', 'top_nesting_level': 0, 'length': 6, 'fan_in': 0, 'fan_out': 0, 'general_fan_out': 0}, {'cyclomatic_complexity': 1, 'nloc': 4, 'token_count': 51, 'name': 'error', 'long_name': '(ctx context.Context,c cid.Cid)error', 'start_line': 86, 'end_line': 89, 'full_parameters': [], 'filename': '/home/dimi/Documents/Informatik_Studium/FSS/SoftEvo/DataCollection/FFS_SoftEvo/go-ipfs/fuse/ipns/ipns_unix.go', 'top_nesting_level': 0, 'length': 4, 'fan_in': 0, 'fan_out': 0, 'general_fan_out': 0}, {'cyclomatic_complexity': 5, 'nloc': 20, 'token_count': 167, 'name': 'loadRoot', 'long_name': 'loadRoot ctx context . Context , ipfs iface . CoreAPI , key iface . Key', 'start_line': 92, 'end_line': 114, 'full_parameters': ['ctx context . Context', ' ipfs iface . CoreAPI', ' key iface . Key'], 'filename': '/home/dimi/Documents/Informatik_Studium/FSS/SoftEvo/DataCollection/FFS_SoftEvo/go-ipfs/fuse/ipns/ipns_unix.go', 'top_nesting_level': 0, 'length': 23, 'fan_in': 0, 'fan_out': 0, 'general_fan_out': 0}, {'cyclomatic_complexity': 3, 'nloc': 26, 'token_count': 175, 'name': 'CreateRoot', 'long_name': 'CreateRoot ctx context . Context , ipfs iface . CoreAPI , keys map [ string ] iface . Key , ipfspath , ipnspath string', 'start_line': 116, 'end_line': 146, 'full_parameters': ['ctx context . Context', ' ipfs iface . CoreAPI', ' keys map [ string ] iface . Key', ' ipfspath', ' ipnspath string'], 'filename': '/home/dimi/Documents/Informatik_Studium/FSS/SoftEvo/DataCollection/FFS_SoftEvo/go-ipfs/fuse/ipns/ipns_unix.go', 'top_nesting_level': 0, 'length': 31, 'fan_in': 0, 'fan_out': 0, 'general_fan_out': 0}, {'cyclomatic_complexity': 1, 'nloc': 1, 'token_count': 2, 'name': '', 'long_name': '(', 'start_line': 149, 'end_line': 149, 'full_parameters': [], 'filename': '/home/dimi/Documents/Informatik_Studium/FSS/SoftEvo/DataCollection/FFS_SoftEvo/go-ipfs/fuse/ipns/ipns_unix.go', 'top_nesting_level': 0, 'length': 1, 'fan_in': 0, 'fan_out': 0, 'general_fan_out': 0}, {'cyclomatic_complexity': 1, 'nloc': 3, 'token_count': 15, 'name': '', 'long_name': '()', 'start_line': 352, 'end_line': 354, 'full_parameters': [], 'filename': '/home/dimi/Documents/Informatik_Studium/FSS/SoftEvo/DataCollection/FFS_SoftEvo/go-ipfs/fuse/ipns/ipns_unix.go', 'top_nesting_level': 0, 'length': 3, 'fan_in': 0, 'fan_out': 0, 'general_fan_out': 0}, {'cyclomatic_complexity': 1, 'nloc': 3, 'token_count': 15, 'name': '', 'long_name': '()', 'start_line': 384, 'end_line': 386, 'full_parameters': [], 'filename': '/home/dimi/Documents/Informatik_Studium/FSS/SoftEvo/DataCollection/FFS_SoftEvo/go-ipfs/fuse/ipns/ipns_unix.go', 'top_nesting_level': 0, 'length': 3, 'fan_in': 0, 'fan_out': 0, 'general_fan_out': 0}]",-42,-148,0,73,73,"[{'timestamp': 1512365669.0, 'added_lines': 2, 'deleted_lines': 2, 'nloc': 494}, {'timestamp': 1516838128.0, 'added_lines': 2, 'deleted_lines': 2, 'nloc': 494}, {'timestamp': 1517453697.0, 'added_lines': 2, 'deleted_lines': 2, 'nloc': 494}, {'timestamp': 1519404450.0, 'added_lines': 1, 'deleted_lines': 1, 'nloc': 494}, {'timestamp': 1519855044.0, 'added_lines': 1, 'deleted_lines': 1, 'nloc': 494}, {'timestamp': 1521399286.0, 'added_lines': 1, 'deleted_lines': 1, 'nloc': 494}, {'timestamp': 1525408792.0, 'added_lines': 3, 'deleted_lines': 3, 'nloc': 494}, {'timestamp': 1528006520.0, 'added_lines': 2, 'deleted_lines': 2, 'nloc': 494}, {'timestamp': 1528520460.0, 'added_lines': 5, 'deleted_lines': 5, 'nloc': 494}, {'timestamp': 1529984485.0, 'added_lines': 2, 'deleted_lines': 2, 'nloc': 494}, {'timestamp': 1530280654.0, 'added_lines': 1, 'deleted_lines': 8, 'nloc': 487}, {'timestamp': 1531779409.0, 'added_lines': 1, 'deleted_lines': 1, 'nloc': 487}, {'timestamp': 1532764253.0, 'added_lines': 1, 'deleted_lines': 1, 'nloc': 487}, {'timestamp': 1532847462.0, 'added_lines': 1, 'deleted_lines': 1, 'nloc': 487}, {'timestamp': 1532986515.0, 'added_lines': 1, 'deleted_lines': 1, 'nloc': 487}, {'timestamp': 1533500571.0, 'added_lines': 3, 'deleted_lines': 3, 'nloc': 487}, {'timestamp': 1533618653.0, 'added_lines': 3, 'deleted_lines': 3, 'nloc': 487}, {'timestamp': 1533779477.0, 'added_lines': 6, 'deleted_lines': 6, 'nloc': 487}, {'timestamp': 1533946888.0, 'added_lines': 1, 'deleted_lines': 1, 'nloc': 487}, {'timestamp': 1534115707.0, 'added_lines': 4, 'deleted_lines': 4, 'nloc': 487}, {'timestamp': 1534195762.0, 'added_lines': 3, 'deleted_lines': 3, 'nloc': 487}, {'timestamp': 1534347022.0, 'added_lines': 4, 'deleted_lines': 4, 'nloc': 487}, {'timestamp': 1533141008.0, 'added_lines': 2, 'deleted_lines': 1, 'nloc': 488}, {'timestamp': 1534358994.0, 'added_lines': 2, 'deleted_lines': 2, 'nloc': 488}, {'timestamp': 1534771694.0, 'added_lines': 1, 'deleted_lines': 1, 'nloc': 488}, {'timestamp': 1534896611.0, 'added_lines': 6, 'deleted_lines': 6, 'nloc': 488}, {'timestamp': 1535601896.0, 'added_lines': 4, 'deleted_lines': 4, 'nloc': 488}, {'timestamp': 1536388808.0, 'added_lines': 4, 'deleted_lines': 4, 'nloc': 488}, {'timestamp': 1536718784.0, 'added_lines': 6, 'deleted_lines': 6, 'nloc': 488}, {'timestamp': 1536723292.0, 'added_lines': 4, 'deleted_lines': 4, 'nloc': 488}, {'timestamp': 1537790637.0, 'added_lines': 4, 'deleted_lines': 4, 'nloc': 488}, {'timestamp': 1537792589.0, 'added_lines': 6, 'deleted_lines': 6, 'nloc': 488}, {'timestamp': 1538544957.0, 'added_lines': 4, 'deleted_lines': 4, 'nloc': 488}, {'timestamp': 1538694687.0, 'added_lines': 4, 'deleted_lines': 4, 'nloc': 488}, {'timestamp': 1538695953.0, 'added_lines': 4, 'deleted_lines': 4, 'nloc': 488}, {'timestamp': 1538773916.0, 'added_lines': 4, 'deleted_lines': 4, 'nloc': 488}, {'timestamp': 1539176817.0, 'added_lines': 4, 'deleted_lines': 4, 'nloc': 488}, {'timestamp': 1539357340.0, 'added_lines': 4, 'deleted_lines': 4, 'nloc': 488}, {'timestamp': 1539850591.0, 'added_lines': 2, 'deleted_lines': 2, 'nloc': 488}, {'timestamp': 1540400358.0, 'added_lines': 5, 'deleted_lines': 5, 'nloc': 488}, {'timestamp': 1540410565.0, 'added_lines': 4, 'deleted_lines': 4, 'nloc': 488}, {'timestamp': 1540418491.0, 'added_lines': 4, 'deleted_lines': 4, 'nloc': 488}, {'timestamp': 1540603818.0, 'added_lines': 4, 'deleted_lines': 4, 'nloc': 488}, {'timestamp': 1540916861.0, 'added_lines': 2, 'deleted_lines': 2, 'nloc': 488}, {'timestamp': 1541106379.0, 'added_lines': 2, 'deleted_lines': 2, 'nloc': 488}, {'timestamp': 1541189794.0, 'added_lines': 4, 'deleted_lines': 4, 'nloc': 488}, {'timestamp': 1541204121.0, 'added_lines': 8, 'deleted_lines': 8, 'nloc': 488}, {'timestamp': 1541903826.0, 'added_lines': 4, 'deleted_lines': 4, 'nloc': 488}, {'timestamp': 1543443696.0, 'added_lines': 4, 'deleted_lines': 4, 'nloc': 488}, {'timestamp': 1544225843.0, 'added_lines': 5, 'deleted_lines': 5, 'nloc': 488}, {'timestamp': 1540556089.0, 'added_lines': 2, 'deleted_lines': 2, 'nloc': 488}, {'timestamp': 1547003974.0, 'added_lines': 4, 'deleted_lines': 4, 'nloc': 488}, {'timestamp': 1547005544.0, 'added_lines': 16, 'deleted_lines': 30, 'nloc': 474}, {'timestamp': 1547499910.0, 'added_lines': 4, 'deleted_lines': 4, 'nloc': 474}, {'timestamp': 1548866534.0, 'added_lines': 2, 'deleted_lines': 2, 'nloc': 474}, {'timestamp': 1549588289.0, 'added_lines': 5, 'deleted_lines': 5, 'nloc': 474}, {'timestamp': 1549903582.0, 'added_lines': 2, 'deleted_lines': 2, 'nloc': 474}, {'timestamp': 1550185115.0, 'added_lines': 4, 'deleted_lines': 4, 'nloc': 474}, {'timestamp': 1550507829.0, 'added_lines': 7, 'deleted_lines': 7, 'nloc': 474}, {'timestamp': 1550711994.0, 'added_lines': 4, 'deleted_lines': 4, 'nloc': 474}, {'timestamp': 1550723346.0, 'added_lines': 5, 'deleted_lines': 5, 'nloc': 474}, {'timestamp': 1551229859.0, 'added_lines': 5, 'deleted_lines': 5, 'nloc': 474}, {'timestamp': 1551299964.0, 'added_lines': 4, 'deleted_lines': 4, 'nloc': 474}, {'timestamp': 1551551196.0, 'added_lines': 11, 'deleted_lines': 11, 'nloc': 474}, {'timestamp': 1554256305.0, 'added_lines': 3, 'deleted_lines': 1, 'nloc': 475}, {'timestamp': 1554303405.0, 'added_lines': 2, 'deleted_lines': 2, 'nloc': 475}, {'timestamp': 1559060517.0, 'added_lines': 2, 'deleted_lines': 2, 'nloc': 475}, {'timestamp': 1563668276.0, 'added_lines': 1, 'deleted_lines': 1, 'nloc': 475}, {'timestamp': 1563837872.0, 'added_lines': 1, 'deleted_lines': 1, 'nloc': 475}, {'timestamp': 1579218500.0, 'added_lines': 1, 'deleted_lines': 1, 'nloc': 475}, {'timestamp': 1566440221.0, 'added_lines': 36, 'deleted_lines': 64, 'nloc': 452}, {'timestamp': 1589935098.0, 'added_lines': 1, 'deleted_lines': 1, 'nloc': 452}, {'timestamp': 1600726105.0, 'added_lines': 1, 'deleted_lines': 1, 'nloc': 452}]","{'assets/assets.go': 48, 'blocks/blockstore/arc_cache.go': 2, 'blocks/blockstore/arc_cache_test.go': 2, 'blocks/blockstore/blockstore.go': 3, 'blocks/blockstore/blockstore_test.go': 2, 'blocks/blockstore/bloom_cache.go': 2, 'blocks/blockstore/bloom_cache_test.go': 2, 'blocks/blockstore/util/remove.go': 2, 'blocks/blocksutil/block_generator.go': 2, 'blockservice/blockservice.go': 7, 'blockservice/blockservice_test.go': 6, 'blockservice/test/blocks_test.go': 6, 'cmd/ipfs/daemon.go': 22, 'cmd/ipfs/init.go': 25, 'cmd/ipfs/ipfs.go': 18, 'cmd/ipfs/main.go': 26, 'cmd/ipfs/main_test.go': 1, 'cmd/ipfswatch/main.go': 19, 'cmd/seccat/seccat.go': 27, 'commands/command.go': 12, 'commands/command_test.go': 3, 'commands/request.go': 16, 'commands/response.go': 7, 'commands/response_test.go': 3, 'core/bootstrap.go': 23, 'core/bootstrap_test.go': 23, 'core/builder.go': 56, 'core/commands/active.go': 11, 'core/commands/add.go': 41, 'core/commands/bitswap.go': 48, 'core/commands/block.go': 25, 'core/commands/bootstrap.go': 21, 'core/commands/cat.go': 24, 'core/commands/commands.go': 18, 'core/commands/config.go': 22, 'core/commands/dag/dag.go': 51, 'core/commands/dht.go': 55, 'core/commands/dht_test.go': 23, 'core/commands/diag.go': 11, 'core/commands/dns.go': 19, 'core/commands/external.go': 11, 'core/commands/files/files.go': 3, 'core/commands/filestore.go': 23, 'core/commands/get.go': 55, 'core/commands/get_test.go': 18, 'core/commands/helptext_test.go': 18, 'core/commands/id.go': 37, 'core/commands/ipns.go': 13, 'core/commands/ipnsps.go': 6, 'core/commands/keystore.go': 22, 'core/commands/log.go': 17, 'core/commands/ls.go': 52, 'core/commands/mount_nofuse.go': 11, 'core/commands/mount_unix.go': 21, 'core/commands/mount_windows.go': 11, 'core/commands/name.go': 4, 'core/commands/object/diff.go': 17, 'core/commands/object/object.go': 53, 'core/commands/object/patch.go': 24, 'core/commands/p2p.go': 25, 'core/commands/pin.go': 53, 'core/commands/ping.go': 31, 'core/commands/publish.go': 16, 'core/commands/pubsub.go': 32, 'core/commands/refs.go': 50, 'core/commands/repo.go': 36, 'core/commands/resolve.go': 49, 'core/commands/root.go': 18, 'core/commands/shutdown.go': 14, 'core/commands/stat.go': 23, 'core/commands/swarm.go': 33, 'core/commands/sysdiag.go': 17, 'core/commands/tar.go': 49, 'core/commands/unixfs/ls.go': 49, 'core/commands/unixfs/unixfs.go': 11, 'core/commands/version.go': 12, 'core/core.go': 59, 'core/coreapi/coreapi.go': 25, 'core/coreapi/interface/interface.go': 2, 'core/coreapi/unixfs.go': 50, 'core/coreapi/unixfs_test.go': 41, 'core/coredag/cbor.go': 17, 'core/coredag/dagpb.go': 43, 'core/coredag/dagtransl.go': 13, 'core/coredag/raw.go': 43, 'core/corehttp/commands.go': 52, 'core/corehttp/corehttp.go': 14, 'core/corehttp/gateway.go': 32, 'core/corehttp/gateway_handler.go': 58, 'core/corehttp/gateway_test.go': 51, 'core/corehttp/metrics_test.go': 31, 'core/corerepo/gc.go': 52, 'core/corerepo/pinning.go': 21, 'core/coreunix/add.go': 56, 'core/coreunix/add_test.go': 50, 'core/coreunix/metadata.go': 50, 'core/coreunix/metadata_test.go': 52, 'core/mock/mock.go': 32, 'core/pathresolver.go': 49, 'exchange/bitswap/bitswap.go': 7, 'exchange/bitswap/bitswap_test.go': 7, 'exchange/bitswap/decision/bench_test.go': 7, 'exchange/bitswap/decision/engine.go': 7, 'exchange/bitswap/decision/engine_test.go': 7, 'exchange/bitswap/decision/ledger.go': 7, 'exchange/bitswap/decision/peer_request_queue.go': 7, 'exchange/bitswap/decision/peer_request_queue_test.go': 7, 'exchange/bitswap/get.go': 6, 'exchange/bitswap/message/message.go': 7, 'exchange/bitswap/message/message_test.go': 4, 'exchange/bitswap/network/interface.go': 7, 'exchange/bitswap/network/ipfs_impl.go': 7, 'exchange/bitswap/notifications/notifications.go': 4, 'exchange/bitswap/notifications/notifications_test.go': 4, 'exchange/bitswap/session.go': 7, 'exchange/bitswap/session_test.go': 6, 'exchange/bitswap/stat.go': 4, 'exchange/bitswap/testnet/interface.go': 6, 'exchange/bitswap/testnet/network_test.go': 7, 'exchange/bitswap/testnet/peernet.go': 7, 'exchange/bitswap/testnet/virtual.go': 8, 'exchange/bitswap/testutils.go': 7, 'exchange/bitswap/wantlist/wantlist.go': 4, 'exchange/bitswap/wantlist/wantlist_test.go': 4, 'exchange/bitswap/wantmanager.go': 7, 'exchange/bitswap/workers.go': 7, 'exchange/interface.go': 2, 'exchange/offline/offline.go': 2, 'exchange/offline/offline_test.go': 2, 'exchange/reprovide/providers.go': 45, 'exchange/reprovide/reprovide.go': 29, 'exchange/reprovide/reprovide_test.go': 32, 'filestore/filestore.go': 26, 'filestore/filestore_test.go': 45, 'filestore/fsrefstore.go': 25, 'filestore/util.go': 23, 'fuse/ipns/ipns_test.go': 36, 'fuse/node/mount_test.go': 34, 'fuse/readonly/ipfs_test.go': 59, 'fuse/readonly/readonly_unix.go': 60, 'importer/balanced/balanced_test.go': 8, 'importer/balanced/builder.go': 4, 'importer/chunk/rabin_test.go': 2, 'importer/chunk/splitting_test.go': 2, 'importer/helpers/dagbuilder.go': 7, 'importer/helpers/helpers.go': 5, 'importer/importer.go': 6, 'importer/importer_test.go': 7, 'importer/trickle/trickle_test.go': 8, 'importer/trickle/trickledag.go': 6, 'merkledag/batch.go': 2, 'merkledag/coding.go': 5, 'merkledag/merkledag.go': 5, 'merkledag/merkledag_test.go': 7, 'merkledag/node.go': 4, 'merkledag/node_test.go': 4, 'merkledag/raw.go': 4, 'merkledag/traverse/traverse.go': 4, 'merkledag/traverse/traverse_test.go': 4, 'merkledag/utils/diff.go': 4, 'merkledag/utils/diffenum.go': 4, 'merkledag/utils/diffenum_test.go': 4, 'merkledag/utils/utils.go': 6, 'merkledag/utils/utils_test.go': 4, 'mfs/dir.go': 13, 'mfs/file.go': 15, 'mfs/mfs_test.go': 18, 'mfs/ops.go': 12, 'mfs/repub_test.go': 10, 'mfs/system.go': 17, 'namesys/ipns_select_test.go': 4, 'namesys/namesys.go': 51, 'namesys/publisher.go': 55, 'namesys/publisher_test.go': 32, 'namesys/pubsub.go': 7, 'namesys/pubsub_test.go': 6, 'namesys/republisher/repub.go': 47, 'namesys/republisher/repub_test.go': 49, 'namesys/resolve_test.go': 51, 'namesys/routing.go': 51, 'p2p/p2p.go': 24, 'p2p/registry.go': 10, 'package.json': 56, 'path/path.go': 4, 'path/resolver.go': 3, 'path/resolver_test.go': 2, 'pin/gc/gc.go': 46, 'pin/pin.go': 47, 'pin/pin_test.go': 45, 'pin/set.go': 43, 'pin/set_test.go': 45, 'plugin/ipld.go': 13, 'plugin/loader/initializer.go': 10, 'plugin/plugins/git/git.go': 13, 'repo/config/bootstrap_peers.go': 7, 'repo/config/init.go': 8, 'repo/fsrepo/fsrepo.go': 25, 'repo/fsrepo/lock/lock.go': 3, 'repo/fsrepo/serialize/serialize.go': 4, 'repo/mock.go': 17, 'repo/repo.go': 21, 'routing/mock/centralized_client.go': 3, 'routing/mock/centralized_server.go': 3, 'routing/mock/centralized_test.go': 3, 'routing/mock/interface.go': 3, 'routing/none/none_client.go': 3, 'routing/offline/offline.go': 3, 'routing/offline/offline_test.go': 3, 'tar/format.go': 55, 'test/dependencies/ma-pipe-unidir/main.go': 9, 'test/integration/addcat_test.go': 33, 'test/integration/bench_cat_test.go': 33, 'test/integration/bench_test.go': 18, 'test/integration/bitswap_wo_routing_test.go': 34, 'test/integration/three_legged_cat_test.go': 33, 'thirdparty/ds-help/key.go': 2, 'thirdparty/pollEndpoint/main.go': 15, 'thirdparty/posinfo/posinfo.go': 2, 'unixfs/archive/archive.go': 5, 'unixfs/archive/tar/writer.go': 6, 'unixfs/hamt/hamt.go': 6, 'unixfs/io/dagreader.go': 6, 'unixfs/io/dirbuilder.go': 3, 'unixfs/io/resolve.go': 6, 'unixfs/mod/dagmodifier.go': 8, 'unixfs/mod/dagmodifier_test.go': 4, 'unixfs/test/utils.go': 9, 'commands/legacy/command.go': 11, 'commands/legacy/legacy.go': 11, 'commands/legacy/legacy_test.go': 11, 'commands/legacy/request.go': 12, 'commands/legacy/response.go': 11, 'core/commands/commands_test.go': 17, 'core/coreapi/dag.go': 12, 'core/coreapi/dag_test.go': 3, 'core/coreapi/interface/options/dag.go': 8, 'core/coreapi/key.go': 47, 'core/coreapi/name.go': 50, 'merkledag/test/utils.go': 5, 'namesys/namesys_test.go': 56, 'repo/fsrepo/datastores.go': 15, 'repo/fsrepo/fsrepo_test.go': 18, 'thirdparty/datastore2/datastore_closer.go': 1, 'thirdparty/datastore2/delayed.go': 1, 'thirdparty/datastore2/threadsafe.go': 1, 'unixfs/io/pbdagreader.go': 6, 'cmd/ipfs/util/ulimit.go': 9, 'cmd/seccat/util.go': 9, 'core/corehttp/logs.go': 9, 'fuse/mount/mount.go': 11, 'fuse/node/mount_unix.go': 12, 'importer/chunk/splitting.go': 1, 'namesys/ipns_validate_test.go': 5, 'plugin/loader/load.go': 7, 'core/corehttp/ipns_hostname.go': 10, 'namesys/base.go': 43, 'namesys/dns.go': 43, 'namesys/interface.go': 46, 'namesys/opts.go': 1, 'namesys/proquint.go': 43, 'namesys/dns_test.go': 10, None: 30, 'namesys/opts/opts.go': 1, 'core/coreapi/object.go': 49, 'fuse/mount/fuse.go': 8, 'keystore/keystore_test.go': 7, 'repo/config/config.go': 1, 'unixfs/unixfs.go': 3, 'blocks/blockstoreutil/remove.go': 21, 'blockservice/test/mock.go': 4, 'core/commands/files.go': 54, 'core/core_test.go': 17, 'core/coreapi/pin.go': 44, 'fuse/ipns/common.go': 49, 'keystore/keystore.go': 10, 'keystore/memkeystore.go': 6, 'namesys/validator.go': 2, 'path/resolver/resolver.go': 5, 'repo/config/identity.go': 2, 'thirdparty/verifbs/verifbs.go': 21, 'fuse/ipns/link_unix.go': 6, 'cmd/ipfs/util/ulimit_freebsd.go': 2, 'cmd/ipfs/util/ulimit_unix.go': 2, 'core/coreapi/block.go': 15, 'core/coreapi/block_test.go': 2, 'core/coreapi/interface/coreapi.go': 9, 'core/coreapi/interface/dag.go': 9, 'core/coreapi/interface/object.go': 9, 'core/coreapi/interface/options/block.go': 3, 'core/coreapi/interface/path.go': 35, 'core/coreapi/interface/unixfs.go': 13, 'fuse/node/mount_darwin.go': 2, 'merkledag/errservice.go': 2, 'merkledag/readonly.go': 2, 'merkledag/readonly_test.go': 2, 'merkledag/rwservice.go': 2, 'merkledag/session.go': 2, 'path/resolver/resolver_test.go': 3, 'thirdparty/verifcid/validate.go': 2, 'thirdparty/verifcid/validate_test.go': 2, 'unixfs/hamt/hamt_stress_test.go': 4, 'unixfs/hamt/hamt_test.go': 4, 'namesys/ipns_resolver_validation_test.go': 44, 'test/sharness/t0170-dht.sh': 1, 'core/commands/urlstore.go': 46, 'unixfs/io/directory.go': 3, 'Rules.mk': 1, 'dagutils/diff.go': 40, 'dagutils/diffenum.go': 39, 'dagutils/diffenum_test.go': 39, 'dagutils/utils.go': 41, 'dagutils/utils_test.go': 41, 'unixfs/io/dagreader_test.go': 2, 'unixfs/io/directory_test.go': 2, 'core/coreapi/name_test.go': 32, 'core/coreapi/path.go': 49, 'core/coreunix/cat.go': 16, 'core/pathresolver_test.go': 40, 'namesys/cache.go': 40, 'mfs/fd.go': 8, 'unixfs/importer/balanced/balanced_test.go': 1, 'unixfs/importer/balanced/builder.go': 1, 'unixfs/importer/helpers/dagbuilder.go': 1, 'unixfs/importer/helpers/helpers.go': 1, 'unixfs/importer/importer.go': 1, 'unixfs/importer/importer_test.go': 1, 'unixfs/importer/trickle/trickle_test.go': 1, 'unixfs/importer/trickle/trickledag.go': 1, 'unixfs/unixfs_test.go': 1, 'core/commands/env.go': 3, 'core/coreapi/interface/key.go': 7, 'filestore/pb/dataobj.pb.go': 3, 'pin/internal/pb/header.pb.go': 3, 'thirdparty/cidv0v1/blockstore.go': 16, 'repo/fsrepo/config_test.go': 13, 'repo/fsrepo/misc.go': 13, 'test/bench/bench_cli_ipfs_add/main.go': 13, 'test/bench/offline_add/main.go': 13, 'core/commands/cmdenv/env.go': 20, 'core/commands/name/ipns.go': 36, 'core/commands/name/publish.go': 19, 'core/coreapi/dht.go': 31, 'core/coreapi/dht_test.go': 5, 'test/sharness/t0275-cid-security.sh': 1, 'core/commands/name/ipnsps.go': 14, 'core/commands/name/name.go': 9, 'core/coreapi/interface/dht.go': 10, 'p2p/listener.go': 14, 'p2p/local.go': 15, 'p2p/remote.go': 14, 'p2p/stream.go': 14, 'core/coreapi/interface/swarm.go': 9, 'core/coreapi/swarm.go': 21, 'core/coreapi/interface/options/unixfs.go': 15, 'core/coreapi/pubsub.go': 19, 'core/coreapi/unixfile.go': 17, 'core/commands/cid.go': 9, 'cmd/ipfs/dnsresolve_test.go': 5, 'core/coreapi/interface/pubsub.go': 4, 'test/dependencies/iptb/iptb.go': 12, 'plugin/plugins/badgerds/badgerds.go': 3, 'plugin/plugins/flatfs/flatfs.go': 3, 'plugin/plugins/levelds/levelds.go': 3, 'commands/context.go': 13, 'core/corehttp/proxy.go': 10, 'core/coreapi/interface/tests/name.go': 4, 'core/coreapi/interface/tests/unixfs.go': 4, 'core/coreapi/test/api_test.go': 11, 'plugin/loader/loader.go': 9, 'core/commands/cmdenv/cidbase.go': 6, 'core/commands/cmdenv/file.go': 3, 'plugin/daemon.go': 8, 'core/commands/cmdenv/cidbase_test.go': 2, 'core/corehttp/metrics.go': 1, 'core/corehttp/proxy_test.go': 2, 'core/corerepo/stat.go': 1, 'plugin/tracer.go': 1, 'thirdparty/notifier/notifier.go': 1, 'namesys/resolve/pathresolver_test.go': 1, 'namesys/resolve/resolve.go': 2, 'core/node/builder.go': 2, 'core/node/core.go': 2, 'core/node/groups.go': 2, 'core/node/libp2p.go': 1, 'core/bootstrap/bootstrap.go': 2, 'core/bootstrap/bootstrap_test.go': 1, 'core/node/identity.go': 1, 'core/node/ipns.go': 1, 'core/node/libp2p/addrs.go': 1, 'core/node/libp2p/discovery.go': 2, 'core/node/libp2p/host.go': 1, 'core/node/libp2p/hostopt.go': 1, 'core/node/libp2p/libp2p.go': 1, 'core/node/libp2p/nat.go': 1, 'core/node/libp2p/pnet.go': 2, 'core/node/libp2p/pubsub.go': 1, 'core/node/libp2p/routing.go': 1, 'core/node/libp2p/routingopt.go': 1, 'core/node/libp2p/smux.go': 2, 'core/node/libp2p/transport.go': 2, 'core/node/provider.go': 1, 'go.mod': 2, 'go.sum': 2, 'provider/simple/provider.go': 1, 'provider/simple/provider_test.go': 1, 'provider/simple/reprovide.go': 1, 'provider/simple/reprovide_test.go': 1, 'fuse/node/mount_openbsd.go': 1, 'fuse/readonly/mount_unix.go': 2, 'mk/util.mk': 2, 'fuse/node/mount_notsupp.go': 2, 'plugin/loader/load_unix.go': 1, 'fuse/ipns/mount_unix.go': 1, 'test/sharness/t0030-mount.sh': 1, 'cmd/ipfs/util/ulimit_test.go': 1, 'cmd/ipfswatch/ipfswatch_test.go': 1, 'cmd/seccat/seccat_plan9.go': 1, 'cmd/seccat/seccat_posix.go': 1}","('fuse/readonly/readonly_unix.go', 0.821917808219178, 0.8695652173913043)"
fuse/ipns/link_unix.go,20,110,2,"[{'cyclomatic_complexity': 1, 'nloc': 5, 'token_count': 39, 'name': 'Attr', 'long_name': '(l*Link)Attr ctx context . Context , a * fuse . Attr', 'start_line': 17, 'end_line': 21, 'full_parameters': ['ctx context . Context', ' a * fuse . Attr'], 'filename': '/home/dimi/Documents/Informatik_Studium/FSS/SoftEvo/DataCollection/FFS_SoftEvo/go-ipfs/fuse/ipns/link_unix.go', 'top_nesting_level': 0, 'length': 5, 'fan_in': 0, 'fan_out': 0, 'general_fan_out': 0}, {'cyclomatic_complexity': 1, 'nloc': 4, 'token_count': 42, 'name': 'Readlink', 'long_name': '(l*Link)Readlink ctx context . Context , req * fuse . ReadlinkRequest', 'start_line': 23, 'end_line': 26, 'full_parameters': ['ctx context . Context', ' req * fuse . ReadlinkRequest'], 'filename': '/home/dimi/Documents/Informatik_Studium/FSS/SoftEvo/DataCollection/FFS_SoftEvo/go-ipfs/fuse/ipns/link_unix.go', 'top_nesting_level': 0, 'length': 4, 'fan_in': 0, 'fan_out': 0, 'general_fan_out': 0}]",20,110,2,"[{'cyclomatic_complexity': 1, 'nloc': 5, 'token_count': 39, 'name': 'Attr', 'long_name': '(l*Link)Attr ctx context . Context , a * fuse . Attr', 'start_line': 17, 'end_line': 21, 'full_parameters': ['ctx context . Context', ' a * fuse . Attr'], 'filename': '/home/dimi/Documents/Informatik_Studium/FSS/SoftEvo/DataCollection/FFS_SoftEvo/go-ipfs/fuse/ipns/link_unix.go', 'top_nesting_level': 0, 'length': 5, 'fan_in': 0, 'fan_out': 0, 'general_fan_out': 0}, {'cyclomatic_complexity': 1, 'nloc': 4, 'token_count': 42, 'name': 'Readlink', 'long_name': '(l*Link)Readlink ctx context . Context , req * fuse . ReadlinkRequest', 'start_line': 23, 'end_line': 26, 'full_parameters': ['ctx context . Context', ' req * fuse . ReadlinkRequest'], 'filename': '/home/dimi/Documents/Informatik_Studium/FSS/SoftEvo/DataCollection/FFS_SoftEvo/go-ipfs/fuse/ipns/link_unix.go', 'top_nesting_level': 0, 'length': 4, 'fan_in': 0, 'fan_out': 0, 'general_fan_out': 0}]",0,0,0,6,6,"[{'timestamp': 1528006520.0, 'added_lines': 2, 'deleted_lines': 2, 'nloc': 20}, {'timestamp': 1528520460.0, 'added_lines': 2, 'deleted_lines': 2, 'nloc': 20}, {'timestamp': 1551551196.0, 'added_lines': 2, 'deleted_lines': 2, 'nloc': 20}, {'timestamp': 1563668276.0, 'added_lines': 1, 'deleted_lines': 1, 'nloc': 20}, {'timestamp': 1563837872.0, 'added_lines': 1, 'deleted_lines': 1, 'nloc': 20}, {'timestamp': 1600726105.0, 'added_lines': 1, 'deleted_lines': 1, 'nloc': 20}]","{'cmd/ipfswatch/main.go': 4, 'fuse/ipns/ipns_test.go': 6, 'fuse/ipns/ipns_unix.go': 6, 'fuse/mount/fuse.go': 6, 'fuse/readonly/ipfs_test.go': 6, 'fuse/readonly/readonly_unix.go': 5, 'package.json': 2, 'assets/assets.go': 2, 'blocks/blockstoreutil/remove.go': 2, 'blockservice/blockservice.go': 1, 'blockservice/blockservice_test.go': 1, 'blockservice/test/blocks_test.go': 1, 'blockservice/test/mock.go': 1, 'cmd/ipfs/daemon.go': 2, 'cmd/ipfs/init.go': 2, 'cmd/ipfs/ipfs.go': 2, 'cmd/ipfs/main.go': 2, 'cmd/ipfs/util/ulimit.go': 2, 'cmd/ipfs/util/ulimit_freebsd.go': 2, 'cmd/ipfs/util/ulimit_unix.go': 2, 'cmd/seccat/seccat.go': 3, 'cmd/seccat/util.go': 2, 'commands/command.go': 1, 'commands/legacy/command.go': 1, 'commands/legacy/legacy.go': 1, 'commands/legacy/legacy_test.go': 1, 'commands/legacy/request.go': 1, 'commands/legacy/response.go': 1, 'commands/request.go': 1, 'commands/response.go': 1, 'core/bootstrap.go': 2, 'core/bootstrap_test.go': 2, 'core/builder.go': 2, 'core/commands/active.go': 2, 'core/commands/add.go': 3, 'core/commands/bitswap.go': 2, 'core/commands/block.go': 2, 'core/commands/bootstrap.go': 2, 'core/commands/cat.go': 2, 'core/commands/commands.go': 2, 'core/commands/commands_test.go': 2, 'core/commands/config.go': 2, 'core/commands/dag/dag.go': 3, 'core/commands/dht.go': 2, 'core/commands/dht_test.go': 2, 'core/commands/diag.go': 2, 'core/commands/dns.go': 2, 'core/commands/external.go': 2, 'core/commands/files.go': 2, 'core/commands/filestore.go': 2, 'core/commands/get.go': 3, 'core/commands/get_test.go': 2, 'core/commands/helptext_test.go': 2, 'core/commands/id.go': 2, 'core/commands/ipns.go': 1, 'core/commands/ipnsps.go': 1, 'core/commands/keystore.go': 2, 'core/commands/log.go': 2, 'core/commands/ls.go': 2, 'core/commands/mount_nofuse.go': 2, 'core/commands/mount_unix.go': 2, 'core/commands/mount_windows.go': 2, 'core/commands/name.go': 1, 'core/commands/object/diff.go': 2, 'core/commands/object/object.go': 2, 'core/commands/object/patch.go': 2, 'core/commands/p2p.go': 2, 'core/commands/pin.go': 2, 'core/commands/ping.go': 2, 'core/commands/publish.go': 1, 'core/commands/pubsub.go': 2, 'core/commands/refs.go': 2, 'core/commands/repo.go': 2, 'core/commands/resolve.go': 2, 'core/commands/root.go': 2, 'core/commands/shutdown.go': 2, 'core/commands/stat.go': 2, 'core/commands/swarm.go': 2, 'core/commands/sysdiag.go': 2, 'core/commands/tar.go': 2, 'core/commands/unixfs/ls.go': 2, 'core/commands/unixfs/unixfs.go': 2, 'core/commands/version.go': 2, 'core/core.go': 2, 'core/coreapi/block.go': 2, 'core/coreapi/block_test.go': 1, 'core/coreapi/coreapi.go': 2, 'core/coreapi/dag.go': 2, 'core/coreapi/dag_test.go': 1, 'core/coreapi/interface/coreapi.go': 1, 'core/coreapi/interface/dag.go': 1, 'core/coreapi/interface/object.go': 1, 'core/coreapi/interface/options/block.go': 1, 'core/coreapi/interface/options/dag.go': 1, 'core/coreapi/interface/path.go': 1, 'core/coreapi/interface/unixfs.go': 1, 'core/coreapi/key.go': 2, 'core/coreapi/name.go': 2, 'core/coreapi/object.go': 2, 'core/coreapi/pin.go': 2, 'core/coreapi/unixfs.go': 2, 'core/coreapi/unixfs_test.go': 1, 'core/coredag/cbor.go': 2, 'core/coredag/dagpb.go': 2, 'core/coredag/dagtransl.go': 2, 'core/coredag/raw.go': 2, 'core/corehttp/commands.go': 2, 'core/corehttp/corehttp.go': 2, 'core/corehttp/gateway.go': 2, 'core/corehttp/gateway_handler.go': 2, 'core/corehttp/gateway_test.go': 2, 'core/corehttp/logs.go': 2, 'core/corehttp/metrics_test.go': 2, 'core/corerepo/gc.go': 2, 'core/corerepo/pinning.go': 1, 'core/coreunix/add.go': 2, 'core/coreunix/add_test.go': 2, 'core/coreunix/metadata.go': 2, 'core/coreunix/metadata_test.go': 2, 'core/mock/mock.go': 2, 'core/pathresolver.go': 2, 'exchange/bitswap/bitswap.go': 1, 'exchange/bitswap/bitswap_test.go': 1, 'exchange/bitswap/decision/bench_test.go': 1, 'exchange/bitswap/decision/engine.go': 1, 'exchange/bitswap/decision/engine_test.go': 1, 'exchange/bitswap/decision/ledger.go': 1, 'exchange/bitswap/decision/peer_request_queue.go': 1, 'exchange/bitswap/decision/peer_request_queue_test.go': 1, 'exchange/bitswap/get.go': 1, 'exchange/bitswap/message/message.go': 1, 'exchange/bitswap/message/message_test.go': 1, 'exchange/bitswap/network/interface.go': 1, 'exchange/bitswap/network/ipfs_impl.go': 1, 'exchange/bitswap/notifications/notifications.go': 1, 'exchange/bitswap/notifications/notifications_test.go': 1, 'exchange/bitswap/session.go': 1, 'exchange/bitswap/session_test.go': 1, 'exchange/bitswap/stat.go': 1, 'exchange/bitswap/testnet/interface.go': 1, 'exchange/bitswap/testnet/network_test.go': 1, 'exchange/bitswap/testnet/peernet.go': 1, 'exchange/bitswap/testnet/virtual.go': 1, 'exchange/bitswap/testutils.go': 1, 'exchange/bitswap/wantlist/wantlist.go': 1, 'exchange/bitswap/wantlist/wantlist_test.go': 1, 'exchange/bitswap/wantmanager.go': 1, 'exchange/bitswap/workers.go': 1, 'exchange/reprovide/providers.go': 2, 'exchange/reprovide/reprovide.go': 2, 'exchange/reprovide/reprovide_test.go': 2, 'filestore/filestore.go': 2, 'filestore/filestore_test.go': 2, 'filestore/fsrefstore.go': 2, 'filestore/util.go': 2, 'fuse/mount/mount.go': 2, 'fuse/node/mount_darwin.go': 2, 'fuse/node/mount_test.go': 5, 'fuse/node/mount_unix.go': 5, 'importer/balanced/balanced_test.go': 1, 'importer/balanced/builder.go': 1, 'importer/helpers/dagbuilder.go': 1, 'importer/helpers/helpers.go': 1, 'importer/importer.go': 1, 'importer/importer_test.go': 1, 'importer/trickle/trickle_test.go': 1, 'importer/trickle/trickledag.go': 1, 'keystore/keystore.go': 2, 'merkledag/coding.go': 1, 'merkledag/errservice.go': 1, 'merkledag/merkledag.go': 1, 'merkledag/merkledag_test.go': 1, 'merkledag/node.go': 1, 'merkledag/node_test.go': 1, 'merkledag/raw.go': 1, 'merkledag/readonly.go': 1, 'merkledag/readonly_test.go': 1, 'merkledag/rwservice.go': 1, 'merkledag/session.go': 1, 'merkledag/test/utils.go': 1, 'merkledag/traverse/traverse.go': 1, 'merkledag/traverse/traverse_test.go': 1, 'merkledag/utils/diff.go': 1, 'merkledag/utils/diffenum.go': 1, 'merkledag/utils/diffenum_test.go': 1, 'merkledag/utils/utils.go': 1, 'merkledag/utils/utils_test.go': 1, 'mfs/dir.go': 1, 'mfs/file.go': 1, 'mfs/mfs_test.go': 1, 'mfs/ops.go': 1, 'mfs/repub_test.go': 1, 'mfs/system.go': 1, 'namesys/ipns_select_test.go': 1, 'namesys/ipns_validate_test.go': 1, 'namesys/namesys.go': 2, 'namesys/namesys_test.go': 2, 'namesys/publisher.go': 2, 'namesys/publisher_test.go': 2, 'namesys/republisher/repub.go': 2, 'namesys/republisher/repub_test.go': 2, 'namesys/resolve_test.go': 2, 'namesys/routing.go': 2, 'namesys/validator.go': 1, 'p2p/p2p.go': 2, 'p2p/registry.go': 1, 'path/path.go': 1, 'path/resolver/resolver.go': 1, 'path/resolver/resolver_test.go': 1, 'pin/gc/gc.go': 2, 'pin/pin.go': 2, 'pin/pin_test.go': 2, 'pin/set.go': 2, 'pin/set_test.go': 2, 'plugin/ipld.go': 2, 'plugin/loader/initializer.go': 1, 'plugin/loader/load.go': 1, 'plugin/plugins/git/git.go': 2, 'repo/config/bootstrap_peers.go': 1, 'repo/config/init.go': 1, 'repo/fsrepo/datastores.go': 2, 'repo/fsrepo/fsrepo.go': 2, 'repo/fsrepo/serialize/serialize.go': 1, 'repo/mock.go': 2, 'repo/repo.go': 2, 'tar/format.go': 2, 'test/dependencies/ma-pipe-unidir/main.go': 2, 'test/integration/addcat_test.go': 2, 'test/integration/bench_cat_test.go': 2, 'test/integration/bench_test.go': 2, 'test/integration/bitswap_wo_routing_test.go': 2, 'test/integration/three_legged_cat_test.go': 2, 'thirdparty/pollEndpoint/main.go': 2, 'thirdparty/verifbs/verifbs.go': 2, 'thirdparty/verifcid/validate.go': 1, 'thirdparty/verifcid/validate_test.go': 1, 'unixfs/archive/archive.go': 1, 'unixfs/archive/tar/writer.go': 1, 'unixfs/hamt/hamt.go': 1, 'unixfs/hamt/hamt_stress_test.go': 1, 'unixfs/hamt/hamt_test.go': 1, 'unixfs/io/dagreader.go': 1, 'unixfs/io/dirbuilder.go': 1, 'unixfs/io/pbdagreader.go': 1, 'unixfs/io/resolve.go': 1, 'unixfs/mod/dagmodifier.go': 1, 'unixfs/mod/dagmodifier_test.go': 1, 'unixfs/test/utils.go': 1, 'cmd/ipfs/dnsresolve_test.go': 1, 'commands/context.go': 1, 'core/commands/cid.go': 1, 'core/commands/cmdenv/cidbase.go': 1, 'core/commands/cmdenv/cidbase_test.go': 1, 'core/commands/cmdenv/env.go': 1, 'core/commands/cmdenv/file.go': 1, 'core/commands/name/ipns.go': 1, 'core/commands/name/ipnsps.go': 1, 'core/commands/name/name.go': 1, 'core/commands/name/publish.go': 1, 'core/commands/urlstore.go': 1, 'core/core_test.go': 1, 'core/coreapi/dht.go': 1, 'core/coreapi/path.go': 1, 'core/coreapi/pubsub.go': 1, 'core/coreapi/swarm.go': 1, 'core/coreapi/test/api_test.go': 1, 'core/corehttp/ipns_hostname.go': 1, 'core/corehttp/metrics.go': 1, 'core/corehttp/proxy.go': 1, 'core/corehttp/proxy_test.go': 1, 'core/corerepo/stat.go': 1, 'core/pathresolver_test.go': 1, 'dagutils/diff.go': 1, 'dagutils/diffenum.go': 1, 'dagutils/diffenum_test.go': 1, 'dagutils/utils.go': 1, 'dagutils/utils_test.go': 1, 'filestore/pb/dataobj.pb.go': 1, 'fuse/ipns/common.go': 1, 'keystore/keystore_test.go': 1, 'keystore/memkeystore.go': 1, 'namesys/base.go': 1, 'namesys/cache.go': 1, 'namesys/dns.go': 1, 'namesys/dns_test.go': 1, 'namesys/interface.go': 1, 'namesys/ipns_resolver_validation_test.go': 1, 'namesys/proquint.go': 1, 'p2p/listener.go': 1, 'p2p/local.go': 1, 'p2p/remote.go': 1, 'p2p/stream.go': 1, 'pin/internal/pb/header.pb.go': 1, 'plugin/daemon.go': 1, 'plugin/loader/loader.go': 1, 'plugin/plugins/badgerds/badgerds.go': 1, 'plugin/plugins/flatfs/flatfs.go': 1, 'plugin/plugins/levelds/levelds.go': 1, 'plugin/tracer.go': 1, 'repo/fsrepo/config_test.go': 1, 'repo/fsrepo/fsrepo_test.go': 1, 'repo/fsrepo/misc.go': 1, 'test/bench/bench_cli_ipfs_add/main.go': 1, 'test/bench/offline_add/main.go': 1, 'test/dependencies/iptb/iptb.go': 1, 'thirdparty/cidv0v1/blockstore.go': 1, 'thirdparty/notifier/notifier.go': 1, 'fuse/node/mount_openbsd.go': 1, 'fuse/readonly/mount_unix.go': 2, 'mk/util.mk': 2, 'fuse/node/mount_notsupp.go': 2, 'cmd/ipfs/util/ulimit_test.go': 1, 'cmd/ipfswatch/ipfswatch_test.go': 1, 'cmd/seccat/seccat_plan9.go': 1, 'cmd/seccat/seccat_posix.go': 1, 'go.mod': 1, 'go.sum': 1}","('fuse/ipns/ipns_test.go', 1.0, 0.11538461538461539)"
fuse/ipns/mount_unix.go,17,103,1,"[{'cyclomatic_complexity': 3, 'nloc': 12, 'token_count': 94, 'name': 'Mount', 'long_name': 'Mount ipfs * core . IpfsNode , ipnsmp , ipfsmp string', 'start_line': 12, 'end_line': 26, 'full_parameters': ['ipfs * core . IpfsNode', ' ipnsmp', ' ipfsmp string'], 'filename': '/home/dimi/Documents/Informatik_Studium/FSS/SoftEvo/DataCollection/FFS_SoftEvo/go-ipfs/fuse/ipns/mount_unix.go', 'top_nesting_level': 0, 'length': 15, 'fan_in': 0, 'fan_out': 0, 'general_fan_out': 0}]",22,125,1,"[{'cyclomatic_complexity': 4, 'nloc': 16, 'token_count': 114, 'name': 'Mount', 'long_name': 'Mount ipfs * core . IpfsNode , ipnsmp , ipfsmp string', 'start_line': 13, 'end_line': 32, 'full_parameters': ['ipfs * core . IpfsNode', ' ipnsmp', ' ipfsmp string'], 'filename': '/home/dimi/Documents/Informatik_Studium/FSS/SoftEvo/DataCollection/FFS_SoftEvo/go-ipfs/fuse/ipns/mount_unix.go', 'top_nesting_level': 0, 'length': 20, 'fan_in': 0, 'fan_out': 0, 'general_fan_out': 0}]",5,22,0,2,2,"[{'timestamp': 1553871352.0, 'added_lines': 1, 'deleted_lines': 1, 'nloc': 17}, {'timestamp': 1566440221.0, 'added_lines': 7, 'deleted_lines': 1, 'nloc': 22}]","{'cmd/ipfs/daemon.go': 1, 'core/builder.go': 1, 'core/commands/shutdown.go': 1, 'core/core.go': 1, 'core/corehttp/corehttp.go': 1, 'core/ncore.go': 1, 'fuse/readonly/mount_unix.go': 1, 'fuse/ipns/ipns_test.go': 1, 'fuse/ipns/ipns_unix.go': 1}","('core/core.go', 0.5, 0.00558659217877095)"
fuse/mount/fuse.go,114,628,9,"[{'cyclomatic_complexity': 4, 'nloc': 26, 'token_count': 155, 'name': 'NewMount', 'long_name': 'NewMount p goprocess . Process , fsys fs . FS , mountpoint string , allow_other bool', 'start_line': 33, 'end_line': 64, 'full_parameters': ['p goprocess . Process', ' fsys fs . FS', ' mountpoint string', ' allow_other bool'], 'filename': '/home/dimi/Documents/Informatik_Studium/FSS/SoftEvo/DataCollection/FFS_SoftEvo/go-ipfs/fuse/mount/fuse.go', 'top_nesting_level': 0, 'length': 32, 'fan_in': 0, 'fan_out': 0, 'general_fan_out': 0}, {'cyclomatic_complexity': 2, 'nloc': 9, 'token_count': 55, 'name': '', 'long_name': '()', 'start_line': 70, 'end_line': 79, 'full_parameters': [], 'filename': '/home/dimi/Documents/Informatik_Studium/FSS/SoftEvo/DataCollection/FFS_SoftEvo/go-ipfs/fuse/mount/fuse.go', 'top_nesting_level': 0, 'length': 10, 'fan_in': 0, 'fan_out': 0, 'general_fan_out': 0}, {'cyclomatic_complexity': 5, 'nloc': 18, 'token_count': 117, 'name': 'mount', 'long_name': '(m*mount)mount', 'start_line': 66, 'end_line': 99, 'full_parameters': [], 'filename': '/home/dimi/Documents/Informatik_Studium/FSS/SoftEvo/DataCollection/FFS_SoftEvo/go-ipfs/fuse/mount/fuse.go', 'top_nesting_level': 0, 'length': 34, 'fan_in': 0, 'fan_out': 0, 'general_fan_out': 0}, {'cyclomatic_complexity': 4, 'nloc': 21, 'token_count': 126, 'name': 'unmount', 'long_name': '(m*mount)unmount', 'start_line': 105, 'end_line': 132, 'full_parameters': [], 'filename': '/home/dimi/Documents/Informatik_Studium/FSS/SoftEvo/DataCollection/FFS_SoftEvo/go-ipfs/fuse/mount/fuse.go', 'top_nesting_level': 0, 'length': 28, 'fan_in': 0, 'fan_out': 0, 'general_fan_out': 0}, {'cyclomatic_complexity': 1, 'nloc': 3, 'token_count': 18, 'name': 'Process', 'long_name': '(m*mount)Process', 'start_line': 134, 'end_line': 136, 'full_parameters': [], 'filename': '/home/dimi/Documents/Informatik_Studium/FSS/SoftEvo/DataCollection/FFS_SoftEvo/go-ipfs/fuse/mount/fuse.go', 'top_nesting_level': 0, 'length': 3, 'fan_in': 0, 'fan_out': 0, 'general_fan_out': 0}, {'cyclomatic_complexity': 1, 'nloc': 3, 'token_count': 16, 'name': 'MountPoint', 'long_name': '(m*mount)MountPoint', 'start_line': 138, 'end_line': 140, 'full_parameters': [], 'filename': '/home/dimi/Documents/Informatik_Studium/FSS/SoftEvo/DataCollection/FFS_SoftEvo/go-ipfs/fuse/mount/fuse.go', 'top_nesting_level': 0, 'length': 3, 'fan_in': 0, 'fan_out': 0, 'general_fan_out': 0}, {'cyclomatic_complexity': 2, 'nloc': 6, 'token_count': 31, 'name': 'Unmount', 'long_name': '(m*mount)Unmount', 'start_line': 142, 'end_line': 149, 'full_parameters': [], 'filename': '/home/dimi/Documents/Informatik_Studium/FSS/SoftEvo/DataCollection/FFS_SoftEvo/go-ipfs/fuse/mount/fuse.go', 'top_nesting_level': 0, 'length': 8, 'fan_in': 0, 'fan_out': 0, 'general_fan_out': 0}, {'cyclomatic_complexity': 1, 'nloc': 5, 'token_count': 31, 'name': 'IsActive', 'long_name': '(m*mount)IsActive', 'start_line': 151, 'end_line': 156, 'full_parameters': [], 'filename': '/home/dimi/Documents/Informatik_Studium/FSS/SoftEvo/DataCollection/FFS_SoftEvo/go-ipfs/fuse/mount/fuse.go', 'top_nesting_level': 0, 'length': 6, 'fan_in': 0, 'fan_out': 0, 'general_fan_out': 0}, {'cyclomatic_complexity': 1, 'nloc': 5, 'token_count': 32, 'name': 'setActive', 'long_name': '(m*mount)setActive a bool', 'start_line': 158, 'end_line': 162, 'full_parameters': ['a bool'], 'filename': '/home/dimi/Documents/Informatik_Studium/FSS/SoftEvo/DataCollection/FFS_SoftEvo/go-ipfs/fuse/mount/fuse.go', 'top_nesting_level': 0, 'length': 5, 'fan_in': 0, 'fan_out': 0, 'general_fan_out': 0}]",117,653,9,"[{'cyclomatic_complexity': 4, 'nloc': 29, 'token_count': 180, 'name': 'NewMount', 'long_name': 'NewMount p goprocess . Process , fsys fs . FS , mountpoint string , allow_other bool', 'start_line': 32, 'end_line': 67, 'full_parameters': ['p goprocess . Process', ' fsys fs . FS', ' mountpoint string', ' allow_other bool'], 'filename': '/home/dimi/Documents/Informatik_Studium/FSS/SoftEvo/DataCollection/FFS_SoftEvo/go-ipfs/fuse/mount/fuse.go', 'top_nesting_level': 0, 'length': 36, 'fan_in': 0, 'fan_out': 0, 'general_fan_out': 0}, {'cyclomatic_complexity': 2, 'nloc': 9, 'token_count': 55, 'name': '', 'long_name': '()', 'start_line': 73, 'end_line': 82, 'full_parameters': [], 'filename': '/home/dimi/Documents/Informatik_Studium/FSS/SoftEvo/DataCollection/FFS_SoftEvo/go-ipfs/fuse/mount/fuse.go', 'top_nesting_level': 0, 'length': 10, 'fan_in': 0, 'fan_out': 0, 'general_fan_out': 0}, {'cyclomatic_complexity': 5, 'nloc': 18, 'token_count': 117, 'name': 'mount', 'long_name': '(m*mount)mount', 'start_line': 69, 'end_line': 102, 'full_parameters': [], 'filename': '/home/dimi/Documents/Informatik_Studium/FSS/SoftEvo/DataCollection/FFS_SoftEvo/go-ipfs/fuse/mount/fuse.go', 'top_nesting_level': 0, 'length': 34, 'fan_in': 0, 'fan_out': 0, 'general_fan_out': 0}, {'cyclomatic_complexity': 4, 'nloc': 21, 'token_count': 126, 'name': 'unmount', 'long_name': '(m*mount)unmount', 'start_line': 108, 'end_line': 135, 'full_parameters': [], 'filename': '/home/dimi/Documents/Informatik_Studium/FSS/SoftEvo/DataCollection/FFS_SoftEvo/go-ipfs/fuse/mount/fuse.go', 'top_nesting_level': 0, 'length': 28, 'fan_in': 0, 'fan_out': 0, 'general_fan_out': 0}, {'cyclomatic_complexity': 1, 'nloc': 3, 'token_count': 18, 'name': 'Process', 'long_name': '(m*mount)Process', 'start_line': 137, 'end_line': 139, 'full_parameters': [], 'filename': '/home/dimi/Documents/Informatik_Studium/FSS/SoftEvo/DataCollection/FFS_SoftEvo/go-ipfs/fuse/mount/fuse.go', 'top_nesting_level': 0, 'length': 3, 'fan_in': 0, 'fan_out': 0, 'general_fan_out': 0}, {'cyclomatic_complexity': 1, 'nloc': 3, 'token_count': 16, 'name': 'MountPoint', 'long_name': '(m*mount)MountPoint', 'start_line': 141, 'end_line': 143, 'full_parameters': [], 'filename': '/home/dimi/Documents/Informatik_Studium/FSS/SoftEvo/DataCollection/FFS_SoftEvo/go-ipfs/fuse/mount/fuse.go', 'top_nesting_level': 0, 'length': 3, 'fan_in': 0, 'fan_out': 0, 'general_fan_out': 0}, {'cyclomatic_complexity': 2, 'nloc': 6, 'token_count': 31, 'name': 'Unmount', 'long_name': '(m*mount)Unmount', 'start_line': 145, 'end_line': 152, 'full_parameters': [], 'filename': '/home/dimi/Documents/Informatik_Studium/FSS/SoftEvo/DataCollection/FFS_SoftEvo/go-ipfs/fuse/mount/fuse.go', 'top_nesting_level': 0, 'length': 8, 'fan_in': 0, 'fan_out': 0, 'general_fan_out': 0}, {'cyclomatic_complexity': 1, 'nloc': 5, 'token_count': 31, 'name': 'IsActive', 'long_name': '(m*mount)IsActive', 'start_line': 154, 'end_line': 159, 'full_parameters': [], 'filename': '/home/dimi/Documents/Informatik_Studium/FSS/SoftEvo/DataCollection/FFS_SoftEvo/go-ipfs/fuse/mount/fuse.go', 'top_nesting_level': 0, 'length': 6, 'fan_in': 0, 'fan_out': 0, 'general_fan_out': 0}, {'cyclomatic_complexity': 1, 'nloc': 5, 'token_count': 32, 'name': 'setActive', 'long_name': '(m*mount)setActive a bool', 'start_line': 161, 'end_line': 165, 'full_parameters': ['a bool'], 'filename': '/home/dimi/Documents/Informatik_Studium/FSS/SoftEvo/DataCollection/FFS_SoftEvo/go-ipfs/fuse/mount/fuse.go', 'top_nesting_level': 0, 'length': 5, 'fan_in': 0, 'fan_out': 0, 'general_fan_out': 0}]",3,25,0,10,10,"[{'timestamp': 1521399286.0, 'added_lines': 1, 'deleted_lines': 1, 'nloc': 114}, {'timestamp': 1528006520.0, 'added_lines': 2, 'deleted_lines': 2, 'nloc': 114}, {'timestamp': 1528520460.0, 'added_lines': 2, 'deleted_lines': 2, 'nloc': 114}, {'timestamp': 1551551196.0, 'added_lines': 3, 'deleted_lines': 3, 'nloc': 114}, {'timestamp': 1553697989.0, 'added_lines': 1, 'deleted_lines': 1, 'nloc': 114}, {'timestamp': 1563668276.0, 'added_lines': 1, 'deleted_lines': 2, 'nloc': 114}, {'timestamp': 1563837872.0, 'added_lines': 1, 'deleted_lines': 1, 'nloc': 114}, {'timestamp': 1579218500.0, 'added_lines': 2, 'deleted_lines': 2, 'nloc': 114}, {'timestamp': 1600726105.0, 'added_lines': 1, 'deleted_lines': 1, 'nloc': 114}, {'timestamp': 1630012431.0, 'added_lines': 7, 'deleted_lines': 3, 'nloc': 117}]","{'cmd/ipfs/init.go': 3, 'cmd/seccat/seccat.go': 5, 'commands/legacy/request.go': 2, 'core/commands/cat.go': 4, 'core/commands/config.go': 4, 'core/commands/dht.go': 3, 'core/commands/get.go': 5, 'core/commands/id.go': 3, 'core/commands/object/object.go': 3, 'core/commands/pin.go': 3, 'core/commands/publish.go': 2, 'core/commands/pubsub.go': 3, 'core/core.go': 5, 'core/coreapi/object.go': 3, 'core/corerepo/gc.go': 5, 'exchange/bitswap/testnet/virtual.go': 2, 'exchange/reprovide/reprovide.go': 3, 'fuse/ipns/ipns_unix.go': 8, 'fuse/mount/mount.go': 4, 'fuse/readonly/ipfs_test.go': 8, 'fuse/readonly/readonly_unix.go': 7, 'importer/balanced/balanced_test.go': 2, 'importer/trickle/trickle_test.go': 2, 'importer/trickle/trickledag.go': 2, 'keystore/keystore_test.go': 3, 'merkledag/coding.go': 2, 'merkledag/merkledag.go': 2, 'merkledag/merkledag_test.go': 2, 'mfs/mfs_test.go': 2, 'namesys/dns_test.go': 2, 'namesys/interface.go': 2, 'namesys/namesys_test.go': 4, 'namesys/pubsub.go': 1, 'namesys/resolve_test.go': 3, 'pin/pin.go': 3, 'repo/config/config.go': 1, 'repo/config/init.go': 2, 'repo/fsrepo/fsrepo.go': 4, 'repo/fsrepo/serialize/serialize.go': 2, 'thirdparty/pollEndpoint/main.go': 3, 'unixfs/io/pbdagreader.go': 2, 'unixfs/test/utils.go': 2, 'unixfs/unixfs.go': 1, 'cmd/ipfswatch/main.go': 5, 'fuse/ipns/ipns_test.go': 7, 'fuse/ipns/link_unix.go': 6, 'package.json': 2, 'assets/assets.go': 2, 'blocks/blockstoreutil/remove.go': 2, 'blockservice/blockservice.go': 1, 'blockservice/blockservice_test.go': 1, 'blockservice/test/blocks_test.go': 1, 'blockservice/test/mock.go': 1, 'cmd/ipfs/daemon.go': 4, 'cmd/ipfs/ipfs.go': 2, 'cmd/ipfs/main.go': 3, 'cmd/ipfs/util/ulimit.go': 2, 'cmd/ipfs/util/ulimit_freebsd.go': 2, 'cmd/ipfs/util/ulimit_unix.go': 2, 'cmd/seccat/util.go': 2, 'commands/command.go': 1, 'commands/legacy/command.go': 1, 'commands/legacy/legacy.go': 1, 'commands/legacy/legacy_test.go': 1, 'commands/legacy/response.go': 1, 'commands/request.go': 1, 'commands/response.go': 1, 'core/bootstrap.go': 2, 'core/bootstrap_test.go': 2, 'core/builder.go': 3, 'core/commands/active.go': 2, 'core/commands/add.go': 5, 'core/commands/bitswap.go': 2, 'core/commands/block.go': 2, 'core/commands/bootstrap.go': 2, 'core/commands/commands.go': 3, 'core/commands/commands_test.go': 2, 'core/commands/dag/dag.go': 3, 'core/commands/dht_test.go': 2, 'core/commands/diag.go': 2, 'core/commands/dns.go': 2, 'core/commands/external.go': 2, 'core/commands/files.go': 3, 'core/commands/filestore.go': 2, 'core/commands/get_test.go': 2, 'core/commands/helptext_test.go': 2, 'core/commands/ipns.go': 1, 'core/commands/ipnsps.go': 1, 'core/commands/keystore.go': 2, 'core/commands/log.go': 2, 'core/commands/ls.go': 2, 'core/commands/mount_nofuse.go': 2, 'core/commands/mount_unix.go': 2, 'core/commands/mount_windows.go': 2, 'core/commands/name.go': 1, 'core/commands/object/diff.go': 2, 'core/commands/object/patch.go': 2, 'core/commands/p2p.go': 3, 'core/commands/ping.go': 2, 'core/commands/refs.go': 2, 'core/commands/repo.go': 3, 'core/commands/resolve.go': 2, 'core/commands/root.go': 2, 'core/commands/shutdown.go': 2, 'core/commands/stat.go': 2, 'core/commands/swarm.go': 3, 'core/commands/sysdiag.go': 2, 'core/commands/tar.go': 2, 'core/commands/unixfs/ls.go': 2, 'core/commands/unixfs/unixfs.go': 2, 'core/commands/version.go': 2, 'core/coreapi/block.go': 2, 'core/coreapi/block_test.go': 1, 'core/coreapi/coreapi.go': 2, 'core/coreapi/dag.go': 2, 'core/coreapi/dag_test.go': 1, 'core/coreapi/interface/coreapi.go': 1, 'core/coreapi/interface/dag.go': 1, 'core/coreapi/interface/object.go': 1, 'core/coreapi/interface/options/block.go': 1, 'core/coreapi/interface/options/dag.go': 1, 'core/coreapi/interface/path.go': 1, 'core/coreapi/interface/unixfs.go': 1, 'core/coreapi/key.go': 2, 'core/coreapi/name.go': 2, 'core/coreapi/pin.go': 2, 'core/coreapi/unixfs.go': 2, 'core/coreapi/unixfs_test.go': 1, 'core/coredag/cbor.go': 2, 'core/coredag/dagpb.go': 2, 'core/coredag/dagtransl.go': 2, 'core/coredag/raw.go': 2, 'core/corehttp/commands.go': 3, 'core/corehttp/corehttp.go': 2, 'core/corehttp/gateway.go': 2, 'core/corehttp/gateway_handler.go': 3, 'core/corehttp/gateway_test.go': 3, 'core/corehttp/logs.go': 2, 'core/corehttp/metrics_test.go': 2, 'core/corerepo/pinning.go': 1, 'core/coreunix/add.go': 2, 'core/coreunix/add_test.go': 3, 'core/coreunix/metadata.go': 2, 'core/coreunix/metadata_test.go': 3, 'core/mock/mock.go': 2, 'core/pathresolver.go': 2, 'exchange/bitswap/bitswap.go': 1, 'exchange/bitswap/bitswap_test.go': 1, 'exchange/bitswap/decision/bench_test.go': 1, 'exchange/bitswap/decision/engine.go': 1, 'exchange/bitswap/decision/engine_test.go': 1, 'exchange/bitswap/decision/ledger.go': 1, 'exchange/bitswap/decision/peer_request_queue.go': 1, 'exchange/bitswap/decision/peer_request_queue_test.go': 1, 'exchange/bitswap/get.go': 1, 'exchange/bitswap/message/message.go': 1, 'exchange/bitswap/message/message_test.go': 1, 'exchange/bitswap/network/interface.go': 1, 'exchange/bitswap/network/ipfs_impl.go': 1, 'exchange/bitswap/notifications/notifications.go': 1, 'exchange/bitswap/notifications/notifications_test.go': 1, 'exchange/bitswap/session.go': 1, 'exchange/bitswap/session_test.go': 1, 'exchange/bitswap/stat.go': 1, 'exchange/bitswap/testnet/interface.go': 1, 'exchange/bitswap/testnet/network_test.go': 1, 'exchange/bitswap/testnet/peernet.go': 1, 'exchange/bitswap/testutils.go': 1, 'exchange/bitswap/wantlist/wantlist.go': 1, 'exchange/bitswap/wantlist/wantlist_test.go': 1, 'exchange/bitswap/wantmanager.go': 1, 'exchange/bitswap/workers.go': 1, 'exchange/reprovide/providers.go': 2, 'exchange/reprovide/reprovide_test.go': 3, 'filestore/filestore.go': 2, 'filestore/filestore_test.go': 2, 'filestore/fsrefstore.go': 2, 'filestore/util.go': 2, 'fuse/node/mount_darwin.go': 2, 'fuse/node/mount_test.go': 5, 'fuse/node/mount_unix.go': 6, 'importer/balanced/builder.go': 1, 'importer/helpers/dagbuilder.go': 1, 'importer/helpers/helpers.go': 1, 'importer/importer.go': 1, 'importer/importer_test.go': 1, 'keystore/keystore.go': 3, 'merkledag/errservice.go': 1, 'merkledag/node.go': 1, 'merkledag/node_test.go': 1, 'merkledag/raw.go': 1, 'merkledag/readonly.go': 1, 'merkledag/readonly_test.go': 1, 'merkledag/rwservice.go': 1, 'merkledag/session.go': 1, 'merkledag/test/utils.go': 1, 'merkledag/traverse/traverse.go': 1, 'merkledag/traverse/traverse_test.go': 1, 'merkledag/utils/diff.go': 1, 'merkledag/utils/diffenum.go': 1, 'merkledag/utils/diffenum_test.go': 1, 'merkledag/utils/utils.go': 1, 'merkledag/utils/utils_test.go': 1, 'mfs/dir.go': 1, 'mfs/file.go': 1, 'mfs/ops.go': 1, 'mfs/repub_test.go': 1, 'mfs/system.go': 1, 'namesys/ipns_select_test.go': 1, 'namesys/ipns_validate_test.go': 1, 'namesys/namesys.go': 3, 'namesys/publisher.go': 2, 'namesys/publisher_test.go': 2, 'namesys/republisher/repub.go': 2, 'namesys/republisher/repub_test.go': 3, 'namesys/routing.go': 3, 'namesys/validator.go': 1, 'p2p/p2p.go': 2, 'p2p/registry.go': 1, 'path/path.go': 1, 'path/resolver/resolver.go': 1, 'path/resolver/resolver_test.go': 1, 'pin/gc/gc.go': 2, 'pin/pin_test.go': 3, 'pin/set.go': 2, 'pin/set_test.go': 2, 'plugin/ipld.go': 2, 'plugin/loader/initializer.go': 1, 'plugin/loader/load.go': 1, 'plugin/plugins/git/git.go': 2, 'repo/config/bootstrap_peers.go': 1, 'repo/fsrepo/datastores.go': 2, 'repo/mock.go': 2, 'repo/repo.go': 2, 'tar/format.go': 2, 'test/dependencies/ma-pipe-unidir/main.go': 3, 'test/integration/addcat_test.go': 3, 'test/integration/bench_cat_test.go': 3, 'test/integration/bench_test.go': 2, 'test/integration/bitswap_wo_routing_test.go': 3, 'test/integration/three_legged_cat_test.go': 3, 'thirdparty/verifbs/verifbs.go': 2, 'thirdparty/verifcid/validate.go': 1, 'thirdparty/verifcid/validate_test.go': 1, 'unixfs/archive/archive.go': 1, 'unixfs/archive/tar/writer.go': 1, 'unixfs/hamt/hamt.go': 1, 'unixfs/hamt/hamt_stress_test.go': 1, 'unixfs/hamt/hamt_test.go': 1, 'unixfs/io/dagreader.go': 1, 'unixfs/io/dirbuilder.go': 1, 'unixfs/io/resolve.go': 1, 'unixfs/mod/dagmodifier.go': 1, 'unixfs/mod/dagmodifier_test.go': 1, 'cmd/ipfs/dnsresolve_test.go': 1, 'commands/context.go': 1, 'core/commands/cid.go': 2, 'core/commands/cmdenv/cidbase.go': 1, 'core/commands/cmdenv/cidbase_test.go': 1, 'core/commands/cmdenv/env.go': 1, 'core/commands/cmdenv/file.go': 1, 'core/commands/name/ipns.go': 1, 'core/commands/name/ipnsps.go': 1, 'core/commands/name/name.go': 1, 'core/commands/name/publish.go': 1, 'core/commands/urlstore.go': 1, 'core/core_test.go': 1, 'core/coreapi/dht.go': 1, 'core/coreapi/path.go': 1, 'core/coreapi/pubsub.go': 2, 'core/coreapi/swarm.go': 2, 'core/coreapi/test/api_test.go': 1, 'core/corehttp/ipns_hostname.go': 1, 'core/corehttp/metrics.go': 1, 'core/corehttp/proxy.go': 1, 'core/corehttp/proxy_test.go': 1, 'core/corerepo/stat.go': 1, 'core/pathresolver_test.go': 1, 'dagutils/diff.go': 2, 'dagutils/diffenum.go': 1, 'dagutils/diffenum_test.go': 1, 'dagutils/utils.go': 2, 'dagutils/utils_test.go': 1, 'filestore/pb/dataobj.pb.go': 1, 'fuse/ipns/common.go': 1, 'keystore/memkeystore.go': 1, 'namesys/base.go': 1, 'namesys/cache.go': 1, 'namesys/dns.go': 1, 'namesys/ipns_resolver_validation_test.go': 1, 'namesys/proquint.go': 1, 'p2p/listener.go': 1, 'p2p/local.go': 2, 'p2p/remote.go': 2, 'p2p/stream.go': 2, 'pin/internal/pb/header.pb.go': 1, 'plugin/daemon.go': 1, 'plugin/loader/loader.go': 2, 'plugin/plugins/badgerds/badgerds.go': 1, 'plugin/plugins/flatfs/flatfs.go': 1, 'plugin/plugins/levelds/levelds.go': 1, 'plugin/tracer.go': 1, 'repo/fsrepo/config_test.go': 1, 'repo/fsrepo/fsrepo_test.go': 1, 'repo/fsrepo/misc.go': 1, 'test/bench/bench_cli_ipfs_add/main.go': 2, 'test/bench/offline_add/main.go': 2, 'test/dependencies/iptb/iptb.go': 1, 'thirdparty/cidv0v1/blockstore.go': 1, 'thirdparty/notifier/notifier.go': 1, 'commands/reqlog.go': 1, 'core/corehttp/mutex_profile.go': 1, 'core/corehttp/option_test.go': 1, 'provider/queue.go': 1, 'provider/queue_test.go': 1, 'fuse/node/mount_openbsd.go': 1, 'fuse/readonly/mount_unix.go': 2, 'mk/util.mk': 2, 'fuse/node/mount_notsupp.go': 2, 'core/bootstrap/bootstrap.go': 1, 'core/node/libp2p/discovery.go': 1, 'core/node/libp2p/pnet.go': 1, 'core/node/libp2p/smux.go': 1, 'core/node/libp2p/transport.go': 1, 'plugin/loader/load_unix.go': 1, 'cmd/ipfs/util/ulimit_test.go': 1, 'cmd/ipfswatch/ipfswatch_test.go': 1, 'cmd/seccat/seccat_plan9.go': 1, 'cmd/seccat/seccat_posix.go': 1, 'go.mod': 1, 'go.sum': 1}","('fuse/readonly/ipfs_test.go', 0.8, 0.0963855421686747)"
fuse/mount/mount.go,66,341,5,"[{'cyclomatic_complexity': 2, 'nloc': 7, 'token_count': 40, 'name': '', 'long_name': '()', 'start_line': 52, 'end_line': 62, 'full_parameters': [], 'filename': '/home/dimi/Documents/Informatik_Studium/FSS/SoftEvo/DataCollection/FFS_SoftEvo/go-ipfs/fuse/mount/mount.go', 'top_nesting_level': 0, 'length': 11, 'fan_in': 0, 'fan_out': 0, 'general_fan_out': 0}, {'cyclomatic_complexity': 5, 'nloc': 21, 'token_count': 123, 'name': 'ForceUnmount', 'long_name': 'ForceUnmount m Mount', 'start_line': 37, 'end_line': 70, 'full_parameters': ['m Mount'], 'filename': '/home/dimi/Documents/Informatik_Studium/FSS/SoftEvo/DataCollection/FFS_SoftEvo/go-ipfs/fuse/mount/mount.go', 'top_nesting_level': 0, 'length': 34, 'fan_in': 0, 'fan_out': 0, 'general_fan_out': 0}, {'cyclomatic_complexity': 3, 'nloc': 11, 'token_count': 67, 'name': 'ForceUnmountManyTimes', 'long_name': 'ForceUnmountManyTimes m Mount , attempts int', 'start_line': 75, 'end_line': 86, 'full_parameters': ['m Mount', ' attempts int'], 'filename': '/home/dimi/Documents/Informatik_Studium/FSS/SoftEvo/DataCollection/FFS_SoftEvo/go-ipfs/fuse/mount/mount.go', 'top_nesting_level': 0, 'length': 12, 'fan_in': 0, 'fan_out': 0, 'general_fan_out': 0}, {'cyclomatic_complexity': 1, 'nloc': 4, 'token_count': 34, 'name': 'Close', 'long_name': '(c*closer)Close', 'start_line': 92, 'end_line': 95, 'full_parameters': [], 'filename': '/home/dimi/Documents/Informatik_Studium/FSS/SoftEvo/DataCollection/FFS_SoftEvo/go-ipfs/fuse/mount/mount.go', 'top_nesting_level': 0, 'length': 4, 'fan_in': 0, 'fan_out': 0, 'general_fan_out': 0}, {'cyclomatic_complexity': 1, 'nloc': 3, 'token_count': 17, 'name': 'Closer', 'long_name': 'Closer m Mount', 'start_line': 97, 'end_line': 99, 'full_parameters': ['m Mount'], 'filename': '/home/dimi/Documents/Informatik_Studium/FSS/SoftEvo/DataCollection/FFS_SoftEvo/go-ipfs/fuse/mount/mount.go', 'top_nesting_level': 0, 'length': 3, 'fan_in': 0, 'fan_out': 0, 'general_fan_out': 0}]",71,371,6,"[{'cyclomatic_complexity': 2, 'nloc': 7, 'token_count': 40, 'name': '', 'long_name': '()', 'start_line': 47, 'end_line': 57, 'full_parameters': [], 'filename': '/home/dimi/Documents/Informatik_Studium/FSS/SoftEvo/DataCollection/FFS_SoftEvo/go-ipfs/fuse/mount/mount.go', 'top_nesting_level': 0, 'length': 11, 'fan_in': 0, 'fan_out': 0, 'general_fan_out': 0}, {'cyclomatic_complexity': 4, 'nloc': 16, 'token_count': 86, 'name': 'ForceUnmount', 'long_name': 'ForceUnmount m Mount', 'start_line': 37, 'end_line': 65, 'full_parameters': ['m Mount'], 'filename': '/home/dimi/Documents/Informatik_Studium/FSS/SoftEvo/DataCollection/FFS_SoftEvo/go-ipfs/fuse/mount/mount.go', 'top_nesting_level': 0, 'length': 29, 'fan_in': 0, 'fan_out': 0, 'general_fan_out': 0}, {'cyclomatic_complexity': 3, 'nloc': 10, 'token_count': 67, 'name': 'UnmountCmd', 'long_name': 'UnmountCmd point string', 'start_line': 69, 'end_line': 78, 'full_parameters': ['point string'], 'filename': '/home/dimi/Documents/Informatik_Studium/FSS/SoftEvo/DataCollection/FFS_SoftEvo/go-ipfs/fuse/mount/mount.go', 'top_nesting_level': 0, 'length': 10, 'fan_in': 0, 'fan_out': 0, 'general_fan_out': 0}, {'cyclomatic_complexity': 3, 'nloc': 11, 'token_count': 67, 'name': 'ForceUnmountManyTimes', 'long_name': 'ForceUnmountManyTimes m Mount , attempts int', 'start_line': 83, 'end_line': 94, 'full_parameters': ['m Mount', ' attempts int'], 'filename': '/home/dimi/Documents/Informatik_Studium/FSS/SoftEvo/DataCollection/FFS_SoftEvo/go-ipfs/fuse/mount/mount.go', 'top_nesting_level': 0, 'length': 12, 'fan_in': 0, 'fan_out': 0, 'general_fan_out': 0}, {'cyclomatic_complexity': 1, 'nloc': 4, 'token_count': 34, 'name': 'Close', 'long_name': '(c*closer)Close', 'start_line': 100, 'end_line': 103, 'full_parameters': [], 'filename': '/home/dimi/Documents/Informatik_Studium/FSS/SoftEvo/DataCollection/FFS_SoftEvo/go-ipfs/fuse/mount/mount.go', 'top_nesting_level': 0, 'length': 4, 'fan_in': 0, 'fan_out': 0, 'general_fan_out': 0}, {'cyclomatic_complexity': 1, 'nloc': 3, 'token_count': 17, 'name': 'Closer', 'long_name': 'Closer m Mount', 'start_line': 105, 'end_line': 107, 'full_parameters': ['m Mount'], 'filename': '/home/dimi/Documents/Informatik_Studium/FSS/SoftEvo/DataCollection/FFS_SoftEvo/go-ipfs/fuse/mount/mount.go', 'top_nesting_level': 0, 'length': 3, 'fan_in': 0, 'fan_out': 0, 'general_fan_out': 0}]",5,30,1,12,12,"[{'timestamp': 1517453697.0, 'added_lines': 1, 'deleted_lines': 1, 'nloc': 66}, {'timestamp': 1521399286.0, 'added_lines': 1, 'deleted_lines': 1, 'nloc': 66}, {'timestamp': 1525408792.0, 'added_lines': 1, 'deleted_lines': 1, 'nloc': 66}, {'timestamp': 1528520460.0, 'added_lines': 1, 'deleted_lines': 1, 'nloc': 66}, {'timestamp': 1529984485.0, 'added_lines': 1, 'deleted_lines': 1, 'nloc': 66}, {'timestamp': 1533779477.0, 'added_lines': 1, 'deleted_lines': 1, 'nloc': 66}, {'timestamp': 1537073644.0, 'added_lines': 16, 'deleted_lines': 8, 'nloc': 71}, {'timestamp': 1537792589.0, 'added_lines': 1, 'deleted_lines': 1, 'nloc': 71}, {'timestamp': 1541204121.0, 'added_lines': 1, 'deleted_lines': 1, 'nloc': 71}, {'timestamp': 1550507829.0, 'added_lines': 1, 'deleted_lines': 1, 'nloc': 71}, {'timestamp': 1551551196.0, 'added_lines': 2, 'deleted_lines': 2, 'nloc': 71}, {'timestamp': 1579218500.0, 'added_lines': 2, 'deleted_lines': 2, 'nloc': 71}]","{'blocks/blockstore/blockstore.go': 1, 'blockservice/blockservice.go': 4, 'cmd/ipfs/daemon.go': 10, 'cmd/ipfs/ipfs.go': 9, 'cmd/ipfs/main.go': 9, 'cmd/ipfs/util/ulimit.go': 9, 'cmd/seccat/seccat.go': 10, 'cmd/seccat/util.go': 9, 'commands/command.go': 7, 'commands/command_test.go': 1, 'commands/legacy/command.go': 7, 'commands/legacy/legacy.go': 7, 'commands/legacy/legacy_test.go': 7, 'commands/legacy/request.go': 8, 'commands/legacy/response.go': 7, 'commands/request.go': 7, 'commands/response.go': 2, 'commands/response_test.go': 1, 'core/bootstrap.go': 9, 'core/bootstrap_test.go': 9, 'core/builder.go': 9, 'core/commands/add.go': 10, 'core/commands/bitswap.go': 9, 'core/commands/block.go': 9, 'core/commands/cat.go': 11, 'core/commands/commands.go': 9, 'core/commands/commands_test.go': 9, 'core/commands/dag/dag.go': 7, 'core/commands/dht.go': 10, 'core/commands/dht_test.go': 9, 'core/commands/files/files.go': 1, 'core/commands/filestore.go': 9, 'core/commands/get.go': 10, 'core/commands/get_test.go': 9, 'core/commands/helptext_test.go': 9, 'core/commands/id.go': 10, 'core/commands/keystore.go': 9, 'core/commands/log.go': 9, 'core/commands/object/patch.go': 9, 'core/commands/ping.go': 9, 'core/commands/publish.go': 6, 'core/commands/pubsub.go': 10, 'core/commands/repo.go': 9, 'core/commands/root.go': 9, 'core/commands/stat.go': 9, 'core/commands/swarm.go': 9, 'core/core.go': 11, 'core/coreapi/key.go': 9, 'core/coreapi/name.go': 9, 'core/coreapi/unixfs_test.go': 7, 'core/corehttp/commands.go': 10, 'core/corehttp/corehttp.go': 9, 'core/corehttp/gateway.go': 9, 'core/corehttp/gateway_handler.go': 10, 'core/corehttp/gateway_test.go': 9, 'core/corehttp/logs.go': 9, 'core/corehttp/metrics_test.go': 9, 'core/corerepo/gc.go': 11, 'core/coreunix/add.go': 9, 'core/mock/mock.go': 9, 'core/pathresolver.go': 9, 'exchange/bitswap/bitswap.go': 4, 'exchange/bitswap/bitswap_test.go': 4, 'exchange/bitswap/decision/bench_test.go': 4, 'exchange/bitswap/decision/engine.go': 4, 'exchange/bitswap/decision/engine_test.go': 4, 'exchange/bitswap/decision/ledger.go': 4, 'exchange/bitswap/decision/peer_request_queue.go': 4, 'exchange/bitswap/decision/peer_request_queue_test.go': 4, 'exchange/bitswap/message/message.go': 4, 'exchange/bitswap/network/interface.go': 4, 'exchange/bitswap/network/ipfs_impl.go': 4, 'exchange/bitswap/session.go': 4, 'exchange/bitswap/testnet/interface.go': 4, 'exchange/bitswap/testnet/network_test.go': 4, 'exchange/bitswap/testnet/peernet.go': 4, 'exchange/bitswap/testnet/virtual.go': 5, 'exchange/bitswap/testutils.go': 4, 'exchange/bitswap/wantmanager.go': 4, 'exchange/bitswap/workers.go': 4, 'exchange/reprovide/reprovide.go': 10, 'exchange/reprovide/reprovide_test.go': 9, 'filestore/filestore.go': 9, 'fuse/ipns/ipns_test.go': 9, 'fuse/ipns/ipns_unix.go': 11, 'fuse/node/mount_test.go': 10, 'fuse/node/mount_unix.go': 9, 'fuse/readonly/ipfs_test.go': 10, 'fuse/readonly/readonly_unix.go': 11, 'importer/chunk/splitting.go': 1, 'mfs/repub_test.go': 5, 'mfs/system.go': 5, 'namesys/ipns_validate_test.go': 3, 'namesys/namesys.go': 9, 'namesys/publisher.go': 9, 'namesys/publisher_test.go': 9, 'namesys/pubsub.go': 3, 'namesys/pubsub_test.go': 2, 'namesys/republisher/repub.go': 9, 'namesys/republisher/repub_test.go': 9, 'namesys/resolve_test.go': 10, 'namesys/routing.go': 9, 'p2p/p2p.go': 9, 'p2p/registry.go': 5, 'package.json': 8, 'path/resolver.go': 1, 'pin/gc/gc.go': 9, 'pin/pin.go': 10, 'plugin/loader/load.go': 7, 'repo/config/bootstrap_peers.go': 5, 'repo/config/init.go': 6, 'repo/fsrepo/datastores.go': 9, 'repo/fsrepo/fsrepo.go': 11, 'repo/fsrepo/lock/lock.go': 1, 'routing/mock/centralized_client.go': 1, 'routing/mock/centralized_server.go': 1, 'routing/mock/centralized_test.go': 1, 'routing/mock/interface.go': 1, 'routing/none/none_client.go': 1, 'routing/offline/offline.go': 1, 'routing/offline/offline_test.go': 1, 'tar/format.go': 9, 'test/integration/addcat_test.go': 9, 'test/integration/bench_cat_test.go': 9, 'test/integration/bench_test.go': 9, 'test/integration/bitswap_wo_routing_test.go': 9, 'test/integration/three_legged_cat_test.go': 9, 'thirdparty/pollEndpoint/main.go': 10, 'cmd/ipfs/init.go': 9, 'core/commands/config.go': 6, 'core/commands/object/object.go': 9, 'core/commands/pin.go': 9, 'core/coreapi/object.go': 7, 'fuse/mount/fuse.go': 4, 'importer/balanced/balanced_test.go': 4, 'importer/trickle/trickle_test.go': 4, 'importer/trickle/trickledag.go': 2, 'keystore/keystore_test.go': 6, 'merkledag/coding.go': 2, 'merkledag/merkledag.go': 2, 'merkledag/merkledag_test.go': 4, 'mfs/mfs_test.go': 5, 'namesys/dns_test.go': 3, 'namesys/interface.go': 7, 'namesys/namesys_test.go': 9, 'repo/config/config.go': 1, 'repo/fsrepo/serialize/serialize.go': 2, 'unixfs/io/pbdagreader.go': 2, 'unixfs/test/utils.go': 4, 'unixfs/unixfs.go': 1, 'blocks/blockstoreutil/remove.go': 8, 'blockservice/blockservice_test.go': 3, 'blockservice/test/blocks_test.go': 3, 'blockservice/test/mock.go': 3, 'core/commands/files.go': 8, 'core/commands/ipns.go': 4, 'core/commands/ls.go': 8, 'core/core_test.go': 5, 'core/coreapi/pin.go': 8, 'core/coreunix/add_test.go': 8, 'core/coreunix/metadata_test.go': 8, 'exchange/bitswap/get.go': 3, 'exchange/bitswap/session_test.go': 3, 'exchange/reprovide/providers.go': 8, 'filestore/filestore_test.go': 8, 'filestore/fsrefstore.go': 8, 'filestore/util.go': 8, 'fuse/ipns/common.go': 6, 'importer/helpers/dagbuilder.go': 3, 'importer/importer.go': 3, 'importer/importer_test.go': 3, 'keystore/keystore.go': 9, 'keystore/memkeystore.go': 5, 'merkledag/test/utils.go': 3, 'merkledag/utils/utils.go': 3, 'mfs/file.go': 4, 'namesys/ipns_select_test.go': 2, 'namesys/validator.go': 2, 'path/resolver/resolver.go': 3, 'pin/pin_test.go': 8, 'pin/set_test.go': 8, 'repo/config/identity.go': 2, 'repo/fsrepo/fsrepo_test.go': 5, 'repo/repo.go': 7, 'thirdparty/verifbs/verifbs.go': 8, 'unixfs/mod/dagmodifier.go': 3, 'assets/assets.go': 6, 'cmd/ipfs/util/ulimit_freebsd.go': 2, 'cmd/ipfs/util/ulimit_unix.go': 2, 'cmd/ipfswatch/main.go': 5, 'core/commands/active.go': 3, 'core/commands/bootstrap.go': 5, 'core/commands/diag.go': 3, 'core/commands/dns.go': 4, 'core/commands/external.go': 3, 'core/commands/ipnsps.go': 3, 'core/commands/mount_nofuse.go': 3, 'core/commands/mount_unix.go': 5, 'core/commands/mount_windows.go': 3, 'core/commands/name.go': 1, 'core/commands/object/diff.go': 4, 'core/commands/p2p.go': 6, 'core/commands/refs.go': 6, 'core/commands/resolve.go': 6, 'core/commands/shutdown.go': 6, 'core/commands/sysdiag.go': 5, 'core/commands/tar.go': 6, 'core/commands/unixfs/ls.go': 6, 'core/commands/unixfs/unixfs.go': 3, 'core/commands/version.go': 4, 'core/coreapi/block.go': 4, 'core/coreapi/block_test.go': 2, 'core/coreapi/coreapi.go': 4, 'core/coreapi/dag.go': 3, 'core/coreapi/dag_test.go': 2, 'core/coreapi/interface/coreapi.go': 2, 'core/coreapi/interface/dag.go': 2, 'core/coreapi/interface/object.go': 2, 'core/coreapi/interface/options/block.go': 2, 'core/coreapi/interface/options/dag.go': 2, 'core/coreapi/interface/path.go': 4, 'core/coreapi/interface/unixfs.go': 2, 'core/coreapi/unixfs.go': 6, 'core/coredag/cbor.go': 4, 'core/coredag/dagpb.go': 6, 'core/coredag/dagtransl.go': 3, 'core/coredag/raw.go': 6, 'core/corerepo/pinning.go': 4, 'core/coreunix/metadata.go': 6, 'exchange/bitswap/message/message_test.go': 1, 'exchange/bitswap/notifications/notifications.go': 1, 'exchange/bitswap/notifications/notifications_test.go': 1, 'exchange/bitswap/stat.go': 1, 'exchange/bitswap/wantlist/wantlist.go': 1, 'exchange/bitswap/wantlist/wantlist_test.go': 1, 'fuse/ipns/link_unix.go': 2, 'fuse/node/mount_darwin.go': 2, 'importer/balanced/builder.go': 1, 'importer/helpers/helpers.go': 1, 'merkledag/errservice.go': 1, 'merkledag/node.go': 1, 'merkledag/node_test.go': 1, 'merkledag/raw.go': 1, 'merkledag/readonly.go': 1, 'merkledag/readonly_test.go': 1, 'merkledag/rwservice.go': 1, 'merkledag/session.go': 1, 'merkledag/traverse/traverse.go': 1, 'merkledag/traverse/traverse_test.go': 1, 'merkledag/utils/diff.go': 1, 'merkledag/utils/diffenum.go': 1, 'merkledag/utils/diffenum_test.go': 1, 'merkledag/utils/utils_test.go': 1, 'mfs/dir.go': 2, 'mfs/ops.go': 2, 'path/path.go': 1, 'path/resolver/resolver_test.go': 1, 'pin/set.go': 6, 'plugin/ipld.go': 3, 'plugin/loader/initializer.go': 2, 'plugin/plugins/git/git.go': 3, 'repo/mock.go': 6, 'test/dependencies/ma-pipe-unidir/main.go': 4, 'thirdparty/verifcid/validate.go': 1, 'thirdparty/verifcid/validate_test.go': 1, 'unixfs/archive/archive.go': 1, 'unixfs/archive/tar/writer.go': 1, 'unixfs/hamt/hamt.go': 1, 'unixfs/hamt/hamt_stress_test.go': 1, 'unixfs/hamt/hamt_test.go': 1, 'unixfs/io/dagreader.go': 1, 'unixfs/io/dirbuilder.go': 1, 'unixfs/io/resolve.go': 1, 'unixfs/mod/dagmodifier_test.go': 1, 'namesys/ipns_resolver_validation_test.go': 6, 'test/sharness/t0170-dht.sh': 1, 'core/commands/env.go': 1, 'core/commands/urlstore.go': 5, 'core/coreapi/interface/key.go': 3, 'core/coreapi/name_test.go': 3, 'core/coreapi/path.go': 5, 'core/coreunix/cat.go': 2, 'core/pathresolver_test.go': 5, 'dagutils/diff.go': 5, 'dagutils/diffenum.go': 5, 'dagutils/diffenum_test.go': 5, 'dagutils/utils.go': 5, 'dagutils/utils_test.go': 5, 'filestore/pb/dataobj.pb.go': 3, 'mfs/fd.go': 1, 'namesys/base.go': 5, 'namesys/cache.go': 5, 'namesys/dns.go': 5, 'namesys/proquint.go': 5, 'pin/internal/pb/header.pb.go': 3, 'thirdparty/cidv0v1/blockstore.go': 5, 'core/commands/cmdenv/env.go': 4, 'core/commands/name/ipns.go': 4, 'core/commands/name/ipnsps.go': 4, 'core/commands/name/name.go': 4, 'core/commands/name/publish.go': 4, 'core/coreapi/dht.go': 4, 'core/coreapi/dht_test.go': 2, 'core/coreapi/interface/dht.go': 2, 'p2p/listener.go': 4, 'p2p/local.go': 5, 'p2p/remote.go': 4, 'p2p/stream.go': 4, 'repo/fsrepo/config_test.go': 4, 'repo/fsrepo/misc.go': 4, 'test/bench/bench_cli_ipfs_add/main.go': 4, 'test/bench/offline_add/main.go': 4, 'cmd/ipfs/dnsresolve_test.go': 2, 'core/commands/cid.go': 3, 'core/coreapi/interface/options/unixfs.go': 1, 'core/coreapi/interface/pubsub.go': 1, 'core/coreapi/interface/swarm.go': 1, 'core/coreapi/pubsub.go': 3, 'core/coreapi/swarm.go': 3, 'core/coreapi/unixfile.go': 1, 'test/dependencies/iptb/iptb.go': 3, 'commands/context.go': 2, 'core/commands/cmdenv/cidbase.go': 2, 'core/coreapi/test/api_test.go': 2, 'core/corehttp/ipns_hostname.go': 2, 'core/corehttp/proxy.go': 2, 'plugin/daemon.go': 2, 'plugin/loader/loader.go': 2, 'plugin/plugins/badgerds/badgerds.go': 2, 'plugin/plugins/flatfs/flatfs.go': 2, 'plugin/plugins/levelds/levelds.go': 2, 'core/commands/cmdenv/cidbase_test.go': 1, 'core/commands/cmdenv/file.go': 1, 'core/corehttp/metrics.go': 1, 'core/corehttp/proxy_test.go': 1, 'core/corerepo/stat.go': 1, 'plugin/tracer.go': 1, 'thirdparty/notifier/notifier.go': 1, 'core/bootstrap/bootstrap.go': 1, 'core/node/libp2p/discovery.go': 1, 'core/node/libp2p/pnet.go': 1, 'core/node/libp2p/smux.go': 1, 'core/node/libp2p/transport.go': 1, 'plugin/loader/load_unix.go': 1}","('core/core.go', 0.9166666666666666, 0.061452513966480445)"
fuse/node/mount_windows.go,7,25,1,"[{'cyclomatic_complexity': 1, 'nloc': 3, 'token_count': 19, 'name': 'Mount', 'long_name': 'Mount node * core . IpfsNode , fsdir , nsdir string', 'start_line': 7, 'end_line': 11, 'full_parameters': ['node * core . IpfsNode', ' fsdir', ' nsdir string'], 'filename': '/home/dimi/Documents/Informatik_Studium/FSS/SoftEvo/DataCollection/FFS_SoftEvo/go-ipfs/fuse/node/mount_windows.go', 'top_nesting_level': 0, 'length': 5, 'fan_in': 0, 'fan_out': 0, 'general_fan_out': 0}]",7,25,1,"[{'cyclomatic_complexity': 1, 'nloc': 3, 'token_count': 19, 'name': 'Mount', 'long_name': 'Mount node * core . IpfsNode , fsdir , nsdir string', 'start_line': 7, 'end_line': 11, 'full_parameters': ['node * core . IpfsNode', ' fsdir', ' nsdir string'], 'filename': '/home/dimi/Documents/Informatik_Studium/FSS/SoftEvo/DataCollection/FFS_SoftEvo/go-ipfs/fuse/node/mount_windows.go', 'top_nesting_level': 0, 'length': 5, 'fan_in': 0, 'fan_out': 0, 'general_fan_out': 0}]",0,0,0,0,0,[],{},()
fuse/node/mount_darwin.go,169,1066,7,"[{'cyclomatic_complexity': 1, 'nloc': 3, 'token_count': 9, 'name': 'init', 'long_name': 'init', 'start_line': 18, 'end_line': 21, 'full_parameters': [], 'filename': '/home/dimi/Documents/Informatik_Studium/FSS/SoftEvo/DataCollection/FFS_SoftEvo/go-ipfs/fuse/node/mount_darwin.go', 'top_nesting_level': 0, 'length': 4, 'fan_in': 0, 'fan_out': 0, 'general_fan_out': 0}, {'cyclomatic_complexity': 7, 'nloc': 25, 'token_count': 118, 'name': 'darwinFuseCheckVersion', 'long_name': 'darwinFuseCheckVersion node * core . IpfsNode', 'start_line': 122, 'end_line': 154, 'full_parameters': ['node * core . IpfsNode'], 'filename': '/home/dimi/Documents/Informatik_Studium/FSS/SoftEvo/DataCollection/FFS_SoftEvo/go-ipfs/fuse/node/mount_darwin.go', 'top_nesting_level': 0, 'length': 33, 'fan_in': 0, 'fan_out': 0, 'general_fan_out': 0}, {'cyclomatic_complexity': 2, 'nloc': 8, 'token_count': 38, 'name': 'tryGFV', 'long_name': 'tryGFV', 'start_line': 156, 'end_line': 165, 'full_parameters': [], 'filename': '/home/dimi/Documents/Informatik_Studium/FSS/SoftEvo/DataCollection/FFS_SoftEvo/go-ipfs/fuse/node/mount_darwin.go', 'top_nesting_level': 0, 'length': 10, 'fan_in': 0, 'fan_out': 0, 'general_fan_out': 0}, {'cyclomatic_complexity': 2, 'nloc': 9, 'token_count': 51, 'name': 'trySysctl', 'long_name': 'trySysctl', 'start_line': 167, 'end_line': 175, 'full_parameters': [], 'filename': '/home/dimi/Documents/Informatik_Studium/FSS/SoftEvo/DataCollection/FFS_SoftEvo/go-ipfs/fuse/node/mount_darwin.go', 'top_nesting_level': 0, 'length': 9, 'fan_in': 0, 'fan_out': 0, 'general_fan_out': 0}, {'cyclomatic_complexity': 3, 'nloc': 12, 'token_count': 95, 'name': 'tryGFVFromFuseVersion', 'long_name': 'tryGFVFromFuseVersion', 'start_line': 177, 'end_line': 190, 'full_parameters': [], 'filename': '/home/dimi/Documents/Informatik_Studium/FSS/SoftEvo/DataCollection/FFS_SoftEvo/go-ipfs/fuse/node/mount_darwin.go', 'top_nesting_level': 0, 'length': 14, 'fan_in': 0, 'fan_out': 0, 'general_fan_out': 0}, {'cyclomatic_complexity': 5, 'nloc': 25, 'token_count': 175, 'name': 'ensureFuseVersionIsInstalled', 'long_name': 'ensureFuseVersionIsInstalled', 'start_line': 192, 'end_line': 225, 'full_parameters': [], 'filename': '/home/dimi/Documents/Informatik_Studium/FSS/SoftEvo/DataCollection/FFS_SoftEvo/go-ipfs/fuse/node/mount_darwin.go', 'top_nesting_level': 0, 'length': 34, 'fan_in': 0, 'fan_out': 0, 'general_fan_out': 0}, {'cyclomatic_complexity': 4, 'nloc': 15, 'token_count': 83, 'name': 'userAskedToSkipFuseCheck', 'long_name': 'userAskedToSkipFuseCheck node * core . IpfsNode', 'start_line': 227, 'end_line': 243, 'full_parameters': ['node * core . IpfsNode'], 'filename': '/home/dimi/Documents/Informatik_Studium/FSS/SoftEvo/DataCollection/FFS_SoftEvo/go-ipfs/fuse/node/mount_darwin.go', 'top_nesting_level': 0, 'length': 17, 'fan_in': 0, 'fan_out': 0, 'general_fan_out': 0}]",174,1090,8,"[{'cyclomatic_complexity': 1, 'nloc': 3, 'token_count': 9, 'name': 'init', 'long_name': 'init', 'start_line': 18, 'end_line': 21, 'full_parameters': [], 'filename': '/home/dimi/Documents/Informatik_Studium/FSS/SoftEvo/DataCollection/FFS_SoftEvo/go-ipfs/fuse/node/mount_darwin.go', 'top_nesting_level': 0, 'length': 4, 'fan_in': 0, 'fan_out': 0, 'general_fan_out': 0}, {'cyclomatic_complexity': 1, 'nloc': 18, 'token_count': 160, 'name': 'Error', 'long_name': '(me errNeedFuseVersion)Error', 'start_line': 65, 'end_line': 88, 'full_parameters': [], 'filename': '/home/dimi/Documents/Informatik_Studium/FSS/SoftEvo/DataCollection/FFS_SoftEvo/go-ipfs/fuse/node/mount_darwin.go', 'top_nesting_level': 0, 'length': 24, 'fan_in': 0, 'fan_out': 0, 'general_fan_out': 0}, {'cyclomatic_complexity': 7, 'nloc': 25, 'token_count': 118, 'name': 'darwinFuseCheckVersion', 'long_name': 'darwinFuseCheckVersion node * core . IpfsNode', 'start_line': 128, 'end_line': 160, 'full_parameters': ['node * core . IpfsNode'], 'filename': '/home/dimi/Documents/Informatik_Studium/FSS/SoftEvo/DataCollection/FFS_SoftEvo/go-ipfs/fuse/node/mount_darwin.go', 'top_nesting_level': 0, 'length': 33, 'fan_in': 0, 'fan_out': 0, 'general_fan_out': 0}, {'cyclomatic_complexity': 2, 'nloc': 8, 'token_count': 38, 'name': 'tryGFV', 'long_name': 'tryGFV', 'start_line': 162, 'end_line': 171, 'full_parameters': [], 'filename': '/home/dimi/Documents/Informatik_Studium/FSS/SoftEvo/DataCollection/FFS_SoftEvo/go-ipfs/fuse/node/mount_darwin.go', 'top_nesting_level': 0, 'length': 10, 'fan_in': 0, 'fan_out': 0, 'general_fan_out': 0}, {'cyclomatic_complexity': 2, 'nloc': 9, 'token_count': 51, 'name': 'trySysctl', 'long_name': 'trySysctl', 'start_line': 173, 'end_line': 181, 'full_parameters': [], 'filename': '/home/dimi/Documents/Informatik_Studium/FSS/SoftEvo/DataCollection/FFS_SoftEvo/go-ipfs/fuse/node/mount_darwin.go', 'top_nesting_level': 0, 'length': 9, 'fan_in': 0, 'fan_out': 0, 'general_fan_out': 0}, {'cyclomatic_complexity': 3, 'nloc': 12, 'token_count': 95, 'name': 'tryGFVFromFuseVersion', 'long_name': 'tryGFVFromFuseVersion', 'start_line': 183, 'end_line': 196, 'full_parameters': [], 'filename': '/home/dimi/Documents/Informatik_Studium/FSS/SoftEvo/DataCollection/FFS_SoftEvo/go-ipfs/fuse/node/mount_darwin.go', 'top_nesting_level': 0, 'length': 14, 'fan_in': 0, 'fan_out': 0, 'general_fan_out': 0}, {'cyclomatic_complexity': 5, 'nloc': 25, 'token_count': 163, 'name': 'ensureFuseVersionIsInstalled', 'long_name': 'ensureFuseVersionIsInstalled', 'start_line': 198, 'end_line': 231, 'full_parameters': [], 'filename': '/home/dimi/Documents/Informatik_Studium/FSS/SoftEvo/DataCollection/FFS_SoftEvo/go-ipfs/fuse/node/mount_darwin.go', 'top_nesting_level': 0, 'length': 34, 'fan_in': 0, 'fan_out': 0, 'general_fan_out': 0}, {'cyclomatic_complexity': 4, 'nloc': 15, 'token_count': 83, 'name': 'userAskedToSkipFuseCheck', 'long_name': 'userAskedToSkipFuseCheck node * core . IpfsNode', 'start_line': 233, 'end_line': 249, 'full_parameters': ['node * core . IpfsNode'], 'filename': '/home/dimi/Documents/Informatik_Studium/FSS/SoftEvo/DataCollection/FFS_SoftEvo/go-ipfs/fuse/node/mount_darwin.go', 'top_nesting_level': 0, 'length': 17, 'fan_in': 0, 'fan_out': 0, 'general_fan_out': 0}]",5,24,1,10,10,"[{'timestamp': 1510002729.0, 'added_lines': 2, 'deleted_lines': 2, 'nloc': 169}, {'timestamp': 1528520460.0, 'added_lines': 1, 'deleted_lines': 1, 'nloc': 169}, {'timestamp': 1548659918.0, 'added_lines': 1, 'deleted_lines': 1, 'nloc': 169}, {'timestamp': 1551551196.0, 'added_lines': 2, 'deleted_lines': 2, 'nloc': 169}, {'timestamp': 1553090518.0, 'added_lines': 3, 'deleted_lines': 3, 'nloc': 169}, {'timestamp': 1553654254.0, 'added_lines': 13, 'deleted_lines': 6, 'nloc': 175}, {'timestamp': 1553656251.0, 'added_lines': 1, 'deleted_lines': 1, 'nloc': 175}, {'timestamp': 1553657835.0, 'added_lines': 0, 'deleted_lines': 1, 'nloc': 174}, {'timestamp': 1587221101.0, 'added_lines': 5, 'deleted_lines': 5, 'nloc': 174}, {'timestamp': 1614284918.0, 'added_lines': 1, 'deleted_lines': 1, 'nloc': 174}]","{'cmd/ipfs/ulimit_freebsd.go': 1, 'cmd/ipfs/ulimit_unix.go': 1, 'package.json': 2, 'assets/assets.go': 2, 'blocks/blockstoreutil/remove.go': 3, 'blockservice/blockservice.go': 1, 'blockservice/blockservice_test.go': 1, 'blockservice/test/blocks_test.go': 1, 'blockservice/test/mock.go': 1, 'cmd/ipfs/daemon.go': 3, 'cmd/ipfs/init.go': 2, 'cmd/ipfs/ipfs.go': 2, 'cmd/ipfs/main.go': 2, 'cmd/ipfs/util/ulimit.go': 3, 'cmd/ipfs/util/ulimit_freebsd.go': 2, 'cmd/ipfs/util/ulimit_unix.go': 2, 'cmd/ipfswatch/main.go': 2, 'cmd/seccat/seccat.go': 2, 'cmd/seccat/util.go': 2, 'commands/command.go': 1, 'commands/legacy/command.go': 1, 'commands/legacy/legacy.go': 1, 'commands/legacy/legacy_test.go': 1, 'commands/legacy/request.go': 1, 'commands/legacy/response.go': 1, 'commands/request.go': 1, 'commands/response.go': 1, 'core/bootstrap.go': 2, 'core/bootstrap_test.go': 2, 'core/builder.go': 2, 'core/commands/active.go': 2, 'core/commands/add.go': 2, 'core/commands/bitswap.go': 2, 'core/commands/block.go': 2, 'core/commands/bootstrap.go': 2, 'core/commands/cat.go': 2, 'core/commands/commands.go': 3, 'core/commands/commands_test.go': 2, 'core/commands/config.go': 2, 'core/commands/dag/dag.go': 3, 'core/commands/dht.go': 2, 'core/commands/dht_test.go': 2, 'core/commands/diag.go': 2, 'core/commands/dns.go': 2, 'core/commands/external.go': 2, 'core/commands/files.go': 3, 'core/commands/filestore.go': 2, 'core/commands/get.go': 3, 'core/commands/get_test.go': 2, 'core/commands/helptext_test.go': 2, 'core/commands/id.go': 2, 'core/commands/ipns.go': 1, 'core/commands/ipnsps.go': 1, 'core/commands/keystore.go': 2, 'core/commands/log.go': 2, 'core/commands/ls.go': 2, 'core/commands/mount_nofuse.go': 2, 'core/commands/mount_unix.go': 2, 'core/commands/mount_windows.go': 2, 'core/commands/name.go': 1, 'core/commands/object/diff.go': 2, 'core/commands/object/object.go': 2, 'core/commands/object/patch.go': 2, 'core/commands/p2p.go': 2, 'core/commands/pin.go': 3, 'core/commands/ping.go': 2, 'core/commands/publish.go': 1, 'core/commands/pubsub.go': 2, 'core/commands/refs.go': 2, 'core/commands/repo.go': 2, 'core/commands/resolve.go': 2, 'core/commands/root.go': 2, 'core/commands/shutdown.go': 2, 'core/commands/stat.go': 2, 'core/commands/swarm.go': 2, 'core/commands/sysdiag.go': 2, 'core/commands/tar.go': 2, 'core/commands/unixfs/ls.go': 2, 'core/commands/unixfs/unixfs.go': 2, 'core/commands/version.go': 2, 'core/core.go': 2, 'core/coreapi/block.go': 2, 'core/coreapi/block_test.go': 1, 'core/coreapi/coreapi.go': 2, 'core/coreapi/dag.go': 2, 'core/coreapi/dag_test.go': 1, 'core/coreapi/interface/coreapi.go': 1, 'core/coreapi/interface/dag.go': 1, 'core/coreapi/interface/object.go': 1, 'core/coreapi/interface/options/block.go': 1, 'core/coreapi/interface/options/dag.go': 1, 'core/coreapi/interface/path.go': 1, 'core/coreapi/interface/unixfs.go': 1, 'core/coreapi/key.go': 2, 'core/coreapi/name.go': 2, 'core/coreapi/object.go': 2, 'core/coreapi/pin.go': 2, 'core/coreapi/unixfs.go': 2, 'core/coreapi/unixfs_test.go': 1, 'core/coredag/cbor.go': 2, 'core/coredag/dagpb.go': 2, 'core/coredag/dagtransl.go': 2, 'core/coredag/raw.go': 2, 'core/corehttp/commands.go': 2, 'core/corehttp/corehttp.go': 3, 'core/corehttp/gateway.go': 2, 'core/corehttp/gateway_handler.go': 3, 'core/corehttp/gateway_test.go': 2, 'core/corehttp/logs.go': 2, 'core/corehttp/metrics_test.go': 2, 'core/corerepo/gc.go': 2, 'core/corerepo/pinning.go': 1, 'core/coreunix/add.go': 2, 'core/coreunix/add_test.go': 3, 'core/coreunix/metadata.go': 2, 'core/coreunix/metadata_test.go': 2, 'core/mock/mock.go': 2, 'core/pathresolver.go': 2, 'exchange/bitswap/bitswap.go': 1, 'exchange/bitswap/bitswap_test.go': 1, 'exchange/bitswap/decision/bench_test.go': 1, 'exchange/bitswap/decision/engine.go': 1, 'exchange/bitswap/decision/engine_test.go': 1, 'exchange/bitswap/decision/ledger.go': 1, 'exchange/bitswap/decision/peer_request_queue.go': 1, 'exchange/bitswap/decision/peer_request_queue_test.go': 1, 'exchange/bitswap/get.go': 1, 'exchange/bitswap/message/message.go': 1, 'exchange/bitswap/message/message_test.go': 1, 'exchange/bitswap/network/interface.go': 1, 'exchange/bitswap/network/ipfs_impl.go': 1, 'exchange/bitswap/notifications/notifications.go': 1, 'exchange/bitswap/notifications/notifications_test.go': 1, 'exchange/bitswap/session.go': 1, 'exchange/bitswap/session_test.go': 1, 'exchange/bitswap/stat.go': 1, 'exchange/bitswap/testnet/interface.go': 1, 'exchange/bitswap/testnet/network_test.go': 1, 'exchange/bitswap/testnet/peernet.go': 1, 'exchange/bitswap/testnet/virtual.go': 1, 'exchange/bitswap/testutils.go': 1, 'exchange/bitswap/wantlist/wantlist.go': 1, 'exchange/bitswap/wantlist/wantlist_test.go': 1, 'exchange/bitswap/wantmanager.go': 1, 'exchange/bitswap/workers.go': 1, 'exchange/reprovide/providers.go': 2, 'exchange/reprovide/reprovide.go': 2, 'exchange/reprovide/reprovide_test.go': 2, 'filestore/filestore.go': 2, 'filestore/filestore_test.go': 2, 'filestore/fsrefstore.go': 2, 'filestore/util.go': 2, 'fuse/ipns/ipns_test.go': 4, 'fuse/ipns/ipns_unix.go': 2, 'fuse/ipns/link_unix.go': 2, 'fuse/mount/fuse.go': 2, 'fuse/mount/mount.go': 2, 'fuse/node/mount_test.go': 3, 'fuse/node/mount_unix.go': 2, 'fuse/readonly/ipfs_test.go': 3, 'fuse/readonly/readonly_unix.go': 3, 'importer/balanced/balanced_test.go': 1, 'importer/balanced/builder.go': 1, 'importer/helpers/dagbuilder.go': 1, 'importer/helpers/helpers.go': 1, 'importer/importer.go': 1, 'importer/importer_test.go': 1, 'importer/trickle/trickle_test.go': 1, 'importer/trickle/trickledag.go': 1, 'keystore/keystore.go': 3, 'merkledag/coding.go': 1, 'merkledag/errservice.go': 1, 'merkledag/merkledag.go': 1, 'merkledag/merkledag_test.go': 1, 'merkledag/node.go': 1, 'merkledag/node_test.go': 1, 'merkledag/raw.go': 1, 'merkledag/readonly.go': 1, 'merkledag/readonly_test.go': 1, 'merkledag/rwservice.go': 1, 'merkledag/session.go': 1, 'merkledag/test/utils.go': 1, 'merkledag/traverse/traverse.go': 1, 'merkledag/traverse/traverse_test.go': 1, 'merkledag/utils/diff.go': 1, 'merkledag/utils/diffenum.go': 1, 'merkledag/utils/diffenum_test.go': 1, 'merkledag/utils/utils.go': 1, 'merkledag/utils/utils_test.go': 1, 'mfs/dir.go': 1, 'mfs/file.go': 1, 'mfs/mfs_test.go': 1, 'mfs/ops.go': 1, 'mfs/repub_test.go': 1, 'mfs/system.go': 1, 'namesys/ipns_select_test.go': 1, 'namesys/ipns_validate_test.go': 1, 'namesys/namesys.go': 3, 'namesys/namesys_test.go': 2, 'namesys/publisher.go': 2, 'namesys/publisher_test.go': 2, 'namesys/republisher/repub.go': 2, 'namesys/republisher/repub_test.go': 3, 'namesys/resolve_test.go': 2, 'namesys/routing.go': 2, 'namesys/validator.go': 1, 'p2p/p2p.go': 2, 'p2p/registry.go': 1, 'path/path.go': 1, 'path/resolver/resolver.go': 1, 'path/resolver/resolver_test.go': 1, 'pin/gc/gc.go': 2, 'pin/pin.go': 2, 'pin/pin_test.go': 2, 'pin/set.go': 2, 'pin/set_test.go': 2, 'plugin/ipld.go': 2, 'plugin/loader/initializer.go': 1, 'plugin/loader/load.go': 1, 'plugin/plugins/git/git.go': 2, 'repo/config/bootstrap_peers.go': 1, 'repo/config/init.go': 1, 'repo/fsrepo/datastores.go': 2, 'repo/fsrepo/fsrepo.go': 2, 'repo/fsrepo/serialize/serialize.go': 1, 'repo/mock.go': 2, 'repo/repo.go': 2, 'tar/format.go': 2, 'test/dependencies/ma-pipe-unidir/main.go': 2, 'test/integration/addcat_test.go': 2, 'test/integration/bench_cat_test.go': 2, 'test/integration/bench_test.go': 2, 'test/integration/bitswap_wo_routing_test.go': 2, 'test/integration/three_legged_cat_test.go': 2, 'thirdparty/pollEndpoint/main.go': 2, 'thirdparty/verifbs/verifbs.go': 2, 'thirdparty/verifcid/validate.go': 1, 'thirdparty/verifcid/validate_test.go': 1, 'unixfs/archive/archive.go': 1, 'unixfs/archive/tar/writer.go': 1, 'unixfs/hamt/hamt.go': 1, 'unixfs/hamt/hamt_stress_test.go': 1, 'unixfs/hamt/hamt_test.go': 1, 'unixfs/io/dagreader.go': 1, 'unixfs/io/dirbuilder.go': 1, 'unixfs/io/pbdagreader.go': 1, 'unixfs/io/resolve.go': 1, 'unixfs/mod/dagmodifier.go': 1, 'unixfs/mod/dagmodifier_test.go': 1, 'unixfs/test/utils.go': 1, 'cmd/ipfs/dnsresolve_test.go': 1, 'commands/context.go': 1, 'core/commands/cid.go': 2, 'core/commands/cmdenv/cidbase.go': 1, 'core/commands/cmdenv/cidbase_test.go': 1, 'core/commands/cmdenv/env.go': 1, 'core/commands/cmdenv/file.go': 1, 'core/commands/name/ipns.go': 1, 'core/commands/name/ipnsps.go': 1, 'core/commands/name/name.go': 1, 'core/commands/name/publish.go': 1, 'core/commands/urlstore.go': 1, 'core/core_test.go': 1, 'core/coreapi/dht.go': 1, 'core/coreapi/path.go': 1, 'core/coreapi/pubsub.go': 1, 'core/coreapi/swarm.go': 1, 'core/coreapi/test/api_test.go': 1, 'core/corehttp/ipns_hostname.go': 1, 'core/corehttp/metrics.go': 1, 'core/corehttp/proxy.go': 1, 'core/corehttp/proxy_test.go': 1, 'core/corerepo/stat.go': 1, 'core/pathresolver_test.go': 1, 'dagutils/diff.go': 1, 'dagutils/diffenum.go': 1, 'dagutils/diffenum_test.go': 1, 'dagutils/utils.go': 1, 'dagutils/utils_test.go': 1, 'filestore/pb/dataobj.pb.go': 1, 'fuse/ipns/common.go': 1, 'keystore/keystore_test.go': 2, 'keystore/memkeystore.go': 2, 'namesys/base.go': 1, 'namesys/cache.go': 1, 'namesys/dns.go': 1, 'namesys/dns_test.go': 1, 'namesys/interface.go': 1, 'namesys/ipns_resolver_validation_test.go': 1, 'namesys/proquint.go': 1, 'p2p/listener.go': 1, 'p2p/local.go': 1, 'p2p/remote.go': 1, 'p2p/stream.go': 1, 'pin/internal/pb/header.pb.go': 1, 'plugin/daemon.go': 1, 'plugin/loader/loader.go': 1, 'plugin/plugins/badgerds/badgerds.go': 1, 'plugin/plugins/flatfs/flatfs.go': 1, 'plugin/plugins/levelds/levelds.go': 1, 'plugin/tracer.go': 1, 'repo/fsrepo/config_test.go': 1, 'repo/fsrepo/fsrepo_test.go': 1, 'repo/fsrepo/misc.go': 1, 'test/bench/bench_cli_ipfs_add/main.go': 1, 'test/bench/offline_add/main.go': 1, 'test/dependencies/iptb/iptb.go': 1, 'thirdparty/cidv0v1/blockstore.go': 1, 'thirdparty/notifier/notifier.go': 2, 'CHANGELOG.md': 1, 'Dockerfile': 1, 'README.md': 1, 'bin/check_go_version': 1, 'coverage/Rules.mk': 1, 'docs/config.md': 1, 'docs/debug-guide.md': 1, 'docs/environment-variables.md': 1, 'gc/gc.go': 1, 'keystore/memkeystore_test.go': 1, 'misc/completion/ipfs-completion.bash': 1, 'plugin/plugins/gen_main.sh': 1, 'repo/fsrepo/migrations/migrations.go': 1, 'repo/onlyone.go': 1, 'test/3nodetest/run-test-on-img.sh': 1, 'test/ipfs-test-lib.sh': 1, 'test/sharness/README.md': 1, 'test/sharness/lib/iptb-lib.sh': 1, 'test/sharness/t0010-basic-commands.sh': 1, 'test/sharness/t0020-init.sh': 1, 'test/sharness/t0030-mount.sh': 1, 'test/sharness/t0031-mount-publish.sh': 1, 'test/sharness/t0040-add-and-cat.sh': 1, 'test/sharness/t0050-block.sh': 1, 'test/sharness/t0051-object.sh': 1, 'test/sharness/t0053-dag.sh': 1, 'test/sharness/t0060-daemon.sh': 1, 'test/sharness/t0062-daemon-api.sh': 1, 'test/sharness/t0080-repo.sh': 1, 'test/sharness/t0087-repo-robust-gc.sh': 1, 'test/sharness/t0090-get.sh': 1, 'test/sharness/t0110-gateway.sh': 1, 'test/sharness/t0114-gateway-subdomains.sh': 1, 'test/sharness/t0131-multinode-client-routing.sh': 1, 'test/sharness/t0140-swarm.sh': 1, 'test/sharness/t0183-namesys-pubsub.sh': 1, 'test/sharness/t0250-files-api.sh': 1, 'test/sharness/t0270-filestore.sh': 1, 'test/sharness/t0272-urlstore.sh': 1, 'test/sharness/t0410-api-add.sh': 1, 'test/sharness/t0600-issues-and-regressions-online.sh': 1, 'test/sharness_test_coverage_helper.sh': 1, 'thirdparty/README.md': 1, 'go.mod': 1, 'go.sum': 1}","('fuse/ipns/ipns_test.go', 0.4, 0.07692307692307693)"
fuse/node/mount_nofuse.go,8,32,1,"[{'cyclomatic_complexity': 1, 'nloc': 3, 'token_count': 24, 'name': 'Mount', 'long_name': 'Mount node * core . IpfsNode , fsdir , nsdir string', 'start_line': 12, 'end_line': 14, 'full_parameters': ['node * core . IpfsNode', ' fsdir', ' nsdir string'], 'filename': '/home/dimi/Documents/Informatik_Studium/FSS/SoftEvo/DataCollection/FFS_SoftEvo/go-ipfs/fuse/node/mount_nofuse.go', 'top_nesting_level': 0, 'length': 3, 'fan_in': 0, 'fan_out': 0, 'general_fan_out': 0}]",8,32,1,"[{'cyclomatic_complexity': 1, 'nloc': 3, 'token_count': 24, 'name': 'Mount', 'long_name': 'Mount node * core . IpfsNode , fsdir , nsdir string', 'start_line': 11, 'end_line': 13, 'full_parameters': ['node * core . IpfsNode', ' fsdir', ' nsdir string'], 'filename': '/home/dimi/Documents/Informatik_Studium/FSS/SoftEvo/DataCollection/FFS_SoftEvo/go-ipfs/fuse/node/mount_nofuse.go', 'top_nesting_level': 0, 'length': 3, 'fan_in': 0, 'fan_out': 0, 'general_fan_out': 0}]",0,0,0,4,4,"[{'timestamp': 1526916180.0, 'added_lines': 1, 'deleted_lines': 1, 'nloc': 8}, {'timestamp': 1527086998.0, 'added_lines': 1, 'deleted_lines': 2, 'nloc': 8}, {'timestamp': 1554146764.0, 'added_lines': 2, 'deleted_lines': 0, 'nloc': 9}, {'timestamp': 1555636229.0, 'added_lines': 0, 'deleted_lines': 2, 'nloc': 8}]","{'core/commands/mount_nofuse.go': 2, 'core/commands/mount_unix.go': 1, 'fuse/node/mount_unix.go': 3, 'fuse/node/mount_test.go': 1}","('fuse/node/mount_unix.go', 0.75, 0.17647058823529413)"
fuse/node/mount_test.go,72,399,3,"[{'cyclomatic_complexity': 2, 'nloc': 5, 'token_count': 25, 'name': 'maybeSkipFuseTests', 'long_name': 'maybeSkipFuseTests t * testing . T', 'start_line': 21, 'end_line': 25, 'full_parameters': ['t * testing . T'], 'filename': '/home/dimi/Documents/Informatik_Studium/FSS/SoftEvo/DataCollection/FFS_SoftEvo/go-ipfs/fuse/node/mount_test.go', 'top_nesting_level': 0, 'length': 5, 'fan_in': 0, 'fan_out': 0, 'general_fan_out': 0}, {'cyclomatic_complexity': 2, 'nloc': 6, 'token_count': 42, 'name': 'mkdir', 'long_name': 'mkdir t * testing . T , path string', 'start_line': 27, 'end_line': 32, 'full_parameters': ['t * testing . T', ' path string'], 'filename': '/home/dimi/Documents/Informatik_Studium/FSS/SoftEvo/DataCollection/FFS_SoftEvo/go-ipfs/fuse/node/mount_test.go', 'top_nesting_level': 0, 'length': 6, 'fan_in': 0, 'fan_out': 0, 'general_fan_out': 0}, {'cyclomatic_complexity': 10, 'nloc': 46, 'token_count': 308, 'name': 'TestExternalUnmount', 'long_name': 'TestExternalUnmount t * testing . T', 'start_line': 35, 'end_line': 98, 'full_parameters': ['t * testing . T'], 'filename': '/home/dimi/Documents/Informatik_Studium/FSS/SoftEvo/DataCollection/FFS_SoftEvo/go-ipfs/fuse/node/mount_test.go', 'top_nesting_level': 0, 'length': 64, 'fan_in': 0, 'fan_out': 0, 'general_fan_out': 0}]",68,352,3,"[{'cyclomatic_complexity': 2, 'nloc': 5, 'token_count': 25, 'name': 'maybeSkipFuseTests', 'long_name': 'maybeSkipFuseTests t * testing . T', 'start_line': 23, 'end_line': 27, 'full_parameters': ['t * testing . T'], 'filename': '/home/dimi/Documents/Informatik_Studium/FSS/SoftEvo/DataCollection/FFS_SoftEvo/go-ipfs/fuse/node/mount_test.go', 'top_nesting_level': 0, 'length': 5, 'fan_in': 0, 'fan_out': 0, 'general_fan_out': 0}, {'cyclomatic_complexity': 2, 'nloc': 6, 'token_count': 42, 'name': 'mkdir', 'long_name': 'mkdir t * testing . T , path string', 'start_line': 29, 'end_line': 34, 'full_parameters': ['t * testing . T', ' path string'], 'filename': '/home/dimi/Documents/Informatik_Studium/FSS/SoftEvo/DataCollection/FFS_SoftEvo/go-ipfs/fuse/node/mount_test.go', 'top_nesting_level': 0, 'length': 6, 'fan_in': 0, 'fan_out': 0, 'general_fan_out': 0}, {'cyclomatic_complexity': 12, 'nloc': 43, 'token_count': 265, 'name': 'TestExternalUnmount', 'long_name': 'TestExternalUnmount t * testing . T', 'start_line': 37, 'end_line': 95, 'full_parameters': ['t * testing . T'], 'filename': '/home/dimi/Documents/Informatik_Studium/FSS/SoftEvo/DataCollection/FFS_SoftEvo/go-ipfs/fuse/node/mount_test.go', 'top_nesting_level': 0, 'length': 59, 'fan_in': 0, 'fan_out': 0, 'general_fan_out': 0}]",-4,-47,0,50,50,"[{'timestamp': 1507212616.0, 'added_lines': 1, 'deleted_lines': 1, 'nloc': 72}, {'timestamp': 1507304579.0, 'added_lines': 1, 'deleted_lines': 1, 'nloc': 72}, {'timestamp': 1491058697.0, 'added_lines': 2, 'deleted_lines': 1, 'nloc': 72}, {'timestamp': 1511223906.0, 'added_lines': 1, 'deleted_lines': 1, 'nloc': 72}, {'timestamp': 1512365669.0, 'added_lines': 1, 'deleted_lines': 1, 'nloc': 72}, {'timestamp': 1516838128.0, 'added_lines': 1, 'deleted_lines': 1, 'nloc': 72}, {'timestamp': 1517453697.0, 'added_lines': 1, 'deleted_lines': 1, 'nloc': 72}, {'timestamp': 1518185191.0, 'added_lines': 2, 'deleted_lines': 1, 'nloc': 72}, {'timestamp': 1519761835.0, 'added_lines': 1, 'deleted_lines': 1, 'nloc': 72}, {'timestamp': 1519999272.0, 'added_lines': 1, 'deleted_lines': 1, 'nloc': 72}, {'timestamp': 1525408792.0, 'added_lines': 2, 'deleted_lines': 2, 'nloc': 72}, {'timestamp': 1528131220.0, 'added_lines': 1, 'deleted_lines': 1, 'nloc': 72}, {'timestamp': 1528268108.0, 'added_lines': 1, 'deleted_lines': 1, 'nloc': 72}, {'timestamp': 1528520460.0, 'added_lines': 2, 'deleted_lines': 2, 'nloc': 72}, {'timestamp': 1528945488.0, 'added_lines': 2, 'deleted_lines': 2, 'nloc': 72}, {'timestamp': 1529984485.0, 'added_lines': 2, 'deleted_lines': 2, 'nloc': 72}, {'timestamp': 1531779409.0, 'added_lines': 1, 'deleted_lines': 1, 'nloc': 72}, {'timestamp': 1533779477.0, 'added_lines': 2, 'deleted_lines': 2, 'nloc': 72}, {'timestamp': 1534115707.0, 'added_lines': 1, 'deleted_lines': 1, 'nloc': 72}, {'timestamp': 1534195762.0, 'added_lines': 1, 'deleted_lines': 1, 'nloc': 72}, {'timestamp': 1534347022.0, 'added_lines': 1, 'deleted_lines': 1, 'nloc': 72}, {'timestamp': 1534896611.0, 'added_lines': 2, 'deleted_lines': 2, 'nloc': 72}, {'timestamp': 1535601896.0, 'added_lines': 1, 'deleted_lines': 1, 'nloc': 72}, {'timestamp': 1536388808.0, 'added_lines': 1, 'deleted_lines': 1, 'nloc': 72}, {'timestamp': 1536718784.0, 'added_lines': 1, 'deleted_lines': 1, 'nloc': 72}, {'timestamp': 1536723292.0, 'added_lines': 1, 'deleted_lines': 1, 'nloc': 72}, {'timestamp': 1537073644.0, 'added_lines': 8, 'deleted_lines': 12, 'nloc': 69}, {'timestamp': 1537790637.0, 'added_lines': 1, 'deleted_lines': 1, 'nloc': 69}, {'timestamp': 1537792589.0, 'added_lines': 2, 'deleted_lines': 2, 'nloc': 69}, {'timestamp': 1538544957.0, 'added_lines': 1, 'deleted_lines': 1, 'nloc': 69}, {'timestamp': 1538773916.0, 'added_lines': 1, 'deleted_lines': 1, 'nloc': 69}, {'timestamp': 1539176817.0, 'added_lines': 1, 'deleted_lines': 1, 'nloc': 69}, {'timestamp': 1540400358.0, 'added_lines': 2, 'deleted_lines': 2, 'nloc': 69}, {'timestamp': 1541204121.0, 'added_lines': 2, 'deleted_lines': 2, 'nloc': 69}, {'timestamp': 1541903826.0, 'added_lines': 1, 'deleted_lines': 1, 'nloc': 69}, {'timestamp': 1544225843.0, 'added_lines': 2, 'deleted_lines': 2, 'nloc': 69}, {'timestamp': 1544667474.0, 'added_lines': 0, 'deleted_lines': 10, 'nloc': 61}, {'timestamp': 1547003974.0, 'added_lines': 1, 'deleted_lines': 1, 'nloc': 61}, {'timestamp': 1549588289.0, 'added_lines': 1, 'deleted_lines': 1, 'nloc': 61}, {'timestamp': 1550507829.0, 'added_lines': 1, 'deleted_lines': 1, 'nloc': 61}, {'timestamp': 1551229859.0, 'added_lines': 1, 'deleted_lines': 1, 'nloc': 61}, {'timestamp': 1551551196.0, 'added_lines': 1, 'deleted_lines': 1, 'nloc': 61}, {'timestamp': 1553654254.0, 'added_lines': 6, 'deleted_lines': 1, 'nloc': 65}, {'timestamp': 1555636229.0, 'added_lines': 2, 'deleted_lines': 1, 'nloc': 66}, {'timestamp': 1556839836.0, 'added_lines': 1, 'deleted_lines': 1, 'nloc': 66}, {'timestamp': 1556840626.0, 'added_lines': 5, 'deleted_lines': 2, 'nloc': 68}, {'timestamp': 1559060517.0, 'added_lines': 1, 'deleted_lines': 1, 'nloc': 68}, {'timestamp': 1563668276.0, 'added_lines': 1, 'deleted_lines': 1, 'nloc': 68}, {'timestamp': 1563837872.0, 'added_lines': 1, 'deleted_lines': 1, 'nloc': 68}, {'timestamp': 1600726105.0, 'added_lines': 1, 'deleted_lines': 1, 'nloc': 68}]","{'core/bootstrap_test.go': 27, 'core/commands/dht_test.go': 27, 'core/mock/mock.go': 30, 'exchange/bitswap/bitswap_test.go': 17, 'exchange/bitswap/decision/bench_test.go': 10, 'exchange/bitswap/decision/engine_test.go': 12, 'exchange/bitswap/decision/peer_request_queue_test.go': 10, 'exchange/bitswap/testnet/interface.go': 9, 'exchange/bitswap/testnet/network_test.go': 17, 'exchange/bitswap/testnet/peernet.go': 17, 'exchange/bitswap/testnet/virtual.go': 16, 'exchange/bitswap/testutils.go': 13, 'exchange/reprovide/reprovide_test.go': 40, 'fuse/ipns/ipns_test.go': 46, 'fuse/readonly/ipfs_test.go': 38, 'mfs/repub_test.go': 14, 'namesys/publisher_test.go': 40, 'namesys/resolve_test.go': 40, 'package.json': 39, 'routing/mock/centralized_client.go': 6, 'routing/mock/centralized_server.go': 6, 'routing/mock/centralized_test.go': 6, 'routing/mock/interface.go': 6, 'routing/offline/offline_test.go': 7, 'test/integration/addcat_test.go': 30, 'test/integration/bench_cat_test.go': 30, 'test/integration/bench_test.go': 21, 'test/integration/grandcentral_test.go': 1, 'test/integration/three_legged_cat_test.go': 30, 'core/bootstrap.go': 28, 'core/commands/dht.go': 38, 'core/commands/id.go': 30, 'core/commands/pubsub.go': 25, 'core/core.go': 40, 'core/corehttp/gateway.go': 28, 'core/corehttp/gateway_test.go': 34, 'core/corehttp/metrics_test.go': 28, 'exchange/bitswap/network/ipfs_impl.go': 11, 'namesys/republisher/repub_test.go': 35, 'p2p/p2p.go': 28, 'routing/none/none_client.go': 5, 'test/integration/bitswap_wo_routing_test.go': 32, 'thirdparty/ipfsaddr/ipfsaddr.go': 1, 'blocks/blockstore/caching.go': 1, 'blocks/blockstore/util/remove.go': 3, 'cmd/ipfs/daemon.go': 18, 'cmd/ipfs/init.go': 21, 'cmd/ipfs/ipfs.go': 14, 'cmd/ipfs/main.go': 23, 'cmd/ipfs/main_test.go': 3, 'cmd/ipfswatch/main.go': 18, 'cmd/seccat/seccat.go': 28, None: 19, 'commands/channelmarshaler.go': 1, 'commands/cli/cmd_suggestion.go': 1, 'commands/cli/helptext.go': 2, 'commands/cli/helptext_test.go': 2, 'commands/cli/parse.go': 2, 'commands/cli/parse_test.go': 2, 'commands/command.go': 12, 'commands/command_test.go': 5, 'commands/http/client.go': 2, 'commands/http/handler.go': 2, 'commands/http/multifilereader.go': 2, 'commands/http/multifilereader_test.go': 2, 'commands/http/parse.go': 2, 'commands/reqlog.go': 1, 'commands/request.go': 16, 'commands/response.go': 7, 'commands/response_test.go': 5, 'core/commands/active.go': 7, 'core/commands/add.go': 27, 'core/commands/bitswap.go': 33, 'core/commands/block.go': 18, 'core/commands/bootstrap.go': 17, 'core/commands/cat.go': 16, 'core/commands/commands.go': 14, 'core/commands/config.go': 17, 'core/commands/dag/dag.go': 31, 'core/commands/diag.go': 7, 'core/commands/dns.go': 10, 'core/commands/e/error.go': 1, 'core/commands/external.go': 7, 'core/commands/files/files.go': 5, 'core/commands/filestore.go': 18, 'core/commands/get.go': 31, 'core/commands/helptext_test.go': 14, 'core/commands/ipns.go': 18, 'core/commands/keystore.go': 15, 'core/commands/log.go': 13, 'core/commands/ls.go': 30, 'core/commands/mount_nofuse.go': 7, 'core/commands/mount_unix.go': 17, 'core/commands/mount_windows.go': 6, 'core/commands/name.go': 5, 'core/commands/object/diff.go': 9, 'core/commands/object/object.go': 31, 'core/commands/object/patch.go': 14, 'core/commands/p2p.go': 21, 'core/commands/pin.go': 31, 'core/commands/ping.go': 26, 'core/commands/publish.go': 13, 'core/commands/refs.go': 29, 'core/commands/repo.go': 31, 'core/commands/resolve.go': 28, 'core/commands/root.go': 14, 'core/commands/shutdown.go': 10, 'core/commands/stat.go': 20, 'core/commands/swarm.go': 28, 'core/commands/sysdiag.go': 14, 'core/commands/tar.go': 27, 'core/commands/unixfs/ls.go': 27, 'core/commands/unixfs/unixfs.go': 7, 'core/commands/version.go': 8, 'core/core_test.go': 18, 'core/corehttp/commands.go': 31, 'core/coreunix/add.go': 33, 'core/coreunix/add_test.go': 32, 'core/coreunix/metadata_test.go': 31, 'exchange/bitswap/message/message_test.go': 5, 'exchange/bitswap/message/pb/Makefile': 1, 'fuse/ipns/common.go': 26, 'importer/balanced/balanced_test.go': 7, 'importer/chunk/rabin_test.go': 3, 'importer/helpers/dagbuilder.go': 8, 'importer/importer.go': 8, 'merkledag/utils/utils_test.go': 5, 'namesys/dns.go': 24, 'namesys/interface.go': 26, 'namesys/ipns_select_test.go': 5, 'namesys/proquint.go': 24, 'repo/config/identity.go': 3, 'core/commands/get_test.go': 13, 'exchange/bitswap/message/message.go': 9, 'exchange/bitswap/network/interface.go': 9, 'p2p/registry.go': 12, 'repo/config/bootstrap_peers.go': 10, 'assets/assets.go': 26, 'blocks/blockstore/arc_cache.go': 2, 'blocks/blockstore/arc_cache_test.go': 2, 'blocks/blockstore/blockstore.go': 3, 'blocks/blockstore/blockstore_test.go': 2, 'blocks/blockstore/bloom_cache.go': 2, 'blocks/blockstore/bloom_cache_test.go': 2, 'blocks/blocksutil/block_generator.go': 2, 'blockservice/blockservice.go': 8, 'blockservice/blockservice_test.go': 7, 'blockservice/test/blocks_test.go': 7, 'core/builder.go': 34, 'core/commands/ipnsps.go': 5, 'core/coreapi/coreapi.go': 14, 'core/coreapi/interface/interface.go': 2, 'core/coreapi/unixfs.go': 27, 'core/coreapi/unixfs_test.go': 26, 'core/coredag/cbor.go': 11, 'core/coredag/dagpb.go': 27, 'core/coredag/dagtransl.go': 10, 'core/coredag/raw.go': 27, 'core/corehttp/corehttp.go': 15, 'core/corehttp/gateway_handler.go': 32, 'core/corerepo/gc.go': 29, 'core/corerepo/pinning.go': 16, 'core/coreunix/metadata.go': 27, 'core/pathresolver.go': 30, 'exchange/bitswap/bitswap.go': 8, 'exchange/bitswap/decision/engine.go': 8, 'exchange/bitswap/decision/ledger.go': 7, 'exchange/bitswap/decision/peer_request_queue.go': 7, 'exchange/bitswap/get.go': 7, 'exchange/bitswap/notifications/notifications.go': 4, 'exchange/bitswap/notifications/notifications_test.go': 4, 'exchange/bitswap/session.go': 7, 'exchange/bitswap/session_test.go': 6, 'exchange/bitswap/stat.go': 4, 'exchange/bitswap/wantlist/wantlist.go': 4, 'exchange/bitswap/wantlist/wantlist_test.go': 4, 'exchange/bitswap/wantmanager.go': 7, 'exchange/bitswap/workers.go': 7, 'exchange/interface.go': 2, 'exchange/offline/offline.go': 3, 'exchange/offline/offline_test.go': 3, 'exchange/reprovide/providers.go': 30, 'exchange/reprovide/reprovide.go': 28, 'filestore/filestore.go': 23, 'filestore/filestore_test.go': 30, 'filestore/fsrefstore.go': 22, 'filestore/util.go': 22, 'fuse/ipns/ipns_unix.go': 34, 'fuse/readonly/readonly_unix.go': 32, 'importer/balanced/builder.go': 4, 'importer/chunk/splitting_test.go': 2, 'importer/helpers/helpers.go': 4, 'importer/importer_test.go': 6, 'importer/trickle/trickle_test.go': 6, 'importer/trickle/trickledag.go': 4, 'merkledag/batch.go': 2, 'merkledag/coding.go': 4, 'merkledag/merkledag.go': 4, 'merkledag/merkledag_test.go': 6, 'merkledag/node.go': 4, 'merkledag/node_test.go': 4, 'merkledag/raw.go': 4, 'merkledag/traverse/traverse.go': 4, 'merkledag/traverse/traverse_test.go': 4, 'merkledag/utils/diff.go': 4, 'merkledag/utils/diffenum.go': 4, 'merkledag/utils/diffenum_test.go': 4, 'merkledag/utils/utils.go': 7, 'mfs/dir.go': 8, 'mfs/file.go': 10, 'mfs/mfs_test.go': 11, 'mfs/ops.go': 8, 'mfs/system.go': 11, 'namesys/namesys.go': 33, 'namesys/publisher.go': 35, 'namesys/pubsub.go': 6, 'namesys/pubsub_test.go': 7, 'namesys/republisher/repub.go': 33, 'namesys/routing.go': 34, 'path/path.go': 4, 'path/resolver.go': 3, 'path/resolver_test.go': 2, 'pin/gc/gc.go': 31, 'pin/pin.go': 31, 'pin/pin_test.go': 30, 'pin/set.go': 27, 'pin/set_test.go': 30, 'plugin/ipld.go': 10, 'plugin/loader/initializer.go': 9, 'plugin/plugins/git/git.go': 10, 'repo/config/init.go': 7, 'repo/fsrepo/fsrepo.go': 24, 'repo/fsrepo/lock/lock.go': 3, 'repo/fsrepo/serialize/serialize.go': 3, 'repo/mock.go': 17, 'repo/repo.go': 22, 'routing/offline/offline.go': 3, 'tar/format.go': 30, 'test/dependencies/ma-pipe-unidir/main.go': 10, 'thirdparty/ds-help/key.go': 2, 'thirdparty/pollEndpoint/main.go': 15, 'thirdparty/posinfo/posinfo.go': 2, 'unixfs/archive/archive.go': 4, 'unixfs/archive/tar/writer.go': 4, 'unixfs/hamt/hamt.go': 4, 'unixfs/io/dagreader.go': 4, 'unixfs/io/dirbuilder.go': 3, 'unixfs/io/resolve.go': 4, 'unixfs/mod/dagmodifier.go': 6, 'unixfs/mod/dagmodifier_test.go': 3, 'unixfs/test/utils.go': 6, 'commands/legacy/command.go': 9, 'commands/legacy/legacy.go': 9, 'commands/legacy/legacy_test.go': 9, 'commands/legacy/request.go': 9, 'commands/legacy/response.go': 9, 'core/commands/commands_test.go': 11, 'core/coreapi/dag.go': 9, 'core/coreapi/dag_test.go': 3, 'core/coreapi/interface/options/dag.go': 8, 'core/coreapi/key.go': 29, 'core/coreapi/name.go': 37, 'merkledag/test/utils.go': 6, 'namesys/namesys_test.go': 35, 'repo/fsrepo/datastores.go': 16, 'repo/fsrepo/fsrepo_test.go': 19, 'thirdparty/datastore2/datastore_closer.go': 2, 'thirdparty/datastore2/delayed.go': 2, 'thirdparty/datastore2/threadsafe.go': 2, 'unixfs/io/pbdagreader.go': 3, 'cmd/ipfs/util/ulimit.go': 9, 'cmd/seccat/util.go': 9, 'core/corehttp/logs.go': 9, 'fuse/mount/mount.go': 10, 'fuse/node/mount_unix.go': 13, 'importer/chunk/splitting.go': 1, 'namesys/ipns_validate_test.go': 8, 'plugin/loader/load.go': 7, 'blockservice/test/mock.go': 10, 'blocks/blockstoreutil/remove.go': 20, 'namesys/validator.go': 5, 'core/commands/files.go': 27, 'core/coreapi/pin.go': 27, 'keystore/keystore.go': 9, 'keystore/keystore_test.go': 6, 'keystore/memkeystore.go': 6, 'path/resolver/resolver.go': 4, 'thirdparty/verifbs/verifbs.go': 19, 'cmd/ipfs/util/ulimit_freebsd.go': 2, 'cmd/ipfs/util/ulimit_unix.go': 2, 'core/coreapi/block.go': 10, 'core/coreapi/block_test.go': 2, 'core/coreapi/interface/coreapi.go': 7, 'core/coreapi/interface/dag.go': 7, 'core/coreapi/interface/object.go': 7, 'core/coreapi/interface/options/block.go': 3, 'core/coreapi/interface/path.go': 22, 'core/coreapi/interface/unixfs.go': 8, 'core/coreapi/object.go': 25, 'fuse/ipns/link_unix.go': 5, 'fuse/mount/fuse.go': 5, 'fuse/node/mount_darwin.go': 3, 'merkledag/errservice.go': 2, 'merkledag/readonly.go': 2, 'merkledag/readonly_test.go': 2, 'merkledag/rwservice.go': 2, 'merkledag/session.go': 2, 'path/resolver/resolver_test.go': 2, 'thirdparty/verifcid/validate.go': 2, 'thirdparty/verifcid/validate_test.go': 2, 'unixfs/hamt/hamt_stress_test.go': 2, 'unixfs/hamt/hamt_test.go': 2, 'namesys/ipns_resolver_validation_test.go': 27, 'test/sharness/t0170-dht.sh': 1, 'core/commands/urlstore.go': 24, 'unixfs/io/directory.go': 1, 'core/commands/env.go': 2, 'core/coreapi/interface/key.go': 7, 'core/coreapi/name_test.go': 18, 'core/coreapi/path.go': 23, 'core/coreunix/cat.go': 11, 'core/pathresolver_test.go': 23, 'dagutils/diff.go': 23, 'dagutils/diffenum.go': 23, 'dagutils/diffenum_test.go': 23, 'dagutils/utils.go': 23, 'dagutils/utils_test.go': 23, 'filestore/pb/dataobj.pb.go': 3, 'mfs/fd.go': 4, 'namesys/base.go': 23, 'namesys/cache.go': 23, 'pin/internal/pb/header.pb.go': 3, 'thirdparty/cidv0v1/blockstore.go': 15, 'repo/fsrepo/config_test.go': 13, 'repo/fsrepo/misc.go': 13, 'test/bench/bench_cli_ipfs_add/main.go': 13, 'test/bench/offline_add/main.go': 13, 'core/commands/cmdenv/env.go': 12, 'core/commands/name/ipns.go': 18, 'core/commands/name/publish.go': 11, 'core/coreapi/dht.go': 17, 'core/coreapi/dht_test.go': 5, 'test/sharness/t0275-cid-security.sh': 1, 'core/commands/name/ipnsps.go': 9, 'core/commands/name/name.go': 4, 'core/coreapi/interface/dht.go': 10, 'p2p/listener.go': 14, 'p2p/local.go': 14, 'p2p/remote.go': 14, 'p2p/stream.go': 14, 'core/coreapi/interface/swarm.go': 9, 'core/coreapi/swarm.go': 13, 'core/coreapi/interface/options/unixfs.go': 8, 'core/coreapi/pubsub.go': 12, 'core/coreapi/unixfile.go': 7, 'cmd/ipfs/dnsresolve_test.go': 5, 'core/coreapi/interface/pubsub.go': 4, 'core/commands/cid.go': 3, 'test/dependencies/iptb/iptb.go': 8, 'plugin/plugins/badgerds/badgerds.go': 3, 'plugin/plugins/flatfs/flatfs.go': 3, 'plugin/plugins/levelds/levelds.go': 3, 'commands/context.go': 6, 'core/corehttp/proxy.go': 7, 'core/coreapi/interface/tests/name.go': 2, 'core/coreapi/interface/tests/unixfs.go': 2, 'core/coreapi/test/api_test.go': 6, 'core/commands/cmdenv/cidbase.go': 2, 'core/corehttp/ipns_hostname.go': 3, 'namesys/dns_test.go': 3, 'plugin/daemon.go': 3, 'plugin/loader/loader.go': 3, 'core/commands/cmdenv/cidbase_test.go': 1, 'core/commands/cmdenv/file.go': 1, 'core/corehttp/metrics.go': 1, 'core/corehttp/proxy_test.go': 2, 'core/corerepo/stat.go': 1, 'plugin/tracer.go': 1, 'thirdparty/notifier/notifier.go': 1, 'fuse/node/mount_nofuse.go': 1, 'core/bootstrap/bootstrap.go': 1, 'core/bootstrap/bootstrap_test.go': 1, 'core/node/builder.go': 1, 'core/node/core.go': 1, 'core/node/groups.go': 1, 'core/node/identity.go': 1, 'core/node/ipns.go': 1, 'core/node/libp2p/addrs.go': 1, 'core/node/libp2p/discovery.go': 1, 'core/node/libp2p/host.go': 1, 'core/node/libp2p/hostopt.go': 1, 'core/node/libp2p/libp2p.go': 1, 'core/node/libp2p/nat.go': 1, 'core/node/libp2p/pnet.go': 1, 'core/node/libp2p/pubsub.go': 1, 'core/node/libp2p/routing.go': 1, 'core/node/libp2p/routingopt.go': 1, 'core/node/libp2p/smux.go': 1, 'core/node/libp2p/transport.go': 1, 'core/node/provider.go': 1, 'go.mod': 2, 'go.sum': 2, 'provider/simple/provider.go': 1, 'provider/simple/provider_test.go': 1, 'provider/simple/reprovide.go': 1, 'provider/simple/reprovide_test.go': 1, 'fuse/node/mount_openbsd.go': 1, 'fuse/readonly/mount_unix.go': 2, 'mk/util.mk': 2, 'fuse/node/mount_notsupp.go': 2, 'cmd/ipfs/util/ulimit_test.go': 1, 'cmd/ipfswatch/ipfswatch_test.go': 1, 'cmd/seccat/seccat_plan9.go': 1, 'cmd/seccat/seccat_posix.go': 1}","('fuse/ipns/ipns_test.go', 0.92, 0.8846153846153846)"
fuse/node/mount_unix.go,82,446,4,"[{'cyclomatic_complexity': 6, 'nloc': 12, 'token_count': 99, 'name': 'Mount', 'long_name': 'Mount node * core . IpfsNode , fsdir , nsdir string', 'start_line': 33, 'end_line': 49, 'full_parameters': ['node * core . IpfsNode', ' fsdir', ' nsdir string'], 'filename': '/home/dimi/Documents/Informatik_Studium/FSS/SoftEvo/DataCollection/FFS_SoftEvo/go-ipfs/fuse/node/mount_unix.go', 'top_nesting_level': 0, 'length': 17, 'fan_in': 0, 'fan_out': 0, 'general_fan_out': 0}, {'cyclomatic_complexity': 3, 'nloc': 13, 'token_count': 85, 'name': 'error', 'long_name': '(err error,mountpoint string)error', 'start_line': 52, 'end_line': 64, 'full_parameters': [], 'filename': '/home/dimi/Documents/Informatik_Studium/FSS/SoftEvo/DataCollection/FFS_SoftEvo/go-ipfs/fuse/node/mount_unix.go', 'top_nesting_level': 0, 'length': 13, 'fan_in': 0, 'fan_out': 0, 'general_fan_out': 0}, {'cyclomatic_complexity': 1, 'nloc': 1, 'token_count': 2, 'name': '', 'long_name': '(', 'start_line': 73, 'end_line': 73, 'full_parameters': [], 'filename': '/home/dimi/Documents/Informatik_Studium/FSS/SoftEvo/DataCollection/FFS_SoftEvo/go-ipfs/fuse/node/mount_unix.go', 'top_nesting_level': 0, 'length': 1, 'fan_in': 0, 'fan_out': 0, 'general_fan_out': 0}, {'cyclomatic_complexity': 1, 'nloc': 4, 'token_count': 25, 'name': '', 'long_name': '()', 'start_line': 80, 'end_line': 83, 'full_parameters': [], 'filename': '/home/dimi/Documents/Informatik_Studium/FSS/SoftEvo/DataCollection/FFS_SoftEvo/go-ipfs/fuse/node/mount_unix.go', 'top_nesting_level': 0, 'length': 4, 'fan_in': 0, 'fan_out': 0, 'general_fan_out': 0}]",82,452,4,"[{'cyclomatic_complexity': 6, 'nloc': 12, 'token_count': 103, 'name': 'Mount', 'long_name': 'Mount node * core . IpfsNode , fsdir , nsdir string', 'start_line': 33, 'end_line': 51, 'full_parameters': ['node * core . IpfsNode', ' fsdir', ' nsdir string'], 'filename': '/home/dimi/Documents/Informatik_Studium/FSS/SoftEvo/DataCollection/FFS_SoftEvo/go-ipfs/fuse/node/mount_unix.go', 'top_nesting_level': 0, 'length': 19, 'fan_in': 0, 'fan_out': 0, 'general_fan_out': 0}, {'cyclomatic_complexity': 3, 'nloc': 13, 'token_count': 85, 'name': 'error', 'long_name': '(err error,mountpoint string)error', 'start_line': 54, 'end_line': 66, 'full_parameters': [], 'filename': '/home/dimi/Documents/Informatik_Studium/FSS/SoftEvo/DataCollection/FFS_SoftEvo/go-ipfs/fuse/node/mount_unix.go', 'top_nesting_level': 0, 'length': 13, 'fan_in': 0, 'fan_out': 0, 'general_fan_out': 0}, {'cyclomatic_complexity': 1, 'nloc': 1, 'token_count': 2, 'name': '', 'long_name': '(', 'start_line': 75, 'end_line': 75, 'full_parameters': [], 'filename': '/home/dimi/Documents/Informatik_Studium/FSS/SoftEvo/DataCollection/FFS_SoftEvo/go-ipfs/fuse/node/mount_unix.go', 'top_nesting_level': 0, 'length': 1, 'fan_in': 0, 'fan_out': 0, 'general_fan_out': 0}, {'cyclomatic_complexity': 1, 'nloc': 4, 'token_count': 25, 'name': '', 'long_name': '()', 'start_line': 82, 'end_line': 85, 'full_parameters': [], 'filename': '/home/dimi/Documents/Informatik_Studium/FSS/SoftEvo/DataCollection/FFS_SoftEvo/go-ipfs/fuse/node/mount_unix.go', 'top_nesting_level': 0, 'length': 4, 'fan_in': 0, 'fan_out': 0, 'general_fan_out': 0}]",0,6,0,17,17,"[{'timestamp': 1517453697.0, 'added_lines': 1, 'deleted_lines': 1, 'nloc': 82}, {'timestamp': 1527086998.0, 'added_lines': 3, 'deleted_lines': 3, 'nloc': 82}, {'timestamp': 1525408792.0, 'added_lines': 2, 'deleted_lines': 2, 'nloc': 82}, {'timestamp': 1528520460.0, 'added_lines': 1, 'deleted_lines': 1, 'nloc': 82}, {'timestamp': 1529984485.0, 'added_lines': 1, 'deleted_lines': 1, 'nloc': 82}, {'timestamp': 1533779477.0, 'added_lines': 1, 'deleted_lines': 1, 'nloc': 82}, {'timestamp': 1537792589.0, 'added_lines': 1, 'deleted_lines': 1, 'nloc': 82}, {'timestamp': 1541204121.0, 'added_lines': 1, 'deleted_lines': 1, 'nloc': 82}, {'timestamp': 1550507829.0, 'added_lines': 1, 'deleted_lines': 1, 'nloc': 82}, {'timestamp': 1551754781.0, 'added_lines': 1, 'deleted_lines': 1, 'nloc': 82}, {'timestamp': 1551551196.0, 'added_lines': 1, 'deleted_lines': 1, 'nloc': 82}, {'timestamp': 1553697989.0, 'added_lines': 6, 'deleted_lines': 4, 'nloc': 82}, {'timestamp': 1554146764.0, 'added_lines': 2, 'deleted_lines': 0, 'nloc': 83}, {'timestamp': 1555636229.0, 'added_lines': 0, 'deleted_lines': 2, 'nloc': 82}, {'timestamp': 1563668276.0, 'added_lines': 1, 'deleted_lines': 1, 'nloc': 82}, {'timestamp': 1563837872.0, 'added_lines': 1, 'deleted_lines': 1, 'nloc': 82}, {'timestamp': 1600726105.0, 'added_lines': 1, 'deleted_lines': 1, 'nloc': 82}]","{'blocks/blockstore/blockstore.go': 1, 'blockservice/blockservice.go': 4, 'cmd/ipfs/daemon.go': 11, 'cmd/ipfs/ipfs.go': 9, 'cmd/ipfs/main.go': 11, 'cmd/ipfs/util/ulimit.go': 9, 'cmd/seccat/seccat.go': 11, 'cmd/seccat/util.go': 9, 'commands/command.go': 7, 'commands/command_test.go': 1, 'commands/legacy/command.go': 7, 'commands/legacy/legacy.go': 7, 'commands/legacy/legacy_test.go': 7, 'commands/legacy/request.go': 7, 'commands/legacy/response.go': 7, 'commands/request.go': 7, 'commands/response.go': 2, 'commands/response_test.go': 1, 'core/bootstrap.go': 9, 'core/bootstrap_test.go': 9, 'core/builder.go': 11, 'core/commands/add.go': 11, 'core/commands/bitswap.go': 10, 'core/commands/block.go': 9, 'core/commands/cat.go': 9, 'core/commands/commands.go': 10, 'core/commands/commands_test.go': 9, 'core/commands/dag/dag.go': 8, 'core/commands/dht.go': 10, 'core/commands/dht_test.go': 9, 'core/commands/files/files.go': 1, 'core/commands/filestore.go': 9, 'core/commands/get.go': 11, 'core/commands/get_test.go': 9, 'core/commands/helptext_test.go': 9, 'core/commands/id.go': 10, 'core/commands/keystore.go': 9, 'core/commands/log.go': 9, 'core/commands/object/patch.go': 9, 'core/commands/ping.go': 10, 'core/commands/publish.go': 5, 'core/commands/pubsub.go': 9, 'core/commands/repo.go': 10, 'core/commands/root.go': 9, 'core/commands/stat.go': 10, 'core/commands/swarm.go': 10, 'core/core.go': 11, 'core/coreapi/key.go': 9, 'core/coreapi/name.go': 9, 'core/coreapi/unixfs_test.go': 7, 'core/corehttp/commands.go': 9, 'core/corehttp/corehttp.go': 9, 'core/corehttp/gateway.go': 9, 'core/corehttp/gateway_handler.go': 10, 'core/corehttp/gateway_test.go': 10, 'core/corehttp/logs.go': 9, 'core/corehttp/metrics_test.go': 9, 'core/corerepo/gc.go': 10, 'core/coreunix/add.go': 9, 'core/mock/mock.go': 9, 'core/pathresolver.go': 9, 'exchange/bitswap/bitswap.go': 4, 'exchange/bitswap/bitswap_test.go': 4, 'exchange/bitswap/decision/bench_test.go': 4, 'exchange/bitswap/decision/engine.go': 4, 'exchange/bitswap/decision/engine_test.go': 4, 'exchange/bitswap/decision/ledger.go': 4, 'exchange/bitswap/decision/peer_request_queue.go': 4, 'exchange/bitswap/decision/peer_request_queue_test.go': 4, 'exchange/bitswap/message/message.go': 4, 'exchange/bitswap/network/interface.go': 4, 'exchange/bitswap/network/ipfs_impl.go': 4, 'exchange/bitswap/session.go': 4, 'exchange/bitswap/testnet/interface.go': 4, 'exchange/bitswap/testnet/network_test.go': 4, 'exchange/bitswap/testnet/peernet.go': 4, 'exchange/bitswap/testnet/virtual.go': 4, 'exchange/bitswap/testutils.go': 4, 'exchange/bitswap/wantmanager.go': 4, 'exchange/bitswap/workers.go': 4, 'exchange/reprovide/reprovide.go': 9, 'exchange/reprovide/reprovide_test.go': 10, 'filestore/filestore.go': 9, 'fuse/ipns/ipns_test.go': 13, 'fuse/ipns/ipns_unix.go': 12, 'fuse/mount/mount.go': 9, 'fuse/node/mount_test.go': 13, 'fuse/readonly/ipfs_test.go': 13, 'fuse/readonly/readonly_unix.go': 11, 'importer/chunk/splitting.go': 1, 'mfs/repub_test.go': 5, 'mfs/system.go': 5, 'namesys/ipns_validate_test.go': 3, 'namesys/namesys.go': 10, 'namesys/publisher.go': 9, 'namesys/publisher_test.go': 9, 'namesys/pubsub.go': 2, 'namesys/pubsub_test.go': 2, 'namesys/republisher/repub.go': 9, 'namesys/republisher/repub_test.go': 10, 'namesys/resolve_test.go': 9, 'namesys/routing.go': 10, 'p2p/p2p.go': 9, 'p2p/registry.go': 5, 'package.json': 8, 'path/resolver.go': 1, 'pin/gc/gc.go': 9, 'pin/pin.go': 9, 'plugin/loader/load.go': 7, 'repo/config/bootstrap_peers.go': 5, 'repo/config/init.go': 5, 'repo/fsrepo/datastores.go': 9, 'repo/fsrepo/fsrepo.go': 9, 'repo/fsrepo/lock/lock.go': 1, 'routing/mock/centralized_client.go': 1, 'routing/mock/centralized_server.go': 1, 'routing/mock/centralized_test.go': 1, 'routing/mock/interface.go': 1, 'routing/none/none_client.go': 1, 'routing/offline/offline.go': 1, 'routing/offline/offline_test.go': 1, 'tar/format.go': 9, 'test/integration/addcat_test.go': 10, 'test/integration/bench_cat_test.go': 10, 'test/integration/bench_test.go': 9, 'test/integration/bitswap_wo_routing_test.go': 10, 'test/integration/three_legged_cat_test.go': 10, 'thirdparty/pollEndpoint/main.go': 9, 'core/commands/mount_nofuse.go': 4, 'core/commands/mount_unix.go': 7, 'fuse/node/mount_nofuse.go': 3, 'blocks/blockstoreutil/remove.go': 8, 'blockservice/blockservice_test.go': 3, 'blockservice/test/blocks_test.go': 3, 'blockservice/test/mock.go': 3, 'cmd/ipfs/init.go': 8, 'core/commands/files.go': 9, 'core/commands/ipns.go': 4, 'core/commands/ls.go': 8, 'core/commands/object/object.go': 8, 'core/commands/pin.go': 8, 'core/core_test.go': 5, 'core/coreapi/pin.go': 8, 'core/coreunix/add_test.go': 9, 'core/coreunix/metadata_test.go': 9, 'exchange/bitswap/get.go': 3, 'exchange/bitswap/session_test.go': 3, 'exchange/reprovide/providers.go': 8, 'filestore/filestore_test.go': 8, 'filestore/fsrefstore.go': 8, 'filestore/util.go': 8, 'fuse/ipns/common.go': 6, 'importer/balanced/balanced_test.go': 3, 'importer/helpers/dagbuilder.go': 3, 'importer/importer.go': 3, 'importer/importer_test.go': 3, 'importer/trickle/trickle_test.go': 3, 'keystore/keystore.go': 8, 'keystore/keystore_test.go': 6, 'keystore/memkeystore.go': 5, 'merkledag/merkledag_test.go': 3, 'merkledag/test/utils.go': 3, 'merkledag/utils/utils.go': 3, 'mfs/file.go': 4, 'mfs/mfs_test.go': 4, 'namesys/interface.go': 6, 'namesys/ipns_select_test.go': 2, 'namesys/namesys_test.go': 9, 'namesys/validator.go': 2, 'path/resolver/resolver.go': 3, 'pin/pin_test.go': 9, 'pin/set_test.go': 8, 'repo/config/identity.go': 2, 'repo/fsrepo/fsrepo_test.go': 5, 'repo/repo.go': 7, 'thirdparty/verifbs/verifbs.go': 8, 'unixfs/mod/dagmodifier.go': 3, 'unixfs/test/utils.go': 3, 'assets/assets.go': 6, 'cmd/ipfs/util/ulimit_freebsd.go': 2, 'cmd/ipfs/util/ulimit_unix.go': 2, 'cmd/ipfswatch/main.go': 7, 'core/commands/active.go': 3, 'core/commands/bootstrap.go': 5, 'core/commands/config.go': 6, 'core/commands/diag.go': 3, 'core/commands/dns.go': 4, 'core/commands/external.go': 3, 'core/commands/ipnsps.go': 3, 'core/commands/mount_windows.go': 3, 'core/commands/name.go': 1, 'core/commands/object/diff.go': 4, 'core/commands/p2p.go': 8, 'core/commands/refs.go': 6, 'core/commands/resolve.go': 6, 'core/commands/shutdown.go': 7, 'core/commands/sysdiag.go': 6, 'core/commands/tar.go': 6, 'core/commands/unixfs/ls.go': 6, 'core/commands/unixfs/unixfs.go': 3, 'core/commands/version.go': 4, 'core/coreapi/block.go': 4, 'core/coreapi/block_test.go': 2, 'core/coreapi/coreapi.go': 5, 'core/coreapi/dag.go': 3, 'core/coreapi/dag_test.go': 2, 'core/coreapi/interface/coreapi.go': 2, 'core/coreapi/interface/dag.go': 2, 'core/coreapi/interface/object.go': 2, 'core/coreapi/interface/options/block.go': 2, 'core/coreapi/interface/options/dag.go': 2, 'core/coreapi/interface/path.go': 4, 'core/coreapi/interface/unixfs.go': 2, 'core/coreapi/object.go': 6, 'core/coreapi/unixfs.go': 6, 'core/coredag/cbor.go': 4, 'core/coredag/dagpb.go': 6, 'core/coredag/dagtransl.go': 3, 'core/coredag/raw.go': 6, 'core/corerepo/pinning.go': 4, 'core/coreunix/metadata.go': 6, 'exchange/bitswap/message/message_test.go': 1, 'exchange/bitswap/notifications/notifications.go': 1, 'exchange/bitswap/notifications/notifications_test.go': 1, 'exchange/bitswap/stat.go': 1, 'exchange/bitswap/wantlist/wantlist.go': 1, 'exchange/bitswap/wantlist/wantlist_test.go': 1, 'fuse/ipns/link_unix.go': 5, 'fuse/mount/fuse.go': 6, 'fuse/node/mount_darwin.go': 2, 'importer/balanced/builder.go': 1, 'importer/helpers/helpers.go': 1, 'importer/trickle/trickledag.go': 1, 'merkledag/coding.go': 1, 'merkledag/errservice.go': 1, 'merkledag/merkledag.go': 1, 'merkledag/node.go': 1, 'merkledag/node_test.go': 1, 'merkledag/raw.go': 1, 'merkledag/readonly.go': 1, 'merkledag/readonly_test.go': 1, 'merkledag/rwservice.go': 1, 'merkledag/session.go': 1, 'merkledag/traverse/traverse.go': 1, 'merkledag/traverse/traverse_test.go': 1, 'merkledag/utils/diff.go': 1, 'merkledag/utils/diffenum.go': 1, 'merkledag/utils/diffenum_test.go': 1, 'merkledag/utils/utils_test.go': 1, 'mfs/dir.go': 2, 'mfs/ops.go': 2, 'path/path.go': 1, 'path/resolver/resolver_test.go': 1, 'pin/set.go': 6, 'plugin/ipld.go': 3, 'plugin/loader/initializer.go': 2, 'plugin/plugins/git/git.go': 3, 'repo/fsrepo/serialize/serialize.go': 1, 'repo/mock.go': 6, 'test/dependencies/ma-pipe-unidir/main.go': 5, 'thirdparty/verifcid/validate.go': 1, 'thirdparty/verifcid/validate_test.go': 1, 'unixfs/archive/archive.go': 1, 'unixfs/archive/tar/writer.go': 1, 'unixfs/hamt/hamt.go': 1, 'unixfs/hamt/hamt_stress_test.go': 1, 'unixfs/hamt/hamt_test.go': 1, 'unixfs/io/dagreader.go': 1, 'unixfs/io/dirbuilder.go': 1, 'unixfs/io/pbdagreader.go': 1, 'unixfs/io/resolve.go': 1, 'unixfs/mod/dagmodifier_test.go': 1, 'namesys/ipns_resolver_validation_test.go': 6, 'test/sharness/t0170-dht.sh': 1, 'core/commands/env.go': 1, 'core/commands/urlstore.go': 5, 'core/coreapi/interface/key.go': 3, 'core/coreapi/name_test.go': 3, 'core/coreapi/path.go': 5, 'core/coreunix/cat.go': 2, 'core/pathresolver_test.go': 5, 'dagutils/diff.go': 6, 'dagutils/diffenum.go': 5, 'dagutils/diffenum_test.go': 5, 'dagutils/utils.go': 6, 'dagutils/utils_test.go': 5, 'filestore/pb/dataobj.pb.go': 3, 'mfs/fd.go': 1, 'namesys/base.go': 5, 'namesys/cache.go': 5, 'namesys/dns.go': 5, 'namesys/proquint.go': 5, 'pin/internal/pb/header.pb.go': 3, 'thirdparty/cidv0v1/blockstore.go': 5, 'core/commands/cmdenv/env.go': 4, 'core/commands/name/ipns.go': 4, 'core/commands/name/ipnsps.go': 4, 'core/commands/name/name.go': 4, 'core/commands/name/publish.go': 4, 'core/coreapi/dht.go': 4, 'core/coreapi/dht_test.go': 2, 'core/coreapi/interface/dht.go': 2, 'p2p/listener.go': 4, 'p2p/local.go': 4, 'p2p/remote.go': 5, 'p2p/stream.go': 5, 'repo/fsrepo/config_test.go': 4, 'repo/fsrepo/misc.go': 4, 'test/bench/bench_cli_ipfs_add/main.go': 5, 'test/bench/offline_add/main.go': 5, 'cmd/ipfs/dnsresolve_test.go': 2, 'core/commands/cid.go': 4, 'core/coreapi/interface/options/unixfs.go': 1, 'core/coreapi/interface/pubsub.go': 1, 'core/coreapi/interface/swarm.go': 1, 'core/coreapi/pubsub.go': 4, 'core/coreapi/swarm.go': 4, 'core/coreapi/unixfile.go': 1, 'test/dependencies/iptb/iptb.go': 3, 'commands/context.go': 2, 'core/commands/cmdenv/cidbase.go': 2, 'core/coreapi/test/api_test.go': 2, 'core/corehttp/ipns_hostname.go': 2, 'core/corehttp/proxy.go': 2, 'namesys/dns_test.go': 2, 'plugin/daemon.go': 2, 'plugin/loader/loader.go': 3, 'plugin/plugins/badgerds/badgerds.go': 2, 'plugin/plugins/flatfs/flatfs.go': 2, 'plugin/plugins/levelds/levelds.go': 2, 'core/commands/cmdenv/cidbase_test.go': 1, 'core/commands/cmdenv/file.go': 1, 'core/corehttp/metrics.go': 1, 'core/corehttp/proxy_test.go': 1, 'core/corerepo/stat.go': 1, 'plugin/tracer.go': 1, 'thirdparty/notifier/notifier.go': 1, 'commands/reqlog.go': 1, 'core/corehttp/mutex_profile.go': 1, 'core/corehttp/option_test.go': 1, 'provider/queue.go': 1, 'provider/queue_test.go': 1, 'fuse/node/mount_openbsd.go': 1, 'fuse/readonly/mount_unix.go': 2, 'mk/util.mk': 2, 'fuse/node/mount_notsupp.go': 2, 'cmd/ipfs/util/ulimit_test.go': 1, 'cmd/ipfswatch/ipfswatch_test.go': 1, 'cmd/seccat/seccat_plan9.go': 1, 'cmd/seccat/seccat_posix.go': 1, 'go.mod': 1, 'go.sum': 1}","('fuse/ipns/ipns_test.go', 0.7647058823529411, 0.25)"
fuse/readonly/doc.go,1,2,0,[],1,2,0,[],0,0,0,0,0,[],{},()
fuse/readonly/ipfs_test.go,220,1400,10,"[{'cyclomatic_complexity': 2, 'nloc': 5, 'token_count': 25, 'name': 'maybeSkipFuseTests', 'long_name': 'maybeSkipFuseTests t * testing . T', 'start_line': 30, 'end_line': 34, 'full_parameters': ['t * testing . T'], 'filename': '/home/dimi/Documents/Informatik_Studium/FSS/SoftEvo/DataCollection/FFS_SoftEvo/go-ipfs/fuse/readonly/ipfs_test.go', 'top_nesting_level': 0, 'length': 5, 'fan_in': 0, 'fan_out': 0, 'general_fan_out': 0}, {'cyclomatic_complexity': 2, 'nloc': 10, 'token_count': 92, 'name': 'randObj', 'long_name': 'randObj t * testing . T , nd * core . IpfsNode , size int64', 'start_line': 36, 'end_line': 46, 'full_parameters': ['t * testing . T', ' nd * core . IpfsNode', ' size int64'], 'filename': '/home/dimi/Documents/Informatik_Studium/FSS/SoftEvo/DataCollection/FFS_SoftEvo/go-ipfs/fuse/readonly/ipfs_test.go', 'top_nesting_level': 0, 'length': 11, 'fan_in': 0, 'fan_out': 0, 'general_fan_out': 0}, {'cyclomatic_complexity': 4, 'nloc': 16, 'token_count': 98, 'name': 'setupIpfsTest', 'long_name': 'setupIpfsTest t * testing . T , node * core . IpfsNode', 'start_line': 48, 'end_line': 66, 'full_parameters': ['t * testing . T', ' node * core . IpfsNode'], 'filename': '/home/dimi/Documents/Informatik_Studium/FSS/SoftEvo/DataCollection/FFS_SoftEvo/go-ipfs/fuse/readonly/ipfs_test.go', 'top_nesting_level': 0, 'length': 19, 'fan_in': 0, 'fan_out': 0, 'general_fan_out': 0}, {'cyclomatic_complexity': 4, 'nloc': 17, 'token_count': 115, 'name': 'TestIpfsBasicRead', 'long_name': 'TestIpfsBasicRead t * testing . T', 'start_line': 69, 'end_line': 87, 'full_parameters': ['t * testing . T'], 'filename': '/home/dimi/Documents/Informatik_Studium/FSS/SoftEvo/DataCollection/FFS_SoftEvo/go-ipfs/fuse/readonly/ipfs_test.go', 'top_nesting_level': 0, 'length': 19, 'fan_in': 0, 'fan_out': 0, 'general_fan_out': 0}, {'cyclomatic_complexity': 5, 'nloc': 19, 'token_count': 154, 'name': 'getPaths', 'long_name': 'getPaths t * testing . T , ipfs * core . IpfsNode , name string , n * dag . ProtoNode', 'start_line': 89, 'end_line': 109, 'full_parameters': ['t * testing . T', ' ipfs * core . IpfsNode', ' name string', ' n * dag . ProtoNode'], 'filename': '/home/dimi/Documents/Informatik_Studium/FSS/SoftEvo/DataCollection/FFS_SoftEvo/go-ipfs/fuse/readonly/ipfs_test.go', 'top_nesting_level': 0, 'length': 21, 'fan_in': 0, 'fan_out': 0, 'general_fan_out': 0}, {'cyclomatic_complexity': 6, 'nloc': 22, 'token_count': 139, 'name': '', 'long_name': '()', 'start_line': 164, 'end_line': 189, 'full_parameters': [], 'filename': '/home/dimi/Documents/Informatik_Studium/FSS/SoftEvo/DataCollection/FFS_SoftEvo/go-ipfs/fuse/readonly/ipfs_test.go', 'top_nesting_level': 0, 'length': 26, 'fan_in': 0, 'fan_out': 0, 'general_fan_out': 0}, {'cyclomatic_complexity': 1, 'nloc': 4, 'token_count': 14, 'name': '', 'long_name': '()', 'start_line': 192, 'end_line': 195, 'full_parameters': [], 'filename': '/home/dimi/Documents/Informatik_Studium/FSS/SoftEvo/DataCollection/FFS_SoftEvo/go-ipfs/fuse/readonly/ipfs_test.go', 'top_nesting_level': 0, 'length': 4, 'fan_in': 0, 'fan_out': 0, 'general_fan_out': 0}, {'cyclomatic_complexity': 11, 'nloc': 49, 'token_count': 353, 'name': 'TestIpfsStressRead', 'long_name': 'TestIpfsStressRead t * testing . T', 'start_line': 112, 'end_line': 202, 'full_parameters': ['t * testing . T'], 'filename': '/home/dimi/Documents/Informatik_Studium/FSS/SoftEvo/DataCollection/FFS_SoftEvo/go-ipfs/fuse/readonly/ipfs_test.go', 'top_nesting_level': 0, 'length': 91, 'fan_in': 0, 'fan_out': 0, 'general_fan_out': 0}, {'cyclomatic_complexity': 10, 'nloc': 40, 'token_count': 257, 'name': 'TestIpfsBasicDirRead', 'long_name': 'TestIpfsBasicDirRead t * testing . T', 'start_line': 205, 'end_line': 253, 'full_parameters': ['t * testing . T'], 'filename': '/home/dimi/Documents/Informatik_Studium/FSS/SoftEvo/DataCollection/FFS_SoftEvo/go-ipfs/fuse/readonly/ipfs_test.go', 'top_nesting_level': 0, 'length': 49, 'fan_in': 0, 'fan_out': 0, 'general_fan_out': 0}, {'cyclomatic_complexity': 4, 'nloc': 17, 'token_count': 119, 'name': 'TestFileSizeReporting', 'long_name': 'TestFileSizeReporting t * testing . T', 'start_line': 256, 'end_line': 276, 'full_parameters': ['t * testing . T'], 'filename': '/home/dimi/Documents/Informatik_Studium/FSS/SoftEvo/DataCollection/FFS_SoftEvo/go-ipfs/fuse/readonly/ipfs_test.go', 'top_nesting_level': 0, 'length': 21, 'fan_in': 0, 'fan_out': 0, 'general_fan_out': 0}]",240,1529,10,"[{'cyclomatic_complexity': 2, 'nloc': 5, 'token_count': 25, 'name': 'maybeSkipFuseTests', 'long_name': 'maybeSkipFuseTests t * testing . T', 'start_line': 37, 'end_line': 41, 'full_parameters': ['t * testing . T'], 'filename': '/home/dimi/Documents/Informatik_Studium/FSS/SoftEvo/DataCollection/FFS_SoftEvo/go-ipfs/fuse/readonly/ipfs_test.go', 'top_nesting_level': 0, 'length': 5, 'fan_in': 0, 'fan_out': 0, 'general_fan_out': 0}, {'cyclomatic_complexity': 3, 'nloc': 13, 'token_count': 110, 'name': 'randObj', 'long_name': 'randObj t * testing . T , nd * core . IpfsNode , size int64', 'start_line': 43, 'end_line': 56, 'full_parameters': ['t * testing . T', ' nd * core . IpfsNode', ' size int64'], 'filename': '/home/dimi/Documents/Informatik_Studium/FSS/SoftEvo/DataCollection/FFS_SoftEvo/go-ipfs/fuse/readonly/ipfs_test.go', 'top_nesting_level': 0, 'length': 14, 'fan_in': 0, 'fan_out': 0, 'general_fan_out': 0}, {'cyclomatic_complexity': 5, 'nloc': 20, 'token_count': 119, 'name': 'setupIpfsTest', 'long_name': 'setupIpfsTest t * testing . T , node * core . IpfsNode', 'start_line': 58, 'end_line': 80, 'full_parameters': ['t * testing . T', ' node * core . IpfsNode'], 'filename': '/home/dimi/Documents/Informatik_Studium/FSS/SoftEvo/DataCollection/FFS_SoftEvo/go-ipfs/fuse/readonly/ipfs_test.go', 'top_nesting_level': 0, 'length': 23, 'fan_in': 0, 'fan_out': 0, 'general_fan_out': 0}, {'cyclomatic_complexity': 4, 'nloc': 17, 'token_count': 115, 'name': 'TestIpfsBasicRead', 'long_name': 'TestIpfsBasicRead t * testing . T', 'start_line': 83, 'end_line': 101, 'full_parameters': ['t * testing . T'], 'filename': '/home/dimi/Documents/Informatik_Studium/FSS/SoftEvo/DataCollection/FFS_SoftEvo/go-ipfs/fuse/readonly/ipfs_test.go', 'top_nesting_level': 0, 'length': 19, 'fan_in': 0, 'fan_out': 0, 'general_fan_out': 0}, {'cyclomatic_complexity': 5, 'nloc': 19, 'token_count': 154, 'name': 'getPaths', 'long_name': 'getPaths t * testing . T , ipfs * core . IpfsNode , name string , n * dag . ProtoNode', 'start_line': 103, 'end_line': 123, 'full_parameters': ['t * testing . T', ' ipfs * core . IpfsNode', ' name string', ' n * dag . ProtoNode'], 'filename': '/home/dimi/Documents/Informatik_Studium/FSS/SoftEvo/DataCollection/FFS_SoftEvo/go-ipfs/fuse/readonly/ipfs_test.go', 'top_nesting_level': 0, 'length': 21, 'fan_in': 0, 'fan_out': 0, 'general_fan_out': 0}, {'cyclomatic_complexity': 6, 'nloc': 25, 'token_count': 187, 'name': '', 'long_name': '()', 'start_line': 183, 'end_line': 217, 'full_parameters': [], 'filename': '/home/dimi/Documents/Informatik_Studium/FSS/SoftEvo/DataCollection/FFS_SoftEvo/go-ipfs/fuse/readonly/ipfs_test.go', 'top_nesting_level': 0, 'length': 35, 'fan_in': 0, 'fan_out': 0, 'general_fan_out': 0}, {'cyclomatic_complexity': 1, 'nloc': 4, 'token_count': 14, 'name': '', 'long_name': '()', 'start_line': 220, 'end_line': 223, 'full_parameters': [], 'filename': '/home/dimi/Documents/Informatik_Studium/FSS/SoftEvo/DataCollection/FFS_SoftEvo/go-ipfs/fuse/readonly/ipfs_test.go', 'top_nesting_level': 0, 'length': 4, 'fan_in': 0, 'fan_out': 0, 'general_fan_out': 0}, {'cyclomatic_complexity': 12, 'nloc': 53, 'token_count': 379, 'name': 'TestIpfsStressRead', 'long_name': 'TestIpfsStressRead t * testing . T', 'start_line': 126, 'end_line': 230, 'full_parameters': ['t * testing . T'], 'filename': '/home/dimi/Documents/Informatik_Studium/FSS/SoftEvo/DataCollection/FFS_SoftEvo/go-ipfs/fuse/readonly/ipfs_test.go', 'top_nesting_level': 0, 'length': 105, 'fan_in': 0, 'fan_out': 0, 'general_fan_out': 0}, {'cyclomatic_complexity': 10, 'nloc': 40, 'token_count': 265, 'name': 'TestIpfsBasicDirRead', 'long_name': 'TestIpfsBasicDirRead t * testing . T', 'start_line': 233, 'end_line': 281, 'full_parameters': ['t * testing . T'], 'filename': '/home/dimi/Documents/Informatik_Studium/FSS/SoftEvo/DataCollection/FFS_SoftEvo/go-ipfs/fuse/readonly/ipfs_test.go', 'top_nesting_level': 0, 'length': 49, 'fan_in': 0, 'fan_out': 0, 'general_fan_out': 0}, {'cyclomatic_complexity': 4, 'nloc': 17, 'token_count': 119, 'name': 'TestFileSizeReporting', 'long_name': 'TestFileSizeReporting t * testing . T', 'start_line': 284, 'end_line': 304, 'full_parameters': ['t * testing . T'], 'filename': '/home/dimi/Documents/Informatik_Studium/FSS/SoftEvo/DataCollection/FFS_SoftEvo/go-ipfs/fuse/readonly/ipfs_test.go', 'top_nesting_level': 0, 'length': 21, 'fan_in': 0, 'fan_out': 0, 'general_fan_out': 0}]",20,129,0,83,83,"[{'timestamp': 1507212616.0, 'added_lines': 1, 'deleted_lines': 1, 'nloc': 220}, {'timestamp': 1507304579.0, 'added_lines': 1, 'deleted_lines': 1, 'nloc': 220}, {'timestamp': 1511223906.0, 'added_lines': 1, 'deleted_lines': 1, 'nloc': 220}, {'timestamp': 1512365669.0, 'added_lines': 3, 'deleted_lines': 3, 'nloc': 220}, {'timestamp': 1516838128.0, 'added_lines': 3, 'deleted_lines': 3, 'nloc': 220}, {'timestamp': 1516911711.0, 'added_lines': 3, 'deleted_lines': 3, 'nloc': 220}, {'timestamp': 1517255734.0, 'added_lines': 3, 'deleted_lines': 3, 'nloc': 220}, {'timestamp': 1517453697.0, 'added_lines': 1, 'deleted_lines': 1, 'nloc': 220}, {'timestamp': 1517858907.0, 'added_lines': 1, 'deleted_lines': 1, 'nloc': 220}, {'timestamp': 1517996381.0, 'added_lines': 1, 'deleted_lines': 1, 'nloc': 220}, {'timestamp': 1518090209.0, 'added_lines': 2, 'deleted_lines': 2, 'nloc': 220}, {'timestamp': 1518090579.0, 'added_lines': 2, 'deleted_lines': 2, 'nloc': 220}, {'timestamp': 1521399286.0, 'added_lines': 1, 'deleted_lines': 1, 'nloc': 220}, {'timestamp': 1525408792.0, 'added_lines': 2, 'deleted_lines': 2, 'nloc': 220}, {'timestamp': 1528006520.0, 'added_lines': 1, 'deleted_lines': 1, 'nloc': 220}, {'timestamp': 1528520460.0, 'added_lines': 5, 'deleted_lines': 5, 'nloc': 220}, {'timestamp': 1529984485.0, 'added_lines': 2, 'deleted_lines': 2, 'nloc': 220}, {'timestamp': 1531779409.0, 'added_lines': 2, 'deleted_lines': 2, 'nloc': 220}, {'timestamp': 1532764253.0, 'added_lines': 1, 'deleted_lines': 1, 'nloc': 220}, {'timestamp': 1532986515.0, 'added_lines': 2, 'deleted_lines': 2, 'nloc': 220}, {'timestamp': 1533500571.0, 'added_lines': 3, 'deleted_lines': 3, 'nloc': 220}, {'timestamp': 1533618653.0, 'added_lines': 3, 'deleted_lines': 3, 'nloc': 220}, {'timestamp': 1533779477.0, 'added_lines': 5, 'deleted_lines': 5, 'nloc': 220}, {'timestamp': 1533946888.0, 'added_lines': 2, 'deleted_lines': 2, 'nloc': 220}, {'timestamp': 1534115707.0, 'added_lines': 5, 'deleted_lines': 5, 'nloc': 220}, {'timestamp': 1534195762.0, 'added_lines': 3, 'deleted_lines': 3, 'nloc': 220}, {'timestamp': 1534347022.0, 'added_lines': 5, 'deleted_lines': 5, 'nloc': 220}, {'timestamp': 1534896611.0, 'added_lines': 6, 'deleted_lines': 6, 'nloc': 220}, {'timestamp': 1535601896.0, 'added_lines': 3, 'deleted_lines': 3, 'nloc': 220}, {'timestamp': 1536388808.0, 'added_lines': 3, 'deleted_lines': 3, 'nloc': 220}, {'timestamp': 1536718784.0, 'added_lines': 5, 'deleted_lines': 5, 'nloc': 220}, {'timestamp': 1536723292.0, 'added_lines': 3, 'deleted_lines': 3, 'nloc': 220}, {'timestamp': 1537790637.0, 'added_lines': 3, 'deleted_lines': 3, 'nloc': 220}, {'timestamp': 1537792589.0, 'added_lines': 5, 'deleted_lines': 5, 'nloc': 220}, {'timestamp': 1537393245.0, 'added_lines': 10, 'deleted_lines': 7, 'nloc': 222}, {'timestamp': 1538544957.0, 'added_lines': 3, 'deleted_lines': 3, 'nloc': 222}, {'timestamp': 1538694687.0, 'added_lines': 3, 'deleted_lines': 3, 'nloc': 222}, {'timestamp': 1538695953.0, 'added_lines': 3, 'deleted_lines': 3, 'nloc': 222}, {'timestamp': 1538773916.0, 'added_lines': 4, 'deleted_lines': 4, 'nloc': 222}, {'timestamp': 1539176817.0, 'added_lines': 4, 'deleted_lines': 4, 'nloc': 222}, {'timestamp': 1539357340.0, 'added_lines': 3, 'deleted_lines': 3, 'nloc': 222}, {'timestamp': 1539850591.0, 'added_lines': 2, 'deleted_lines': 2, 'nloc': 222}, {'timestamp': 1539104245.0, 'added_lines': 1, 'deleted_lines': 1, 'nloc': 222}, {'timestamp': 1540400358.0, 'added_lines': 4, 'deleted_lines': 4, 'nloc': 222}, {'timestamp': 1540410565.0, 'added_lines': 3, 'deleted_lines': 3, 'nloc': 222}, {'timestamp': 1540418491.0, 'added_lines': 3, 'deleted_lines': 3, 'nloc': 222}, {'timestamp': 1540603818.0, 'added_lines': 4, 'deleted_lines': 4, 'nloc': 222}, {'timestamp': 1541106379.0, 'added_lines': 2, 'deleted_lines': 2, 'nloc': 222}, {'timestamp': 1541189794.0, 'added_lines': 3, 'deleted_lines': 3, 'nloc': 222}, {'timestamp': 1541204121.0, 'added_lines': 7, 'deleted_lines': 7, 'nloc': 222}, {'timestamp': 1541903826.0, 'added_lines': 3, 'deleted_lines': 3, 'nloc': 222}, {'timestamp': 1543443696.0, 'added_lines': 3, 'deleted_lines': 3, 'nloc': 222}, {'timestamp': 1544225843.0, 'added_lines': 4, 'deleted_lines': 4, 'nloc': 222}, {'timestamp': 1540556089.0, 'added_lines': 2, 'deleted_lines': 2, 'nloc': 222}, {'timestamp': 1542594282.0, 'added_lines': 2, 'deleted_lines': 1, 'nloc': 223}, {'timestamp': 1544131548.0, 'added_lines': 4, 'deleted_lines': 1, 'nloc': 226}, {'timestamp': 1547003974.0, 'added_lines': 4, 'deleted_lines': 4, 'nloc': 226}, {'timestamp': 1547156385.0, 'added_lines': 25, 'deleted_lines': 28, 'nloc': 221}, {'timestamp': 1547160145.0, 'added_lines': 1, 'deleted_lines': 1, 'nloc': 221}, {'timestamp': 1547492199.0, 'added_lines': 26, 'deleted_lines': 12, 'nloc': 231}, {'timestamp': 1547499910.0, 'added_lines': 4, 'deleted_lines': 4, 'nloc': 231}, {'timestamp': 1548866534.0, 'added_lines': 3, 'deleted_lines': 3, 'nloc': 231}, {'timestamp': 1549588289.0, 'added_lines': 4, 'deleted_lines': 4, 'nloc': 231}, {'timestamp': 1549672857.0, 'added_lines': 1, 'deleted_lines': 1, 'nloc': 231}, {'timestamp': 1549673846.0, 'added_lines': 1, 'deleted_lines': 1, 'nloc': 231}, {'timestamp': 1549903582.0, 'added_lines': 4, 'deleted_lines': 4, 'nloc': 231}, {'timestamp': 1550185115.0, 'added_lines': 4, 'deleted_lines': 4, 'nloc': 231}, {'timestamp': 1550507829.0, 'added_lines': 6, 'deleted_lines': 6, 'nloc': 231}, {'timestamp': 1550576884.0, 'added_lines': 1, 'deleted_lines': 1, 'nloc': 231}, {'timestamp': 1550711994.0, 'added_lines': 4, 'deleted_lines': 4, 'nloc': 231}, {'timestamp': 1550723346.0, 'added_lines': 6, 'deleted_lines': 6, 'nloc': 231}, {'timestamp': 1551229859.0, 'added_lines': 5, 'deleted_lines': 5, 'nloc': 231}, {'timestamp': 1551299964.0, 'added_lines': 4, 'deleted_lines': 4, 'nloc': 231}, {'timestamp': 1551551196.0, 'added_lines': 10, 'deleted_lines': 10, 'nloc': 231}, {'timestamp': 1553654254.0, 'added_lines': 7, 'deleted_lines': 1, 'nloc': 236}, {'timestamp': 1553697989.0, 'added_lines': 5, 'deleted_lines': 1, 'nloc': 240}, {'timestamp': 1553529899.0, 'added_lines': 1, 'deleted_lines': 1, 'nloc': 240}, {'timestamp': 1553608614.0, 'added_lines': 2, 'deleted_lines': 2, 'nloc': 240}, {'timestamp': 1553609463.0, 'added_lines': 1, 'deleted_lines': 1, 'nloc': 240}, {'timestamp': 1559060517.0, 'added_lines': 1, 'deleted_lines': 1, 'nloc': 240}, {'timestamp': 1563668276.0, 'added_lines': 1, 'deleted_lines': 1, 'nloc': 240}, {'timestamp': 1563837872.0, 'added_lines': 1, 'deleted_lines': 1, 'nloc': 240}, {'timestamp': 1600726105.0, 'added_lines': 1, 'deleted_lines': 1, 'nloc': 240}]","{'core/bootstrap_test.go': 26, 'core/commands/dht_test.go': 26, 'core/mock/mock.go': 35, 'exchange/bitswap/bitswap_test.go': 10, 'exchange/bitswap/decision/bench_test.go': 10, 'exchange/bitswap/decision/engine_test.go': 10, 'exchange/bitswap/decision/peer_request_queue_test.go': 10, 'exchange/bitswap/testnet/interface.go': 9, 'exchange/bitswap/testnet/network_test.go': 10, 'exchange/bitswap/testnet/peernet.go': 10, 'exchange/bitswap/testnet/virtual.go': 11, 'exchange/bitswap/testutils.go': 10, 'exchange/reprovide/reprovide_test.go': 36, 'fuse/ipns/ipns_test.go': 40, 'fuse/node/mount_test.go': 38, 'mfs/repub_test.go': 13, 'namesys/publisher_test.go': 35, 'namesys/resolve_test.go': 51, 'package.json': 60, 'routing/mock/centralized_client.go': 6, 'routing/mock/centralized_server.go': 6, 'routing/mock/centralized_test.go': 6, 'routing/mock/interface.go': 6, 'routing/offline/offline_test.go': 6, 'test/integration/addcat_test.go': 41, 'test/integration/bench_cat_test.go': 41, 'test/integration/bench_test.go': 21, 'test/integration/grandcentral_test.go': 1, 'test/integration/three_legged_cat_test.go': 41, 'core/bootstrap.go': 25, 'core/commands/dht.go': 57, 'core/commands/id.go': 39, 'core/commands/pubsub.go': 38, 'core/core.go': 60, 'core/corehttp/gateway.go': 38, 'core/corehttp/gateway_test.go': 56, 'core/corehttp/metrics_test.go': 33, 'exchange/bitswap/network/ipfs_impl.go': 9, 'namesys/republisher/repub_test.go': 48, 'p2p/p2p.go': 26, 'routing/none/none_client.go': 5, 'test/integration/bitswap_wo_routing_test.go': 37, 'thirdparty/ipfsaddr/ipfsaddr.go': 1, 'cmd/ipfs/daemon.go': 23, 'cmd/ipfs/init.go': 27, 'cmd/ipfs/ipfs.go': 19, 'cmd/ipfs/main.go': 28, 'cmd/ipfs/main_test.go': 2, 'cmd/ipfswatch/main.go': 21, 'cmd/seccat/seccat.go': 29, 'commands/cli/helptext.go': 1, 'commands/cli/helptext_test.go': 1, 'commands/cli/parse.go': 1, 'commands/cli/parse_test.go': 1, 'commands/command.go': 13, 'commands/command_test.go': 4, 'commands/http/client.go': 1, 'commands/http/handler.go': 1, 'commands/http/multifilereader.go': 1, 'commands/http/multifilereader_test.go': 1, 'commands/http/parse.go': 1, 'commands/request.go': 17, 'commands/response.go': 8, 'commands/response_test.go': 4, 'core/commands/active.go': 12, 'core/commands/add.go': 45, 'core/commands/bitswap.go': 49, 'core/commands/block.go': 34, 'core/commands/bootstrap.go': 22, 'core/commands/cat.go': 33, 'core/commands/commands.go': 20, 'core/commands/config.go': 25, 'core/commands/dag/dag.go': 59, 'core/commands/diag.go': 12, 'core/commands/dns.go': 20, 'core/commands/external.go': 12, 'core/commands/files/files.go': 6, 'core/commands/filestore.go': 24, 'core/commands/get.go': 61, 'core/commands/get_test.go': 19, 'core/commands/helptext_test.go': 19, 'core/commands/ipns.go': 12, 'core/commands/keystore.go': 26, 'core/commands/log.go': 18, 'core/commands/ls.go': 61, 'core/commands/mount_nofuse.go': 12, 'core/commands/mount_unix.go': 22, 'core/commands/name.go': 5, 'core/commands/object/diff.go': 23, 'core/commands/object/object.go': 62, 'core/commands/object/patch.go': 32, 'core/commands/p2p.go': 27, 'core/commands/pin.go': 61, 'core/commands/ping.go': 32, 'core/commands/publish.go': 16, 'core/commands/refs.go': 50, 'core/commands/repo.go': 38, 'core/commands/resolve.go': 52, 'core/commands/root.go': 19, 'core/commands/shutdown.go': 15, 'core/commands/stat.go': 24, 'core/commands/swarm.go': 35, 'core/commands/sysdiag.go': 18, 'core/commands/tar.go': 49, 'core/commands/unixfs/ls.go': 56, 'core/commands/unixfs/unixfs.go': 12, 'core/commands/version.go': 13, 'core/corehttp/commands.go': 50, 'core/coreunix/add.go': 65, 'core/coreunix/add_test.go': 57, 'exchange/bitswap/message/message.go': 8, 'exchange/bitswap/network/interface.go': 8, 'importer/helpers/dagbuilder.go': 14, 'importer/importer.go': 13, 'p2p/registry.go': 11, 'repo/config/bootstrap_peers.go': 8, 'assets/assets.go': 52, 'blocks/blockstore/arc_cache.go': 2, 'blocks/blockstore/arc_cache_test.go': 2, 'blocks/blockstore/blockstore.go': 3, 'blocks/blockstore/blockstore_test.go': 2, 'blocks/blockstore/bloom_cache.go': 2, 'blocks/blockstore/bloom_cache_test.go': 2, 'blocks/blockstore/util/remove.go': 2, 'blocks/blocksutil/block_generator.go': 2, 'blockservice/blockservice.go': 8, 'blockservice/blockservice_test.go': 6, 'blockservice/test/blocks_test.go': 7, 'core/builder.go': 54, 'core/commands/ipnsps.go': 6, 'core/commands/mount_windows.go': 11, 'core/coreapi/coreapi.go': 29, 'core/coreapi/interface/interface.go': 2, 'core/coreapi/unixfs.go': 57, 'core/coreapi/unixfs_test.go': 45, 'core/coredag/cbor.go': 18, 'core/coredag/dagpb.go': 44, 'core/coredag/dagtransl.go': 14, 'core/coredag/raw.go': 44, 'core/corehttp/corehttp.go': 14, 'core/corehttp/gateway_handler.go': 68, 'core/corerepo/gc.go': 50, 'core/corerepo/pinning.go': 21, 'core/coreunix/metadata.go': 51, 'core/coreunix/metadata_test.go': 59, 'core/pathresolver.go': 47, 'exchange/bitswap/bitswap.go': 7, 'exchange/bitswap/decision/engine.go': 7, 'exchange/bitswap/decision/ledger.go': 7, 'exchange/bitswap/decision/peer_request_queue.go': 7, 'exchange/bitswap/get.go': 6, 'exchange/bitswap/message/message_test.go': 4, 'exchange/bitswap/notifications/notifications.go': 4, 'exchange/bitswap/notifications/notifications_test.go': 4, 'exchange/bitswap/session.go': 7, 'exchange/bitswap/session_test.go': 6, 'exchange/bitswap/stat.go': 4, 'exchange/bitswap/wantlist/wantlist.go': 4, 'exchange/bitswap/wantlist/wantlist_test.go': 4, 'exchange/bitswap/wantmanager.go': 7, 'exchange/bitswap/workers.go': 7, 'exchange/interface.go': 2, 'exchange/offline/offline.go': 2, 'exchange/offline/offline_test.go': 2, 'exchange/reprovide/providers.go': 47, 'exchange/reprovide/reprovide.go': 29, 'filestore/filestore.go': 26, 'filestore/filestore_test.go': 45, 'filestore/fsrefstore.go': 25, 'filestore/util.go': 23, 'fuse/ipns/ipns_unix.go': 59, 'fuse/readonly/readonly_unix.go': 59, 'importer/balanced/balanced_test.go': 14, 'importer/balanced/builder.go': 5, 'importer/chunk/rabin_test.go': 2, 'importer/chunk/splitting_test.go': 2, 'importer/helpers/helpers.go': 7, 'importer/importer_test.go': 13, 'importer/trickle/trickle_test.go': 14, 'importer/trickle/trickledag.go': 7, 'merkledag/batch.go': 2, 'merkledag/coding.go': 6, 'merkledag/merkledag.go': 7, 'merkledag/merkledag_test.go': 13, 'merkledag/node.go': 6, 'merkledag/node_test.go': 6, 'merkledag/raw.go': 5, 'merkledag/traverse/traverse.go': 5, 'merkledag/traverse/traverse_test.go': 6, 'merkledag/utils/diff.go': 6, 'merkledag/utils/diffenum.go': 5, 'merkledag/utils/diffenum_test.go': 6, 'merkledag/utils/utils.go': 8, 'merkledag/utils/utils_test.go': 6, 'mfs/dir.go': 15, 'mfs/file.go': 21, 'mfs/mfs_test.go': 22, 'mfs/ops.go': 11, 'mfs/system.go': 18, 'namesys/ipns_select_test.go': 4, 'namesys/namesys.go': 51, 'namesys/publisher.go': 54, 'namesys/pubsub.go': 5, 'namesys/pubsub_test.go': 4, 'namesys/republisher/repub.go': 45, 'namesys/routing.go': 51, 'path/path.go': 4, 'path/resolver.go': 5, 'path/resolver_test.go': 4, 'pin/gc/gc.go': 48, 'pin/pin.go': 49, 'pin/pin_test.go': 47, 'pin/set.go': 45, 'pin/set_test.go': 45, 'plugin/ipld.go': 14, 'plugin/loader/initializer.go': 11, 'plugin/plugins/git/git.go': 13, 'repo/config/init.go': 8, 'repo/fsrepo/fsrepo.go': 24, 'repo/fsrepo/lock/lock.go': 3, 'repo/fsrepo/serialize/serialize.go': 4, 'repo/mock.go': 17, 'repo/repo.go': 21, 'routing/offline/offline.go': 3, 'tar/format.go': 59, 'test/dependencies/ma-pipe-unidir/main.go': 10, 'thirdparty/ds-help/key.go': 2, 'thirdparty/pollEndpoint/main.go': 15, 'thirdparty/posinfo/posinfo.go': 3, 'unixfs/archive/archive.go': 7, 'unixfs/archive/tar/writer.go': 8, 'unixfs/hamt/hamt.go': 8, 'unixfs/io/dagreader.go': 8, 'unixfs/io/dirbuilder.go': 5, 'unixfs/io/resolve.go': 8, 'unixfs/mod/dagmodifier.go': 14, 'unixfs/mod/dagmodifier_test.go': 4, 'unixfs/test/utils.go': 15, 'commands/legacy/command.go': 11, 'commands/legacy/legacy.go': 11, 'commands/legacy/legacy_test.go': 11, 'commands/legacy/request.go': 12, 'commands/legacy/response.go': 11, 'core/commands/commands_test.go': 17, 'core/coreapi/dag.go': 13, 'core/coreapi/dag_test.go': 3, 'core/coreapi/interface/options/dag.go': 8, 'core/coreapi/key.go': 51, 'core/coreapi/name.go': 53, 'merkledag/test/utils.go': 7, 'namesys/namesys_test.go': 56, 'repo/fsrepo/datastores.go': 15, 'repo/fsrepo/fsrepo_test.go': 18, 'thirdparty/datastore2/datastore_closer.go': 1, 'thirdparty/datastore2/delayed.go': 1, 'thirdparty/datastore2/threadsafe.go': 1, 'unixfs/io/pbdagreader.go': 8, None: 25, 'mfs/fd.go': 9, 'unixfs/hamt/hamt_stress_test.go': 6, 'unixfs/hamt/hamt_test.go': 6, 'unixfs/io/dagreader_test.go': 3, 'unixfs/io/dirbuilder_test.go': 1, 'cmd/ipfs/util/ulimit.go': 9, 'cmd/seccat/util.go': 9, 'core/corehttp/logs.go': 9, 'fuse/mount/mount.go': 10, 'fuse/node/mount_unix.go': 13, 'importer/chunk/splitting.go': 1, 'namesys/ipns_validate_test.go': 3, 'plugin/loader/load.go': 7, 'core/coreapi/object.go': 54, 'fuse/mount/fuse.go': 8, 'keystore/keystore_test.go': 8, 'namesys/dns_test.go': 11, 'namesys/interface.go': 45, 'repo/config/config.go': 1, 'unixfs/unixfs.go': 3, 'blocks/blockstoreutil/remove.go': 21, 'blockservice/test/mock.go': 4, 'core/commands/files.go': 59, 'core/core_test.go': 17, 'core/coreapi/pin.go': 50, 'fuse/ipns/common.go': 47, 'keystore/keystore.go': 9, 'keystore/memkeystore.go': 6, 'namesys/validator.go': 2, 'path/resolver/resolver.go': 5, 'repo/config/identity.go': 2, 'thirdparty/verifbs/verifbs.go': 21, 'fuse/ipns/link_unix.go': 6, 'cmd/ipfs/util/ulimit_freebsd.go': 2, 'cmd/ipfs/util/ulimit_unix.go': 2, 'core/coreapi/block.go': 20, 'core/coreapi/block_test.go': 2, 'core/coreapi/interface/coreapi.go': 9, 'core/coreapi/interface/dag.go': 9, 'core/coreapi/interface/object.go': 9, 'core/coreapi/interface/options/block.go': 3, 'core/coreapi/interface/path.go': 33, 'core/coreapi/interface/unixfs.go': 15, 'fuse/node/mount_darwin.go': 3, 'merkledag/errservice.go': 2, 'merkledag/readonly.go': 2, 'merkledag/readonly_test.go': 2, 'merkledag/rwservice.go': 2, 'merkledag/session.go': 2, 'path/resolver/resolver_test.go': 3, 'thirdparty/verifcid/validate.go': 2, 'thirdparty/verifcid/validate_test.go': 2, 'namesys/ipns_resolver_validation_test.go': 45, 'test/sharness/t0170-dht.sh': 1, 'core/commands/urlstore.go': 46, 'unixfs/io/directory.go': 3, 'Rules.mk': 1, 'dagutils/diff.go': 44, 'dagutils/diffenum.go': 39, 'dagutils/diffenum_test.go': 39, 'dagutils/utils.go': 40, 'dagutils/utils_test.go': 39, 'unixfs/io/directory_test.go': 2, 'core/coreapi/path.go': 51, 'core/coreunix/cat.go': 15, 'unixfs/importer/balanced/balanced_test.go': 1, 'unixfs/importer/balanced/builder.go': 1, 'unixfs/importer/helpers/dagbuilder.go': 1, 'unixfs/importer/helpers/helpers.go': 1, 'unixfs/importer/importer.go': 1, 'unixfs/importer/importer_test.go': 1, 'unixfs/importer/trickle/trickle_test.go': 1, 'unixfs/importer/trickle/trickledag.go': 1, 'unixfs/unixfs_test.go': 1, 'core/coreapi/name_test.go': 30, 'core/pathresolver_test.go': 38, 'namesys/base.go': 42, 'namesys/cache.go': 38, 'namesys/dns.go': 42, 'namesys/proquint.go': 42, 'core/commands/env.go': 3, 'core/coreapi/interface/key.go': 7, 'filestore/pb/dataobj.pb.go': 3, 'pin/internal/pb/header.pb.go': 3, 'thirdparty/cidv0v1/blockstore.go': 16, 'repo/fsrepo/config_test.go': 13, 'repo/fsrepo/misc.go': 13, 'test/bench/bench_cli_ipfs_add/main.go': 14, 'test/bench/offline_add/main.go': 14, 'core/commands/cmdenv/env.go': 23, 'core/commands/name/ipns.go': 38, 'core/commands/name/publish.go': 25, 'core/coreapi/dht.go': 36, 'core/coreapi/dht_test.go': 5, 'test/sharness/t0275-cid-security.sh': 1, 'core/commands/name/ipnsps.go': 14, 'core/commands/name/name.go': 9, 'core/coreapi/interface/dht.go': 10, 'p2p/listener.go': 14, 'p2p/local.go': 14, 'p2p/remote.go': 15, 'p2p/stream.go': 15, 'core/coreapi/interface/util.go': 1, 'core/coreapi/interface/swarm.go': 9, 'core/coreapi/swarm.go': 25, 'core/coreapi/interface/options/unixfs.go': 15, 'core/coreapi/pubsub.go': 24, 'core/coreapi/unixfile.go': 18, 'core/commands/cid.go': 10, 'cmd/ipfs/dnsresolve_test.go': 5, 'core/coreapi/interface/pubsub.go': 4, 'test/dependencies/iptb/iptb.go': 12, 'plugin/plugins/badgerds/badgerds.go': 3, 'plugin/plugins/flatfs/flatfs.go': 3, 'plugin/plugins/levelds/levelds.go': 3, 'commands/context.go': 17, 'core/corehttp/proxy.go': 10, 'core/coreapi/interface/tests/name.go': 4, 'core/coreapi/interface/tests/unixfs.go': 4, 'core/coreapi/test/api_test.go': 14, 'plugin/loader/loader.go': 13, 'core/commands/cmdenv/cidbase.go': 6, 'core/commands/cmdenv/file.go': 3, 'core/corehttp/ipns_hostname.go': 11, 'plugin/daemon.go': 10, 'core/commands/cmdenv/cidbase_test.go': 2, 'core/corehttp/metrics.go': 1, 'core/corehttp/proxy_test.go': 2, 'core/corerepo/stat.go': 1, 'plugin/tracer.go': 1, 'thirdparty/notifier/notifier.go': 1, 'commands/reqlog.go': 1, 'core/corehttp/mutex_profile.go': 1, 'core/corehttp/option_test.go': 1, 'provider/queue.go': 1, 'provider/queue_test.go': 1, 'core/bootstrap/bootstrap.go': 1, 'core/bootstrap/bootstrap_test.go': 1, 'core/node/builder.go': 1, 'core/node/core.go': 1, 'core/node/groups.go': 1, 'core/node/identity.go': 1, 'core/node/ipns.go': 1, 'core/node/libp2p/addrs.go': 1, 'core/node/libp2p/discovery.go': 1, 'core/node/libp2p/host.go': 1, 'core/node/libp2p/hostopt.go': 1, 'core/node/libp2p/libp2p.go': 1, 'core/node/libp2p/nat.go': 1, 'core/node/libp2p/pnet.go': 1, 'core/node/libp2p/pubsub.go': 1, 'core/node/libp2p/routing.go': 1, 'core/node/libp2p/routingopt.go': 1, 'core/node/libp2p/smux.go': 1, 'core/node/libp2p/transport.go': 1, 'core/node/provider.go': 1, 'go.mod': 2, 'go.sum': 2, 'provider/simple/provider.go': 1, 'provider/simple/provider_test.go': 1, 'provider/simple/reprovide.go': 1, 'provider/simple/reprovide_test.go': 1, 'fuse/node/mount_openbsd.go': 1, 'fuse/readonly/mount_unix.go': 2, 'mk/util.mk': 2, 'fuse/node/mount_notsupp.go': 2, 'cmd/ipfs/util/ulimit_test.go': 1, 'cmd/ipfswatch/ipfswatch_test.go': 1, 'cmd/seccat/seccat_plan9.go': 1, 'cmd/seccat/seccat_posix.go': 1}","('core/corehttp/gateway_handler.go', 0.8192771084337349, 0.43312101910828027)"
fuse/readonly/mount_unix.go,14,81,1,"[{'cyclomatic_complexity': 2, 'nloc': 9, 'token_count': 72, 'name': 'Mount', 'long_name': 'Mount ipfs * core . IpfsNode , mountpoint string', 'start_line': 12, 'end_line': 20, 'full_parameters': ['ipfs * core . IpfsNode', ' mountpoint string'], 'filename': '/home/dimi/Documents/Informatik_Studium/FSS/SoftEvo/DataCollection/FFS_SoftEvo/go-ipfs/fuse/readonly/mount_unix.go', 'top_nesting_level': 0, 'length': 9, 'fan_in': 0, 'fan_out': 0, 'general_fan_out': 0}]",14,79,1,"[{'cyclomatic_complexity': 2, 'nloc': 9, 'token_count': 70, 'name': 'Mount', 'long_name': 'Mount ipfs * core . IpfsNode , mountpoint string', 'start_line': 12, 'end_line': 20, 'full_parameters': ['ipfs * core . IpfsNode', ' mountpoint string'], 'filename': '/home/dimi/Documents/Informatik_Studium/FSS/SoftEvo/DataCollection/FFS_SoftEvo/go-ipfs/fuse/readonly/mount_unix.go', 'top_nesting_level': 0, 'length': 9, 'fan_in': 0, 'fan_out': 0, 'general_fan_out': 0}]",0,-2,0,3,3,"[{'timestamp': 1553871352.0, 'added_lines': 1, 'deleted_lines': 1, 'nloc': 14}, {'timestamp': 1563668276.0, 'added_lines': 1, 'deleted_lines': 1, 'nloc': 14}, {'timestamp': 1563837872.0, 'added_lines': 1, 'deleted_lines': 1, 'nloc': 14}]","{'cmd/ipfs/daemon.go': 1, 'core/builder.go': 1, 'core/commands/shutdown.go': 1, 'core/core.go': 1, 'core/corehttp/corehttp.go': 1, 'core/ncore.go': 1, 'fuse/ipns/mount_unix.go': 1, 'fuse/ipns/ipns_test.go': 2, 'fuse/ipns/ipns_unix.go': 2, 'fuse/ipns/link_unix.go': 2, 'fuse/mount/fuse.go': 2, 'fuse/node/mount_openbsd.go': 1, 'fuse/node/mount_test.go': 2, 'fuse/node/mount_unix.go': 2, 'fuse/readonly/ipfs_test.go': 2, 'fuse/readonly/readonly_unix.go': 2, 'mk/util.mk': 2, 'fuse/node/mount_notsupp.go': 1}","('fuse/ipns/ipns_test.go', 0.6666666666666666, 0.038461538461538464)"
fuse/readonly/readonly_unix.go,236,1601,9,"[{'cyclomatic_complexity': 1, 'nloc': 3, 'token_count': 21, 'name': 'NewFileSystem', 'long_name': 'NewFileSystem ipfs * core . IpfsNode', 'start_line': 35, 'end_line': 37, 'full_parameters': ['ipfs * core . IpfsNode'], 'filename': '/home/dimi/Documents/Informatik_Studium/FSS/SoftEvo/DataCollection/FFS_SoftEvo/go-ipfs/fuse/readonly/readonly_unix.go', 'top_nesting_level': 0, 'length': 3, 'fan_in': 0, 'fan_out': 0, 'general_fan_out': 0}, {'cyclomatic_complexity': 1, 'nloc': 3, 'token_count': 29, 'name': 'Root', 'long_name': '(f FileSystem)Root', 'start_line': 40, 'end_line': 42, 'full_parameters': [], 'filename': '/home/dimi/Documents/Informatik_Studium/FSS/SoftEvo/DataCollection/FFS_SoftEvo/go-ipfs/fuse/readonly/readonly_unix.go', 'top_nesting_level': 0, 'length': 3, 'fan_in': 0, 'fan_out': 0, 'general_fan_out': 0}, {'cyclomatic_complexity': 1, 'nloc': 4, 'token_count': 32, 'name': 'Attr', 'long_name': '(*Root)Attr ctx context . Context , a * fuse . Attr', 'start_line': 50, 'end_line': 53, 'full_parameters': ['ctx context . Context', ' a * fuse . Attr'], 'filename': '/home/dimi/Documents/Informatik_Studium/FSS/SoftEvo/DataCollection/FFS_SoftEvo/go-ipfs/fuse/readonly/readonly_unix.go', 'top_nesting_level': 0, 'length': 4, 'fan_in': 0, 'fan_out': 0, 'general_fan_out': 0}, {'cyclomatic_complexity': 5, 'nloc': 23, 'token_count': 161, 'name': 'Lookup', 'long_name': '(s*Root)Lookup ctx context . Context , name string', 'start_line': 56, 'end_line': 84, 'full_parameters': ['ctx context . Context', ' name string'], 'filename': '/home/dimi/Documents/Informatik_Studium/FSS/SoftEvo/DataCollection/FFS_SoftEvo/go-ipfs/fuse/readonly/readonly_unix.go', 'top_nesting_level': 0, 'length': 29, 'fan_in': 0, 'fan_out': 0, 'general_fan_out': 0}, {'cyclomatic_complexity': 1, 'nloc': 4, 'token_count': 35, 'name': 'ReadDirAll', 'long_name': '(*Root)ReadDirAll ctx context . Context', 'start_line': 87, 'end_line': 90, 'full_parameters': ['ctx context . Context'], 'filename': '/home/dimi/Documents/Informatik_Studium/FSS/SoftEvo/DataCollection/FFS_SoftEvo/go-ipfs/fuse/readonly/readonly_unix.go', 'top_nesting_level': 0, 'length': 4, 'fan_in': 0, 'fan_out': 0, 'general_fan_out': 0}, {'cyclomatic_complexity': 2, 'nloc': 7, 'token_count': 58, 'name': 'loadData', 'long_name': '(s*Node)loadData', 'start_line': 99, 'end_line': 105, 'full_parameters': [], 'filename': '/home/dimi/Documents/Informatik_Studium/FSS/SoftEvo/DataCollection/FFS_SoftEvo/go-ipfs/fuse/readonly/readonly_unix.go', 'top_nesting_level': 0, 'length': 7, 'fan_in': 0, 'fan_out': 0, 'general_fan_out': 0}, {'cyclomatic_complexity': 8, 'nloc': 33, 'token_count': 271, 'name': 'Attr', 'long_name': '(s*Node)Attr ctx context . Context , a * fuse . Attr', 'start_line': 108, 'end_line': 141, 'full_parameters': ['ctx context . Context', ' a * fuse . Attr'], 'filename': '/home/dimi/Documents/Informatik_Studium/FSS/SoftEvo/DataCollection/FFS_SoftEvo/go-ipfs/fuse/readonly/readonly_unix.go', 'top_nesting_level': 0, 'length': 34, 'fan_in': 0, 'fan_out': 0, 'general_fan_out': 0}, {'cyclomatic_complexity': 5, 'nloc': 21, 'token_count': 164, 'name': 'Lookup', 'long_name': '(s*Node)Lookup ctx context . Context , name string', 'start_line': 144, 'end_line': 169, 'full_parameters': ['ctx context . Context', ' name string'], 'filename': '/home/dimi/Documents/Informatik_Studium/FSS/SoftEvo/DataCollection/FFS_SoftEvo/go-ipfs/fuse/readonly/readonly_unix.go', 'top_nesting_level': 0, 'length': 26, 'fan_in': 0, 'fan_out': 0, 'general_fan_out': 0}, {'cyclomatic_complexity': 10, 'nloc': 35, 'token_count': 228, 'name': 'error', 'long_name': '(lnk*format.Link)error', 'start_line': 180, 'end_line': 215, 'full_parameters': [], 'filename': '/home/dimi/Documents/Informatik_Studium/FSS/SoftEvo/DataCollection/FFS_SoftEvo/go-ipfs/fuse/readonly/readonly_unix.go', 'top_nesting_level': 0, 'length': 36, 'fan_in': 0, 'fan_out': 0, 'general_fan_out': 0}]",252,1651,9,"[{'cyclomatic_complexity': 1, 'nloc': 3, 'token_count': 21, 'name': 'NewFileSystem', 'long_name': 'NewFileSystem ipfs * core . IpfsNode', 'start_line': 36, 'end_line': 38, 'full_parameters': ['ipfs * core . IpfsNode'], 'filename': '/home/dimi/Documents/Informatik_Studium/FSS/SoftEvo/DataCollection/FFS_SoftEvo/go-ipfs/fuse/readonly/readonly_unix.go', 'top_nesting_level': 0, 'length': 3, 'fan_in': 0, 'fan_out': 0, 'general_fan_out': 0}, {'cyclomatic_complexity': 1, 'nloc': 3, 'token_count': 29, 'name': 'Root', 'long_name': '(f FileSystem)Root', 'start_line': 41, 'end_line': 43, 'full_parameters': [], 'filename': '/home/dimi/Documents/Informatik_Studium/FSS/SoftEvo/DataCollection/FFS_SoftEvo/go-ipfs/fuse/readonly/readonly_unix.go', 'top_nesting_level': 0, 'length': 3, 'fan_in': 0, 'fan_out': 0, 'general_fan_out': 0}, {'cyclomatic_complexity': 1, 'nloc': 4, 'token_count': 32, 'name': 'Attr', 'long_name': '(*Root)Attr ctx context . Context , a * fuse . Attr', 'start_line': 51, 'end_line': 54, 'full_parameters': ['ctx context . Context', ' a * fuse . Attr'], 'filename': '/home/dimi/Documents/Informatik_Studium/FSS/SoftEvo/DataCollection/FFS_SoftEvo/go-ipfs/fuse/readonly/readonly_unix.go', 'top_nesting_level': 0, 'length': 4, 'fan_in': 0, 'fan_out': 0, 'general_fan_out': 0}, {'cyclomatic_complexity': 10, 'nloc': 47, 'token_count': 321, 'name': 'Lookup', 'long_name': '(s*Root)Lookup ctx context . Context , name string', 'start_line': 57, 'end_line': 112, 'full_parameters': ['ctx context . Context', ' name string'], 'filename': '/home/dimi/Documents/Informatik_Studium/FSS/SoftEvo/DataCollection/FFS_SoftEvo/go-ipfs/fuse/readonly/readonly_unix.go', 'top_nesting_level': 0, 'length': 56, 'fan_in': 0, 'fan_out': 0, 'general_fan_out': 0}, {'cyclomatic_complexity': 1, 'nloc': 4, 'token_count': 35, 'name': 'ReadDirAll', 'long_name': '(*Root)ReadDirAll ctx context . Context', 'start_line': 115, 'end_line': 118, 'full_parameters': ['ctx context . Context'], 'filename': '/home/dimi/Documents/Informatik_Studium/FSS/SoftEvo/DataCollection/FFS_SoftEvo/go-ipfs/fuse/readonly/readonly_unix.go', 'top_nesting_level': 0, 'length': 4, 'fan_in': 0, 'fan_out': 0, 'general_fan_out': 0}, {'cyclomatic_complexity': 3, 'nloc': 10, 'token_count': 60, 'name': 'loadData', 'long_name': '(s*Node)loadData', 'start_line': 127, 'end_line': 136, 'full_parameters': [], 'filename': '/home/dimi/Documents/Informatik_Studium/FSS/SoftEvo/DataCollection/FFS_SoftEvo/go-ipfs/fuse/readonly/readonly_unix.go', 'top_nesting_level': 0, 'length': 10, 'fan_in': 0, 'fan_out': 0, 'general_fan_out': 0}, {'cyclomatic_complexity': 8, 'nloc': 33, 'token_count': 271, 'name': 'Attr', 'long_name': '(s*Node)Attr ctx context . Context , a * fuse . Attr', 'start_line': 139, 'end_line': 172, 'full_parameters': ['ctx context . Context', ' a * fuse . Attr'], 'filename': '/home/dimi/Documents/Informatik_Studium/FSS/SoftEvo/DataCollection/FFS_SoftEvo/go-ipfs/fuse/readonly/readonly_unix.go', 'top_nesting_level': 0, 'length': 34, 'fan_in': 0, 'fan_out': 0, 'general_fan_out': 0}, {'cyclomatic_complexity': 5, 'nloc': 21, 'token_count': 164, 'name': 'Lookup', 'long_name': '(s*Node)Lookup ctx context . Context , name string', 'start_line': 175, 'end_line': 200, 'full_parameters': ['ctx context . Context', ' name string'], 'filename': '/home/dimi/Documents/Informatik_Studium/FSS/SoftEvo/DataCollection/FFS_SoftEvo/go-ipfs/fuse/readonly/readonly_unix.go', 'top_nesting_level': 0, 'length': 26, 'fan_in': 0, 'fan_out': 0, 'general_fan_out': 0}, {'cyclomatic_complexity': 10, 'nloc': 34, 'token_count': 222, 'name': 'error', 'long_name': '(lnk*ipld.Link)error', 'start_line': 211, 'end_line': 245, 'full_parameters': [], 'filename': '/home/dimi/Documents/Informatik_Studium/FSS/SoftEvo/DataCollection/FFS_SoftEvo/go-ipfs/fuse/readonly/readonly_unix.go', 'top_nesting_level': 0, 'length': 35, 'fan_in': 0, 'fan_out': 0, 'general_fan_out': 0}]",16,50,0,69,69,"[{'timestamp': 1512365669.0, 'added_lines': 2, 'deleted_lines': 2, 'nloc': 236}, {'timestamp': 1516838128.0, 'added_lines': 2, 'deleted_lines': 2, 'nloc': 236}, {'timestamp': 1516911711.0, 'added_lines': 4, 'deleted_lines': 4, 'nloc': 236}, {'timestamp': 1517105039.0, 'added_lines': 1, 'deleted_lines': 1, 'nloc': 236}, {'timestamp': 1517255734.0, 'added_lines': 4, 'deleted_lines': 4, 'nloc': 236}, {'timestamp': 1517453697.0, 'added_lines': 2, 'deleted_lines': 2, 'nloc': 236}, {'timestamp': 1521399286.0, 'added_lines': 1, 'deleted_lines': 1, 'nloc': 236}, {'timestamp': 1525408792.0, 'added_lines': 2, 'deleted_lines': 2, 'nloc': 236}, {'timestamp': 1528006520.0, 'added_lines': 2, 'deleted_lines': 2, 'nloc': 236}, {'timestamp': 1528520460.0, 'added_lines': 5, 'deleted_lines': 5, 'nloc': 236}, {'timestamp': 1529984485.0, 'added_lines': 2, 'deleted_lines': 2, 'nloc': 236}, {'timestamp': 1531779409.0, 'added_lines': 1, 'deleted_lines': 1, 'nloc': 236}, {'timestamp': 1532764253.0, 'added_lines': 1, 'deleted_lines': 1, 'nloc': 236}, {'timestamp': 1532847462.0, 'added_lines': 1, 'deleted_lines': 1, 'nloc': 236}, {'timestamp': 1532986515.0, 'added_lines': 2, 'deleted_lines': 2, 'nloc': 236}, {'timestamp': 1533500571.0, 'added_lines': 4, 'deleted_lines': 4, 'nloc': 236}, {'timestamp': 1533618653.0, 'added_lines': 4, 'deleted_lines': 4, 'nloc': 236}, {'timestamp': 1533779477.0, 'added_lines': 7, 'deleted_lines': 7, 'nloc': 236}, {'timestamp': 1533946888.0, 'added_lines': 2, 'deleted_lines': 2, 'nloc': 236}, {'timestamp': 1534115707.0, 'added_lines': 5, 'deleted_lines': 5, 'nloc': 236}, {'timestamp': 1534195762.0, 'added_lines': 4, 'deleted_lines': 4, 'nloc': 236}, {'timestamp': 1534347022.0, 'added_lines': 5, 'deleted_lines': 5, 'nloc': 236}, {'timestamp': 1534896611.0, 'added_lines': 6, 'deleted_lines': 6, 'nloc': 236}, {'timestamp': 1535601896.0, 'added_lines': 4, 'deleted_lines': 4, 'nloc': 236}, {'timestamp': 1536388808.0, 'added_lines': 4, 'deleted_lines': 4, 'nloc': 236}, {'timestamp': 1536718784.0, 'added_lines': 5, 'deleted_lines': 5, 'nloc': 236}, {'timestamp': 1536723292.0, 'added_lines': 4, 'deleted_lines': 4, 'nloc': 236}, {'timestamp': 1537790637.0, 'added_lines': 4, 'deleted_lines': 4, 'nloc': 236}, {'timestamp': 1537792589.0, 'added_lines': 6, 'deleted_lines': 6, 'nloc': 236}, {'timestamp': 1537957978.0, 'added_lines': 25, 'deleted_lines': 24, 'nloc': 237}, {'timestamp': 1538544957.0, 'added_lines': 4, 'deleted_lines': 4, 'nloc': 237}, {'timestamp': 1538694687.0, 'added_lines': 4, 'deleted_lines': 4, 'nloc': 237}, {'timestamp': 1538695953.0, 'added_lines': 4, 'deleted_lines': 4, 'nloc': 237}, {'timestamp': 1538773916.0, 'added_lines': 4, 'deleted_lines': 4, 'nloc': 237}, {'timestamp': 1539176817.0, 'added_lines': 4, 'deleted_lines': 4, 'nloc': 237}, {'timestamp': 1539357340.0, 'added_lines': 4, 'deleted_lines': 4, 'nloc': 237}, {'timestamp': 1539850591.0, 'added_lines': 2, 'deleted_lines': 2, 'nloc': 237}, {'timestamp': 1540400358.0, 'added_lines': 5, 'deleted_lines': 5, 'nloc': 237}, {'timestamp': 1540410565.0, 'added_lines': 4, 'deleted_lines': 4, 'nloc': 237}, {'timestamp': 1540418491.0, 'added_lines': 4, 'deleted_lines': 4, 'nloc': 237}, {'timestamp': 1540603818.0, 'added_lines': 5, 'deleted_lines': 5, 'nloc': 237}, {'timestamp': 1540916861.0, 'added_lines': 1, 'deleted_lines': 1, 'nloc': 237}, {'timestamp': 1541106379.0, 'added_lines': 2, 'deleted_lines': 2, 'nloc': 237}, {'timestamp': 1541189794.0, 'added_lines': 4, 'deleted_lines': 4, 'nloc': 237}, {'timestamp': 1541204121.0, 'added_lines': 7, 'deleted_lines': 7, 'nloc': 237}, {'timestamp': 1541903826.0, 'added_lines': 4, 'deleted_lines': 4, 'nloc': 237}, {'timestamp': 1543443696.0, 'added_lines': 4, 'deleted_lines': 4, 'nloc': 237}, {'timestamp': 1544225843.0, 'added_lines': 5, 'deleted_lines': 5, 'nloc': 237}, {'timestamp': 1540556089.0, 'added_lines': 2, 'deleted_lines': 2, 'nloc': 237}, {'timestamp': 1547003974.0, 'added_lines': 5, 'deleted_lines': 5, 'nloc': 237}, {'timestamp': 1547499910.0, 'added_lines': 5, 'deleted_lines': 5, 'nloc': 237}, {'timestamp': 1548866534.0, 'added_lines': 2, 'deleted_lines': 2, 'nloc': 237}, {'timestamp': 1549588289.0, 'added_lines': 5, 'deleted_lines': 5, 'nloc': 237}, {'timestamp': 1549903582.0, 'added_lines': 2, 'deleted_lines': 2, 'nloc': 237}, {'timestamp': 1550185115.0, 'added_lines': 4, 'deleted_lines': 4, 'nloc': 237}, {'timestamp': 1550507829.0, 'added_lines': 6, 'deleted_lines': 6, 'nloc': 237}, {'timestamp': 1550711994.0, 'added_lines': 4, 'deleted_lines': 4, 'nloc': 237}, {'timestamp': 1550723346.0, 'added_lines': 5, 'deleted_lines': 5, 'nloc': 237}, {'timestamp': 1551229859.0, 'added_lines': 5, 'deleted_lines': 5, 'nloc': 237}, {'timestamp': 1551299964.0, 'added_lines': 4, 'deleted_lines': 4, 'nloc': 237}, {'timestamp': 1551551196.0, 'added_lines': 10, 'deleted_lines': 10, 'nloc': 237}, {'timestamp': 1563668276.0, 'added_lines': 1, 'deleted_lines': 1, 'nloc': 237}, {'timestamp': 1563837872.0, 'added_lines': 1, 'deleted_lines': 1, 'nloc': 237}, {'timestamp': 1580183360.0, 'added_lines': 6, 'deleted_lines': 11, 'nloc': 233}, {'timestamp': 1579218500.0, 'added_lines': 2, 'deleted_lines': 2, 'nloc': 233}, {'timestamp': 1579220333.0, 'added_lines': 2, 'deleted_lines': 14, 'nloc': 224}, {'timestamp': 1587221101.0, 'added_lines': 1, 'deleted_lines': 1, 'nloc': 224}, {'timestamp': 1629221569.0, 'added_lines': 33, 'deleted_lines': 10, 'nloc': 245}, {'timestamp': 1632761426.0, 'added_lines': 8, 'deleted_lines': 1, 'nloc': 252}]","{'assets/assets.go': 48, 'blocks/blockstore/arc_cache.go': 2, 'blocks/blockstore/arc_cache_test.go': 2, 'blocks/blockstore/blockstore.go': 3, 'blocks/blockstore/blockstore_test.go': 2, 'blocks/blockstore/bloom_cache.go': 2, 'blocks/blockstore/bloom_cache_test.go': 2, 'blocks/blockstore/util/remove.go': 2, 'blocks/blocksutil/block_generator.go': 2, 'blockservice/blockservice.go': 8, 'blockservice/blockservice_test.go': 6, 'blockservice/test/blocks_test.go': 7, 'cmd/ipfs/daemon.go': 24, 'cmd/ipfs/init.go': 25, 'cmd/ipfs/ipfs.go': 19, 'cmd/ipfs/main.go': 27, 'cmd/ipfs/main_test.go': 1, 'cmd/ipfswatch/main.go': 18, 'cmd/seccat/seccat.go': 25, 'commands/command.go': 13, 'commands/command_test.go': 4, 'commands/request.go': 17, 'commands/response.go': 8, 'commands/response_test.go': 4, 'core/bootstrap.go': 24, 'core/bootstrap_test.go': 23, 'core/builder.go': 55, 'core/commands/active.go': 11, 'core/commands/add.go': 40, 'core/commands/bitswap.go': 48, 'core/commands/block.go': 27, 'core/commands/bootstrap.go': 21, 'core/commands/cat.go': 25, 'core/commands/commands.go': 20, 'core/commands/config.go': 22, 'core/commands/dag/dag.go': 54, 'core/commands/dht.go': 57, 'core/commands/dht_test.go': 22, 'core/commands/diag.go': 11, 'core/commands/dns.go': 16, 'core/commands/external.go': 11, 'core/commands/files/files.go': 5, 'core/commands/filestore.go': 24, 'core/commands/get.go': 56, 'core/commands/get_test.go': 19, 'core/commands/helptext_test.go': 19, 'core/commands/id.go': 37, 'core/commands/ipns.go': 11, 'core/commands/ipnsps.go': 6, 'core/commands/keystore.go': 22, 'core/commands/log.go': 17, 'core/commands/ls.go': 55, 'core/commands/mount_nofuse.go': 11, 'core/commands/mount_unix.go': 21, 'core/commands/mount_windows.go': 11, 'core/commands/name.go': 4, 'core/commands/object/diff.go': 17, 'core/commands/object/object.go': 55, 'core/commands/object/patch.go': 25, 'core/commands/p2p.go': 24, 'core/commands/pin.go': 55, 'core/commands/ping.go': 30, 'core/commands/publish.go': 16, 'core/commands/pubsub.go': 34, 'core/commands/refs.go': 51, 'core/commands/repo.go': 37, 'core/commands/resolve.go': 47, 'core/commands/root.go': 19, 'core/commands/shutdown.go': 14, 'core/commands/stat.go': 23, 'core/commands/swarm.go': 33, 'core/commands/sysdiag.go': 17, 'core/commands/tar.go': 49, 'core/commands/unixfs/ls.go': 50, 'core/commands/unixfs/unixfs.go': 11, 'core/commands/version.go': 12, 'core/core.go': 61, 'core/coreapi/coreapi.go': 25, 'core/coreapi/interface/interface.go': 2, 'core/coreapi/unixfs.go': 51, 'core/coreapi/unixfs_test.go': 42, 'core/coredag/cbor.go': 18, 'core/coredag/dagpb.go': 44, 'core/coredag/dagtransl.go': 14, 'core/coredag/raw.go': 44, 'core/corehttp/commands.go': 53, 'core/corehttp/corehttp.go': 15, 'core/corehttp/gateway.go': 33, 'core/corehttp/gateway_handler.go': 59, 'core/corehttp/gateway_test.go': 51, 'core/corehttp/metrics_test.go': 31, 'core/corerepo/gc.go': 52, 'core/corerepo/pinning.go': 21, 'core/coreunix/add.go': 56, 'core/coreunix/add_test.go': 52, 'core/coreunix/metadata.go': 51, 'core/coreunix/metadata_test.go': 54, 'core/mock/mock.go': 32, 'core/pathresolver.go': 48, 'exchange/bitswap/bitswap.go': 7, 'exchange/bitswap/bitswap_test.go': 8, 'exchange/bitswap/decision/bench_test.go': 7, 'exchange/bitswap/decision/engine.go': 7, 'exchange/bitswap/decision/engine_test.go': 7, 'exchange/bitswap/decision/ledger.go': 7, 'exchange/bitswap/decision/peer_request_queue.go': 7, 'exchange/bitswap/decision/peer_request_queue_test.go': 7, 'exchange/bitswap/get.go': 6, 'exchange/bitswap/message/message.go': 7, 'exchange/bitswap/message/message_test.go': 4, 'exchange/bitswap/network/interface.go': 7, 'exchange/bitswap/network/ipfs_impl.go': 7, 'exchange/bitswap/notifications/notifications.go': 4, 'exchange/bitswap/notifications/notifications_test.go': 4, 'exchange/bitswap/session.go': 8, 'exchange/bitswap/session_test.go': 6, 'exchange/bitswap/stat.go': 4, 'exchange/bitswap/testnet/interface.go': 6, 'exchange/bitswap/testnet/network_test.go': 7, 'exchange/bitswap/testnet/peernet.go': 8, 'exchange/bitswap/testnet/virtual.go': 8, 'exchange/bitswap/testutils.go': 8, 'exchange/bitswap/wantlist/wantlist.go': 4, 'exchange/bitswap/wantlist/wantlist_test.go': 4, 'exchange/bitswap/wantmanager.go': 7, 'exchange/bitswap/workers.go': 7, 'exchange/interface.go': 2, 'exchange/offline/offline.go': 2, 'exchange/offline/offline_test.go': 2, 'exchange/reprovide/providers.go': 47, 'exchange/reprovide/reprovide.go': 29, 'exchange/reprovide/reprovide_test.go': 32, 'filestore/filestore.go': 26, 'filestore/filestore_test.go': 45, 'filestore/fsrefstore.go': 25, 'filestore/util.go': 23, 'fuse/ipns/ipns_test.go': 34, 'fuse/ipns/ipns_unix.go': 60, 'fuse/node/mount_test.go': 32, 'fuse/readonly/ipfs_test.go': 59, 'importer/balanced/balanced_test.go': 10, 'importer/balanced/builder.go': 5, 'importer/chunk/rabin_test.go': 2, 'importer/chunk/splitting_test.go': 2, 'importer/helpers/dagbuilder.go': 9, 'importer/helpers/helpers.go': 7, 'importer/importer.go': 8, 'importer/importer_test.go': 9, 'importer/trickle/trickle_test.go': 10, 'importer/trickle/trickledag.go': 7, 'merkledag/batch.go': 2, 'merkledag/coding.go': 6, 'merkledag/merkledag.go': 7, 'merkledag/merkledag_test.go': 9, 'merkledag/node.go': 6, 'merkledag/node_test.go': 6, 'merkledag/raw.go': 5, 'merkledag/traverse/traverse.go': 5, 'merkledag/traverse/traverse_test.go': 6, 'merkledag/utils/diff.go': 6, 'merkledag/utils/diffenum.go': 5, 'merkledag/utils/diffenum_test.go': 6, 'merkledag/utils/utils.go': 8, 'merkledag/utils/utils_test.go': 6, 'mfs/dir.go': 15, 'mfs/file.go': 17, 'mfs/mfs_test.go': 19, 'mfs/ops.go': 12, 'mfs/repub_test.go': 10, 'mfs/system.go': 18, 'namesys/ipns_select_test.go': 4, 'namesys/namesys.go': 50, 'namesys/publisher.go': 54, 'namesys/publisher_test.go': 31, 'namesys/pubsub.go': 6, 'namesys/pubsub_test.go': 5, 'namesys/republisher/repub.go': 46, 'namesys/republisher/repub_test.go': 48, 'namesys/resolve_test.go': 48, 'namesys/routing.go': 48, 'p2p/p2p.go': 23, 'p2p/registry.go': 10, 'package.json': 56, 'path/path.go': 4, 'path/resolver.go': 5, 'path/resolver_test.go': 4, 'pin/gc/gc.go': 48, 'pin/pin.go': 49, 'pin/pin_test.go': 46, 'pin/set.go': 45, 'pin/set_test.go': 45, 'plugin/ipld.go': 15, 'plugin/loader/initializer.go': 11, 'plugin/plugins/git/git.go': 14, 'repo/config/bootstrap_peers.go': 8, 'repo/config/init.go': 8, 'repo/fsrepo/fsrepo.go': 25, 'repo/fsrepo/lock/lock.go': 3, 'repo/fsrepo/serialize/serialize.go': 4, 'repo/mock.go': 17, 'repo/repo.go': 21, 'routing/mock/centralized_client.go': 3, 'routing/mock/centralized_server.go': 3, 'routing/mock/centralized_test.go': 3, 'routing/mock/interface.go': 3, 'routing/none/none_client.go': 3, 'routing/offline/offline.go': 3, 'routing/offline/offline_test.go': 3, 'tar/format.go': 57, 'test/dependencies/ma-pipe-unidir/main.go': 9, 'test/integration/addcat_test.go': 33, 'test/integration/bench_cat_test.go': 33, 'test/integration/bench_test.go': 17, 'test/integration/bitswap_wo_routing_test.go': 35, 'test/integration/three_legged_cat_test.go': 33, 'thirdparty/ds-help/key.go': 2, 'thirdparty/pollEndpoint/main.go': 15, 'thirdparty/posinfo/posinfo.go': 3, 'unixfs/archive/archive.go': 7, 'unixfs/archive/tar/writer.go': 8, 'unixfs/hamt/hamt.go': 8, 'unixfs/io/dagreader.go': 8, 'unixfs/io/dirbuilder.go': 5, 'unixfs/io/resolve.go': 8, 'unixfs/mod/dagmodifier.go': 10, 'unixfs/mod/dagmodifier_test.go': 4, 'unixfs/test/utils.go': 11, 'commands/legacy/command.go': 12, 'commands/legacy/legacy.go': 12, 'commands/legacy/legacy_test.go': 12, 'commands/legacy/request.go': 13, 'commands/legacy/response.go': 12, 'core/commands/commands_test.go': 18, 'core/coreapi/dag.go': 13, 'core/coreapi/dag_test.go': 3, 'core/coreapi/interface/options/dag.go': 8, 'core/coreapi/key.go': 46, 'core/coreapi/name.go': 47, 'merkledag/test/utils.go': 7, 'namesys/namesys_test.go': 53, 'repo/fsrepo/datastores.go': 15, 'repo/fsrepo/fsrepo_test.go': 18, 'thirdparty/datastore2/datastore_closer.go': 1, 'thirdparty/datastore2/delayed.go': 1, 'thirdparty/datastore2/threadsafe.go': 1, 'unixfs/io/pbdagreader.go': 8, None: 23, 'mfs/fd.go': 9, 'unixfs/hamt/hamt_stress_test.go': 6, 'unixfs/hamt/hamt_test.go': 6, 'unixfs/io/dagreader_test.go': 3, 'unixfs/io/dirbuilder_test.go': 1, 'cmd/ipfs/util/ulimit.go': 10, 'cmd/seccat/util.go': 9, 'core/corehttp/logs.go': 10, 'fuse/mount/mount.go': 11, 'fuse/node/mount_unix.go': 11, 'importer/chunk/splitting.go': 1, 'namesys/ipns_validate_test.go': 3, 'plugin/loader/load.go': 7, 'core/coreapi/object.go': 49, 'fuse/mount/fuse.go': 7, 'keystore/keystore_test.go': 7, 'namesys/dns_test.go': 9, 'namesys/interface.go': 43, 'repo/config/config.go': 1, 'unixfs/unixfs.go': 3, 'blocks/blockstoreutil/remove.go': 22, 'blockservice/test/mock.go': 4, 'core/commands/files.go': 53, 'core/core_test.go': 17, 'core/coreapi/pin.go': 44, 'fuse/ipns/common.go': 48, 'keystore/keystore.go': 10, 'keystore/memkeystore.go': 6, 'namesys/validator.go': 2, 'path/resolver/resolver.go': 5, 'repo/config/identity.go': 2, 'thirdparty/verifbs/verifbs.go': 21, 'fuse/ipns/link_unix.go': 5, 'cmd/ipfs/util/ulimit_freebsd.go': 2, 'cmd/ipfs/util/ulimit_unix.go': 2, 'core/coreapi/block.go': 15, 'core/coreapi/block_test.go': 2, 'core/coreapi/interface/coreapi.go': 9, 'core/coreapi/interface/dag.go': 9, 'core/coreapi/interface/object.go': 9, 'core/coreapi/interface/options/block.go': 3, 'core/coreapi/interface/path.go': 35, 'core/coreapi/interface/unixfs.go': 13, 'fuse/node/mount_darwin.go': 3, 'merkledag/errservice.go': 2, 'merkledag/readonly.go': 2, 'merkledag/readonly_test.go': 2, 'merkledag/rwservice.go': 2, 'merkledag/session.go': 2, 'path/resolver/resolver_test.go': 3, 'thirdparty/verifcid/validate.go': 2, 'thirdparty/verifcid/validate_test.go': 2, 'namesys/ipns_resolver_validation_test.go': 43, 'test/sharness/t0170-dht.sh': 1, 'core/commands/urlstore.go': 46, 'unixfs/io/directory.go': 3, 'Rules.mk': 1, 'dagutils/diff.go': 40, 'dagutils/diffenum.go': 39, 'dagutils/diffenum_test.go': 39, 'dagutils/utils.go': 41, 'dagutils/utils_test.go': 41, 'unixfs/io/directory_test.go': 2, 'core/coreapi/name_test.go': 32, 'core/coreapi/path.go': 48, 'core/coreunix/cat.go': 16, 'core/pathresolver_test.go': 40, 'namesys/base.go': 41, 'namesys/cache.go': 40, 'namesys/dns.go': 41, 'namesys/proquint.go': 41, 'unixfs/importer/balanced/balanced_test.go': 1, 'unixfs/importer/balanced/builder.go': 1, 'unixfs/importer/helpers/dagbuilder.go': 1, 'unixfs/importer/helpers/helpers.go': 1, 'unixfs/importer/importer.go': 1, 'unixfs/importer/importer_test.go': 1, 'unixfs/importer/trickle/trickle_test.go': 1, 'unixfs/importer/trickle/trickledag.go': 1, 'unixfs/unixfs_test.go': 1, 'core/commands/env.go': 3, 'core/coreapi/interface/key.go': 7, 'filestore/pb/dataobj.pb.go': 3, 'pin/internal/pb/header.pb.go': 3, 'thirdparty/cidv0v1/blockstore.go': 16, 'repo/fsrepo/config_test.go': 13, 'repo/fsrepo/misc.go': 13, 'test/bench/bench_cli_ipfs_add/main.go': 13, 'test/bench/offline_add/main.go': 13, 'core/commands/cmdenv/env.go': 20, 'core/commands/name/ipns.go': 36, 'core/commands/name/publish.go': 19, 'core/coreapi/dht.go': 30, 'core/coreapi/dht_test.go': 5, 'test/sharness/t0275-cid-security.sh': 1, 'core/commands/name/ipnsps.go': 13, 'core/commands/name/name.go': 9, 'core/coreapi/interface/dht.go': 10, 'p2p/listener.go': 13, 'p2p/local.go': 14, 'p2p/remote.go': 13, 'p2p/stream.go': 13, 'core/coreapi/interface/swarm.go': 9, 'core/coreapi/swarm.go': 20, 'core/coreapi/interface/options/unixfs.go': 15, 'core/coreapi/pubsub.go': 18, 'core/coreapi/unixfile.go': 17, 'core/commands/cid.go': 10, 'cmd/ipfs/dnsresolve_test.go': 5, 'core/coreapi/interface/pubsub.go': 4, 'test/dependencies/iptb/iptb.go': 12, 'plugin/plugins/badgerds/badgerds.go': 3, 'plugin/plugins/flatfs/flatfs.go': 3, 'plugin/plugins/levelds/levelds.go': 3, 'commands/context.go': 13, 'core/corehttp/proxy.go': 9, 'core/coreapi/interface/tests/name.go': 4, 'core/coreapi/interface/tests/unixfs.go': 4, 'core/coreapi/test/api_test.go': 10, 'plugin/loader/loader.go': 10, 'core/commands/cmdenv/cidbase.go': 6, 'core/commands/cmdenv/file.go': 3, 'core/corehttp/ipns_hostname.go': 8, 'plugin/daemon.go': 8, 'core/commands/cmdenv/cidbase_test.go': 2, 'core/corehttp/metrics.go': 1, 'core/corehttp/proxy_test.go': 1, 'core/corerepo/stat.go': 1, 'plugin/tracer.go': 1, 'thirdparty/notifier/notifier.go': 2, 'fuse/node/mount_openbsd.go': 1, 'fuse/readonly/mount_unix.go': 2, 'mk/util.mk': 2, 'fuse/node/mount_notsupp.go': 1, 'core/bootstrap/bootstrap.go': 2, 'core/node/libp2p/discovery.go': 1, 'core/node/libp2p/pnet.go': 1, 'core/node/libp2p/smux.go': 1, 'core/node/libp2p/transport.go': 1, 'plugin/loader/load_unix.go': 1, 'gc/gc.go': 2, 'go.sum': 3, 'namesys/resolve/resolve.go': 1, 'CHANGELOG.md': 2, 'Dockerfile': 1, 'README.md': 1, 'bin/check_go_version': 1, 'coverage/Rules.mk': 1, 'docs/config.md': 1, 'docs/debug-guide.md': 1, 'docs/environment-variables.md': 1, 'keystore/memkeystore_test.go': 1, 'misc/completion/ipfs-completion.bash': 1, 'plugin/plugins/gen_main.sh': 1, 'repo/fsrepo/migrations/migrations.go': 1, 'repo/onlyone.go': 1, 'test/3nodetest/run-test-on-img.sh': 1, 'test/ipfs-test-lib.sh': 1, 'test/sharness/README.md': 1, 'test/sharness/lib/iptb-lib.sh': 1, 'test/sharness/t0010-basic-commands.sh': 1, 'test/sharness/t0020-init.sh': 1, 'test/sharness/t0030-mount.sh': 1, 'test/sharness/t0031-mount-publish.sh': 1, 'test/sharness/t0040-add-and-cat.sh': 1, 'test/sharness/t0050-block.sh': 1, 'test/sharness/t0051-object.sh': 1, 'test/sharness/t0053-dag.sh': 2, 'test/sharness/t0060-daemon.sh': 1, 'test/sharness/t0062-daemon-api.sh': 1, 'test/sharness/t0080-repo.sh': 1, 'test/sharness/t0087-repo-robust-gc.sh': 1, 'test/sharness/t0090-get.sh': 1, 'test/sharness/t0110-gateway.sh': 1, 'test/sharness/t0114-gateway-subdomains.sh': 1, 'test/sharness/t0131-multinode-client-routing.sh': 1, 'test/sharness/t0140-swarm.sh': 1, 'test/sharness/t0183-namesys-pubsub.sh': 1, 'test/sharness/t0250-files-api.sh': 1, 'test/sharness/t0270-filestore.sh': 1, 'test/sharness/t0272-urlstore.sh': 1, 'test/sharness/t0410-api-add.sh': 1, 'test/sharness/t0600-issues-and-regressions-online.sh': 1, 'test/sharness_test_coverage_helper.sh': 1, 'thirdparty/README.md': 1, 'core/commands/dag/get.go': 1, 'core/commands/dag/put.go': 1, 'core/node/core.go': 1, 'core/node/groups.go': 1, 'core/node/provider.go': 1, 'go.mod': 2, 'test/sharness/t0055-dag-put-json-new-line.sh': 1, 'test/sharness/t0280-plugin-git.sh': 1, 'docs/examples/go-ipfs-as-a-library/go.sum': 1}","('core/core.go', 0.8840579710144928, 0.3407821229050279)"
p2p/p2p.go,182,1060,10,"[{'cyclomatic_complexity': 1, 'nloc': 7, 'token_count': 39, 'name': 'NewP2P', 'long_name': 'NewP2P identity peer . ID , peerHost p2phost . Host , peerstore pstore . Peerstore', 'start_line': 28, 'end_line': 34, 'full_parameters': ['identity peer . ID', ' peerHost p2phost . Host', ' peerstore pstore . Peerstore'], 'filename': '/home/dimi/Documents/Informatik_Studium/FSS/SoftEvo/DataCollection/FFS_SoftEvo/go-ipfs/p2p/p2p.go', 'top_nesting_level': 0, 'length': 7, 'fan_in': 0, 'fan_out': 0, 'general_fan_out': 0}, {'cyclomatic_complexity': 2, 'nloc': 9, 'token_count': 97, 'name': 'newStreamTo', 'long_name': '(p2p*P2P)newStreamTo ctx2 context . Context , p peer . ID , protocol string', 'start_line': 36, 'end_line': 44, 'full_parameters': ['ctx2 context . Context', ' p peer . ID', ' protocol string'], 'filename': '/home/dimi/Documents/Informatik_Studium/FSS/SoftEvo/DataCollection/FFS_SoftEvo/go-ipfs/p2p/p2p.go', 'top_nesting_level': 0, 'length': 9, 'fan_in': 0, 'fan_out': 0, 'general_fan_out': 0}, {'cyclomatic_complexity': 6, 'nloc': 31, 'token_count': 198, 'name': 'Dial', 'long_name': '(p2p*P2P)Dial ctx context . Context , addr ma . Multiaddr , peer peer . ID , proto string , bindAddr ma . Multiaddr', 'start_line': 47, 'end_line': 84, 'full_parameters': ['ctx context . Context', ' addr ma . Multiaddr', ' peer peer . ID', ' proto string', ' bindAddr ma . Multiaddr'], 'filename': '/home/dimi/Documents/Informatik_Studium/FSS/SoftEvo/DataCollection/FFS_SoftEvo/go-ipfs/p2p/p2p.go', 'top_nesting_level': 0, 'length': 38, 'fan_in': 0, 'fan_out': 0, 'general_fan_out': 0}, {'cyclomatic_complexity': 2, 'nloc': 19, 'token_count': 122, 'name': 'doAccept', 'long_name': '(p2p*P2P)doAccept listenerInfo * ListenerInfo , remote net . Stream , listener manet . Listener', 'start_line': 86, 'end_line': 111, 'full_parameters': ['listenerInfo * ListenerInfo', ' remote net . Stream', ' listener manet . Listener'], 'filename': '/home/dimi/Documents/Informatik_Studium/FSS/SoftEvo/DataCollection/FFS_SoftEvo/go-ipfs/p2p/p2p.go', 'top_nesting_level': 0, 'length': 26, 'fan_in': 0, 'fan_out': 0, 'general_fan_out': 0}, {'cyclomatic_complexity': 1, 'nloc': 5, 'token_count': 29, 'name': 'Close', 'long_name': '(il*P2PListener)Close', 'start_line': 139, 'end_line': 143, 'full_parameters': [], 'filename': '/home/dimi/Documents/Informatik_Studium/FSS/SoftEvo/DataCollection/FFS_SoftEvo/go-ipfs/p2p/p2p.go', 'top_nesting_level': 0, 'length': 5, 'fan_in': 0, 'fan_out': 0, 'general_fan_out': 0}, {'cyclomatic_complexity': 3, 'nloc': 7, 'token_count': 34, 'name': '', 'long_name': '(s net.Stream)', 'start_line': 157, 'end_line': 163, 'full_parameters': [], 'filename': '/home/dimi/Documents/Informatik_Studium/FSS/SoftEvo/DataCollection/FFS_SoftEvo/go-ipfs/p2p/p2p.go', 'top_nesting_level': 0, 'length': 7, 'fan_in': 0, 'fan_out': 0, 'general_fan_out': 0}, {'cyclomatic_complexity': 1, 'nloc': 12, 'token_count': 89, 'name': 'registerStreamHandler', 'long_name': '(p2p*P2P)registerStreamHandler ctx2 context . Context , protocol string', 'start_line': 146, 'end_line': 166, 'full_parameters': ['ctx2 context . Context', ' protocol string'], 'filename': '/home/dimi/Documents/Informatik_Studium/FSS/SoftEvo/DataCollection/FFS_SoftEvo/go-ipfs/p2p/p2p.go', 'top_nesting_level': 0, 'length': 21, 'fan_in': 0, 'fan_out': 0, 'general_fan_out': 0}, {'cyclomatic_complexity': 2, 'nloc': 17, 'token_count': 109, 'name': 'NewListener', 'long_name': '(p2p*P2P)NewListener ctx context . Context , proto string , addr ma . Multiaddr', 'start_line': 169, 'end_line': 189, 'full_parameters': ['ctx context . Context', ' proto string', ' addr ma . Multiaddr'], 'filename': '/home/dimi/Documents/Informatik_Studium/FSS/SoftEvo/DataCollection/FFS_SoftEvo/go-ipfs/p2p/p2p.go', 'top_nesting_level': 0, 'length': 21, 'fan_in': 0, 'fan_out': 0, 'general_fan_out': 0}, {'cyclomatic_complexity': 4, 'nloc': 27, 'token_count': 154, 'name': 'acceptStreams', 'long_name': '(p2p*P2P)acceptStreams listenerInfo * ListenerInfo , listener Listener', 'start_line': 191, 'end_line': 224, 'full_parameters': ['listenerInfo * ListenerInfo', ' listener Listener'], 'filename': '/home/dimi/Documents/Informatik_Studium/FSS/SoftEvo/DataCollection/FFS_SoftEvo/go-ipfs/p2p/p2p.go', 'top_nesting_level': 0, 'length': 34, 'fan_in': 0, 'fan_out': 0, 'general_fan_out': 0}, {'cyclomatic_complexity': 3, 'nloc': 10, 'token_count': 47, 'name': 'CheckProtoExists', 'long_name': '(p2p*P2P)CheckProtoExists proto string', 'start_line': 228, 'end_line': 238, 'full_parameters': ['proto string'], 'filename': '/home/dimi/Documents/Informatik_Studium/FSS/SoftEvo/DataCollection/FFS_SoftEvo/go-ipfs/p2p/p2p.go', 'top_nesting_level': 0, 'length': 11, 'fan_in': 0, 'fan_out': 0, 'general_fan_out': 0}]",40,185,2,"[{'cyclomatic_complexity': 1, 'nloc': 14, 'token_count': 90, 'name': 'New', 'long_name': 'New identity peer . ID , peerHost p2phost . Host , peerstore pstore . Peerstore', 'start_line': 24, 'end_line': 39, 'full_parameters': ['identity peer . ID', ' peerHost p2phost . Host', ' peerstore pstore . Peerstore'], 'filename': '/home/dimi/Documents/Informatik_Studium/FSS/SoftEvo/DataCollection/FFS_SoftEvo/go-ipfs/p2p/p2p.go', 'top_nesting_level': 0, 'length': 16, 'fan_in': 0, 'fan_out': 0, 'general_fan_out': 0}, {'cyclomatic_complexity': 3, 'nloc': 10, 'token_count': 47, 'name': 'CheckProtoExists', 'long_name': '(p2p*P2P)CheckProtoExists proto string', 'start_line': 43, 'end_line': 53, 'full_parameters': ['proto string'], 'filename': '/home/dimi/Documents/Informatik_Studium/FSS/SoftEvo/DataCollection/FFS_SoftEvo/go-ipfs/p2p/p2p.go', 'top_nesting_level': 0, 'length': 11, 'fan_in': 0, 'fan_out': 0, 'general_fan_out': 0}]",-142,-875,-8,48,48,"[{'timestamp': 1507304579.0, 'added_lines': 1, 'deleted_lines': 1, 'nloc': 182}, {'timestamp': 1511223906.0, 'added_lines': 2, 'deleted_lines': 2, 'nloc': 182}, {'timestamp': 1512365669.0, 'added_lines': 6, 'deleted_lines': 6, 'nloc': 182}, {'timestamp': 1516838128.0, 'added_lines': 6, 'deleted_lines': 6, 'nloc': 182}, {'timestamp': 1517453697.0, 'added_lines': 4, 'deleted_lines': 4, 'nloc': 182}, {'timestamp': 1525408792.0, 'added_lines': 4, 'deleted_lines': 4, 'nloc': 182}, {'timestamp': 1528131220.0, 'added_lines': 1, 'deleted_lines': 1, 'nloc': 182}, {'timestamp': 1528268108.0, 'added_lines': 4, 'deleted_lines': 4, 'nloc': 182}, {'timestamp': 1528520460.0, 'added_lines': 6, 'deleted_lines': 6, 'nloc': 182}, {'timestamp': 1529984485.0, 'added_lines': 6, 'deleted_lines': 6, 'nloc': 182}, {'timestamp': 1533779477.0, 'added_lines': 4, 'deleted_lines': 4, 'nloc': 182}, {'timestamp': 1534896611.0, 'added_lines': 4, 'deleted_lines': 4, 'nloc': 182}, {'timestamp': 1535601896.0, 'added_lines': 2, 'deleted_lines': 2, 'nloc': 182}, {'timestamp': 1536388808.0, 'added_lines': 3, 'deleted_lines': 3, 'nloc': 182}, {'timestamp': 1523023896.0, 'added_lines': 12, 'deleted_lines': 202, 'nloc': 35}, {'timestamp': 1523023188.0, 'added_lines': 0, 'deleted_lines': 17, 'nloc': 23}, {'timestamp': 1526992541.0, 'added_lines': 16, 'deleted_lines': 0, 'nloc': 36}, {'timestamp': 1527256479.0, 'added_lines': 5, 'deleted_lines': 5, 'nloc': 36}, {'timestamp': 1527257570.0, 'added_lines': 4, 'deleted_lines': 0, 'nloc': 39}, {'timestamp': 1527952248.0, 'added_lines': 2, 'deleted_lines': 2, 'nloc': 39}, {'timestamp': 1529500654.0, 'added_lines': 3, 'deleted_lines': 4, 'nloc': 38}, {'timestamp': 1529940335.0, 'added_lines': 1, 'deleted_lines': 0, 'nloc': 39}, {'timestamp': 1532963701.0, 'added_lines': 1, 'deleted_lines': 1, 'nloc': 39}, {'timestamp': 1535967674.0, 'added_lines': 1, 'deleted_lines': 4, 'nloc': 36}, {'timestamp': 1535990095.0, 'added_lines': 4, 'deleted_lines': 4, 'nloc': 36}, {'timestamp': 1536181577.0, 'added_lines': 6, 'deleted_lines': 3, 'nloc': 38}, {'timestamp': 1536181981.0, 'added_lines': 1, 'deleted_lines': 1, 'nloc': 38}, {'timestamp': 1536186957.0, 'added_lines': 3, 'deleted_lines': 1, 'nloc': 40}, {'timestamp': 1536224848.0, 'added_lines': 5, 'deleted_lines': 5, 'nloc': 40}, {'timestamp': 1536226924.0, 'added_lines': 2, 'deleted_lines': 2, 'nloc': 40}, {'timestamp': 1536634719.0, 'added_lines': 2, 'deleted_lines': 2, 'nloc': 40}, {'timestamp': 1537792589.0, 'added_lines': 4, 'deleted_lines': 4, 'nloc': 40}, {'timestamp': 1538544957.0, 'added_lines': 2, 'deleted_lines': 2, 'nloc': 40}, {'timestamp': 1538773916.0, 'added_lines': 2, 'deleted_lines': 2, 'nloc': 40}, {'timestamp': 1539176817.0, 'added_lines': 2, 'deleted_lines': 2, 'nloc': 40}, {'timestamp': 1540400358.0, 'added_lines': 3, 'deleted_lines': 3, 'nloc': 40}, {'timestamp': 1541204121.0, 'added_lines': 4, 'deleted_lines': 4, 'nloc': 40}, {'timestamp': 1541903826.0, 'added_lines': 2, 'deleted_lines': 2, 'nloc': 40}, {'timestamp': 1534960588.0, 'added_lines': 6, 'deleted_lines': 6, 'nloc': 40}, {'timestamp': 1542068487.0, 'added_lines': 6, 'deleted_lines': 6, 'nloc': 40}, {'timestamp': 1544225843.0, 'added_lines': 3, 'deleted_lines': 3, 'nloc': 40}, {'timestamp': 1547003974.0, 'added_lines': 2, 'deleted_lines': 2, 'nloc': 40}, {'timestamp': 1549588289.0, 'added_lines': 3, 'deleted_lines': 3, 'nloc': 40}, {'timestamp': 1550507829.0, 'added_lines': 4, 'deleted_lines': 4, 'nloc': 40}, {'timestamp': 1551229859.0, 'added_lines': 3, 'deleted_lines': 3, 'nloc': 40}, {'timestamp': 1551551196.0, 'added_lines': 4, 'deleted_lines': 4, 'nloc': 40}, {'timestamp': 1556016061.0, 'added_lines': 2, 'deleted_lines': 2, 'nloc': 40}, {'timestamp': 1559060517.0, 'added_lines': 3, 'deleted_lines': 3, 'nloc': 40}]","{'core/bootstrap.go': 27, 'core/bootstrap_test.go': 26, 'core/commands/dht.go': 28, 'core/commands/dht_test.go': 25, 'core/commands/id.go': 28, 'core/commands/pubsub.go': 20, 'core/core.go': 28, 'core/corehttp/gateway.go': 27, 'core/corehttp/gateway_test.go': 28, 'core/corehttp/metrics_test.go': 28, 'core/mock/mock.go': 28, 'exchange/bitswap/bitswap_test.go': 10, 'exchange/bitswap/decision/bench_test.go': 8, 'exchange/bitswap/decision/engine_test.go': 8, 'exchange/bitswap/decision/peer_request_queue_test.go': 8, 'exchange/bitswap/network/ipfs_impl.go': 10, 'exchange/bitswap/testnet/interface.go': 8, 'exchange/bitswap/testnet/network_test.go': 10, 'exchange/bitswap/testnet/peernet.go': 10, 'exchange/bitswap/testnet/virtual.go': 10, 'exchange/bitswap/testutils.go': 10, 'exchange/reprovide/reprovide_test.go': 27, 'fuse/ipns/ipns_test.go': 28, 'fuse/node/mount_test.go': 28, 'fuse/readonly/ipfs_test.go': 26, 'mfs/repub_test.go': 9, 'namesys/publisher_test.go': 28, 'namesys/republisher/repub_test.go': 28, 'namesys/resolve_test.go': 28, 'package.json': 27, 'routing/mock/centralized_client.go': 5, 'routing/mock/centralized_server.go': 5, 'routing/mock/centralized_test.go': 5, 'routing/mock/interface.go': 5, 'routing/none/none_client.go': 5, 'routing/offline/offline_test.go': 5, 'test/integration/addcat_test.go': 28, 'test/integration/bench_cat_test.go': 28, 'test/integration/bench_test.go': 20, 'test/integration/bitswap_wo_routing_test.go': 27, 'test/integration/three_legged_cat_test.go': 28, 'thirdparty/ipfsaddr/ipfsaddr.go': 1, 'cmd/ipfs/daemon.go': 18, 'cmd/ipfs/init.go': 19, 'cmd/ipfs/ipfs.go': 13, 'cmd/ipfs/main.go': 22, 'cmd/ipfs/main_test.go': 2, 'cmd/ipfswatch/main.go': 16, 'cmd/seccat/seccat.go': 26, 'commands/cli/helptext.go': 1, 'commands/cli/helptext_test.go': 1, 'commands/cli/parse.go': 1, 'commands/cli/parse_test.go': 1, 'commands/command.go': 11, 'commands/command_test.go': 4, 'commands/http/client.go': 1, 'commands/http/handler.go': 1, 'commands/http/multifilereader.go': 1, 'commands/http/multifilereader_test.go': 1, 'commands/http/parse.go': 1, 'commands/request.go': 15, 'commands/response.go': 6, 'commands/response_test.go': 4, 'core/commands/active.go': 6, 'core/commands/add.go': 17, 'core/commands/bitswap.go': 25, 'core/commands/block.go': 14, 'core/commands/bootstrap.go': 16, 'core/commands/cat.go': 14, 'core/commands/commands.go': 13, 'core/commands/config.go': 16, 'core/commands/dag/dag.go': 22, 'core/commands/diag.go': 6, 'core/commands/dns.go': 9, 'core/commands/external.go': 6, 'core/commands/files/files.go': 4, 'core/commands/filestore.go': 13, 'core/commands/get.go': 23, 'core/commands/get_test.go': 13, 'core/commands/helptext_test.go': 13, 'core/commands/ipns.go': 9, 'core/commands/keystore.go': 14, 'core/commands/log.go': 12, 'core/commands/ls.go': 22, 'core/commands/mount_nofuse.go': 6, 'core/commands/mount_unix.go': 16, 'core/commands/name.go': 4, 'core/commands/object/diff.go': 8, 'core/commands/object/object.go': 23, 'core/commands/object/patch.go': 13, 'core/commands/p2p.go': 31, 'core/commands/pin.go': 23, 'core/commands/ping.go': 25, 'core/commands/publish.go': 9, 'core/commands/refs.go': 21, 'core/commands/repo.go': 23, 'core/commands/resolve.go': 20, 'core/commands/root.go': 13, 'core/commands/shutdown.go': 9, 'core/commands/stat.go': 19, 'core/commands/swarm.go': 27, 'core/commands/sysdiag.go': 13, 'core/commands/tar.go': 20, 'core/commands/unixfs/ls.go': 20, 'core/commands/unixfs/unixfs.go': 6, 'core/commands/version.go': 7, 'core/corehttp/commands.go': 24, 'core/coreunix/add.go': 24, 'core/coreunix/add_test.go': 23, 'exchange/bitswap/message/message.go': 8, 'exchange/bitswap/network/interface.go': 8, 'importer/helpers/dagbuilder.go': 6, 'importer/importer.go': 6, 'p2p/registry.go': 13, 'repo/config/bootstrap_peers.go': 10, 'assets/assets.go': 19, 'blocks/blockstore/arc_cache.go': 2, 'blocks/blockstore/arc_cache_test.go': 2, 'blocks/blockstore/blockstore.go': 3, 'blocks/blockstore/blockstore_test.go': 2, 'blocks/blockstore/bloom_cache.go': 2, 'blocks/blockstore/bloom_cache_test.go': 2, 'blocks/blockstore/util/remove.go': 2, 'blocks/blocksutil/block_generator.go': 2, 'blockservice/blockservice.go': 6, 'blockservice/blockservice_test.go': 5, 'blockservice/test/blocks_test.go': 5, 'core/builder.go': 24, 'core/commands/ipnsps.go': 5, 'core/commands/mount_windows.go': 5, 'core/coreapi/coreapi.go': 13, 'core/coreapi/interface/interface.go': 2, 'core/coreapi/unixfs.go': 20, 'core/coreapi/unixfs_test.go': 18, 'core/coredag/cbor.go': 7, 'core/coredag/dagpb.go': 20, 'core/coredag/dagtransl.go': 6, 'core/coredag/raw.go': 20, 'core/corehttp/corehttp.go': 15, 'core/corehttp/gateway_handler.go': 25, 'core/corerepo/gc.go': 23, 'core/corerepo/pinning.go': 9, 'core/coreunix/metadata.go': 20, 'core/coreunix/metadata_test.go': 22, 'core/pathresolver.go': 23, 'exchange/bitswap/bitswap.go': 6, 'exchange/bitswap/decision/engine.go': 6, 'exchange/bitswap/decision/ledger.go': 6, 'exchange/bitswap/decision/peer_request_queue.go': 6, 'exchange/bitswap/get.go': 5, 'exchange/bitswap/message/message_test.go': 3, 'exchange/bitswap/notifications/notifications.go': 3, 'exchange/bitswap/notifications/notifications_test.go': 3, 'exchange/bitswap/session.go': 6, 'exchange/bitswap/session_test.go': 5, 'exchange/bitswap/stat.go': 3, 'exchange/bitswap/wantlist/wantlist.go': 3, 'exchange/bitswap/wantlist/wantlist_test.go': 3, 'exchange/bitswap/wantmanager.go': 6, 'exchange/bitswap/workers.go': 6, 'exchange/interface.go': 2, 'exchange/offline/offline.go': 2, 'exchange/offline/offline_test.go': 2, 'exchange/reprovide/providers.go': 22, 'exchange/reprovide/reprovide.go': 23, 'filestore/filestore.go': 16, 'filestore/filestore_test.go': 22, 'filestore/fsrefstore.go': 15, 'filestore/util.go': 15, 'fuse/ipns/ipns_unix.go': 24, 'fuse/readonly/readonly_unix.go': 23, 'importer/balanced/balanced_test.go': 5, 'importer/balanced/builder.go': 3, 'importer/chunk/rabin_test.go': 2, 'importer/chunk/splitting_test.go': 2, 'importer/helpers/helpers.go': 3, 'importer/importer_test.go': 5, 'importer/trickle/trickle_test.go': 5, 'importer/trickle/trickledag.go': 3, 'merkledag/batch.go': 2, 'merkledag/coding.go': 3, 'merkledag/merkledag.go': 3, 'merkledag/merkledag_test.go': 5, 'merkledag/node.go': 3, 'merkledag/node_test.go': 3, 'merkledag/raw.go': 3, 'merkledag/traverse/traverse.go': 3, 'merkledag/traverse/traverse_test.go': 3, 'merkledag/utils/diff.go': 3, 'merkledag/utils/diffenum.go': 3, 'merkledag/utils/diffenum_test.go': 3, 'merkledag/utils/utils.go': 5, 'merkledag/utils/utils_test.go': 3, 'mfs/dir.go': 4, 'mfs/file.go': 6, 'mfs/mfs_test.go': 6, 'mfs/ops.go': 4, 'mfs/system.go': 7, 'namesys/ipns_select_test.go': 4, 'namesys/namesys.go': 25, 'namesys/publisher.go': 25, 'namesys/pubsub.go': 4, 'namesys/pubsub_test.go': 4, 'namesys/republisher/repub.go': 24, 'namesys/routing.go': 26, 'path/path.go': 3, 'path/resolver.go': 3, 'path/resolver_test.go': 2, 'pin/gc/gc.go': 23, 'pin/pin.go': 23, 'pin/pin_test.go': 22, 'pin/set.go': 20, 'pin/set_test.go': 22, 'plugin/ipld.go': 6, 'plugin/loader/initializer.go': 5, 'plugin/plugins/git/git.go': 6, 'repo/config/init.go': 7, 'repo/fsrepo/fsrepo.go': 22, 'repo/fsrepo/lock/lock.go': 3, 'repo/fsrepo/serialize/serialize.go': 3, 'repo/mock.go': 17, 'repo/repo.go': 20, 'routing/offline/offline.go': 3, 'tar/format.go': 23, 'test/dependencies/ma-pipe-unidir/main.go': 10, 'thirdparty/ds-help/key.go': 2, 'thirdparty/pollEndpoint/main.go': 15, 'thirdparty/posinfo/posinfo.go': 2, 'unixfs/archive/archive.go': 3, 'unixfs/archive/tar/writer.go': 3, 'unixfs/hamt/hamt.go': 3, 'unixfs/io/dagreader.go': 3, 'unixfs/io/dirbuilder.go': 3, 'unixfs/io/resolve.go': 3, 'unixfs/mod/dagmodifier.go': 5, 'unixfs/mod/dagmodifier_test.go': 3, 'unixfs/test/utils.go': 5, 'commands/legacy/command.go': 9, 'commands/legacy/legacy.go': 9, 'commands/legacy/legacy_test.go': 9, 'commands/legacy/request.go': 9, 'commands/legacy/response.go': 9, 'core/commands/commands_test.go': 11, 'core/coreapi/dag.go': 5, 'core/coreapi/dag_test.go': 3, 'core/coreapi/interface/options/dag.go': 4, 'core/coreapi/key.go': 23, 'core/coreapi/name.go': 25, 'merkledag/test/utils.go': 4, 'namesys/namesys_test.go': 24, 'repo/fsrepo/datastores.go': 14, 'repo/fsrepo/fsrepo_test.go': 17, 'thirdparty/datastore2/datastore_closer.go': 1, 'thirdparty/datastore2/delayed.go': 1, 'thirdparty/datastore2/threadsafe.go': 1, 'unixfs/io/pbdagreader.go': 2, 'cmd/ipfs/util/ulimit.go': 9, 'cmd/seccat/util.go': 9, 'core/corehttp/logs.go': 9, 'fuse/mount/mount.go': 9, 'fuse/node/mount_unix.go': 9, 'importer/chunk/splitting.go': 1, 'namesys/ipns_validate_test.go': 5, 'plugin/loader/load.go': 7, 'blocks/blockstoreutil/remove.go': 13, 'blockservice/test/mock.go': 5, 'core/commands/files.go': 20, 'core/core_test.go': 16, 'core/coreapi/pin.go': 20, 'fuse/ipns/common.go': 19, 'keystore/keystore.go': 9, 'keystore/keystore_test.go': 6, 'keystore/memkeystore.go': 6, 'namesys/interface.go': 19, 'namesys/validator.go': 3, 'path/resolver/resolver.go': 3, 'repo/config/identity.go': 2, 'thirdparty/verifbs/verifbs.go': 13, 'cmd/ipfs/util/ulimit_freebsd.go': 2, 'cmd/ipfs/util/ulimit_unix.go': 2, 'core/coreapi/block.go': 6, 'core/coreapi/block_test.go': 2, 'core/coreapi/interface/coreapi.go': 3, 'core/coreapi/interface/dag.go': 3, 'core/coreapi/interface/object.go': 3, 'core/coreapi/interface/options/block.go': 2, 'core/coreapi/interface/path.go': 15, 'core/coreapi/interface/unixfs.go': 4, 'core/coreapi/object.go': 18, 'fuse/ipns/link_unix.go': 2, 'fuse/mount/fuse.go': 2, 'fuse/node/mount_darwin.go': 2, 'merkledag/errservice.go': 1, 'merkledag/readonly.go': 1, 'merkledag/readonly_test.go': 1, 'merkledag/rwservice.go': 1, 'merkledag/session.go': 1, 'path/resolver/resolver_test.go': 1, 'thirdparty/verifcid/validate.go': 1, 'thirdparty/verifcid/validate_test.go': 1, 'unixfs/hamt/hamt_stress_test.go': 1, 'unixfs/hamt/hamt_test.go': 1, 'namesys/ipns_resolver_validation_test.go': 19, 'test/sharness/t0170-dht.sh': 1, 'core/commands/env.go': 2, 'core/commands/urlstore.go': 17, 'core/coreapi/interface/key.go': 7, 'core/coreapi/name_test.go': 12, 'core/coreapi/path.go': 17, 'core/coreunix/cat.go': 5, 'core/pathresolver_test.go': 17, 'dagutils/diff.go': 17, 'dagutils/diffenum.go': 17, 'dagutils/diffenum_test.go': 17, 'dagutils/utils.go': 17, 'dagutils/utils_test.go': 17, 'filestore/pb/dataobj.pb.go': 3, 'mfs/fd.go': 1, 'namesys/base.go': 17, 'namesys/cache.go': 17, 'namesys/dns.go': 17, 'namesys/proquint.go': 17, 'pin/internal/pb/header.pb.go': 3, 'thirdparty/cidv0v1/blockstore.go': 10, 'repo/fsrepo/config_test.go': 13, 'repo/fsrepo/misc.go': 13, 'test/bench/bench_cli_ipfs_add/main.go': 13, 'test/bench/offline_add/main.go': 13, 'core/commands/cmdenv/env.go': 12, 'core/commands/name/ipns.go': 15, 'core/commands/name/publish.go': 8, 'p2p/inbound.go': 3, 'p2p/outbound.go': 3, 'p2p/listener.go': 26, None: 2, 'p2p/stream.go': 24, 'p2p/local.go': 27, 'p2p/remote.go': 28, 'docs/experimental-features.md': 2, 'test/sharness/t0180-p2p.sh': 1, 'p2p/local_listener.go': 2, 'p2p/p2p_listener.go': 2, 'core/commands/name/ipnsps.go': 9, 'core/commands/name/name.go': 4, 'core/coreapi/dht.go': 14, 'core/coreapi/dht_test.go': 4, 'core/coreapi/interface/dht.go': 10, 'core/coreapi/interface/swarm.go': 9, 'core/coreapi/swarm.go': 13, 'core/coreapi/interface/options/unixfs.go': 8, 'core/coreapi/pubsub.go': 12, 'core/coreapi/unixfile.go': 7, 'cmd/ipfs/dnsresolve_test.go': 5, 'core/coreapi/interface/pubsub.go': 4, 'core/commands/cid.go': 3, 'test/dependencies/iptb/iptb.go': 8, 'plugin/plugins/badgerds/badgerds.go': 3, 'plugin/plugins/flatfs/flatfs.go': 3, 'plugin/plugins/levelds/levelds.go': 3, 'p2p/proxy.go': 1, 'p2p/proxy_test.go': 1, 'core/corehttp/proxy.go': 8, 'commands/context.go': 6, 'core/coreapi/interface/tests/name.go': 2, 'core/coreapi/interface/tests/unixfs.go': 2, 'core/coreapi/test/api_test.go': 6, 'core/commands/cmdenv/cidbase.go': 2, 'core/corehttp/ipns_hostname.go': 3, 'namesys/dns_test.go': 3, 'plugin/daemon.go': 3, 'plugin/loader/loader.go': 3, 'core/commands/cmdenv/cidbase_test.go': 1, 'core/commands/cmdenv/file.go': 1, 'core/corehttp/metrics.go': 1, 'core/corehttp/proxy_test.go': 2, 'core/corerepo/stat.go': 1, 'plugin/tracer.go': 1, 'thirdparty/notifier/notifier.go': 1, 'core/node/groups.go': 2, 'core/node/libp2p/discovery.go': 2, 'core/node/libp2p/libp2p.go': 2, 'core/bootstrap/bootstrap.go': 1, 'core/bootstrap/bootstrap_test.go': 1, 'core/node/builder.go': 1, 'core/node/core.go': 1, 'core/node/identity.go': 1, 'core/node/ipns.go': 1, 'core/node/libp2p/addrs.go': 1, 'core/node/libp2p/host.go': 1, 'core/node/libp2p/hostopt.go': 1, 'core/node/libp2p/nat.go': 1, 'core/node/libp2p/pnet.go': 1, 'core/node/libp2p/pubsub.go': 1, 'core/node/libp2p/routing.go': 1, 'core/node/libp2p/routingopt.go': 1, 'core/node/libp2p/smux.go': 1, 'core/node/libp2p/transport.go': 1, 'core/node/provider.go': 1, 'go.mod': 1, 'go.sum': 1, 'provider/simple/provider.go': 1, 'provider/simple/provider_test.go': 1, 'provider/simple/reprovide.go': 1, 'provider/simple/reprovide_test.go': 1}","('core/commands/p2p.go', 0.6458333333333334, 0.3924050632911392)"
plugin/ipld.go,10,30,0,[],8,20,0,[],-2,-10,0,15,15,"[{'timestamp': 1512365669.0, 'added_lines': 1, 'deleted_lines': 1, 'nloc': 10}, {'timestamp': 1516838128.0, 'added_lines': 1, 'deleted_lines': 1, 'nloc': 10}, {'timestamp': 1517255734.0, 'added_lines': 2, 'deleted_lines': 2, 'nloc': 10}, {'timestamp': 1528520460.0, 'added_lines': 1, 'deleted_lines': 1, 'nloc': 10}, {'timestamp': 1531779409.0, 'added_lines': 1, 'deleted_lines': 1, 'nloc': 10}, {'timestamp': 1534115707.0, 'added_lines': 1, 'deleted_lines': 1, 'nloc': 10}, {'timestamp': 1534347022.0, 'added_lines': 1, 'deleted_lines': 1, 'nloc': 10}, {'timestamp': 1534896611.0, 'added_lines': 1, 'deleted_lines': 1, 'nloc': 10}, {'timestamp': 1536718784.0, 'added_lines': 1, 'deleted_lines': 1, 'nloc': 10}, {'timestamp': 1540603818.0, 'added_lines': 1, 'deleted_lines': 1, 'nloc': 10}, {'timestamp': 1541204121.0, 'added_lines': 1, 'deleted_lines': 1, 'nloc': 10}, {'timestamp': 1547499910.0, 'added_lines': 1, 'deleted_lines': 1, 'nloc': 10}, {'timestamp': 1550723346.0, 'added_lines': 1, 'deleted_lines': 1, 'nloc': 10}, {'timestamp': 1551551196.0, 'added_lines': 1, 'deleted_lines': 1, 'nloc': 10}, {'timestamp': 1629221569.0, 'added_lines': 3, 'deleted_lines': 6, 'nloc': 8}]","{'assets/assets.go': 13, 'blocks/blockstore/arc_cache.go': 2, 'blocks/blockstore/arc_cache_test.go': 2, 'blocks/blockstore/blockstore.go': 2, 'blocks/blockstore/blockstore_test.go': 2, 'blocks/blockstore/bloom_cache.go': 2, 'blocks/blockstore/bloom_cache_test.go': 2, 'blocks/blockstore/util/remove.go': 2, 'blocks/blocksutil/block_generator.go': 2, 'blockservice/blockservice.go': 4, 'blockservice/blockservice_test.go': 4, 'blockservice/test/blocks_test.go': 4, 'cmd/ipfs/daemon.go': 6, 'cmd/ipfs/init.go': 5, 'cmd/ipfs/ipfs.go': 6, 'cmd/ipfs/main.go': 6, 'cmd/ipfs/main_test.go': 1, 'cmd/ipfswatch/main.go': 5, 'cmd/seccat/seccat.go': 6, 'commands/command.go': 5, 'commands/command_test.go': 2, 'commands/request.go': 5, 'commands/response.go': 4, 'commands/response_test.go': 2, 'core/bootstrap.go': 6, 'core/bootstrap_test.go': 6, 'core/builder.go': 13, 'core/commands/active.go': 4, 'core/commands/add.go': 11, 'core/commands/bitswap.go': 12, 'core/commands/block.go': 10, 'core/commands/bootstrap.go': 5, 'core/commands/cat.go': 7, 'core/commands/commands.go': 6, 'core/commands/config.go': 5, 'core/commands/dag/dag.go': 15, 'core/commands/dht.go': 14, 'core/commands/dht_test.go': 6, 'core/commands/diag.go': 4, 'core/commands/dns.go': 6, 'core/commands/external.go': 4, 'core/commands/files/files.go': 3, 'core/commands/filestore.go': 11, 'core/commands/get.go': 12, 'core/commands/get_test.go': 6, 'core/commands/helptext_test.go': 6, 'core/commands/id.go': 7, 'core/commands/ipns.go': 6, 'core/commands/ipnsps.go': 3, 'core/commands/keystore.go': 7, 'core/commands/log.go': 5, 'core/commands/ls.go': 14, 'core/commands/mount_nofuse.go': 4, 'core/commands/mount_unix.go': 5, 'core/commands/mount_windows.go': 4, 'core/commands/name.go': 3, 'core/commands/object/diff.go': 6, 'core/commands/object/object.go': 14, 'core/commands/object/patch.go': 6, 'core/commands/p2p.go': 6, 'core/commands/pin.go': 13, 'core/commands/ping.go': 7, 'core/commands/publish.go': 6, 'core/commands/pubsub.go': 11, 'core/commands/refs.go': 14, 'core/commands/repo.go': 11, 'core/commands/resolve.go': 11, 'core/commands/root.go': 6, 'core/commands/shutdown.go': 5, 'core/commands/stat.go': 6, 'core/commands/swarm.go': 6, 'core/commands/sysdiag.go': 6, 'core/commands/tar.go': 11, 'core/commands/unixfs/ls.go': 11, 'core/commands/unixfs/unixfs.go': 4, 'core/commands/version.go': 5, 'core/core.go': 15, 'core/coreapi/coreapi.go': 10, 'core/coreapi/interface/interface.go': 2, 'core/coreapi/unixfs.go': 14, 'core/coreapi/unixfs_test.go': 10, 'core/coredag/cbor.go': 14, 'core/coredag/dagpb.go': 14, 'core/coredag/dagtransl.go': 14, 'core/coredag/raw.go': 14, 'core/corehttp/commands.go': 12, 'core/corehttp/corehttp.go': 5, 'core/corehttp/gateway.go': 7, 'core/corehttp/gateway_handler.go': 14, 'core/corehttp/gateway_test.go': 12, 'core/corehttp/metrics_test.go': 7, 'core/corerepo/gc.go': 13, 'core/corerepo/pinning.go': 9, 'core/coreunix/add.go': 14, 'core/coreunix/add_test.go': 13, 'core/coreunix/metadata.go': 13, 'core/coreunix/metadata_test.go': 14, 'core/mock/mock.go': 7, 'core/pathresolver.go': 14, 'exchange/bitswap/bitswap.go': 4, 'exchange/bitswap/bitswap_test.go': 4, 'exchange/bitswap/decision/bench_test.go': 4, 'exchange/bitswap/decision/engine.go': 4, 'exchange/bitswap/decision/engine_test.go': 4, 'exchange/bitswap/decision/ledger.go': 4, 'exchange/bitswap/decision/peer_request_queue.go': 4, 'exchange/bitswap/decision/peer_request_queue_test.go': 4, 'exchange/bitswap/get.go': 4, 'exchange/bitswap/message/message.go': 4, 'exchange/bitswap/message/message_test.go': 4, 'exchange/bitswap/network/interface.go': 4, 'exchange/bitswap/network/ipfs_impl.go': 4, 'exchange/bitswap/notifications/notifications.go': 4, 'exchange/bitswap/notifications/notifications_test.go': 4, 'exchange/bitswap/session.go': 4, 'exchange/bitswap/session_test.go': 4, 'exchange/bitswap/stat.go': 4, 'exchange/bitswap/testnet/interface.go': 3, 'exchange/bitswap/testnet/network_test.go': 4, 'exchange/bitswap/testnet/peernet.go': 4, 'exchange/bitswap/testnet/virtual.go': 4, 'exchange/bitswap/testutils.go': 4, 'exchange/bitswap/wantlist/wantlist.go': 4, 'exchange/bitswap/wantlist/wantlist_test.go': 4, 'exchange/bitswap/wantmanager.go': 4, 'exchange/bitswap/workers.go': 4, 'exchange/interface.go': 2, 'exchange/offline/offline.go': 2, 'exchange/offline/offline_test.go': 2, 'exchange/reprovide/providers.go': 14, 'exchange/reprovide/reprovide.go': 11, 'exchange/reprovide/reprovide_test.go': 11, 'filestore/filestore.go': 13, 'filestore/filestore_test.go': 13, 'filestore/fsrefstore.go': 13, 'filestore/util.go': 11, 'fuse/ipns/ipns_test.go': 10, 'fuse/ipns/ipns_unix.go': 13, 'fuse/node/mount_test.go': 10, 'fuse/readonly/ipfs_test.go': 14, 'fuse/readonly/readonly_unix.go': 15, 'importer/balanced/balanced_test.go': 5, 'importer/balanced/builder.go': 5, 'importer/chunk/rabin_test.go': 2, 'importer/chunk/splitting_test.go': 2, 'importer/helpers/dagbuilder.go': 5, 'importer/helpers/helpers.go': 5, 'importer/importer.go': 5, 'importer/importer_test.go': 5, 'importer/trickle/trickle_test.go': 5, 'importer/trickle/trickledag.go': 5, 'merkledag/batch.go': 2, 'merkledag/coding.go': 5, 'merkledag/merkledag.go': 5, 'merkledag/merkledag_test.go': 5, 'merkledag/node.go': 5, 'merkledag/node_test.go': 5, 'merkledag/raw.go': 5, 'merkledag/traverse/traverse.go': 5, 'merkledag/traverse/traverse_test.go': 5, 'merkledag/utils/diff.go': 5, 'merkledag/utils/diffenum.go': 5, 'merkledag/utils/diffenum_test.go': 5, 'merkledag/utils/utils.go': 5, 'merkledag/utils/utils_test.go': 5, 'mfs/dir.go': 7, 'mfs/file.go': 7, 'mfs/mfs_test.go': 7, 'mfs/ops.go': 7, 'mfs/repub_test.go': 6, 'mfs/system.go': 7, 'namesys/ipns_select_test.go': 3, 'namesys/namesys.go': 13, 'namesys/publisher.go': 13, 'namesys/publisher_test.go': 11, 'namesys/pubsub.go': 2, 'namesys/pubsub_test.go': 2, 'namesys/republisher/repub.go': 12, 'namesys/republisher/repub_test.go': 12, 'namesys/resolve_test.go': 13, 'namesys/routing.go': 13, 'p2p/p2p.go': 6, 'p2p/registry.go': 4, 'package.json': 12, 'path/path.go': 4, 'path/resolver.go': 3, 'path/resolver_test.go': 3, 'pin/gc/gc.go': 14, 'pin/pin.go': 14, 'pin/pin_test.go': 13, 'pin/set.go': 14, 'pin/set_test.go': 13, 'plugin/loader/initializer.go': 11, 'plugin/plugins/git/git.go': 14, 'repo/config/bootstrap_peers.go': 3, 'repo/config/init.go': 3, 'repo/fsrepo/fsrepo.go': 6, 'repo/fsrepo/lock/lock.go': 2, 'repo/fsrepo/serialize/serialize.go': 3, 'repo/mock.go': 6, 'repo/repo.go': 6, 'routing/mock/centralized_client.go': 2, 'routing/mock/centralized_server.go': 2, 'routing/mock/centralized_test.go': 2, 'routing/mock/interface.go': 2, 'routing/none/none_client.go': 2, 'routing/offline/offline.go': 2, 'routing/offline/offline_test.go': 2, 'tar/format.go': 14, 'test/dependencies/ma-pipe-unidir/main.go': 5, 'test/integration/addcat_test.go': 7, 'test/integration/bench_cat_test.go': 7, 'test/integration/bench_test.go': 6, 'test/integration/bitswap_wo_routing_test.go': 11, 'test/integration/three_legged_cat_test.go': 7, 'thirdparty/ds-help/key.go': 2, 'thirdparty/pollEndpoint/main.go': 5, 'thirdparty/posinfo/posinfo.go': 3, 'unixfs/archive/archive.go': 5, 'unixfs/archive/tar/writer.go': 5, 'unixfs/hamt/hamt.go': 5, 'unixfs/io/dagreader.go': 5, 'unixfs/io/dirbuilder.go': 4, 'unixfs/io/resolve.go': 5, 'unixfs/mod/dagmodifier.go': 5, 'unixfs/mod/dagmodifier_test.go': 3, 'unixfs/test/utils.go': 5, 'commands/legacy/command.go': 4, 'commands/legacy/legacy.go': 4, 'commands/legacy/legacy_test.go': 4, 'commands/legacy/request.go': 4, 'commands/legacy/response.go': 4, 'core/commands/commands_test.go': 5, 'core/coreapi/dag.go': 12, 'core/coreapi/dag_test.go': 3, 'core/coreapi/interface/options/dag.go': 8, 'core/coreapi/key.go': 11, 'core/coreapi/name.go': 12, 'merkledag/test/utils.go': 4, 'namesys/namesys_test.go': 12, 'repo/fsrepo/datastores.go': 4, 'repo/fsrepo/fsrepo_test.go': 4, 'thirdparty/datastore2/datastore_closer.go': 1, 'thirdparty/datastore2/delayed.go': 1, 'thirdparty/datastore2/threadsafe.go': 1, 'unixfs/io/pbdagreader.go': 4, 'unixfs/hamt/hamt_stress_test.go': 3, 'unixfs/hamt/hamt_test.go': 3, 'blocks/blockstoreutil/remove.go': 9, 'blockservice/test/mock.go': 2, 'cmd/ipfs/util/ulimit.go': 3, 'cmd/ipfs/util/ulimit_freebsd.go': 2, 'cmd/ipfs/util/ulimit_unix.go': 2, 'cmd/seccat/util.go': 3, 'core/commands/files.go': 11, 'core/coreapi/block.go': 9, 'core/coreapi/block_test.go': 2, 'core/coreapi/interface/coreapi.go': 9, 'core/coreapi/interface/dag.go': 9, 'core/coreapi/interface/object.go': 9, 'core/coreapi/interface/options/block.go': 3, 'core/coreapi/interface/path.go': 9, 'core/coreapi/interface/unixfs.go': 9, 'core/coreapi/object.go': 11, 'core/coreapi/pin.go': 11, 'core/corehttp/logs.go': 3, 'fuse/ipns/link_unix.go': 2, 'fuse/mount/fuse.go': 2, 'fuse/mount/mount.go': 3, 'fuse/node/mount_darwin.go': 2, 'fuse/node/mount_unix.go': 3, 'keystore/keystore.go': 3, 'merkledag/errservice.go': 2, 'merkledag/readonly.go': 2, 'merkledag/readonly_test.go': 2, 'merkledag/rwservice.go': 2, 'merkledag/session.go': 2, 'namesys/ipns_validate_test.go': 1, 'namesys/validator.go': 1, 'path/resolver/resolver.go': 2, 'path/resolver/resolver_test.go': 2, 'plugin/loader/load.go': 2, 'thirdparty/verifbs/verifbs.go': 9, 'thirdparty/verifcid/validate.go': 2, 'thirdparty/verifcid/validate_test.go': 2, 'core/commands/urlstore.go': 10, 'namesys/ipns_resolver_validation_test.go': 10, 'unixfs/io/directory.go': 1, 'core/coreapi/name_test.go': 6, 'core/coreapi/path.go': 10, 'core/coreunix/cat.go': 4, 'core/pathresolver_test.go': 9, 'dagutils/diff.go': 9, 'dagutils/diffenum.go': 9, 'dagutils/diffenum_test.go': 9, 'dagutils/utils.go': 9, 'dagutils/utils_test.go': 9, 'fuse/ipns/common.go': 9, 'mfs/fd.go': 2, 'namesys/base.go': 9, 'namesys/cache.go': 9, 'namesys/dns.go': 9, 'namesys/interface.go': 9, 'namesys/proquint.go': 9, 'thirdparty/cidv0v1/blockstore.go': 7, 'core/commands/env.go': 1, 'core/core_test.go': 3, 'core/coreapi/interface/key.go': 2, 'repo/fsrepo/config_test.go': 3, 'repo/fsrepo/misc.go': 3, 'test/bench/bench_cli_ipfs_add/main.go': 3, 'test/bench/offline_add/main.go': 3, 'core/commands/name/ipns.go': 6, 'core/commands/name/publish.go': 4, 'core/coreapi/dht.go': 6, 'core/coreapi/dht_test.go': 2, 'test/sharness/t0275-cid-security.sh': 1, 'core/coreapi/interface/options/unixfs.go': 3, 'core/coreapi/unixfile.go': 3, 'cmd/ipfs/dnsresolve_test.go': 2, 'core/commands/cid.go': 3, 'core/commands/cmdenv/env.go': 3, 'core/commands/name/ipnsps.go': 2, 'core/commands/name/name.go': 2, 'core/coreapi/interface/dht.go': 1, 'core/coreapi/interface/pubsub.go': 1, 'core/coreapi/interface/swarm.go': 1, 'core/coreapi/pubsub.go': 3, 'core/coreapi/swarm.go': 3, 'keystore/keystore_test.go': 2, 'keystore/memkeystore.go': 2, 'p2p/listener.go': 2, 'p2p/local.go': 2, 'p2p/remote.go': 2, 'p2p/stream.go': 2, 'test/dependencies/iptb/iptb.go': 3, 'core/coreapi/interface/tests/name.go': 1, 'core/coreapi/interface/tests/unixfs.go': 1, 'plugin/loader/loader.go': 4, 'commands/context.go': 2, 'core/commands/cmdenv/cidbase.go': 2, 'core/commands/cmdenv/cidbase_test.go': 2, 'core/coreapi/test/api_test.go': 2, 'core/corehttp/ipns_hostname.go': 2, 'core/corehttp/proxy.go': 2, 'namesys/dns_test.go': 2, 'plugin/daemon.go': 2, 'core/commands/cmdenv/file.go': 1, 'core/corehttp/metrics.go': 1, 'core/corehttp/proxy_test.go': 1, 'core/corerepo/stat.go': 1, 'filestore/pb/dataobj.pb.go': 1, 'pin/internal/pb/header.pb.go': 1, 'plugin/plugins/badgerds/badgerds.go': 1, 'plugin/plugins/flatfs/flatfs.go': 1, 'plugin/plugins/levelds/levelds.go': 1, 'plugin/tracer.go': 1, 'thirdparty/notifier/notifier.go': 1, 'CHANGELOG.md': 1, 'core/commands/dag/get.go': 1, 'core/commands/dag/put.go': 1, 'core/node/core.go': 1, 'core/node/groups.go': 1, 'core/node/provider.go': 1, 'go.mod': 1, 'go.sum': 1, 'test/sharness/t0053-dag.sh': 1, 'test/sharness/t0055-dag-put-json-new-line.sh': 1, 'test/sharness/t0280-plugin-git.sh': 1}","('core/core.go', 1.0, 0.08379888268156424)"
plugin/plugin.go,6,19,0,[],10,33,0,[],4,14,0,4,4,"[{'timestamp': 1521427288.0, 'added_lines': 1, 'deleted_lines': 1, 'nloc': 6}, {'timestamp': 1567106571.0, 'added_lines': 14, 'deleted_lines': 1, 'nloc': 10}, {'timestamp': 1569303147.0, 'added_lines': 4, 'deleted_lines': 1, 'nloc': 10}, {'timestamp': 1589345762.0, 'added_lines': 6, 'deleted_lines': 1, 'nloc': 10}]","{'CHANGELOG.md': 1, 'README.md': 1, 'bin/dist_get': 1, 'cmd/ipfs/init.go': 1, 'cmd/ipfs/main.go': 2, 'cmd/ipfs/util/ulimit_freebsd.go': 1, 'cmd/seccat/seccat.go': 1, 'commands/request.go': 1, 'contribute.md': 1, 'core/builder.go': 1, 'core/commands/add.go': 1, 'core/commands/block.go': 1, 'core/commands/dag/dag.go': 1, 'core/commands/mount_unix.go': 1, 'core/commands/refs.go': 1, 'core/coreapi/coreapi.go': 1, 'core/coreapi/interface/options/pin.go': 1, 'core/coredag/dagtransl.go': 1, 'core/corerepo/pinning.go': 1, 'core/pathresolver.go': 1, 'docs/experimental-features.md': 1, 'docs/file-transfer.md': 1, 'docs/releases.md': 1, 'exchange/bitswap/README.md': 1, 'exchange/bitswap/bitswap.go': 1, 'exchange/bitswap/decision/ledger.go': 1, 'importer/helpers/dagbuilder.go': 1, 'importer/trickle/trickledag.go': 1, 'merkledag/raw.go': 1, 'namesys/pubsub.go': 1, 'pin/pin.go': 1, 'pin/set.go': 1, 'repo/fsrepo/fsrepo.go': 1, 'repo/fsrepo/migrations/mfsr_test.go': 1, 'repo/fsrepo/migrations/migrations.go': 1, 'test/sharness/README.md': 1, 'thirdparty/dir/dir.go': 1, 'unixfs/mod/dagmodifier.go': 1, 'commands/context.go': 1, 'docs/plugins.md': 1, 'go.mod': 1, 'go.sum': 1, 'plugin/loader/loader.go': 2, 'plugin/plugins/badgerds/badgerds.go': 1, 'plugin/plugins/flatfs/flatfs.go': 1, 'plugin/plugins/git/git.go': 1, 'plugin/plugins/levelds/levelds.go': 1, 'repo/fsrepo/config_test.go': 1, 'test/sharness/t0020-init.sh': 1, 'test/sharness/t0280-plugin-data/example.go': 1, 'test/sharness/t0280-plugin.sh': 1, 'plugin/daemon.go': 1, 'plugin/tracer.go': 1}","('cmd/ipfs/main.go', 0.5, 0.01904761904761905)"
plugin/loader/preload.go,5,16,0,[],15,56,1,"[{'cyclomatic_complexity': 1, 'nloc': 7, 'token_count': 41, 'name': 'init', 'long_name': 'init', 'start_line': 15, 'end_line': 21, 'full_parameters': [], 'filename': '/home/dimi/Documents/Informatik_Studium/FSS/SoftEvo/DataCollection/FFS_SoftEvo/go-ipfs/plugin/loader/preload.go', 'top_nesting_level': 0, 'length': 7, 'fan_in': 0, 'fan_out': 0, 'general_fan_out': 0}]",10,40,1,7,7,"[{'timestamp': 1525173823.0, 'added_lines': 4, 'deleted_lines': 1, 'nloc': 8}, {'timestamp': 1540870015.0, 'added_lines': 6, 'deleted_lines': 0, 'nloc': 14}, {'timestamp': 1565893264.0, 'added_lines': 5, 'deleted_lines': 6, 'nloc': 13}, {'timestamp': 1581334191.0, 'added_lines': 2, 'deleted_lines': 0, 'nloc': 15}, {'timestamp': 1581343036.0, 'added_lines': 2, 'deleted_lines': 2, 'nloc': 15}, {'timestamp': 1581367971.0, 'added_lines': 0, 'deleted_lines': 2, 'nloc': 13}, {'timestamp': 1629769463.0, 'added_lines': 2, 'deleted_lines': 0, 'nloc': 15}]","{'plugin/loader/preload_list': 7, 'plugin/plugins/Rules.mk': 2, 'plugin/plugins/badgerds/badgerds.go': 1, 'plugin/plugins/flatfs/flatfs.go': 1, 'plugin/plugins/levelds/levelds.go': 1, 'repo/fsrepo/datastores.go': 1, 'plugin/loader/loader.go': 1, 'plugin/loader/preload.sh': 1, 'plugin/plugins/peeridlog/peeridlog.go': 1, None: 1, 'plugin/plugins/peerlog/peerlog.go': 2, 'test/sharness/t0280-plugin-peerlog.sh': 1}","('repo/fsrepo/datastores.go', 0.14285714285714285, 0.03225806451612903)"
plugin/plugins/git/git.go,57,325,7,"[{'cyclomatic_complexity': 1, 'nloc': 3, 'token_count': 13, 'name': 'Name', 'long_name': '(*gitPlugin)Name', 'start_line': 27, 'end_line': 29, 'full_parameters': [], 'filename': '/home/dimi/Documents/Informatik_Studium/FSS/SoftEvo/DataCollection/FFS_SoftEvo/go-ipfs/plugin/plugins/git/git.go', 'top_nesting_level': 0, 'length': 3, 'fan_in': 0, 'fan_out': 0, 'general_fan_out': 0}, {'cyclomatic_complexity': 1, 'nloc': 3, 'token_count': 13, 'name': 'Version', 'long_name': '(*gitPlugin)Version', 'start_line': 31, 'end_line': 33, 'full_parameters': [], 'filename': '/home/dimi/Documents/Informatik_Studium/FSS/SoftEvo/DataCollection/FFS_SoftEvo/go-ipfs/plugin/plugins/git/git.go', 'top_nesting_level': 0, 'length': 3, 'fan_in': 0, 'fan_out': 0, 'general_fan_out': 0}, {'cyclomatic_complexity': 1, 'nloc': 3, 'token_count': 13, 'name': 'Init', 'long_name': '(*gitPlugin)Init', 'start_line': 35, 'end_line': 37, 'full_parameters': [], 'filename': '/home/dimi/Documents/Informatik_Studium/FSS/SoftEvo/DataCollection/FFS_SoftEvo/go-ipfs/plugin/plugins/git/git.go', 'top_nesting_level': 0, 'length': 3, 'fan_in': 0, 'fan_out': 0, 'general_fan_out': 0}, {'cyclomatic_complexity': 1, 'nloc': 4, 'token_count': 29, 'name': 'RegisterBlockDecoders', 'long_name': '(*gitPlugin)RegisterBlockDecoders dec format . BlockDecoder', 'start_line': 39, 'end_line': 42, 'full_parameters': ['dec format . BlockDecoder'], 'filename': '/home/dimi/Documents/Informatik_Studium/FSS/SoftEvo/DataCollection/FFS_SoftEvo/go-ipfs/plugin/plugins/git/git.go', 'top_nesting_level': 0, 'length': 4, 'fan_in': 0, 'fan_out': 0, 'general_fan_out': 0}, {'cyclomatic_complexity': 1, 'nloc': 5, 'token_count': 37, 'name': 'RegisterInputEncParsers', 'long_name': '(*gitPlugin)RegisterInputEncParsers iec coredag . InputEncParsers', 'start_line': 44, 'end_line': 48, 'full_parameters': ['iec coredag . InputEncParsers'], 'filename': '/home/dimi/Documents/Informatik_Studium/FSS/SoftEvo/DataCollection/FFS_SoftEvo/go-ipfs/plugin/plugins/git/git.go', 'top_nesting_level': 0, 'length': 5, 'fan_in': 0, 'fan_out': 0, 'general_fan_out': 0}, {'cyclomatic_complexity': 6, 'nloc': 13, 'token_count': 110, 'name': 'parseRawGit', 'long_name': 'parseRawGit r io . Reader , mhType uint64 , mhLen int', 'start_line': 50, 'end_line': 65, 'full_parameters': ['r io . Reader', ' mhType uint64', ' mhLen int'], 'filename': '/home/dimi/Documents/Informatik_Studium/FSS/SoftEvo/DataCollection/FFS_SoftEvo/go-ipfs/plugin/plugins/git/git.go', 'top_nesting_level': 0, 'length': 16, 'fan_in': 0, 'fan_out': 0, 'general_fan_out': 0}, {'cyclomatic_complexity': 2, 'nloc': 8, 'token_count': 60, 'name': 'parseZlibGit', 'long_name': 'parseZlibGit r io . Reader , mhType uint64 , mhLen int', 'start_line': 67, 'end_line': 75, 'full_parameters': ['r io . Reader', ' mhType uint64', ' mhLen int'], 'filename': '/home/dimi/Documents/Informatik_Studium/FSS/SoftEvo/DataCollection/FFS_SoftEvo/go-ipfs/plugin/plugins/git/git.go', 'top_nesting_level': 0, 'length': 9, 'fan_in': 0, 'fan_out': 0, 'general_fan_out': 0}]",38,204,5,"[{'cyclomatic_complexity': 1, 'nloc': 3, 'token_count': 13, 'name': 'Name', 'long_name': '(*gitPlugin)Name', 'start_line': 25, 'end_line': 27, 'full_parameters': [], 'filename': '/home/dimi/Documents/Informatik_Studium/FSS/SoftEvo/DataCollection/FFS_SoftEvo/go-ipfs/plugin/plugins/git/git.go', 'top_nesting_level': 0, 'length': 3, 'fan_in': 0, 'fan_out': 0, 'general_fan_out': 0}, {'cyclomatic_complexity': 1, 'nloc': 3, 'token_count': 13, 'name': 'Version', 'long_name': '(*gitPlugin)Version', 'start_line': 29, 'end_line': 31, 'full_parameters': [], 'filename': '/home/dimi/Documents/Informatik_Studium/FSS/SoftEvo/DataCollection/FFS_SoftEvo/go-ipfs/plugin/plugins/git/git.go', 'top_nesting_level': 0, 'length': 3, 'fan_in': 0, 'fan_out': 0, 'general_fan_out': 0}, {'cyclomatic_complexity': 1, 'nloc': 3, 'token_count': 18, 'name': 'Init', 'long_name': '(*gitPlugin)Init _ * plugin . Environment', 'start_line': 33, 'end_line': 35, 'full_parameters': ['_ * plugin . Environment'], 'filename': '/home/dimi/Documents/Informatik_Studium/FSS/SoftEvo/DataCollection/FFS_SoftEvo/go-ipfs/plugin/plugins/git/git.go', 'top_nesting_level': 0, 'length': 3, 'fan_in': 0, 'fan_out': 0, 'general_fan_out': 0}, {'cyclomatic_complexity': 1, 'nloc': 6, 'token_count': 64, 'name': 'Register', 'long_name': '(*gitPlugin)Register reg multicodec . Registry', 'start_line': 37, 'end_line': 43, 'full_parameters': ['reg multicodec . Registry'], 'filename': '/home/dimi/Documents/Informatik_Studium/FSS/SoftEvo/DataCollection/FFS_SoftEvo/go-ipfs/plugin/plugins/git/git.go', 'top_nesting_level': 0, 'length': 7, 'fan_in': 0, 'fan_out': 0, 'general_fan_out': 0}, {'cyclomatic_complexity': 2, 'nloc': 8, 'token_count': 49, 'name': 'decodeZlibGit', 'long_name': 'decodeZlibGit na ipld . NodeAssembler , r io . Reader', 'start_line': 45, 'end_line': 54, 'full_parameters': ['na ipld . NodeAssembler', ' r io . Reader'], 'filename': '/home/dimi/Documents/Informatik_Studium/FSS/SoftEvo/DataCollection/FFS_SoftEvo/go-ipfs/plugin/plugins/git/git.go', 'top_nesting_level': 0, 'length': 10, 'fan_in': 0, 'fan_out': 0, 'general_fan_out': 0}]",-19,-121,-2,17,17,"[{'timestamp': 1509893446.0, 'added_lines': 1, 'deleted_lines': 1, 'nloc': 57}, {'timestamp': 1512365669.0, 'added_lines': 4, 'deleted_lines': 4, 'nloc': 57}, {'timestamp': 1516838128.0, 'added_lines': 4, 'deleted_lines': 4, 'nloc': 57}, {'timestamp': 1525048301.0, 'added_lines': 1, 'deleted_lines': 1, 'nloc': 57}, {'timestamp': 1528520460.0, 'added_lines': 4, 'deleted_lines': 4, 'nloc': 57}, {'timestamp': 1531779409.0, 'added_lines': 3, 'deleted_lines': 3, 'nloc': 57}, {'timestamp': 1534115707.0, 'added_lines': 3, 'deleted_lines': 3, 'nloc': 57}, {'timestamp': 1534347022.0, 'added_lines': 3, 'deleted_lines': 3, 'nloc': 57}, {'timestamp': 1534896611.0, 'added_lines': 3, 'deleted_lines': 3, 'nloc': 57}, {'timestamp': 1536718784.0, 'added_lines': 3, 'deleted_lines': 3, 'nloc': 57}, {'timestamp': 1540603818.0, 'added_lines': 2, 'deleted_lines': 2, 'nloc': 57}, {'timestamp': 1541204121.0, 'added_lines': 4, 'deleted_lines': 4, 'nloc': 57}, {'timestamp': 1547499910.0, 'added_lines': 2, 'deleted_lines': 2, 'nloc': 57}, {'timestamp': 1550723346.0, 'added_lines': 3, 'deleted_lines': 3, 'nloc': 57}, {'timestamp': 1551551196.0, 'added_lines': 4, 'deleted_lines': 4, 'nloc': 57}, {'timestamp': 1567106571.0, 'added_lines': 1, 'deleted_lines': 1, 'nloc': 57}, {'timestamp': 1629221569.0, 'added_lines': 13, 'deleted_lines': 34, 'nloc': 38}]","{'assets/assets.go': 13, 'blocks/blockstore/arc_cache.go': 2, 'blocks/blockstore/arc_cache_test.go': 2, 'blocks/blockstore/blockstore.go': 2, 'blocks/blockstore/blockstore_test.go': 2, 'blocks/blockstore/bloom_cache.go': 2, 'blocks/blockstore/bloom_cache_test.go': 2, 'blocks/blockstore/util/remove.go': 2, 'blocks/blocksutil/block_generator.go': 2, 'blockservice/blockservice.go': 4, 'blockservice/blockservice_test.go': 4, 'blockservice/test/blocks_test.go': 4, 'cmd/ipfs/daemon.go': 6, 'cmd/ipfs/init.go': 5, 'cmd/ipfs/ipfs.go': 6, 'cmd/ipfs/main.go': 7, 'cmd/ipfs/main_test.go': 1, 'cmd/ipfswatch/main.go': 5, 'cmd/seccat/seccat.go': 6, 'commands/command.go': 5, 'commands/command_test.go': 2, 'commands/request.go': 5, 'commands/response.go': 4, 'commands/response_test.go': 2, 'core/bootstrap.go': 6, 'core/bootstrap_test.go': 6, 'core/builder.go': 13, 'core/commands/active.go': 4, 'core/commands/add.go': 11, 'core/commands/bitswap.go': 12, 'core/commands/block.go': 10, 'core/commands/bootstrap.go': 5, 'core/commands/cat.go': 7, 'core/commands/commands.go': 6, 'core/commands/config.go': 5, 'core/commands/dag/dag.go': 14, 'core/commands/dht.go': 13, 'core/commands/dht_test.go': 6, 'core/commands/diag.go': 4, 'core/commands/dns.go': 6, 'core/commands/external.go': 4, 'core/commands/files/files.go': 2, 'core/commands/filestore.go': 11, 'core/commands/get.go': 12, 'core/commands/get_test.go': 6, 'core/commands/helptext_test.go': 6, 'core/commands/id.go': 7, 'core/commands/ipns.go': 6, 'core/commands/ipnsps.go': 3, 'core/commands/keystore.go': 7, 'core/commands/log.go': 5, 'core/commands/ls.go': 13, 'core/commands/mount_nofuse.go': 4, 'core/commands/mount_unix.go': 5, 'core/commands/mount_windows.go': 4, 'core/commands/name.go': 3, 'core/commands/object/diff.go': 6, 'core/commands/object/object.go': 13, 'core/commands/object/patch.go': 6, 'core/commands/p2p.go': 6, 'core/commands/pin.go': 13, 'core/commands/ping.go': 7, 'core/commands/publish.go': 6, 'core/commands/pubsub.go': 11, 'core/commands/refs.go': 13, 'core/commands/repo.go': 11, 'core/commands/resolve.go': 11, 'core/commands/root.go': 6, 'core/commands/shutdown.go': 5, 'core/commands/stat.go': 6, 'core/commands/swarm.go': 6, 'core/commands/sysdiag.go': 6, 'core/commands/tar.go': 11, 'core/commands/unixfs/ls.go': 11, 'core/commands/unixfs/unixfs.go': 4, 'core/commands/version.go': 5, 'core/core.go': 14, 'core/coreapi/coreapi.go': 10, 'core/coreapi/interface/interface.go': 2, 'core/coreapi/unixfs.go': 13, 'core/coreapi/unixfs_test.go': 10, 'core/coredag/cbor.go': 13, 'core/coredag/dagpb.go': 13, 'core/coredag/dagtransl.go': 13, 'core/coredag/raw.go': 13, 'core/corehttp/commands.go': 12, 'core/corehttp/corehttp.go': 5, 'core/corehttp/gateway.go': 7, 'core/corehttp/gateway_handler.go': 13, 'core/corehttp/gateway_test.go': 12, 'core/corehttp/metrics_test.go': 7, 'core/corerepo/gc.go': 13, 'core/corerepo/pinning.go': 9, 'core/coreunix/add.go': 13, 'core/coreunix/add_test.go': 13, 'core/coreunix/metadata.go': 13, 'core/coreunix/metadata_test.go': 13, 'core/mock/mock.go': 7, 'core/pathresolver.go': 13, 'exchange/bitswap/bitswap.go': 4, 'exchange/bitswap/bitswap_test.go': 4, 'exchange/bitswap/decision/bench_test.go': 4, 'exchange/bitswap/decision/engine.go': 4, 'exchange/bitswap/decision/engine_test.go': 4, 'exchange/bitswap/decision/ledger.go': 4, 'exchange/bitswap/decision/peer_request_queue.go': 4, 'exchange/bitswap/decision/peer_request_queue_test.go': 4, 'exchange/bitswap/get.go': 4, 'exchange/bitswap/message/message.go': 4, 'exchange/bitswap/message/message_test.go': 4, 'exchange/bitswap/network/interface.go': 4, 'exchange/bitswap/network/ipfs_impl.go': 4, 'exchange/bitswap/notifications/notifications.go': 4, 'exchange/bitswap/notifications/notifications_test.go': 4, 'exchange/bitswap/session.go': 4, 'exchange/bitswap/session_test.go': 4, 'exchange/bitswap/stat.go': 4, 'exchange/bitswap/testnet/interface.go': 3, 'exchange/bitswap/testnet/network_test.go': 4, 'exchange/bitswap/testnet/peernet.go': 4, 'exchange/bitswap/testnet/virtual.go': 4, 'exchange/bitswap/testutils.go': 4, 'exchange/bitswap/wantlist/wantlist.go': 4, 'exchange/bitswap/wantlist/wantlist_test.go': 4, 'exchange/bitswap/wantmanager.go': 4, 'exchange/bitswap/workers.go': 4, 'exchange/interface.go': 2, 'exchange/offline/offline.go': 2, 'exchange/offline/offline_test.go': 2, 'exchange/reprovide/providers.go': 13, 'exchange/reprovide/reprovide.go': 11, 'exchange/reprovide/reprovide_test.go': 11, 'filestore/filestore.go': 13, 'filestore/filestore_test.go': 13, 'filestore/fsrefstore.go': 13, 'filestore/util.go': 11, 'fuse/ipns/ipns_test.go': 10, 'fuse/ipns/ipns_unix.go': 13, 'fuse/node/mount_test.go': 10, 'fuse/readonly/ipfs_test.go': 13, 'fuse/readonly/readonly_unix.go': 14, 'importer/balanced/balanced_test.go': 4, 'importer/balanced/builder.go': 4, 'importer/chunk/rabin_test.go': 2, 'importer/chunk/splitting_test.go': 2, 'importer/helpers/dagbuilder.go': 4, 'importer/helpers/helpers.go': 4, 'importer/importer.go': 4, 'importer/importer_test.go': 4, 'importer/trickle/trickle_test.go': 4, 'importer/trickle/trickledag.go': 4, 'merkledag/batch.go': 2, 'merkledag/coding.go': 4, 'merkledag/merkledag.go': 4, 'merkledag/merkledag_test.go': 4, 'merkledag/node.go': 4, 'merkledag/node_test.go': 4, 'merkledag/raw.go': 4, 'merkledag/traverse/traverse.go': 4, 'merkledag/traverse/traverse_test.go': 4, 'merkledag/utils/diff.go': 4, 'merkledag/utils/diffenum.go': 4, 'merkledag/utils/diffenum_test.go': 4, 'merkledag/utils/utils.go': 4, 'merkledag/utils/utils_test.go': 4, 'mfs/dir.go': 6, 'mfs/file.go': 6, 'mfs/mfs_test.go': 6, 'mfs/ops.go': 6, 'mfs/repub_test.go': 6, 'mfs/system.go': 6, 'namesys/ipns_select_test.go': 3, 'namesys/namesys.go': 13, 'namesys/publisher.go': 13, 'namesys/publisher_test.go': 11, 'namesys/pubsub.go': 2, 'namesys/pubsub_test.go': 2, 'namesys/republisher/repub.go': 12, 'namesys/republisher/repub_test.go': 12, 'namesys/resolve_test.go': 13, 'namesys/routing.go': 13, 'p2p/p2p.go': 6, 'p2p/registry.go': 4, 'package.json': 13, 'path/path.go': 4, 'path/resolver.go': 2, 'path/resolver_test.go': 2, 'pin/gc/gc.go': 13, 'pin/pin.go': 13, 'pin/pin_test.go': 13, 'pin/set.go': 13, 'pin/set_test.go': 13, 'plugin/ipld.go': 14, 'plugin/loader/initializer.go': 10, 'repo/config/bootstrap_peers.go': 3, 'repo/config/init.go': 3, 'repo/fsrepo/fsrepo.go': 6, 'repo/fsrepo/lock/lock.go': 2, 'repo/fsrepo/serialize/serialize.go': 3, 'repo/mock.go': 6, 'repo/repo.go': 6, 'routing/mock/centralized_client.go': 2, 'routing/mock/centralized_server.go': 2, 'routing/mock/centralized_test.go': 2, 'routing/mock/interface.go': 2, 'routing/none/none_client.go': 2, 'routing/offline/offline.go': 2, 'routing/offline/offline_test.go': 2, 'tar/format.go': 13, 'test/dependencies/ma-pipe-unidir/main.go': 5, 'test/integration/addcat_test.go': 7, 'test/integration/bench_cat_test.go': 7, 'test/integration/bench_test.go': 6, 'test/integration/bitswap_wo_routing_test.go': 11, 'test/integration/three_legged_cat_test.go': 7, 'thirdparty/ds-help/key.go': 2, 'thirdparty/pollEndpoint/main.go': 5, 'thirdparty/posinfo/posinfo.go': 2, 'unixfs/archive/archive.go': 4, 'unixfs/archive/tar/writer.go': 4, 'unixfs/hamt/hamt.go': 4, 'unixfs/io/dagreader.go': 4, 'unixfs/io/dirbuilder.go': 3, 'unixfs/io/resolve.go': 4, 'unixfs/mod/dagmodifier.go': 4, 'unixfs/mod/dagmodifier_test.go': 3, 'unixfs/test/utils.go': 4, 'commands/legacy/command.go': 4, 'commands/legacy/legacy.go': 4, 'commands/legacy/legacy_test.go': 4, 'commands/legacy/request.go': 4, 'commands/legacy/response.go': 4, 'core/commands/commands_test.go': 5, 'core/coreapi/dag.go': 12, 'core/coreapi/dag_test.go': 3, 'core/coreapi/interface/options/dag.go': 8, 'core/coreapi/key.go': 11, 'core/coreapi/name.go': 12, 'merkledag/test/utils.go': 3, 'namesys/namesys_test.go': 12, 'repo/fsrepo/datastores.go': 4, 'repo/fsrepo/fsrepo_test.go': 4, 'thirdparty/datastore2/datastore_closer.go': 1, 'thirdparty/datastore2/delayed.go': 1, 'thirdparty/datastore2/threadsafe.go': 1, 'unixfs/io/pbdagreader.go': 3, 'blocks/blockstoreutil/remove.go': 9, 'blockservice/test/mock.go': 2, 'cmd/ipfs/util/ulimit.go': 3, 'cmd/ipfs/util/ulimit_freebsd.go': 2, 'cmd/ipfs/util/ulimit_unix.go': 2, 'cmd/seccat/util.go': 3, 'core/commands/files.go': 11, 'core/coreapi/block.go': 9, 'core/coreapi/block_test.go': 2, 'core/coreapi/interface/coreapi.go': 9, 'core/coreapi/interface/dag.go': 9, 'core/coreapi/interface/object.go': 9, 'core/coreapi/interface/options/block.go': 3, 'core/coreapi/interface/path.go': 9, 'core/coreapi/interface/unixfs.go': 9, 'core/coreapi/object.go': 11, 'core/coreapi/pin.go': 11, 'core/corehttp/logs.go': 3, 'fuse/ipns/link_unix.go': 2, 'fuse/mount/fuse.go': 2, 'fuse/mount/mount.go': 3, 'fuse/node/mount_darwin.go': 2, 'fuse/node/mount_unix.go': 3, 'keystore/keystore.go': 3, 'merkledag/errservice.go': 2, 'merkledag/readonly.go': 2, 'merkledag/readonly_test.go': 2, 'merkledag/rwservice.go': 2, 'merkledag/session.go': 2, 'namesys/ipns_validate_test.go': 1, 'namesys/validator.go': 1, 'path/resolver/resolver.go': 2, 'path/resolver/resolver_test.go': 2, 'plugin/loader/load.go': 2, 'thirdparty/verifbs/verifbs.go': 9, 'thirdparty/verifcid/validate.go': 2, 'thirdparty/verifcid/validate_test.go': 2, 'unixfs/hamt/hamt_stress_test.go': 2, 'unixfs/hamt/hamt_test.go': 2, 'core/commands/urlstore.go': 10, 'namesys/ipns_resolver_validation_test.go': 10, 'unixfs/io/directory.go': 1, 'core/coreapi/name_test.go': 6, 'core/coreapi/path.go': 10, 'core/coreunix/cat.go': 4, 'core/pathresolver_test.go': 9, 'dagutils/diff.go': 9, 'dagutils/diffenum.go': 9, 'dagutils/diffenum_test.go': 9, 'dagutils/utils.go': 9, 'dagutils/utils_test.go': 9, 'fuse/ipns/common.go': 9, 'mfs/fd.go': 2, 'namesys/base.go': 9, 'namesys/cache.go': 9, 'namesys/dns.go': 9, 'namesys/interface.go': 9, 'namesys/proquint.go': 9, 'thirdparty/cidv0v1/blockstore.go': 7, 'core/commands/env.go': 1, 'core/core_test.go': 3, 'core/coreapi/interface/key.go': 2, 'repo/fsrepo/config_test.go': 4, 'repo/fsrepo/misc.go': 3, 'test/bench/bench_cli_ipfs_add/main.go': 3, 'test/bench/offline_add/main.go': 3, 'core/commands/name/ipns.go': 6, 'core/commands/name/publish.go': 4, 'core/coreapi/dht.go': 6, 'core/coreapi/dht_test.go': 2, 'test/sharness/t0275-cid-security.sh': 1, 'core/coreapi/interface/options/unixfs.go': 3, 'core/coreapi/unixfile.go': 3, 'cmd/ipfs/dnsresolve_test.go': 2, 'core/commands/cid.go': 3, 'core/commands/cmdenv/env.go': 3, 'core/commands/name/ipnsps.go': 2, 'core/commands/name/name.go': 2, 'core/coreapi/interface/dht.go': 1, 'core/coreapi/interface/pubsub.go': 1, 'core/coreapi/interface/swarm.go': 1, 'core/coreapi/pubsub.go': 3, 'core/coreapi/swarm.go': 3, 'keystore/keystore_test.go': 2, 'keystore/memkeystore.go': 2, 'p2p/listener.go': 2, 'p2p/local.go': 2, 'p2p/remote.go': 2, 'p2p/stream.go': 2, 'test/dependencies/iptb/iptb.go': 3, 'core/coreapi/interface/tests/name.go': 1, 'core/coreapi/interface/tests/unixfs.go': 1, 'plugin/loader/loader.go': 5, 'commands/context.go': 3, 'core/commands/cmdenv/cidbase.go': 2, 'core/commands/cmdenv/cidbase_test.go': 2, 'core/coreapi/test/api_test.go': 2, 'core/corehttp/ipns_hostname.go': 2, 'core/corehttp/proxy.go': 2, 'namesys/dns_test.go': 2, 'plugin/daemon.go': 2, 'core/commands/cmdenv/file.go': 1, 'core/corehttp/metrics.go': 1, 'core/corehttp/proxy_test.go': 1, 'core/corerepo/stat.go': 1, 'filestore/pb/dataobj.pb.go': 1, 'pin/internal/pb/header.pb.go': 1, 'plugin/plugins/badgerds/badgerds.go': 2, 'plugin/plugins/flatfs/flatfs.go': 2, 'plugin/plugins/levelds/levelds.go': 2, 'plugin/tracer.go': 1, 'thirdparty/notifier/notifier.go': 1, 'docs/plugins.md': 1, 'go.mod': 2, 'go.sum': 2, 'plugin/plugin.go': 1, 'test/sharness/t0020-init.sh': 1, 'test/sharness/t0280-plugin-data/example.go': 1, 'test/sharness/t0280-plugin.sh': 1, 'CHANGELOG.md': 1, 'core/commands/dag/get.go': 1, 'core/commands/dag/put.go': 1, 'core/node/core.go': 1, 'core/node/groups.go': 1, 'core/node/provider.go': 1, 'test/sharness/t0053-dag.sh': 1, 'test/sharness/t0055-dag-put-json-new-line.sh': 1, 'test/sharness/t0280-plugin-git.sh': 1}","('core/core.go', 0.8235294117647058, 0.0782122905027933)"
repo/mock.go,36,256,11,"[{'cyclomatic_complexity': 1, 'nloc': 3, 'token_count': 26, 'name': 'Config', 'long_name': '(m*Mock)Config', 'start_line': 22, 'end_line': 24, 'full_parameters': [], 'filename': '/home/dimi/Documents/Informatik_Studium/FSS/SoftEvo/DataCollection/FFS_SoftEvo/go-ipfs/repo/mock.go', 'top_nesting_level': 0, 'length': 3, 'fan_in': 0, 'fan_out': 0, 'general_fan_out': 0}, {'cyclomatic_complexity': 1, 'nloc': 4, 'token_count': 25, 'name': 'SetConfig', 'long_name': '(m*Mock)SetConfig updated * config . Config', 'start_line': 26, 'end_line': 29, 'full_parameters': ['updated * config . Config'], 'filename': '/home/dimi/Documents/Informatik_Studium/FSS/SoftEvo/DataCollection/FFS_SoftEvo/go-ipfs/repo/mock.go', 'top_nesting_level': 0, 'length': 4, 'fan_in': 0, 'fan_out': 0, 'general_fan_out': 0}, {'cyclomatic_complexity': 1, 'nloc': 3, 'token_count': 21, 'name': 'SetConfigKey', 'long_name': '(m*Mock)SetConfigKey key string , value interface { }', 'start_line': 31, 'end_line': 33, 'full_parameters': ['key string', ' value interface { }'], 'filename': '/home/dimi/Documents/Informatik_Studium/FSS/SoftEvo/DataCollection/FFS_SoftEvo/go-ipfs/repo/mock.go', 'top_nesting_level': 0, 'length': 3, 'fan_in': 0, 'fan_out': 0, 'general_fan_out': 0}, {'cyclomatic_complexity': 1, 'nloc': 1, 'token_count': 15, 'name': 'GetConfigKey', 'long_name': '(m*Mock)GetConfigKey key string', 'start_line': 35, 'end_line': 35, 'full_parameters': ['key string'], 'filename': '/home/dimi/Documents/Informatik_Studium/FSS/SoftEvo/DataCollection/FFS_SoftEvo/go-ipfs/repo/mock.go', 'top_nesting_level': 0, 'length': 1, 'fan_in': 0, 'fan_out': 0, 'general_fan_out': 0}, {'cyclomatic_complexity': 1, 'nloc': 1, 'token_count': 16, 'name': 'Datastore', 'long_name': '(m*Mock)Datastore', 'start_line': 39, 'end_line': 39, 'full_parameters': [], 'filename': '/home/dimi/Documents/Informatik_Studium/FSS/SoftEvo/DataCollection/FFS_SoftEvo/go-ipfs/repo/mock.go', 'top_nesting_level': 0, 'length': 1, 'fan_in': 0, 'fan_out': 0, 'general_fan_out': 0}, {'cyclomatic_complexity': 1, 'nloc': 1, 'token_count': 20, 'name': 'GetStorageUsage', 'long_name': '(m*Mock)GetStorageUsage', 'start_line': 41, 'end_line': 41, 'full_parameters': [], 'filename': '/home/dimi/Documents/Informatik_Studium/FSS/SoftEvo/DataCollection/FFS_SoftEvo/go-ipfs/repo/mock.go', 'top_nesting_level': 0, 'length': 1, 'fan_in': 0, 'fan_out': 0, 'general_fan_out': 0}, {'cyclomatic_complexity': 1, 'nloc': 1, 'token_count': 14, 'name': 'Close', 'long_name': '(m*Mock)Close', 'start_line': 43, 'end_line': 43, 'full_parameters': [], 'filename': '/home/dimi/Documents/Informatik_Studium/FSS/SoftEvo/DataCollection/FFS_SoftEvo/go-ipfs/repo/mock.go', 'top_nesting_level': 0, 'length': 1, 'fan_in': 0, 'fan_out': 0, 'general_fan_out': 0}, {'cyclomatic_complexity': 1, 'nloc': 1, 'token_count': 18, 'name': 'SetAPIAddr', 'long_name': '(m*Mock)SetAPIAddr addr ma . Multiaddr', 'start_line': 45, 'end_line': 45, 'full_parameters': ['addr ma . Multiaddr'], 'filename': '/home/dimi/Documents/Informatik_Studium/FSS/SoftEvo/DataCollection/FFS_SoftEvo/go-ipfs/repo/mock.go', 'top_nesting_level': 0, 'length': 1, 'fan_in': 0, 'fan_out': 0, 'general_fan_out': 0}, {'cyclomatic_complexity': 1, 'nloc': 1, 'token_count': 16, 'name': 'Keystore', 'long_name': '(m*Mock)Keystore', 'start_line': 47, 'end_line': 47, 'full_parameters': [], 'filename': '/home/dimi/Documents/Informatik_Studium/FSS/SoftEvo/DataCollection/FFS_SoftEvo/go-ipfs/repo/mock.go', 'top_nesting_level': 0, 'length': 1, 'fan_in': 0, 'fan_out': 0, 'general_fan_out': 0}, {'cyclomatic_complexity': 1, 'nloc': 3, 'token_count': 22, 'name': 'SwarmKey', 'long_name': '(m*Mock)SwarmKey', 'start_line': 49, 'end_line': 51, 'full_parameters': [], 'filename': '/home/dimi/Documents/Informatik_Studium/FSS/SoftEvo/DataCollection/FFS_SoftEvo/go-ipfs/repo/mock.go', 'top_nesting_level': 0, 'length': 3, 'fan_in': 0, 'fan_out': 0, 'general_fan_out': 0}, {'cyclomatic_complexity': 1, 'nloc': 1, 'token_count': 17, 'name': 'FileManager', 'long_name': '(m*Mock)FileManager', 'start_line': 53, 'end_line': 53, 'full_parameters': [], 'filename': '/home/dimi/Documents/Informatik_Studium/FSS/SoftEvo/DataCollection/FFS_SoftEvo/go-ipfs/repo/mock.go', 'top_nesting_level': 0, 'length': 1, 'fan_in': 0, 'fan_out': 0, 'general_fan_out': 0}]",40,294,12,"[{'cyclomatic_complexity': 1, 'nloc': 3, 'token_count': 26, 'name': 'Config', 'long_name': '(m*Mock)Config', 'start_line': 23, 'end_line': 25, 'full_parameters': [], 'filename': '/home/dimi/Documents/Informatik_Studium/FSS/SoftEvo/DataCollection/FFS_SoftEvo/go-ipfs/repo/mock.go', 'top_nesting_level': 0, 'length': 3, 'fan_in': 0, 'fan_out': 0, 'general_fan_out': 0}, {'cyclomatic_complexity': 1, 'nloc': 4, 'token_count': 25, 'name': 'SetConfig', 'long_name': '(m*Mock)SetConfig updated * config . Config', 'start_line': 27, 'end_line': 30, 'full_parameters': ['updated * config . Config'], 'filename': '/home/dimi/Documents/Informatik_Studium/FSS/SoftEvo/DataCollection/FFS_SoftEvo/go-ipfs/repo/mock.go', 'top_nesting_level': 0, 'length': 4, 'fan_in': 0, 'fan_out': 0, 'general_fan_out': 0}, {'cyclomatic_complexity': 1, 'nloc': 3, 'token_count': 22, 'name': 'BackupConfig', 'long_name': '(m*Mock)BackupConfig prefix string', 'start_line': 32, 'end_line': 34, 'full_parameters': ['prefix string'], 'filename': '/home/dimi/Documents/Informatik_Studium/FSS/SoftEvo/DataCollection/FFS_SoftEvo/go-ipfs/repo/mock.go', 'top_nesting_level': 0, 'length': 3, 'fan_in': 0, 'fan_out': 0, 'general_fan_out': 0}, {'cyclomatic_complexity': 1, 'nloc': 3, 'token_count': 21, 'name': 'SetConfigKey', 'long_name': '(m*Mock)SetConfigKey key string , value interface { }', 'start_line': 36, 'end_line': 38, 'full_parameters': ['key string', ' value interface { }'], 'filename': '/home/dimi/Documents/Informatik_Studium/FSS/SoftEvo/DataCollection/FFS_SoftEvo/go-ipfs/repo/mock.go', 'top_nesting_level': 0, 'length': 3, 'fan_in': 0, 'fan_out': 0, 'general_fan_out': 0}, {'cyclomatic_complexity': 1, 'nloc': 1, 'token_count': 15, 'name': 'GetConfigKey', 'long_name': '(m*Mock)GetConfigKey key string', 'start_line': 40, 'end_line': 40, 'full_parameters': ['key string'], 'filename': '/home/dimi/Documents/Informatik_Studium/FSS/SoftEvo/DataCollection/FFS_SoftEvo/go-ipfs/repo/mock.go', 'top_nesting_level': 0, 'length': 1, 'fan_in': 0, 'fan_out': 0, 'general_fan_out': 0}, {'cyclomatic_complexity': 1, 'nloc': 1, 'token_count': 16, 'name': 'Datastore', 'long_name': '(m*Mock)Datastore', 'start_line': 44, 'end_line': 44, 'full_parameters': [], 'filename': '/home/dimi/Documents/Informatik_Studium/FSS/SoftEvo/DataCollection/FFS_SoftEvo/go-ipfs/repo/mock.go', 'top_nesting_level': 0, 'length': 1, 'fan_in': 0, 'fan_out': 0, 'general_fan_out': 0}, {'cyclomatic_complexity': 1, 'nloc': 1, 'token_count': 20, 'name': 'GetStorageUsage', 'long_name': '(m*Mock)GetStorageUsage', 'start_line': 46, 'end_line': 46, 'full_parameters': [], 'filename': '/home/dimi/Documents/Informatik_Studium/FSS/SoftEvo/DataCollection/FFS_SoftEvo/go-ipfs/repo/mock.go', 'top_nesting_level': 0, 'length': 1, 'fan_in': 0, 'fan_out': 0, 'general_fan_out': 0}, {'cyclomatic_complexity': 1, 'nloc': 1, 'token_count': 20, 'name': 'Close', 'long_name': '(m*Mock)Close', 'start_line': 48, 'end_line': 48, 'full_parameters': [], 'filename': '/home/dimi/Documents/Informatik_Studium/FSS/SoftEvo/DataCollection/FFS_SoftEvo/go-ipfs/repo/mock.go', 'top_nesting_level': 0, 'length': 1, 'fan_in': 0, 'fan_out': 0, 'general_fan_out': 0}, {'cyclomatic_complexity': 1, 'nloc': 1, 'token_count': 18, 'name': 'SetAPIAddr', 'long_name': '(m*Mock)SetAPIAddr addr ma . Multiaddr', 'start_line': 50, 'end_line': 50, 'full_parameters': ['addr ma . Multiaddr'], 'filename': '/home/dimi/Documents/Informatik_Studium/FSS/SoftEvo/DataCollection/FFS_SoftEvo/go-ipfs/repo/mock.go', 'top_nesting_level': 0, 'length': 1, 'fan_in': 0, 'fan_out': 0, 'general_fan_out': 0}, {'cyclomatic_complexity': 1, 'nloc': 1, 'token_count': 18, 'name': 'Keystore', 'long_name': '(m*Mock)Keystore', 'start_line': 52, 'end_line': 52, 'full_parameters': [], 'filename': '/home/dimi/Documents/Informatik_Studium/FSS/SoftEvo/DataCollection/FFS_SoftEvo/go-ipfs/repo/mock.go', 'top_nesting_level': 0, 'length': 1, 'fan_in': 0, 'fan_out': 0, 'general_fan_out': 0}, {'cyclomatic_complexity': 1, 'nloc': 3, 'token_count': 22, 'name': 'SwarmKey', 'long_name': '(m*Mock)SwarmKey', 'start_line': 54, 'end_line': 56, 'full_parameters': [], 'filename': '/home/dimi/Documents/Informatik_Studium/FSS/SoftEvo/DataCollection/FFS_SoftEvo/go-ipfs/repo/mock.go', 'top_nesting_level': 0, 'length': 3, 'fan_in': 0, 'fan_out': 0, 'general_fan_out': 0}, {'cyclomatic_complexity': 1, 'nloc': 1, 'token_count': 19, 'name': 'FileManager', 'long_name': '(m*Mock)FileManager', 'start_line': 58, 'end_line': 58, 'full_parameters': [], 'filename': '/home/dimi/Documents/Informatik_Studium/FSS/SoftEvo/DataCollection/FFS_SoftEvo/go-ipfs/repo/mock.go', 'top_nesting_level': 0, 'length': 1, 'fan_in': 0, 'fan_out': 0, 'general_fan_out': 0}]",4,38,1,34,34,"[{'timestamp': 1512365669.0, 'added_lines': 1, 'deleted_lines': 1, 'nloc': 36}, {'timestamp': 1513367731.0, 'added_lines': 4, 'deleted_lines': 0, 'nloc': 39}, {'timestamp': 1514829547.0, 'added_lines': 1, 'deleted_lines': 1, 'nloc': 36}, {'timestamp': 1516838128.0, 'added_lines': 1, 'deleted_lines': 1, 'nloc': 39}, {'timestamp': 1528520460.0, 'added_lines': 1, 'deleted_lines': 1, 'nloc': 39}, {'timestamp': 1529984485.0, 'added_lines': 1, 'deleted_lines': 1, 'nloc': 39}, {'timestamp': 1532357069.0, 'added_lines': 1, 'deleted_lines': 1, 'nloc': 39}, {'timestamp': 1532365899.0, 'added_lines': 1, 'deleted_lines': 1, 'nloc': 39}, {'timestamp': 1532388583.0, 'added_lines': 1, 'deleted_lines': 1, 'nloc': 39}, {'timestamp': 1533809170.0, 'added_lines': 1, 'deleted_lines': 1, 'nloc': 39}, {'timestamp': 1534072974.0, 'added_lines': 1, 'deleted_lines': 1, 'nloc': 39}, {'timestamp': 1534896611.0, 'added_lines': 1, 'deleted_lines': 1, 'nloc': 39}, {'timestamp': 1535255498.0, 'added_lines': 1, 'deleted_lines': 1, 'nloc': 39}, {'timestamp': 1535601896.0, 'added_lines': 1, 'deleted_lines': 1, 'nloc': 39}, {'timestamp': 1536388808.0, 'added_lines': 1, 'deleted_lines': 1, 'nloc': 39}, {'timestamp': 1537792589.0, 'added_lines': 1, 'deleted_lines': 1, 'nloc': 39}, {'timestamp': 1538544957.0, 'added_lines': 1, 'deleted_lines': 1, 'nloc': 39}, {'timestamp': 1538547366.0, 'added_lines': 1, 'deleted_lines': 1, 'nloc': 39}, {'timestamp': 1540400358.0, 'added_lines': 2, 'deleted_lines': 2, 'nloc': 39}, {'timestamp': 1540489644.0, 'added_lines': 1, 'deleted_lines': 1, 'nloc': 39}, {'timestamp': 1541204121.0, 'added_lines': 2, 'deleted_lines': 2, 'nloc': 39}, {'timestamp': 1543282933.0, 'added_lines': 1, 'deleted_lines': 1, 'nloc': 39}, {'timestamp': 1544225843.0, 'added_lines': 1, 'deleted_lines': 1, 'nloc': 39}, {'timestamp': 1545323704.0, 'added_lines': 1, 'deleted_lines': 1, 'nloc': 39}, {'timestamp': 1546553605.0, 'added_lines': 1, 'deleted_lines': 1, 'nloc': 39}, {'timestamp': 1547003974.0, 'added_lines': 2, 'deleted_lines': 2, 'nloc': 39}, {'timestamp': 1547496099.0, 'added_lines': 2, 'deleted_lines': 1, 'nloc': 40}, {'timestamp': 1549588289.0, 'added_lines': 1, 'deleted_lines': 1, 'nloc': 40}, {'timestamp': 1550507829.0, 'added_lines': 1, 'deleted_lines': 1, 'nloc': 40}, {'timestamp': 1551229859.0, 'added_lines': 2, 'deleted_lines': 2, 'nloc': 40}, {'timestamp': 1551551196.0, 'added_lines': 2, 'deleted_lines': 2, 'nloc': 40}, {'timestamp': 1563198626.0, 'added_lines': 1, 'deleted_lines': 1, 'nloc': 40}, {'timestamp': 1565993187.0, 'added_lines': 1, 'deleted_lines': 1, 'nloc': 40}, {'timestamp': 1613691223.0, 'added_lines': 1, 'deleted_lines': 1, 'nloc': 40}]","{'assets/assets.go': 15, 'blocks/blockstore/arc_cache.go': 2, 'blocks/blockstore/arc_cache_test.go': 2, 'blocks/blockstore/blockstore.go': 2, 'blocks/blockstore/blockstore_test.go': 2, 'blocks/blockstore/bloom_cache.go': 2, 'blocks/blockstore/bloom_cache_test.go': 2, 'blocks/blockstore/util/remove.go': 2, 'blocks/blocksutil/block_generator.go': 2, 'blockservice/blockservice.go': 4, 'blockservice/blockservice_test.go': 4, 'blockservice/test/blocks_test.go': 4, 'cmd/ipfs/daemon.go': 12, 'cmd/ipfs/init.go': 28, 'cmd/ipfs/ipfs.go': 9, 'cmd/ipfs/main.go': 28, 'cmd/ipfs/main_test.go': 1, 'cmd/ipfswatch/main.go': 26, 'cmd/seccat/seccat.go': 17, 'commands/command.go': 7, 'commands/command_test.go': 2, 'commands/request.go': 20, 'commands/response.go': 4, 'commands/response_test.go': 2, 'core/bootstrap.go': 28, 'core/bootstrap_test.go': 27, 'core/builder.go': 28, 'core/commands/active.go': 5, 'core/commands/add.go': 13, 'core/commands/bitswap.go': 17, 'core/commands/block.go': 10, 'core/commands/bootstrap.go': 26, 'core/commands/cat.go': 10, 'core/commands/commands.go': 9, 'core/commands/config.go': 27, 'core/commands/dag/dag.go': 16, 'core/commands/dht.go': 17, 'core/commands/dht_test.go': 17, 'core/commands/diag.go': 5, 'core/commands/dns.go': 8, 'core/commands/external.go': 5, 'core/commands/files/files.go': 2, 'core/commands/filestore.go': 10, 'core/commands/get.go': 16, 'core/commands/get_test.go': 9, 'core/commands/helptext_test.go': 9, 'core/commands/id.go': 17, 'core/commands/ipns.go': 4, 'core/commands/ipnsps.go': 4, 'core/commands/keystore.go': 10, 'core/commands/log.go': 8, 'core/commands/ls.go': 16, 'core/commands/mount_nofuse.go': 5, 'core/commands/mount_unix.go': 26, 'core/commands/mount_windows.go': 5, 'core/commands/name.go': 3, 'core/commands/object/diff.go': 7, 'core/commands/object/object.go': 17, 'core/commands/object/patch.go': 9, 'core/commands/p2p.go': 15, 'core/commands/pin.go': 17, 'core/commands/ping.go': 16, 'core/commands/publish.go': 5, 'core/commands/pubsub.go': 13, 'core/commands/refs.go': 16, 'core/commands/repo.go': 28, 'core/commands/resolve.go': 16, 'core/commands/root.go': 9, 'core/commands/shutdown.go': 7, 'core/commands/stat.go': 13, 'core/commands/swarm.go': 28, 'core/commands/sysdiag.go': 13, 'core/commands/tar.go': 15, 'core/commands/unixfs/ls.go': 15, 'core/commands/unixfs/unixfs.go': 5, 'core/commands/version.go': 8, 'core/core.go': 30, 'core/coreapi/coreapi.go': 12, 'core/coreapi/interface/interface.go': 3, 'core/coreapi/unixfs.go': 16, 'core/coreapi/unixfs_test.go': 22, 'core/coredag/cbor.go': 7, 'core/coredag/dagpb.go': 16, 'core/coredag/dagtransl.go': 6, 'core/coredag/raw.go': 16, 'core/corehttp/commands.go': 28, 'core/corehttp/corehttp.go': 11, 'core/corehttp/gateway.go': 19, 'core/corehttp/gateway_handler.go': 17, 'core/corehttp/gateway_test.go': 28, 'core/corehttp/metrics_test.go': 17, 'core/corerepo/gc.go': 17, 'core/corerepo/pinning.go': 8, 'core/coreunix/add.go': 17, 'core/coreunix/add_test.go': 27, 'core/coreunix/metadata.go': 16, 'core/coreunix/metadata_test.go': 17, 'core/mock/mock.go': 27, 'core/pathresolver.go': 17, 'exchange/bitswap/bitswap.go': 4, 'exchange/bitswap/bitswap_test.go': 4, 'exchange/bitswap/decision/bench_test.go': 4, 'exchange/bitswap/decision/engine.go': 4, 'exchange/bitswap/decision/engine_test.go': 4, 'exchange/bitswap/decision/ledger.go': 4, 'exchange/bitswap/decision/peer_request_queue.go': 4, 'exchange/bitswap/decision/peer_request_queue_test.go': 4, 'exchange/bitswap/get.go': 4, 'exchange/bitswap/message/message.go': 4, 'exchange/bitswap/message/message_test.go': 3, 'exchange/bitswap/network/interface.go': 4, 'exchange/bitswap/network/ipfs_impl.go': 4, 'exchange/bitswap/notifications/notifications.go': 3, 'exchange/bitswap/notifications/notifications_test.go': 3, 'exchange/bitswap/session.go': 4, 'exchange/bitswap/session_test.go': 4, 'exchange/bitswap/stat.go': 3, 'exchange/bitswap/testnet/interface.go': 4, 'exchange/bitswap/testnet/network_test.go': 4, 'exchange/bitswap/testnet/peernet.go': 4, 'exchange/bitswap/testnet/virtual.go': 4, 'exchange/bitswap/testutils.go': 4, 'exchange/bitswap/wantlist/wantlist.go': 3, 'exchange/bitswap/wantlist/wantlist_test.go': 3, 'exchange/bitswap/wantmanager.go': 4, 'exchange/bitswap/workers.go': 4, 'exchange/interface.go': 2, 'exchange/offline/offline.go': 2, 'exchange/offline/offline_test.go': 2, 'exchange/reprovide/providers.go': 17, 'exchange/reprovide/reprovide.go': 16, 'exchange/reprovide/reprovide_test.go': 17, 'filestore/filestore.go': 11, 'filestore/filestore_test.go': 17, 'filestore/fsrefstore.go': 11, 'filestore/util.go': 11, 'fuse/ipns/ipns_test.go': 17, 'fuse/ipns/ipns_unix.go': 17, 'fuse/node/mount_test.go': 17, 'fuse/readonly/ipfs_test.go': 17, 'fuse/readonly/readonly_unix.go': 17, 'importer/balanced/balanced_test.go': 4, 'importer/balanced/builder.go': 3, 'importer/chunk/rabin_test.go': 2, 'importer/chunk/splitting_test.go': 2, 'importer/helpers/dagbuilder.go': 4, 'importer/helpers/helpers.go': 3, 'importer/importer.go': 4, 'importer/importer_test.go': 4, 'importer/trickle/trickle_test.go': 4, 'importer/trickle/trickledag.go': 3, 'merkledag/batch.go': 2, 'merkledag/coding.go': 3, 'merkledag/merkledag.go': 3, 'merkledag/merkledag_test.go': 4, 'merkledag/node.go': 3, 'merkledag/node_test.go': 3, 'merkledag/raw.go': 3, 'merkledag/traverse/traverse.go': 3, 'merkledag/traverse/traverse_test.go': 3, 'merkledag/utils/diff.go': 3, 'merkledag/utils/diffenum.go': 3, 'merkledag/utils/diffenum_test.go': 3, 'merkledag/utils/utils.go': 4, 'merkledag/utils/utils_test.go': 3, 'mfs/dir.go': 3, 'mfs/file.go': 4, 'mfs/mfs_test.go': 4, 'mfs/ops.go': 3, 'mfs/repub_test.go': 4, 'mfs/system.go': 4, 'namesys/ipns_select_test.go': 3, 'namesys/namesys.go': 17, 'namesys/publisher.go': 17, 'namesys/publisher_test.go': 17, 'namesys/pubsub.go': 2, 'namesys/pubsub_test.go': 2, 'namesys/republisher/repub.go': 17, 'namesys/republisher/repub_test.go': 17, 'namesys/resolve_test.go': 17, 'namesys/routing.go': 17, 'p2p/p2p.go': 17, 'p2p/registry.go': 7, 'package.json': 27, 'path/path.go': 3, 'path/resolver.go': 2, 'path/resolver_test.go': 2, 'pin/gc/gc.go': 17, 'pin/pin.go': 17, 'pin/pin_test.go': 17, 'pin/set.go': 16, 'pin/set_test.go': 17, 'plugin/ipld.go': 6, 'plugin/loader/initializer.go': 5, 'plugin/plugins/git/git.go': 6, 'repo/config/bootstrap_peers.go': 4, 'repo/config/init.go': 4, 'repo/fsrepo/fsrepo.go': 31, 'repo/fsrepo/lock/lock.go': 2, 'repo/fsrepo/serialize/serialize.go': 3, 'repo/repo.go': 31, 'routing/mock/centralized_client.go': 2, 'routing/mock/centralized_server.go': 2, 'routing/mock/centralized_test.go': 2, 'routing/mock/interface.go': 2, 'routing/none/none_client.go': 2, 'routing/offline/offline.go': 2, 'routing/offline/offline_test.go': 2, 'tar/format.go': 17, 'test/dependencies/ma-pipe-unidir/main.go': 9, 'test/integration/addcat_test.go': 17, 'test/integration/bench_cat_test.go': 17, 'test/integration/bench_test.go': 14, 'test/integration/bitswap_wo_routing_test.go': 17, 'test/integration/three_legged_cat_test.go': 17, 'thirdparty/ds-help/key.go': 2, 'thirdparty/pollEndpoint/main.go': 11, 'thirdparty/posinfo/posinfo.go': 2, 'unixfs/archive/archive.go': 3, 'unixfs/archive/tar/writer.go': 3, 'unixfs/hamt/hamt.go': 3, 'unixfs/io/dagreader.go': 3, 'unixfs/io/dirbuilder.go': 3, 'unixfs/io/resolve.go': 3, 'unixfs/mod/dagmodifier.go': 4, 'unixfs/mod/dagmodifier_test.go': 3, 'unixfs/test/utils.go': 4, 'test/sharness/t0021-config.sh': 1, 'core/coreapi/interface/options/key.go': 1, 'core/coreapi/key.go': 17, 'core/coreapi/key_test.go': 1, 'commands/legacy/command.go': 6, 'commands/legacy/legacy.go': 6, 'commands/legacy/legacy_test.go': 6, 'commands/legacy/request.go': 6, 'commands/legacy/response.go': 6, 'core/commands/commands_test.go': 8, 'core/coreapi/dag.go': 5, 'core/coreapi/dag_test.go': 3, 'core/coreapi/interface/options/dag.go': 4, 'core/coreapi/name.go': 17, 'merkledag/test/utils.go': 3, 'namesys/namesys_test.go': 16, 'repo/fsrepo/datastores.go': 9, 'repo/fsrepo/fsrepo_test.go': 24, 'thirdparty/datastore2/datastore_closer.go': 1, 'thirdparty/datastore2/delayed.go': 1, 'thirdparty/datastore2/threadsafe.go': 1, 'unixfs/io/pbdagreader.go': 2, 'blocks/blockstoreutil/remove.go': 9, 'blockservice/test/mock.go': 2, 'cmd/ipfs/util/ulimit.go': 6, 'cmd/ipfs/util/ulimit_freebsd.go': 2, 'cmd/ipfs/util/ulimit_unix.go': 2, 'cmd/seccat/util.go': 6, 'core/commands/files.go': 15, 'core/coreapi/block.go': 6, 'core/coreapi/block_test.go': 2, 'core/coreapi/interface/coreapi.go': 3, 'core/coreapi/interface/dag.go': 3, 'core/coreapi/interface/object.go': 3, 'core/coreapi/interface/options/block.go': 2, 'core/coreapi/interface/path.go': 11, 'core/coreapi/interface/unixfs.go': 4, 'core/coreapi/object.go': 14, 'core/coreapi/pin.go': 15, 'core/corehttp/logs.go': 6, 'fuse/ipns/link_unix.go': 2, 'fuse/mount/fuse.go': 2, 'fuse/mount/mount.go': 6, 'fuse/node/mount_darwin.go': 2, 'fuse/node/mount_unix.go': 6, 'keystore/keystore.go': 6, 'merkledag/errservice.go': 1, 'merkledag/readonly.go': 1, 'merkledag/readonly_test.go': 1, 'merkledag/rwservice.go': 1, 'merkledag/session.go': 1, 'namesys/ipns_validate_test.go': 1, 'namesys/validator.go': 1, 'path/resolver/resolver.go': 2, 'path/resolver/resolver_test.go': 1, 'plugin/loader/load.go': 4, 'thirdparty/verifbs/verifbs.go': 9, 'thirdparty/verifcid/validate.go': 1, 'thirdparty/verifcid/validate_test.go': 1, 'unixfs/hamt/hamt_stress_test.go': 1, 'unixfs/hamt/hamt_test.go': 1, 'namesys/ipns_resolver_validation_test.go': 14, 'test/sharness/t0170-dht.sh': 1, 'core/commands/env.go': 6, 'repo/fsrepo/misc.go': 24, 'cmd/ipfs/Rules.mk': 1, 'core/core_test.go': 23, 'core/corehttp/option_test.go': 1, 'docs/releases.md': 1, 'docs/windows.md': 1, 'repo/fsrepo/config_test.go': 23, 'repo/version.go': 1, 'test/bench/bench_cli_ipfs_add/main.go': 23, 'test/bench/offline_add/main.go': 23, 'core/commands/urlstore.go': 14, 'core/coreapi/interface/key.go': 6, 'core/coreapi/name_test.go': 8, 'core/coreapi/path.go': 14, 'core/coreunix/cat.go': 4, 'core/pathresolver_test.go': 13, 'dagutils/diff.go': 13, 'dagutils/diffenum.go': 13, 'dagutils/diffenum_test.go': 13, 'dagutils/utils.go': 13, 'dagutils/utils_test.go': 13, 'fuse/ipns/common.go': 14, 'namesys/base.go': 13, 'namesys/cache.go': 13, 'namesys/dns.go': 13, 'namesys/interface.go': 13, 'namesys/proquint.go': 13, 'thirdparty/cidv0v1/blockstore.go': 7, 'core/commands/cmdenv/env.go': 18, 'core/commands/name/ipns.go': 13, 'core/commands/name/publish.go': 8, 'core/commands/name/ipnsps.go': 8, 'core/commands/name/name.go': 4, 'core/coreapi/dht.go': 10, 'core/coreapi/dht_test.go': 4, 'core/coreapi/interface/dht.go': 7, 'p2p/listener.go': 10, 'p2p/local.go': 10, 'p2p/remote.go': 10, 'p2p/stream.go': 10, 'core/coreapi/interface/swarm.go': 6, 'core/coreapi/swarm.go': 9, 'cmd/ipfs/dnsresolve_test.go': 5, 'core/coreapi/interface/options/unixfs.go': 5, 'core/coreapi/interface/pubsub.go': 4, 'core/coreapi/pubsub.go': 9, 'core/coreapi/unixfile.go': 4, 'test/sharness/t0180-pubsub.sh': 1, 'core/commands/cid.go': 3, 'keystore/keystore_test.go': 3, 'keystore/memkeystore.go': 3, 'test/dependencies/iptb/iptb.go': 10, 'commands/context.go': 8, 'core/corehttp/proxy.go': 6, 'core/coreapi/test/api_test.go': 9, 'core/coreapi/interface/tests/name.go': 2, 'core/coreapi/interface/tests/unixfs.go': 3, 'core/commands/cmdenv/cidbase.go': 2, 'core/corehttp/ipns_hostname.go': 3, 'filestore/pb/dataobj.pb.go': 2, 'namesys/dns_test.go': 3, 'pin/internal/pb/header.pb.go': 2, 'plugin/daemon.go': 3, 'plugin/loader/loader.go': 3, 'plugin/plugins/badgerds/badgerds.go': 2, 'plugin/plugins/flatfs/flatfs.go': 2, 'plugin/plugins/levelds/levelds.go': 2, 'core/commands/cmdenv/cidbase_test.go': 1, 'core/commands/cmdenv/file.go': 1, 'core/corehttp/metrics.go': 1, 'core/corehttp/proxy_test.go': 1, 'core/corerepo/stat.go': 1, 'plugin/tracer.go': 1, 'thirdparty/notifier/notifier.go': 1, 'core/node/storage.go': 1, 'go.mod': 2, 'go.sum': 2, 'core/corehttp/hostname.go': 1, 'core/node/ipns.go': 1, None: 20}","('repo/fsrepo/fsrepo.go', 0.9117647058823529, 0.4492753623188406)"
repo/onlyone.go,47,249,2,"[{'cyclomatic_complexity': 4, 'nloc': 22, 'token_count': 134, 'name': 'Open', 'long_name': '(o*OnlyOne)Open key interface { } , open func Repo , error', 'start_line': 26, 'end_line': 48, 'full_parameters': ['key interface { }', ' open func Repo', ' error'], 'filename': '/home/dimi/Documents/Informatik_Studium/FSS/SoftEvo/DataCollection/FFS_SoftEvo/go-ipfs/repo/onlyone.go', 'top_nesting_level': 0, 'length': 23, 'fan_in': 0, 'fan_out': 0, 'general_fan_out': 0}, {'cyclomatic_complexity': 2, 'nloc': 10, 'token_count': 65, 'name': 'Close', 'long_name': '(r*ref)Close', 'start_line': 59, 'end_line': 72, 'full_parameters': [], 'filename': '/home/dimi/Documents/Informatik_Studium/FSS/SoftEvo/DataCollection/FFS_SoftEvo/go-ipfs/repo/onlyone.go', 'top_nesting_level': 0, 'length': 14, 'fan_in': 0, 'fan_out': 0, 'general_fan_out': 0}]",47,249,2,"[{'cyclomatic_complexity': 4, 'nloc': 22, 'token_count': 134, 'name': 'Open', 'long_name': '(o*OnlyOne)Open key interface { } , open func Repo , error', 'start_line': 26, 'end_line': 48, 'full_parameters': ['key interface { }', ' open func Repo', ' error'], 'filename': '/home/dimi/Documents/Informatik_Studium/FSS/SoftEvo/DataCollection/FFS_SoftEvo/go-ipfs/repo/onlyone.go', 'top_nesting_level': 0, 'length': 23, 'fan_in': 0, 'fan_out': 0, 'general_fan_out': 0}, {'cyclomatic_complexity': 2, 'nloc': 10, 'token_count': 65, 'name': 'Close', 'long_name': '(r*ref)Close', 'start_line': 59, 'end_line': 72, 'full_parameters': [], 'filename': '/home/dimi/Documents/Informatik_Studium/FSS/SoftEvo/DataCollection/FFS_SoftEvo/go-ipfs/repo/onlyone.go', 'top_nesting_level': 0, 'length': 14, 'fan_in': 0, 'fan_out': 0, 'general_fan_out': 0}]",0,0,0,1,1,"[{'timestamp': 1587221101.0, 'added_lines': 1, 'deleted_lines': 1, 'nloc': 47}]","{'CHANGELOG.md': 1, 'Dockerfile': 1, 'README.md': 1, 'bin/check_go_version': 1, 'blocks/blockstoreutil/remove.go': 1, 'cmd/ipfs/daemon.go': 1, 'cmd/ipfs/util/ulimit.go': 1, 'core/commands/cid.go': 1, 'core/commands/commands.go': 1, 'core/commands/dag/dag.go': 1, 'core/commands/files.go': 1, 'core/commands/get.go': 1, 'core/commands/pin.go': 1, 'core/corehttp/corehttp.go': 1, 'core/corehttp/gateway_handler.go': 1, 'core/coreunix/add_test.go': 1, 'coverage/Rules.mk': 1, 'docs/config.md': 1, 'docs/debug-guide.md': 1, 'docs/environment-variables.md': 1, 'fuse/ipns/ipns_test.go': 1, 'fuse/node/mount_darwin.go': 1, 'fuse/readonly/readonly_unix.go': 1, 'gc/gc.go': 1, 'keystore/keystore.go': 1, 'keystore/keystore_test.go': 1, 'keystore/memkeystore.go': 1, 'keystore/memkeystore_test.go': 1, 'misc/completion/ipfs-completion.bash': 1, 'namesys/namesys.go': 1, 'namesys/republisher/repub_test.go': 1, 'plugin/plugins/gen_main.sh': 1, 'repo/fsrepo/migrations/migrations.go': 1, 'test/3nodetest/run-test-on-img.sh': 1, 'test/ipfs-test-lib.sh': 1, 'test/sharness/README.md': 1, 'test/sharness/lib/iptb-lib.sh': 1, 'test/sharness/t0010-basic-commands.sh': 1, 'test/sharness/t0020-init.sh': 1, 'test/sharness/t0030-mount.sh': 1, 'test/sharness/t0031-mount-publish.sh': 1, 'test/sharness/t0040-add-and-cat.sh': 1, 'test/sharness/t0050-block.sh': 1, 'test/sharness/t0051-object.sh': 1, 'test/sharness/t0053-dag.sh': 1, 'test/sharness/t0060-daemon.sh': 1, 'test/sharness/t0062-daemon-api.sh': 1, 'test/sharness/t0080-repo.sh': 1, 'test/sharness/t0087-repo-robust-gc.sh': 1, 'test/sharness/t0090-get.sh': 1, 'test/sharness/t0110-gateway.sh': 1, 'test/sharness/t0114-gateway-subdomains.sh': 1, 'test/sharness/t0131-multinode-client-routing.sh': 1, 'test/sharness/t0140-swarm.sh': 1, 'test/sharness/t0183-namesys-pubsub.sh': 1, 'test/sharness/t0250-files-api.sh': 1, 'test/sharness/t0270-filestore.sh': 1, 'test/sharness/t0272-urlstore.sh': 1, 'test/sharness/t0410-api-add.sh': 1, 'test/sharness/t0600-issues-and-regressions-online.sh': 1, 'test/sharness_test_coverage_helper.sh': 1, 'thirdparty/README.md': 1, 'thirdparty/notifier/notifier.go': 1}","('fuse/ipns/ipns_test.go', 1.0, 0.019230769230769232)"
repo/repo.go,30,132,0,[],30,139,0,[],0,7,0,39,39,"[{'timestamp': 1511062375.0, 'added_lines': 1, 'deleted_lines': 1, 'nloc': 30}, {'timestamp': 1512365669.0, 'added_lines': 1, 'deleted_lines': 1, 'nloc': 30}, {'timestamp': 1513367731.0, 'added_lines': 1, 'deleted_lines': 0, 'nloc': 31}, {'timestamp': 1516563963.0, 'added_lines': 17, 'deleted_lines': 0, 'nloc': 31}, {'timestamp': 1516838128.0, 'added_lines': 2, 'deleted_lines': 2, 'nloc': 31}, {'timestamp': 1519761835.0, 'added_lines': 1, 'deleted_lines': 1, 'nloc': 31}, {'timestamp': 1525408792.0, 'added_lines': 1, 'deleted_lines': 1, 'nloc': 31}, {'timestamp': 1528520460.0, 'added_lines': 1, 'deleted_lines': 1, 'nloc': 31}, {'timestamp': 1529984485.0, 'added_lines': 1, 'deleted_lines': 1, 'nloc': 31}, {'timestamp': 1532357069.0, 'added_lines': 1, 'deleted_lines': 1, 'nloc': 31}, {'timestamp': 1532365899.0, 'added_lines': 1, 'deleted_lines': 1, 'nloc': 31}, {'timestamp': 1532388583.0, 'added_lines': 1, 'deleted_lines': 1, 'nloc': 31}, {'timestamp': 1533809170.0, 'added_lines': 1, 'deleted_lines': 1, 'nloc': 31}, {'timestamp': 1534195762.0, 'added_lines': 1, 'deleted_lines': 1, 'nloc': 31}, {'timestamp': 1534072974.0, 'added_lines': 1, 'deleted_lines': 1, 'nloc': 31}, {'timestamp': 1534896611.0, 'added_lines': 1, 'deleted_lines': 1, 'nloc': 31}, {'timestamp': 1535255498.0, 'added_lines': 1, 'deleted_lines': 1, 'nloc': 31}, {'timestamp': 1535601896.0, 'added_lines': 1, 'deleted_lines': 1, 'nloc': 31}, {'timestamp': 1536388808.0, 'added_lines': 2, 'deleted_lines': 2, 'nloc': 31}, {'timestamp': 1537792589.0, 'added_lines': 2, 'deleted_lines': 2, 'nloc': 31}, {'timestamp': 1538544957.0, 'added_lines': 2, 'deleted_lines': 2, 'nloc': 31}, {'timestamp': 1538547366.0, 'added_lines': 1, 'deleted_lines': 1, 'nloc': 31}, {'timestamp': 1538773916.0, 'added_lines': 1, 'deleted_lines': 1, 'nloc': 31}, {'timestamp': 1540400358.0, 'added_lines': 2, 'deleted_lines': 2, 'nloc': 31}, {'timestamp': 1540489644.0, 'added_lines': 1, 'deleted_lines': 1, 'nloc': 31}, {'timestamp': 1541204121.0, 'added_lines': 2, 'deleted_lines': 2, 'nloc': 31}, {'timestamp': 1541903826.0, 'added_lines': 1, 'deleted_lines': 1, 'nloc': 31}, {'timestamp': 1543282933.0, 'added_lines': 1, 'deleted_lines': 1, 'nloc': 31}, {'timestamp': 1544225843.0, 'added_lines': 1, 'deleted_lines': 1, 'nloc': 31}, {'timestamp': 1545323704.0, 'added_lines': 1, 'deleted_lines': 1, 'nloc': 31}, {'timestamp': 1546553605.0, 'added_lines': 1, 'deleted_lines': 1, 'nloc': 31}, {'timestamp': 1547003974.0, 'added_lines': 2, 'deleted_lines': 2, 'nloc': 31}, {'timestamp': 1549588289.0, 'added_lines': 1, 'deleted_lines': 1, 'nloc': 31}, {'timestamp': 1550507829.0, 'added_lines': 2, 'deleted_lines': 3, 'nloc': 30}, {'timestamp': 1551229859.0, 'added_lines': 2, 'deleted_lines': 2, 'nloc': 30}, {'timestamp': 1551551196.0, 'added_lines': 3, 'deleted_lines': 3, 'nloc': 30}, {'timestamp': 1552689783.0, 'added_lines': 1, 'deleted_lines': 1, 'nloc': 30}, {'timestamp': 1563198626.0, 'added_lines': 1, 'deleted_lines': 1, 'nloc': 30}, {'timestamp': 1613691223.0, 'added_lines': 1, 'deleted_lines': 1, 'nloc': 30}]","{'blocks/blockstore/arc_cache.go': 3, 'blocks/blockstore/arc_cache_test.go': 3, 'blocks/blockstore/blockstore.go': 4, 'blocks/blockstore/blockstore_test.go': 3, 'blocks/blockstore/bloom_cache_test.go': 3, 'blocks/blockstore/util/remove.go': 3, 'blockservice/blockservice_test.go': 7, 'blockservice/test/blocks_test.go': 7, 'core/builder.go': 34, 'core/commands/dht.go': 23, 'core/core.go': 36, 'core/coreunix/add.go': 23, 'core/coreunix/metadata_test.go': 23, 'exchange/bitswap/decision/engine_test.go': 7, 'exchange/bitswap/testnet/peernet.go': 7, 'exchange/bitswap/testutils.go': 7, 'exchange/offline/offline_test.go': 4, 'exchange/reprovide/reprovide_test.go': 23, 'filestore/filestore.go': 17, 'filestore/filestore_test.go': 23, 'filestore/fsrefstore.go': 17, 'filestore/util.go': 17, 'merkledag/test/utils.go': 6, 'merkledag/utils/utils.go': 7, 'mfs/mfs_test.go': 8, 'namesys/namesys.go': 23, 'namesys/namesys_test.go': 22, 'namesys/publisher.go': 23, 'namesys/publisher_test.go': 23, 'namesys/pubsub.go': 5, 'namesys/pubsub_test.go': 5, 'namesys/republisher/repub.go': 23, 'namesys/resolve_test.go': 23, 'package.json': 33, 'pin/pin.go': 23, 'pin/pin_test.go': 23, 'pin/set_test.go': 23, 'repo/fsrepo/datastores.go': 16, 'repo/fsrepo/fsrepo.go': 37, 'repo/fsrepo/fsrepo_test.go': 30, 'routing/mock/centralized_client.go': 3, 'routing/mock/centralized_server.go': 3, 'routing/mock/interface.go': 3, 'routing/offline/offline.go': 3, 'routing/offline/offline_test.go': 3, 'thirdparty/datastore2/datastore_closer.go': 3, 'thirdparty/datastore2/delayed.go': 3, 'thirdparty/datastore2/threadsafe.go': 3, 'thirdparty/ds-help/key.go': 3, 'assets/assets.go': 18, 'blocks/blockstore/bloom_cache.go': 2, 'blocks/blocksutil/block_generator.go': 2, 'blockservice/blockservice.go': 7, 'cmd/ipfs/daemon.go': 13, 'cmd/ipfs/init.go': 29, 'cmd/ipfs/ipfs.go': 10, 'cmd/ipfs/main.go': 29, 'cmd/ipfs/main_test.go': 1, 'cmd/ipfswatch/main.go': 26, 'cmd/seccat/seccat.go': 20, 'commands/command.go': 8, 'commands/command_test.go': 2, 'commands/request.go': 21, 'commands/response.go': 4, 'commands/response_test.go': 2, 'core/bootstrap.go': 31, 'core/bootstrap_test.go': 30, 'core/commands/active.go': 5, 'core/commands/add.go': 16, 'core/commands/bitswap.go': 21, 'core/commands/block.go': 11, 'core/commands/bootstrap.go': 26, 'core/commands/cat.go': 11, 'core/commands/commands.go': 10, 'core/commands/config.go': 27, 'core/commands/dag/dag.go': 19, 'core/commands/dht_test.go': 20, 'core/commands/diag.go': 5, 'core/commands/dns.go': 8, 'core/commands/external.go': 5, 'core/commands/files/files.go': 2, 'core/commands/filestore.go': 11, 'core/commands/get.go': 20, 'core/commands/get_test.go': 10, 'core/commands/helptext_test.go': 10, 'core/commands/id.go': 20, 'core/commands/ipns.go': 7, 'core/commands/ipnsps.go': 4, 'core/commands/keystore.go': 11, 'core/commands/log.go': 9, 'core/commands/ls.go': 20, 'core/commands/mount_nofuse.go': 5, 'core/commands/mount_unix.go': 26, 'core/commands/mount_windows.go': 5, 'core/commands/name.go': 3, 'core/commands/object/diff.go': 7, 'core/commands/object/object.go': 21, 'core/commands/object/patch.go': 10, 'core/commands/p2p.go': 17, 'core/commands/pin.go': 21, 'core/commands/ping.go': 19, 'core/commands/publish.go': 7, 'core/commands/pubsub.go': 14, 'core/commands/refs.go': 19, 'core/commands/repo.go': 33, 'core/commands/resolve.go': 19, 'core/commands/root.go': 10, 'core/commands/shutdown.go': 7, 'core/commands/stat.go': 14, 'core/commands/swarm.go': 31, 'core/commands/sysdiag.go': 13, 'core/commands/tar.go': 18, 'core/commands/unixfs/ls.go': 18, 'core/commands/unixfs/unixfs.go': 5, 'core/commands/version.go': 8, 'core/coreapi/coreapi.go': 13, 'core/coreapi/interface/interface.go': 2, 'core/coreapi/unixfs.go': 19, 'core/coreapi/unixfs_test.go': 25, 'core/coredag/cbor.go': 7, 'core/coredag/dagpb.go': 19, 'core/coredag/dagtransl.go': 6, 'core/coredag/raw.go': 19, 'core/corehttp/commands.go': 32, 'core/corehttp/corehttp.go': 12, 'core/corehttp/gateway.go': 22, 'core/corehttp/gateway_handler.go': 21, 'core/corehttp/gateway_test.go': 32, 'core/corehttp/metrics_test.go': 20, 'core/corerepo/gc.go': 20, 'core/corerepo/pinning.go': 9, 'core/coreunix/add_test.go': 32, 'core/coreunix/metadata.go': 19, 'core/mock/mock.go': 31, 'core/pathresolver.go': 21, 'exchange/bitswap/bitswap.go': 6, 'exchange/bitswap/bitswap_test.go': 6, 'exchange/bitswap/decision/bench_test.go': 5, 'exchange/bitswap/decision/engine.go': 6, 'exchange/bitswap/decision/ledger.go': 5, 'exchange/bitswap/decision/peer_request_queue.go': 5, 'exchange/bitswap/decision/peer_request_queue_test.go': 5, 'exchange/bitswap/get.go': 6, 'exchange/bitswap/message/message.go': 5, 'exchange/bitswap/message/message_test.go': 3, 'exchange/bitswap/network/interface.go': 5, 'exchange/bitswap/network/ipfs_impl.go': 5, 'exchange/bitswap/notifications/notifications.go': 3, 'exchange/bitswap/notifications/notifications_test.go': 3, 'exchange/bitswap/session.go': 5, 'exchange/bitswap/session_test.go': 5, 'exchange/bitswap/stat.go': 3, 'exchange/bitswap/testnet/interface.go': 5, 'exchange/bitswap/testnet/network_test.go': 6, 'exchange/bitswap/testnet/virtual.go': 6, 'exchange/bitswap/wantlist/wantlist.go': 3, 'exchange/bitswap/wantlist/wantlist_test.go': 3, 'exchange/bitswap/wantmanager.go': 5, 'exchange/bitswap/workers.go': 5, 'exchange/interface.go': 2, 'exchange/offline/offline.go': 3, 'exchange/reprovide/providers.go': 22, 'exchange/reprovide/reprovide.go': 19, 'fuse/ipns/ipns_test.go': 22, 'fuse/ipns/ipns_unix.go': 21, 'fuse/node/mount_test.go': 22, 'fuse/readonly/ipfs_test.go': 21, 'fuse/readonly/readonly_unix.go': 21, 'importer/balanced/balanced_test.go': 5, 'importer/balanced/builder.go': 3, 'importer/chunk/rabin_test.go': 2, 'importer/chunk/splitting_test.go': 2, 'importer/helpers/dagbuilder.go': 5, 'importer/helpers/helpers.go': 3, 'importer/importer.go': 5, 'importer/importer_test.go': 5, 'importer/trickle/trickle_test.go': 5, 'importer/trickle/trickledag.go': 3, 'merkledag/batch.go': 2, 'merkledag/coding.go': 3, 'merkledag/merkledag.go': 3, 'merkledag/merkledag_test.go': 5, 'merkledag/node.go': 3, 'merkledag/node_test.go': 3, 'merkledag/raw.go': 3, 'merkledag/traverse/traverse.go': 3, 'merkledag/traverse/traverse_test.go': 3, 'merkledag/utils/diff.go': 3, 'merkledag/utils/diffenum.go': 3, 'merkledag/utils/diffenum_test.go': 3, 'merkledag/utils/utils_test.go': 3, 'mfs/dir.go': 4, 'mfs/file.go': 6, 'mfs/ops.go': 4, 'mfs/repub_test.go': 5, 'mfs/system.go': 6, 'namesys/ipns_select_test.go': 4, 'namesys/republisher/repub_test.go': 21, 'namesys/routing.go': 21, 'p2p/p2p.go': 20, 'p2p/registry.go': 8, 'path/path.go': 3, 'path/resolver.go': 2, 'path/resolver_test.go': 2, 'pin/gc/gc.go': 22, 'pin/set.go': 19, 'plugin/ipld.go': 6, 'plugin/loader/initializer.go': 5, 'plugin/plugins/git/git.go': 6, 'repo/config/bootstrap_peers.go': 5, 'repo/config/init.go': 5, 'repo/fsrepo/lock/lock.go': 2, 'repo/fsrepo/serialize/serialize.go': 3, 'repo/mock.go': 31, 'routing/mock/centralized_test.go': 2, 'routing/none/none_client.go': 2, 'tar/format.go': 21, 'test/dependencies/ma-pipe-unidir/main.go': 9, 'test/integration/addcat_test.go': 20, 'test/integration/bench_cat_test.go': 20, 'test/integration/bench_test.go': 15, 'test/integration/bitswap_wo_routing_test.go': 20, 'test/integration/three_legged_cat_test.go': 20, 'thirdparty/pollEndpoint/main.go': 12, 'thirdparty/posinfo/posinfo.go': 2, 'unixfs/archive/archive.go': 3, 'unixfs/archive/tar/writer.go': 3, 'unixfs/hamt/hamt.go': 3, 'unixfs/io/dagreader.go': 3, 'unixfs/io/dirbuilder.go': 3, 'unixfs/io/resolve.go': 3, 'unixfs/mod/dagmodifier.go': 5, 'unixfs/mod/dagmodifier_test.go': 3, 'unixfs/test/utils.go': 5, 'test/sharness/t0021-config.sh': 1, 'commands/legacy/command.go': 7, 'commands/legacy/legacy.go': 7, 'commands/legacy/legacy_test.go': 7, 'commands/legacy/request.go': 7, 'commands/legacy/response.go': 7, 'core/commands/commands_test.go': 9, 'core/coreapi/dag.go': 5, 'core/coreapi/dag_test.go': 3, 'core/coreapi/interface/options/dag.go': 4, 'core/coreapi/key.go': 20, 'core/coreapi/name.go': 22, 'unixfs/io/pbdagreader.go': 2, 'blocks/blockstoreutil/remove.go': 14, 'blockservice/test/mock.go': 4, 'namesys/ipns_validate_test.go': 3, 'namesys/validator.go': 3, 'cmd/ipfs/util/ulimit.go': 7, 'cmd/seccat/util.go': 7, 'core/commands/files.go': 19, 'core/core_test.go': 27, 'core/coreapi/pin.go': 19, 'core/corehttp/logs.go': 7, 'fuse/ipns/common.go': 18, 'fuse/mount/mount.go': 7, 'fuse/node/mount_unix.go': 7, 'keystore/keystore.go': 7, 'keystore/keystore_test.go': 4, 'keystore/memkeystore.go': 4, 'namesys/interface.go': 17, 'path/resolver/resolver.go': 3, 'plugin/loader/load.go': 5, 'repo/config/identity.go': 1, 'thirdparty/verifbs/verifbs.go': 13, 'cmd/ipfs/util/ulimit_freebsd.go': 2, 'cmd/ipfs/util/ulimit_unix.go': 2, 'core/coreapi/block.go': 6, 'core/coreapi/block_test.go': 2, 'core/coreapi/interface/coreapi.go': 3, 'core/coreapi/interface/dag.go': 3, 'core/coreapi/interface/object.go': 3, 'core/coreapi/interface/options/block.go': 2, 'core/coreapi/interface/path.go': 14, 'core/coreapi/interface/unixfs.go': 4, 'core/coreapi/object.go': 17, 'fuse/ipns/link_unix.go': 2, 'fuse/mount/fuse.go': 2, 'fuse/node/mount_darwin.go': 2, 'merkledag/errservice.go': 1, 'merkledag/readonly.go': 1, 'merkledag/readonly_test.go': 1, 'merkledag/rwservice.go': 1, 'merkledag/session.go': 1, 'path/resolver/resolver_test.go': 1, 'thirdparty/verifcid/validate.go': 1, 'thirdparty/verifcid/validate_test.go': 1, 'unixfs/hamt/hamt_stress_test.go': 1, 'unixfs/hamt/hamt_test.go': 1, 'namesys/ipns_resolver_validation_test.go': 17, 'test/sharness/t0170-dht.sh': 1, 'core/commands/env.go': 6, 'repo/fsrepo/misc.go': 24, 'cmd/ipfs/Rules.mk': 1, 'core/corehttp/option_test.go': 1, 'docs/releases.md': 1, 'docs/windows.md': 1, 'repo/fsrepo/config_test.go': 23, 'repo/version.go': 1, 'test/bench/bench_cli_ipfs_add/main.go': 23, 'test/bench/offline_add/main.go': 23, 'core/commands/urlstore.go': 17, 'core/coreapi/name_test.go': 11, 'core/coreapi/path.go': 17, 'core/coreunix/cat.go': 5, 'core/pathresolver_test.go': 16, 'dagutils/diff.go': 16, 'dagutils/diffenum.go': 16, 'dagutils/diffenum_test.go': 16, 'dagutils/utils.go': 16, 'dagutils/utils_test.go': 16, 'mfs/fd.go': 1, 'namesys/base.go': 16, 'namesys/cache.go': 16, 'namesys/dns.go': 16, 'namesys/proquint.go': 16, 'thirdparty/cidv0v1/blockstore.go': 10, 'core/coreapi/interface/key.go': 6, 'core/commands/cmdenv/env.go': 18, 'core/commands/name/ipns.go': 15, 'core/commands/name/publish.go': 8, 'core/commands/name/ipnsps.go': 8, 'core/commands/name/name.go': 4, 'core/coreapi/dht.go': 12, 'core/coreapi/dht_test.go': 4, 'core/coreapi/interface/dht.go': 9, 'p2p/listener.go': 12, 'p2p/local.go': 12, 'p2p/remote.go': 12, 'p2p/stream.go': 12, 'core/coreapi/interface/swarm.go': 8, 'core/coreapi/swarm.go': 11, 'core/coreapi/interface/options/unixfs.go': 7, 'core/coreapi/pubsub.go': 11, 'core/coreapi/unixfile.go': 6, 'cmd/ipfs/dnsresolve_test.go': 5, 'core/coreapi/interface/pubsub.go': 4, 'test/sharness/t0180-pubsub.sh': 1, 'core/commands/cid.go': 3, 'test/dependencies/iptb/iptb.go': 11, 'plugin/plugins/badgerds/badgerds.go': 3, 'plugin/plugins/flatfs/flatfs.go': 3, 'plugin/plugins/levelds/levelds.go': 3, 'commands/context.go': 8, 'core/corehttp/proxy.go': 6, 'core/coreapi/test/api_test.go': 8, 'core/coreapi/interface/tests/name.go': 2, 'core/coreapi/interface/tests/unixfs.go': 2, 'core/commands/cmdenv/cidbase.go': 2, 'core/corehttp/ipns_hostname.go': 3, 'filestore/pb/dataobj.pb.go': 2, 'namesys/dns_test.go': 3, 'pin/internal/pb/header.pb.go': 2, 'plugin/daemon.go': 3, 'plugin/loader/loader.go': 3, 'core/commands/cmdenv/cidbase_test.go': 1, 'core/commands/cmdenv/file.go': 1, 'core/corehttp/metrics.go': 1, 'core/corehttp/proxy_test.go': 1, 'core/corerepo/stat.go': 1, 'plugin/tracer.go': 1, 'thirdparty/notifier/notifier.go': 1, 'core/node/storage.go': 1, 'go.mod': 2, 'go.sum': 2, 'core/corehttp/hostname.go': 1, 'core/node/ipns.go': 1, None: 20}","('repo/fsrepo/fsrepo.go', 0.9487179487179487, 0.5362318840579711)"
repo/common/common.go,46,305,2,"[{'cyclomatic_complexity': 1, 'nloc': 1, 'token_count': 19, 'name': 'MapGetKV', 'long_name': 'MapGetKV v map [ string ] interface { } , key string', 'start_line': 8, 'end_line': 8, 'full_parameters': ['v map [ string ] interface { }', ' key string'], 'filename': '/home/dimi/Documents/Informatik_Studium/FSS/SoftEvo/DataCollection/FFS_SoftEvo/go-ipfs/repo/common/common.go', 'top_nesting_level': 0, 'length': 1, 'fan_in': 0, 'fan_out': 0, 'general_fan_out': 0}, {'cyclomatic_complexity': 6, 'nloc': 23, 'token_count': 163, 'name': 'MapSetKV', 'long_name': 'MapSetKV v map [ string ] interface { } , key string , value interface { }', 'start_line': 30, 'end_line': 56, 'full_parameters': ['v map [ string ] interface { }', ' key string', ' value interface { }'], 'filename': '/home/dimi/Documents/Informatik_Studium/FSS/SoftEvo/DataCollection/FFS_SoftEvo/go-ipfs/repo/common/common.go', 'top_nesting_level': 0, 'length': 27, 'fan_in': 0, 'fan_out': 0, 'general_fan_out': 0}]",46,305,2,"[{'cyclomatic_complexity': 1, 'nloc': 1, 'token_count': 19, 'name': 'MapGetKV', 'long_name': 'MapGetKV v map [ string ] interface { } , key string', 'start_line': 8, 'end_line': 8, 'full_parameters': ['v map [ string ] interface { }', ' key string'], 'filename': '/home/dimi/Documents/Informatik_Studium/FSS/SoftEvo/DataCollection/FFS_SoftEvo/go-ipfs/repo/common/common.go', 'top_nesting_level': 0, 'length': 1, 'fan_in': 0, 'fan_out': 0, 'general_fan_out': 0}, {'cyclomatic_complexity': 6, 'nloc': 23, 'token_count': 163, 'name': 'MapSetKV', 'long_name': 'MapSetKV v map [ string ] interface { } , key string , value interface { }', 'start_line': 30, 'end_line': 56, 'full_parameters': ['v map [ string ] interface { }', ' key string', ' value interface { }'], 'filename': '/home/dimi/Documents/Informatik_Studium/FSS/SoftEvo/DataCollection/FFS_SoftEvo/go-ipfs/repo/common/common.go', 'top_nesting_level': 0, 'length': 27, 'fan_in': 0, 'fan_out': 0, 'general_fan_out': 0}]",0,0,0,0,0,[],{},()
repo/fsrepo/doc.go,1,2,0,[],1,2,0,[],0,0,0,0,0,[],{},()
repo/fsrepo/config_test.go,187,1103,4,"[{'cyclomatic_complexity': 7, 'nloc': 27, 'token_count': 220, 'name': 'TestDefaultDatastoreConfig', 'long_name': 'TestDefaultDatastoreConfig t * testing . T', 'start_line': 74, 'end_line': 105, 'full_parameters': ['t * testing . T'], 'filename': '/home/dimi/Documents/Informatik_Studium/FSS/SoftEvo/DataCollection/FFS_SoftEvo/go-ipfs/repo/fsrepo/config_test.go', 'top_nesting_level': 0, 'length': 32, 'fan_in': 0, 'fan_out': 0, 'general_fan_out': 0}, {'cyclomatic_complexity': 8, 'nloc': 32, 'token_count': 221, 'name': 'TestLevelDbConfig', 'long_name': 'TestLevelDbConfig t * testing . T', 'start_line': 107, 'end_line': 143, 'full_parameters': ['t * testing . T'], 'filename': '/home/dimi/Documents/Informatik_Studium/FSS/SoftEvo/DataCollection/FFS_SoftEvo/go-ipfs/repo/fsrepo/config_test.go', 'top_nesting_level': 0, 'length': 37, 'fan_in': 0, 'fan_out': 0, 'general_fan_out': 0}, {'cyclomatic_complexity': 8, 'nloc': 32, 'token_count': 225, 'name': 'TestFlatfsConfig', 'long_name': 'TestFlatfsConfig t * testing . T', 'start_line': 145, 'end_line': 181, 'full_parameters': ['t * testing . T'], 'filename': '/home/dimi/Documents/Informatik_Studium/FSS/SoftEvo/DataCollection/FFS_SoftEvo/go-ipfs/repo/fsrepo/config_test.go', 'top_nesting_level': 0, 'length': 37, 'fan_in': 0, 'fan_out': 0, 'general_fan_out': 0}, {'cyclomatic_complexity': 8, 'nloc': 32, 'token_count': 225, 'name': 'TestMeasureConfig', 'long_name': 'TestMeasureConfig t * testing . T', 'start_line': 183, 'end_line': 219, 'full_parameters': ['t * testing . T'], 'filename': '/home/dimi/Documents/Informatik_Studium/FSS/SoftEvo/DataCollection/FFS_SoftEvo/go-ipfs/repo/fsrepo/config_test.go', 'top_nesting_level': 0, 'length': 37, 'fan_in': 0, 'fan_out': 0, 'general_fan_out': 0}]",201,1172,4,"[{'cyclomatic_complexity': 10, 'nloc': 39, 'token_count': 282, 'name': 'TestDefaultDatastoreConfig', 'long_name': 'TestDefaultDatastoreConfig t * testing . T', 'start_line': 77, 'end_line': 122, 'full_parameters': ['t * testing . T'], 'filename': '/home/dimi/Documents/Informatik_Studium/FSS/SoftEvo/DataCollection/FFS_SoftEvo/go-ipfs/repo/fsrepo/config_test.go', 'top_nesting_level': 0, 'length': 46, 'fan_in': 0, 'fan_out': 0, 'general_fan_out': 0}, {'cyclomatic_complexity': 8, 'nloc': 32, 'token_count': 223, 'name': 'TestLevelDbConfig', 'long_name': 'TestLevelDbConfig t * testing . T', 'start_line': 124, 'end_line': 160, 'full_parameters': ['t * testing . T'], 'filename': '/home/dimi/Documents/Informatik_Studium/FSS/SoftEvo/DataCollection/FFS_SoftEvo/go-ipfs/repo/fsrepo/config_test.go', 'top_nesting_level': 0, 'length': 37, 'fan_in': 0, 'fan_out': 0, 'general_fan_out': 0}, {'cyclomatic_complexity': 8, 'nloc': 32, 'token_count': 227, 'name': 'TestFlatfsConfig', 'long_name': 'TestFlatfsConfig t * testing . T', 'start_line': 162, 'end_line': 198, 'full_parameters': ['t * testing . T'], 'filename': '/home/dimi/Documents/Informatik_Studium/FSS/SoftEvo/DataCollection/FFS_SoftEvo/go-ipfs/repo/fsrepo/config_test.go', 'top_nesting_level': 0, 'length': 37, 'fan_in': 0, 'fan_out': 0, 'general_fan_out': 0}, {'cyclomatic_complexity': 8, 'nloc': 32, 'token_count': 227, 'name': 'TestMeasureConfig', 'long_name': 'TestMeasureConfig t * testing . T', 'start_line': 200, 'end_line': 236, 'full_parameters': ['t * testing . T'], 'filename': '/home/dimi/Documents/Informatik_Studium/FSS/SoftEvo/DataCollection/FFS_SoftEvo/go-ipfs/repo/fsrepo/config_test.go', 'top_nesting_level': 0, 'length': 37, 'fan_in': 0, 'fan_out': 0, 'general_fan_out': 0}]",14,69,0,30,30,"[{'timestamp': 1519765635.0, 'added_lines': 2, 'deleted_lines': 2, 'nloc': 187}, {'timestamp': 1532365899.0, 'added_lines': 1, 'deleted_lines': 1, 'nloc': 187}, {'timestamp': 1532388583.0, 'added_lines': 1, 'deleted_lines': 1, 'nloc': 187}, {'timestamp': 1533809170.0, 'added_lines': 1, 'deleted_lines': 1, 'nloc': 187}, {'timestamp': 1534072974.0, 'added_lines': 1, 'deleted_lines': 1, 'nloc': 187}, {'timestamp': 1534896611.0, 'added_lines': 1, 'deleted_lines': 1, 'nloc': 187}, {'timestamp': 1535255498.0, 'added_lines': 1, 'deleted_lines': 1, 'nloc': 187}, {'timestamp': 1535601896.0, 'added_lines': 1, 'deleted_lines': 1, 'nloc': 187}, {'timestamp': 1536388808.0, 'added_lines': 1, 'deleted_lines': 1, 'nloc': 187}, {'timestamp': 1537792589.0, 'added_lines': 1, 'deleted_lines': 1, 'nloc': 187}, {'timestamp': 1538544957.0, 'added_lines': 1, 'deleted_lines': 1, 'nloc': 187}, {'timestamp': 1538547366.0, 'added_lines': 1, 'deleted_lines': 1, 'nloc': 187}, {'timestamp': 1540400358.0, 'added_lines': 1, 'deleted_lines': 1, 'nloc': 187}, {'timestamp': 1540489644.0, 'added_lines': 1, 'deleted_lines': 1, 'nloc': 187}, {'timestamp': 1541204121.0, 'added_lines': 1, 'deleted_lines': 1, 'nloc': 187}, {'timestamp': 1541368117.0, 'added_lines': 11, 'deleted_lines': 6, 'nloc': 190}, {'timestamp': 1541461419.0, 'added_lines': 1, 'deleted_lines': 1, 'nloc': 190}, {'timestamp': 1543282933.0, 'added_lines': 1, 'deleted_lines': 1, 'nloc': 190}, {'timestamp': 1544225843.0, 'added_lines': 1, 'deleted_lines': 1, 'nloc': 190}, {'timestamp': 1520714446.0, 'added_lines': 13, 'deleted_lines': 1, 'nloc': 201}, {'timestamp': 1545323704.0, 'added_lines': 1, 'deleted_lines': 1, 'nloc': 201}, {'timestamp': 1546553605.0, 'added_lines': 1, 'deleted_lines': 1, 'nloc': 201}, {'timestamp': 1547003974.0, 'added_lines': 1, 'deleted_lines': 1, 'nloc': 201}, {'timestamp': 1548794514.0, 'added_lines': 1, 'deleted_lines': 1, 'nloc': 201}, {'timestamp': 1549588289.0, 'added_lines': 1, 'deleted_lines': 1, 'nloc': 201}, {'timestamp': 1550507829.0, 'added_lines': 2, 'deleted_lines': 2, 'nloc': 201}, {'timestamp': 1551229859.0, 'added_lines': 1, 'deleted_lines': 1, 'nloc': 201}, {'timestamp': 1551551196.0, 'added_lines': 1, 'deleted_lines': 1, 'nloc': 201}, {'timestamp': 1561704149.0, 'added_lines': 1, 'deleted_lines': 1, 'nloc': 201}, {'timestamp': 1567106571.0, 'added_lines': 1, 'deleted_lines': 1, 'nloc': 201}]","{'core/core_test.go': 24, 'core/coreapi/unixfs_test.go': 18, 'core/corehttp/gateway_test.go': 24, 'core/coreunix/add_test.go': 24, 'core/mock/mock.go': 24, None: 4, 'cmd/ipfs/Rules.mk': 1, 'cmd/ipfs/init.go': 23, 'cmd/ipfs/main.go': 28, 'cmd/ipfswatch/main.go': 23, 'commands/request.go': 15, 'core/bootstrap.go': 23, 'core/bootstrap_test.go': 23, 'core/builder.go': 23, 'core/commands/bootstrap.go': 23, 'core/commands/config.go': 23, 'core/commands/env.go': 5, 'core/commands/mount_unix.go': 23, 'core/commands/repo.go': 23, 'core/commands/swarm.go': 23, 'core/commands/sysdiag.go': 8, 'core/commands/version.go': 5, 'core/core.go': 23, 'core/corehttp/commands.go': 23, 'core/corehttp/gateway.go': 14, 'core/corehttp/option_test.go': 1, 'docs/releases.md': 1, 'docs/windows.md': 1, 'package.json': 22, 'repo/fsrepo/fsrepo.go': 23, 'repo/fsrepo/fsrepo_test.go': 23, 'repo/fsrepo/misc.go': 23, 'repo/mock.go': 23, 'repo/repo.go': 23, 'repo/version.go': 1, 'test/bench/bench_cli_ipfs_add/main.go': 23, 'test/bench/offline_add/main.go': 23, 'assets/assets.go': 12, 'blocks/blockstoreutil/remove.go': 7, 'cmd/ipfs/daemon.go': 8, 'cmd/ipfs/ipfs.go': 5, 'cmd/seccat/seccat.go': 13, 'commands/command.go': 3, 'commands/legacy/command.go': 3, 'commands/legacy/legacy.go': 3, 'commands/legacy/legacy_test.go': 3, 'commands/legacy/request.go': 3, 'commands/legacy/response.go': 3, 'commands/response.go': 1, 'core/commands/active.go': 3, 'core/commands/add.go': 9, 'core/commands/bitswap.go': 13, 'core/commands/block.go': 6, 'core/commands/cat.go': 6, 'core/commands/commands.go': 5, 'core/commands/commands_test.go': 5, 'core/commands/dag/dag.go': 13, 'core/commands/dht.go': 13, 'core/commands/dht_test.go': 12, 'core/commands/diag.go': 3, 'core/commands/dns.go': 5, 'core/commands/external.go': 3, 'core/commands/files.go': 13, 'core/commands/filestore.go': 5, 'core/commands/get.go': 12, 'core/commands/get_test.go': 5, 'core/commands/helptext_test.go': 5, 'core/commands/id.go': 13, 'core/commands/ipns.go': 1, 'core/commands/ipnsps.go': 1, 'core/commands/keystore.go': 6, 'core/commands/log.go': 5, 'core/commands/ls.go': 12, 'core/commands/mount_nofuse.go': 3, 'core/commands/mount_windows.go': 3, 'core/commands/name.go': 1, 'core/commands/object/diff.go': 5, 'core/commands/object/object.go': 13, 'core/commands/object/patch.go': 6, 'core/commands/p2p.go': 11, 'core/commands/pin.go': 13, 'core/commands/ping.go': 12, 'core/commands/publish.go': 1, 'core/commands/pubsub.go': 9, 'core/commands/refs.go': 13, 'core/commands/resolve.go': 13, 'core/commands/root.go': 5, 'core/commands/shutdown.go': 5, 'core/commands/stat.go': 9, 'core/commands/tar.go': 13, 'core/commands/unixfs/ls.go': 13, 'core/commands/unixfs/unixfs.go': 3, 'core/commands/urlstore.go': 13, 'core/coreapi/block.go': 5, 'core/coreapi/dag.go': 3, 'core/coreapi/interface/coreapi.go': 2, 'core/coreapi/interface/dag.go': 2, 'core/coreapi/interface/key.go': 6, 'core/coreapi/interface/object.go': 2, 'core/coreapi/interface/options/dag.go': 2, 'core/coreapi/interface/path.go': 10, 'core/coreapi/interface/unixfs.go': 3, 'core/coreapi/key.go': 13, 'core/coreapi/name.go': 13, 'core/coreapi/name_test.go': 8, 'core/coreapi/object.go': 13, 'core/coreapi/path.go': 13, 'core/coreapi/pin.go': 13, 'core/coreapi/unixfs.go': 13, 'core/coredag/cbor.go': 4, 'core/coredag/dagpb.go': 13, 'core/coredag/dagtransl.go': 3, 'core/coredag/raw.go': 13, 'core/corehttp/gateway_handler.go': 13, 'core/corehttp/metrics_test.go': 13, 'core/corerepo/gc.go': 13, 'core/corerepo/pinning.go': 5, 'core/coreunix/add.go': 13, 'core/coreunix/cat.go': 4, 'core/coreunix/metadata.go': 13, 'core/coreunix/metadata_test.go': 13, 'core/pathresolver.go': 13, 'core/pathresolver_test.go': 13, 'dagutils/diff.go': 13, 'dagutils/diffenum.go': 13, 'dagutils/diffenum_test.go': 13, 'dagutils/utils.go': 13, 'dagutils/utils_test.go': 13, 'exchange/reprovide/providers.go': 13, 'exchange/reprovide/reprovide.go': 12, 'exchange/reprovide/reprovide_test.go': 13, 'filestore/filestore.go': 7, 'filestore/filestore_test.go': 13, 'filestore/fsrefstore.go': 7, 'filestore/util.go': 7, 'fuse/ipns/common.go': 13, 'fuse/ipns/ipns_test.go': 13, 'fuse/ipns/ipns_unix.go': 13, 'fuse/node/mount_test.go': 13, 'fuse/readonly/ipfs_test.go': 13, 'fuse/readonly/readonly_unix.go': 13, 'namesys/base.go': 13, 'namesys/cache.go': 13, 'namesys/dns.go': 13, 'namesys/interface.go': 13, 'namesys/ipns_resolver_validation_test.go': 13, 'namesys/namesys.go': 13, 'namesys/namesys_test.go': 13, 'namesys/proquint.go': 13, 'namesys/publisher.go': 13, 'namesys/publisher_test.go': 13, 'namesys/republisher/repub.go': 13, 'namesys/republisher/repub_test.go': 13, 'namesys/resolve_test.go': 13, 'namesys/routing.go': 13, 'p2p/p2p.go': 13, 'p2p/registry.go': 3, 'pin/gc/gc.go': 13, 'pin/pin.go': 13, 'pin/pin_test.go': 13, 'pin/set.go': 13, 'pin/set_test.go': 13, 'plugin/ipld.go': 3, 'plugin/loader/initializer.go': 2, 'plugin/plugins/git/git.go': 4, 'tar/format.go': 13, 'test/integration/addcat_test.go': 13, 'test/integration/bench_cat_test.go': 13, 'test/integration/bench_test.go': 10, 'test/integration/bitswap_wo_routing_test.go': 13, 'test/integration/three_legged_cat_test.go': 13, 'thirdparty/cidv0v1/blockstore.go': 7, 'thirdparty/verifbs/verifbs.go': 7, 'core/commands/cmdenv/env.go': 18, 'core/commands/name/ipns.go': 12, 'core/commands/name/publish.go': 8, 'repo/fsrepo/datastores.go': 6, 'cmd/ipfs/util/ulimit.go': 4, 'cmd/seccat/util.go': 4, 'core/commands/name/ipnsps.go': 8, 'core/commands/name/name.go': 4, 'core/coreapi/dht.go': 10, 'core/coreapi/dht_test.go': 4, 'core/coreapi/interface/dht.go': 7, 'core/corehttp/corehttp.go': 7, 'core/corehttp/logs.go': 4, 'fuse/mount/mount.go': 4, 'fuse/node/mount_unix.go': 4, 'keystore/keystore.go': 4, 'p2p/listener.go': 10, 'p2p/local.go': 10, 'p2p/remote.go': 10, 'p2p/stream.go': 10, 'plugin/loader/load.go': 3, 'thirdparty/pollEndpoint/main.go': 7, 'core/coreapi/interface/swarm.go': 6, 'core/coreapi/swarm.go': 9, 'cmd/ipfs/dnsresolve_test.go': 5, 'core/coreapi/coreapi.go': 8, 'core/coreapi/interface/options/unixfs.go': 5, 'core/coreapi/interface/pubsub.go': 4, 'core/coreapi/pubsub.go': 9, 'core/coreapi/unixfile.go': 4, 'test/dependencies/ma-pipe-unidir/main.go': 5, 'test/sharness/t0180-pubsub.sh': 1, 'core/commands/cid.go': 3, 'core/coreapi/block_test.go': 1, 'core/coreapi/dag_test.go': 1, 'core/coreapi/interface/options/block.go': 1, 'keystore/keystore_test.go': 3, 'keystore/memkeystore.go': 3, 'test/dependencies/iptb/iptb.go': 10, 'commands/context.go': 10, 'core/corehttp/proxy.go': 6, 'plugin/loader/loader.go': 7, 'core/coreapi/test/api_test.go': 6, 'core/coreapi/interface/tests/name.go': 2, 'core/coreapi/interface/tests/unixfs.go': 2, 'core/commands/cmdenv/cidbase.go': 2, 'core/corehttp/ipns_hostname.go': 3, 'filestore/pb/dataobj.pb.go': 2, 'namesys/dns_test.go': 3, 'pin/internal/pb/header.pb.go': 2, 'plugin/daemon.go': 3, 'plugin/plugins/badgerds/badgerds.go': 3, 'plugin/plugins/flatfs/flatfs.go': 3, 'plugin/plugins/levelds/levelds.go': 3, 'cmd/ipfs/util/ulimit_freebsd.go': 1, 'cmd/ipfs/util/ulimit_unix.go': 1, 'core/commands/cmdenv/cidbase_test.go': 1, 'core/commands/cmdenv/file.go': 1, 'core/corehttp/metrics.go': 1, 'core/corehttp/proxy_test.go': 1, 'core/corerepo/stat.go': 1, 'fuse/ipns/link_unix.go': 1, 'fuse/mount/fuse.go': 1, 'fuse/node/mount_darwin.go': 1, 'plugin/tracer.go': 1, 'thirdparty/notifier/notifier.go': 1, 'docs/plugins.md': 1, 'go.mod': 1, 'go.sum': 1, 'plugin/plugin.go': 1, 'test/sharness/t0020-init.sh': 1, 'test/sharness/t0280-plugin-data/example.go': 1, 'test/sharness/t0280-plugin.sh': 1}","('cmd/ipfs/main.go', 0.9333333333333333, 0.26666666666666666)"
repo/fsrepo/datastores.go,310,1866,6,"[{'cyclomatic_complexity': 2, 'nloc': 7, 'token_count': 40, 'name': 'Bytes', 'long_name': '(spec DiskSpec)Bytes', 'start_line': 44, 'end_line': 51, 'full_parameters': [], 'filename': '/home/dimi/Documents/Informatik_Studium/FSS/SoftEvo/DataCollection/FFS_SoftEvo/go-ipfs/repo/fsrepo/datastores.go', 'top_nesting_level': 0, 'length': 8, 'fan_in': 0, 'fan_out': 0, 'general_fan_out': 0}, {'cyclomatic_complexity': 1, 'nloc': 3, 'token_count': 20, 'name': 'String', 'long_name': '(spec DiskSpec)String', 'start_line': 54, 'end_line': 56, 'full_parameters': [], 'filename': '/home/dimi/Documents/Informatik_Studium/FSS/SoftEvo/DataCollection/FFS_SoftEvo/go-ipfs/repo/fsrepo/datastores.go', 'top_nesting_level': 0, 'length': 3, 'fan_in': 0, 'fan_out': 0, 'general_fan_out': 0}, {'cyclomatic_complexity': 1, 'nloc': 11, 'token_count': 43, 'name': 'init', 'long_name': 'init', 'start_line': 60, 'end_line': 70, 'full_parameters': [], 'filename': '/home/dimi/Documents/Informatik_Studium/FSS/SoftEvo/DataCollection/FFS_SoftEvo/go-ipfs/repo/fsrepo/datastores.go', 'top_nesting_level': 0, 'length': 11, 'fan_in': 0, 'fan_out': 0, 'general_fan_out': 0}, {'cyclomatic_complexity': 3, 'nloc': 11, 'token_count': 74, 'name': 'AnyDatastoreConfig', 'long_name': 'AnyDatastoreConfig params map [ string ] interface { }', 'start_line': 74, 'end_line': 84, 'full_parameters': ['params map [ string ] interface { }'], 'filename': '/home/dimi/Documents/Informatik_Studium/FSS/SoftEvo/DataCollection/FFS_SoftEvo/go-ipfs/repo/fsrepo/datastores.go', 'top_nesting_level': 0, 'length': 11, 'fan_in': 0, 'fan_out': 0, 'general_fan_out': 0}, {'cyclomatic_complexity': 1, 'nloc': 3, 'token_count': 36, 'name': 'bool', 'long_name': '(i,j int)bool', 'start_line': 124, 'end_line': 126, 'full_parameters': [], 'filename': '/home/dimi/Documents/Informatik_Studium/FSS/SoftEvo/DataCollection/FFS_SoftEvo/go-ipfs/repo/fsrepo/datastores.go', 'top_nesting_level': 0, 'length': 3, 'fan_in': 0, 'fan_out': 0, 'general_fan_out': 0}, {'cyclomatic_complexity': 1, 'nloc': 1, 'token_count': 2, 'name': '', 'long_name': '(', 'start_line': 131, 'end_line': 131, 'full_parameters': [], 'filename': '/home/dimi/Documents/Informatik_Studium/FSS/SoftEvo/DataCollection/FFS_SoftEvo/go-ipfs/repo/fsrepo/datastores.go', 'top_nesting_level': 0, 'length': 1, 'fan_in': 0, 'fan_out': 0, 'general_fan_out': 0}]",189,1174,7,"[{'cyclomatic_complexity': 2, 'nloc': 7, 'token_count': 40, 'name': 'Bytes', 'long_name': '(spec DiskSpec)Bytes', 'start_line': 42, 'end_line': 49, 'full_parameters': [], 'filename': '/home/dimi/Documents/Informatik_Studium/FSS/SoftEvo/DataCollection/FFS_SoftEvo/go-ipfs/repo/fsrepo/datastores.go', 'top_nesting_level': 0, 'length': 8, 'fan_in': 0, 'fan_out': 0, 'general_fan_out': 0}, {'cyclomatic_complexity': 1, 'nloc': 3, 'token_count': 20, 'name': 'String', 'long_name': '(spec DiskSpec)String', 'start_line': 52, 'end_line': 54, 'full_parameters': [], 'filename': '/home/dimi/Documents/Informatik_Studium/FSS/SoftEvo/DataCollection/FFS_SoftEvo/go-ipfs/repo/fsrepo/datastores.go', 'top_nesting_level': 0, 'length': 3, 'fan_in': 0, 'fan_out': 0, 'general_fan_out': 0}, {'cyclomatic_complexity': 1, 'nloc': 8, 'token_count': 31, 'name': 'init', 'long_name': 'init', 'start_line': 58, 'end_line': 65, 'full_parameters': [], 'filename': '/home/dimi/Documents/Informatik_Studium/FSS/SoftEvo/DataCollection/FFS_SoftEvo/go-ipfs/repo/fsrepo/datastores.go', 'top_nesting_level': 0, 'length': 8, 'fan_in': 0, 'fan_out': 0, 'general_fan_out': 0}, {'cyclomatic_complexity': 2, 'nloc': 8, 'token_count': 41, 'name': 'AddDatastoreConfigHandler', 'long_name': 'AddDatastoreConfigHandler name string , dsc ConfigFromMap', 'start_line': 67, 'end_line': 75, 'full_parameters': ['name string', ' dsc ConfigFromMap'], 'filename': '/home/dimi/Documents/Informatik_Studium/FSS/SoftEvo/DataCollection/FFS_SoftEvo/go-ipfs/repo/fsrepo/datastores.go', 'top_nesting_level': 0, 'length': 9, 'fan_in': 0, 'fan_out': 0, 'general_fan_out': 0}, {'cyclomatic_complexity': 3, 'nloc': 11, 'token_count': 74, 'name': 'AnyDatastoreConfig', 'long_name': 'AnyDatastoreConfig params map [ string ] interface { }', 'start_line': 79, 'end_line': 89, 'full_parameters': ['params map [ string ] interface { }'], 'filename': '/home/dimi/Documents/Informatik_Studium/FSS/SoftEvo/DataCollection/FFS_SoftEvo/go-ipfs/repo/fsrepo/datastores.go', 'top_nesting_level': 0, 'length': 11, 'fan_in': 0, 'fan_out': 0, 'general_fan_out': 0}, {'cyclomatic_complexity': 1, 'nloc': 3, 'token_count': 36, 'name': 'bool', 'long_name': '(i,j int)bool', 'start_line': 129, 'end_line': 131, 'full_parameters': [], 'filename': '/home/dimi/Documents/Informatik_Studium/FSS/SoftEvo/DataCollection/FFS_SoftEvo/go-ipfs/repo/fsrepo/datastores.go', 'top_nesting_level': 0, 'length': 3, 'fan_in': 0, 'fan_out': 0, 'general_fan_out': 0}, {'cyclomatic_complexity': 1, 'nloc': 1, 'token_count': 2, 'name': '', 'long_name': '(', 'start_line': 136, 'end_line': 136, 'full_parameters': [], 'filename': '/home/dimi/Documents/Informatik_Studium/FSS/SoftEvo/DataCollection/FFS_SoftEvo/go-ipfs/repo/fsrepo/datastores.go', 'top_nesting_level': 0, 'length': 1, 'fan_in': 0, 'fan_out': 0, 'general_fan_out': 0}]",-121,-692,1,31,31,"[{'timestamp': 1507368558.0, 'added_lines': 1, 'deleted_lines': 1, 'nloc': 310}, {'timestamp': 1508445482.0, 'added_lines': 1, 'deleted_lines': 1, 'nloc': 310}, {'timestamp': 1509632107.0, 'added_lines': 1, 'deleted_lines': 1, 'nloc': 310}, {'timestamp': 1510305248.0, 'added_lines': 1, 'deleted_lines': 1, 'nloc': 310}, {'timestamp': 1510459742.0, 'added_lines': 1, 'deleted_lines': 1, 'nloc': 310}, {'timestamp': 1511062375.0, 'added_lines': 6, 'deleted_lines': 6, 'nloc': 310}, {'timestamp': 1512676203.0, 'added_lines': 1, 'deleted_lines': 1, 'nloc': 310}, {'timestamp': 1516838128.0, 'added_lines': 6, 'deleted_lines': 6, 'nloc': 310}, {'timestamp': 1516908347.0, 'added_lines': 1, 'deleted_lines': 1, 'nloc': 310}, {'timestamp': 1517259373.0, 'added_lines': 1, 'deleted_lines': 1, 'nloc': 310}, {'timestamp': 1517453697.0, 'added_lines': 1, 'deleted_lines': 1, 'nloc': 310}, {'timestamp': 1517487813.0, 'added_lines': 20, 'deleted_lines': 0, 'nloc': 327}, {'timestamp': 1519761835.0, 'added_lines': 6, 'deleted_lines': 8, 'nloc': 327}, {'timestamp': 1523461221.0, 'added_lines': 1, 'deleted_lines': 1, 'nloc': 327}, {'timestamp': 1525408792.0, 'added_lines': 6, 'deleted_lines': 6, 'nloc': 327}, {'timestamp': 1528520460.0, 'added_lines': 2, 'deleted_lines': 2, 'nloc': 327}, {'timestamp': 1529984485.0, 'added_lines': 1, 'deleted_lines': 1, 'nloc': 327}, {'timestamp': 1532146078.0, 'added_lines': 2, 'deleted_lines': 2, 'nloc': 327}, {'timestamp': 1533779477.0, 'added_lines': 1, 'deleted_lines': 1, 'nloc': 327}, {'timestamp': 1534195762.0, 'added_lines': 6, 'deleted_lines': 6, 'nloc': 327}, {'timestamp': 1536388808.0, 'added_lines': 6, 'deleted_lines': 6, 'nloc': 327}, {'timestamp': 1530726657.0, 'added_lines': 16, 'deleted_lines': 1, 'nloc': 335}, {'timestamp': 1537792589.0, 'added_lines': 6, 'deleted_lines': 6, 'nloc': 327}, {'timestamp': 1538544957.0, 'added_lines': 6, 'deleted_lines': 6, 'nloc': 327}, {'timestamp': 1538773916.0, 'added_lines': 6, 'deleted_lines': 6, 'nloc': 335}, {'timestamp': 1541204121.0, 'added_lines': 1, 'deleted_lines': 1, 'nloc': 335}, {'timestamp': 1540870015.0, 'added_lines': 7, 'deleted_lines': 187, 'nloc': 188}, {'timestamp': 1541903826.0, 'added_lines': 3, 'deleted_lines': 3, 'nloc': 188}, {'timestamp': 1550507829.0, 'added_lines': 3, 'deleted_lines': 3, 'nloc': 188}, {'timestamp': 1551551196.0, 'added_lines': 3, 'deleted_lines': 3, 'nloc': 188}, {'timestamp': 1552689783.0, 'added_lines': 2, 'deleted_lines': 1, 'nloc': 189}]","{'package.json': 26, 'test/sharness/t0025-datastores.sh': 1, 'blocks/blockstore/arc_cache.go': 2, 'blocks/blockstore/arc_cache_test.go': 2, 'blocks/blockstore/blockstore.go': 3, 'blocks/blockstore/blockstore_test.go': 2, 'blocks/blockstore/bloom_cache_test.go': 2, 'blocks/blockstore/util/remove.go': 2, 'blockservice/blockservice_test.go': 7, 'blockservice/test/blocks_test.go': 7, 'core/builder.go': 18, 'core/commands/dht.go': 17, 'core/core.go': 18, 'core/coreunix/add.go': 18, 'core/coreunix/metadata_test.go': 17, 'exchange/bitswap/decision/engine_test.go': 8, 'exchange/bitswap/testnet/peernet.go': 8, 'exchange/bitswap/testutils.go': 8, 'exchange/offline/offline_test.go': 3, 'exchange/reprovide/reprovide_test.go': 18, 'filestore/filestore.go': 18, 'filestore/filestore_test.go': 17, 'filestore/fsrefstore.go': 17, 'filestore/util.go': 17, 'merkledag/test/utils.go': 7, 'merkledag/utils/utils.go': 7, 'mfs/mfs_test.go': 9, 'namesys/namesys.go': 17, 'namesys/namesys_test.go': 16, 'namesys/publisher.go': 17, 'namesys/publisher_test.go': 17, 'namesys/pubsub.go': 5, 'namesys/pubsub_test.go': 5, 'namesys/republisher/repub.go': 17, 'namesys/resolve_test.go': 17, 'pin/pin.go': 17, 'pin/pin_test.go': 17, 'pin/set_test.go': 17, 'repo/fsrepo/fsrepo.go': 18, 'repo/fsrepo/fsrepo_test.go': 13, 'repo/repo.go': 16, 'routing/mock/centralized_client.go': 3, 'routing/mock/centralized_server.go': 3, 'routing/mock/interface.go': 3, 'routing/offline/offline.go': 3, 'routing/offline/offline_test.go': 3, 'thirdparty/datastore2/datastore_closer.go': 3, 'thirdparty/datastore2/delayed.go': 3, 'thirdparty/datastore2/threadsafe.go': 3, 'thirdparty/ds-help/key.go': 2, 'assets/assets.go': 12, 'blocks/blockstore/bloom_cache.go': 1, 'blocks/blocksutil/block_generator.go': 1, 'blockservice/blockservice.go': 7, 'cmd/ipfs/daemon.go': 11, 'cmd/ipfs/ipfs.go': 10, 'cmd/ipfs/main.go': 12, 'cmd/seccat/seccat.go': 14, 'commands/command.go': 8, 'commands/command_test.go': 2, 'commands/legacy/command.go': 8, 'commands/legacy/legacy.go': 8, 'commands/legacy/legacy_test.go': 8, 'commands/legacy/request.go': 8, 'commands/legacy/response.go': 8, 'commands/request.go': 10, 'commands/response.go': 3, 'commands/response_test.go': 2, 'core/bootstrap.go': 14, 'core/bootstrap_test.go': 14, 'core/commands/add.go': 15, 'core/commands/bitswap.go': 15, 'core/commands/block.go': 10, 'core/commands/cat.go': 10, 'core/commands/commands.go': 10, 'core/commands/commands_test.go': 10, 'core/commands/dag/dag.go': 13, 'core/commands/dht_test.go': 14, 'core/commands/files/files.go': 2, 'core/commands/filestore.go': 10, 'core/commands/get.go': 15, 'core/commands/get_test.go': 10, 'core/commands/helptext_test.go': 10, 'core/commands/id.go': 15, 'core/commands/keystore.go': 10, 'core/commands/ls.go': 15, 'core/commands/object/object.go': 14, 'core/commands/p2p.go': 10, 'core/commands/pin.go': 15, 'core/commands/ping.go': 14, 'core/commands/publish.go': 7, 'core/commands/pubsub.go': 13, 'core/commands/refs.go': 12, 'core/commands/repo.go': 17, 'core/commands/root.go': 10, 'core/commands/stat.go': 10, 'core/commands/swarm.go': 15, 'core/commands/sysdiag.go': 6, 'core/coreapi/coreapi.go': 6, 'core/coreapi/dag.go': 4, 'core/coreapi/dag_test.go': 3, 'core/coreapi/interface/interface.go': 1, 'core/coreapi/interface/options/dag.go': 3, 'core/coreapi/key.go': 15, 'core/coreapi/name.go': 16, 'core/coreapi/unixfs.go': 12, 'core/coreapi/unixfs_test.go': 13, 'core/coredag/cbor.go': 5, 'core/coredag/dagpb.go': 12, 'core/coredag/dagtransl.go': 4, 'core/coredag/raw.go': 12, 'core/corehttp/commands.go': 15, 'core/corehttp/corehttp.go': 10, 'core/corehttp/gateway.go': 15, 'core/corehttp/gateway_handler.go': 15, 'core/corehttp/gateway_test.go': 16, 'core/corehttp/metrics_test.go': 15, 'core/corerepo/gc.go': 14, 'core/corerepo/pinning.go': 7, 'core/coreunix/add_test.go': 16, 'core/coreunix/metadata.go': 12, 'core/mock/mock.go': 16, 'core/pathresolver.go': 15, 'exchange/bitswap/bitswap.go': 7, 'exchange/bitswap/bitswap_test.go': 7, 'exchange/bitswap/decision/bench_test.go': 5, 'exchange/bitswap/decision/engine.go': 7, 'exchange/bitswap/decision/ledger.go': 5, 'exchange/bitswap/decision/peer_request_queue.go': 5, 'exchange/bitswap/decision/peer_request_queue_test.go': 5, 'exchange/bitswap/get.go': 6, 'exchange/bitswap/message/message.go': 5, 'exchange/bitswap/message/message_test.go': 2, 'exchange/bitswap/network/interface.go': 5, 'exchange/bitswap/network/ipfs_impl.go': 5, 'exchange/bitswap/notifications/notifications.go': 2, 'exchange/bitswap/notifications/notifications_test.go': 2, 'exchange/bitswap/session.go': 5, 'exchange/bitswap/session_test.go': 4, 'exchange/bitswap/stat.go': 2, 'exchange/bitswap/testnet/interface.go': 5, 'exchange/bitswap/testnet/network_test.go': 6, 'exchange/bitswap/testnet/virtual.go': 6, 'exchange/bitswap/wantlist/wantlist.go': 2, 'exchange/bitswap/wantlist/wantlist_test.go': 2, 'exchange/bitswap/wantmanager.go': 6, 'exchange/bitswap/workers.go': 5, 'exchange/interface.go': 1, 'exchange/offline/offline.go': 2, 'exchange/reprovide/providers.go': 16, 'exchange/reprovide/reprovide.go': 14, 'fuse/ipns/ipns_test.go': 16, 'fuse/ipns/ipns_unix.go': 15, 'fuse/node/mount_test.go': 16, 'fuse/readonly/ipfs_test.go': 15, 'fuse/readonly/readonly_unix.go': 15, 'importer/balanced/balanced_test.go': 4, 'importer/balanced/builder.go': 2, 'importer/chunk/rabin_test.go': 1, 'importer/chunk/splitting_test.go': 1, 'importer/helpers/dagbuilder.go': 4, 'importer/helpers/helpers.go': 2, 'importer/importer.go': 4, 'importer/importer_test.go': 4, 'importer/trickle/trickle_test.go': 4, 'importer/trickle/trickledag.go': 2, 'merkledag/batch.go': 1, 'merkledag/coding.go': 2, 'merkledag/merkledag.go': 2, 'merkledag/merkledag_test.go': 5, 'merkledag/node.go': 2, 'merkledag/node_test.go': 2, 'merkledag/raw.go': 2, 'merkledag/traverse/traverse.go': 2, 'merkledag/traverse/traverse_test.go': 2, 'merkledag/utils/diff.go': 2, 'merkledag/utils/diffenum.go': 2, 'merkledag/utils/diffenum_test.go': 2, 'merkledag/utils/utils_test.go': 2, 'mfs/dir.go': 4, 'mfs/file.go': 6, 'mfs/ops.go': 4, 'mfs/repub_test.go': 6, 'mfs/system.go': 7, 'namesys/ipns_select_test.go': 3, 'namesys/republisher/repub_test.go': 16, 'namesys/routing.go': 16, 'p2p/p2p.go': 14, 'p2p/registry.go': 7, 'path/path.go': 2, 'path/resolver.go': 2, 'path/resolver_test.go': 1, 'pin/gc/gc.go': 17, 'pin/set.go': 12, 'plugin/ipld.go': 4, 'plugin/loader/initializer.go': 4, 'plugin/plugins/git/git.go': 4, 'repo/config/bootstrap_peers.go': 7, 'repo/config/init.go': 6, 'repo/fsrepo/lock/lock.go': 2, 'repo/fsrepo/serialize/serialize.go': 2, 'repo/mock.go': 9, 'routing/mock/centralized_test.go': 2, 'routing/none/none_client.go': 2, 'tar/format.go': 15, 'test/dependencies/ma-pipe-unidir/main.go': 5, 'test/integration/addcat_test.go': 15, 'test/integration/bench_cat_test.go': 15, 'test/integration/bench_test.go': 10, 'test/integration/bitswap_wo_routing_test.go': 15, 'test/integration/three_legged_cat_test.go': 15, 'thirdparty/pollEndpoint/main.go': 10, 'thirdparty/posinfo/posinfo.go': 1, 'unixfs/archive/archive.go': 2, 'unixfs/archive/tar/writer.go': 2, 'unixfs/hamt/hamt.go': 2, 'unixfs/io/dagreader.go': 2, 'unixfs/io/dirbuilder.go': 2, 'unixfs/io/pbdagreader.go': 2, 'unixfs/io/resolve.go': 2, 'unixfs/mod/dagmodifier.go': 4, 'unixfs/mod/dagmodifier_test.go': 2, 'unixfs/test/utils.go': 4, 'cmd/ipfs/util/ulimit.go': 9, 'cmd/seccat/util.go': 9, 'core/commands/log.go': 9, 'core/commands/object/patch.go': 9, 'core/corehttp/logs.go': 9, 'fuse/mount/mount.go': 9, 'fuse/node/mount_unix.go': 9, 'importer/chunk/splitting.go': 1, 'namesys/ipns_validate_test.go': 4, 'plugin/loader/load.go': 7, 'blocks/blockstoreutil/remove.go': 15, 'blockservice/test/mock.go': 4, 'core/commands/ipns.go': 6, 'namesys/validator.go': 3, 'cmd/ipfs/init.go': 10, 'core/commands/files.go': 14, 'core/core_test.go': 10, 'core/coreapi/pin.go': 14, 'fuse/ipns/common.go': 11, 'keystore/keystore.go': 8, 'keystore/keystore_test.go': 5, 'keystore/memkeystore.go': 5, 'namesys/interface.go': 11, 'path/resolver/resolver.go': 3, 'repo/config/identity.go': 2, 'thirdparty/verifbs/verifbs.go': 14, 'cmd/ipfs/util/ulimit_freebsd.go': 2, 'cmd/ipfs/util/ulimit_unix.go': 2, 'cmd/ipfswatch/main.go': 7, 'core/commands/active.go': 3, 'core/commands/bootstrap.go': 7, 'core/commands/config.go': 7, 'core/commands/diag.go': 3, 'core/commands/dns.go': 4, 'core/commands/external.go': 3, 'core/commands/ipnsps.go': 3, 'core/commands/mount_nofuse.go': 3, 'core/commands/mount_unix.go': 7, 'core/commands/mount_windows.go': 3, 'core/commands/name.go': 1, 'core/commands/object/diff.go': 4, 'core/commands/resolve.go': 11, 'core/commands/shutdown.go': 6, 'core/commands/tar.go': 11, 'core/commands/unixfs/ls.go': 11, 'core/commands/unixfs/unixfs.go': 3, 'core/commands/version.go': 4, 'core/coreapi/block.go': 4, 'core/coreapi/block_test.go': 2, 'core/coreapi/interface/coreapi.go': 2, 'core/coreapi/interface/dag.go': 2, 'core/coreapi/interface/object.go': 2, 'core/coreapi/interface/options/block.go': 2, 'core/coreapi/interface/path.go': 9, 'core/coreapi/interface/unixfs.go': 2, 'core/coreapi/object.go': 11, 'fuse/ipns/link_unix.go': 2, 'fuse/mount/fuse.go': 2, 'fuse/node/mount_darwin.go': 2, 'merkledag/errservice.go': 1, 'merkledag/readonly.go': 1, 'merkledag/readonly_test.go': 1, 'merkledag/rwservice.go': 1, 'merkledag/session.go': 1, 'path/resolver/resolver_test.go': 1, 'thirdparty/verifcid/validate.go': 1, 'thirdparty/verifcid/validate_test.go': 1, 'unixfs/hamt/hamt_stress_test.go': 1, 'unixfs/hamt/hamt_test.go': 1, 'namesys/ipns_resolver_validation_test.go': 11, 'test/sharness/t0170-dht.sh': 1, 'core/corehttp/metrics.go': 2, 'core/commands/env.go': 1, 'core/commands/urlstore.go': 10, 'core/coreapi/interface/key.go': 3, 'core/coreapi/name_test.go': 8, 'core/coreapi/path.go': 10, 'core/coreunix/cat.go': 4, 'core/pathresolver_test.go': 10, 'dagutils/diff.go': 10, 'dagutils/diffenum.go': 10, 'dagutils/diffenum_test.go': 10, 'dagutils/utils.go': 10, 'dagutils/utils_test.go': 10, 'filestore/pb/dataobj.pb.go': 3, 'mfs/fd.go': 2, 'namesys/base.go': 10, 'namesys/cache.go': 10, 'namesys/dns.go': 10, 'namesys/proquint.go': 10, 'pin/internal/pb/header.pb.go': 3, 'thirdparty/cidv0v1/blockstore.go': 10, 'core/commands/cmdenv/env.go': 6, 'core/commands/name/ipns.go': 8, 'core/commands/name/publish.go': 6, 'repo/fsrepo/config_test.go': 6, 'repo/fsrepo/misc.go': 6, 'test/bench/bench_cli_ipfs_add/main.go': 6, 'test/bench/offline_add/main.go': 6, 'plugin/datastore.go': 1, 'core/commands/name/ipnsps.go': 4, 'core/commands/name/name.go': 4, 'core/coreapi/dht.go': 7, 'core/coreapi/dht_test.go': 2, 'core/coreapi/interface/dht.go': 5, 'p2p/listener.go': 7, 'p2p/local.go': 7, 'p2p/remote.go': 7, 'p2p/stream.go': 7, 'core/coreapi/interface/swarm.go': 4, 'core/coreapi/swarm.go': 6, 'core/coreapi/interface/options/unixfs.go': 3, 'core/coreapi/pubsub.go': 5, 'core/coreapi/unixfile.go': 3, 'cmd/ipfs/dnsresolve_test.go': 2, 'core/commands/cid.go': 3, 'core/coreapi/interface/pubsub.go': 1, 'test/dependencies/iptb/iptb.go': 4, 'plugin/loader/preload.go': 1, 'plugin/loader/preload_list': 1, 'plugin/plugins/Rules.mk': 1, 'plugin/plugins/badgerds/badgerds.go': 4, 'plugin/plugins/flatfs/flatfs.go': 4, 'plugin/plugins/levelds/levelds.go': 4, 'commands/context.go': 2, 'core/commands/cmdenv/cidbase.go': 2, 'core/coreapi/test/api_test.go': 2, 'core/corehttp/ipns_hostname.go': 2, 'core/corehttp/proxy.go': 2, 'namesys/dns_test.go': 2, 'plugin/daemon.go': 2, 'plugin/loader/loader.go': 2, 'core/commands/cmdenv/cidbase_test.go': 1, 'core/commands/cmdenv/file.go': 1, 'core/corehttp/proxy_test.go': 1, 'core/corerepo/stat.go': 1, 'plugin/tracer.go': 1, 'thirdparty/notifier/notifier.go': 1}","('core/core.go', 0.5806451612903226, 0.1005586592178771)"
repo/fsrepo/fsrepo.go,491,2767,31,"[{'cyclomatic_complexity': 1, 'nloc': 3, 'token_count': 22, 'name': 'Error', 'long_name': '(err NoRepoError)Error', 'start_line': 58, 'end_line': 60, 'full_parameters': [], 'filename': '/home/dimi/Documents/Informatik_Studium/FSS/SoftEvo/DataCollection/FFS_SoftEvo/go-ipfs/repo/fsrepo/fsrepo.go', 'top_nesting_level': 0, 'length': 3, 'fan_in': 0, 'fan_out': 0, 'general_fan_out': 0}, {'cyclomatic_complexity': 1, 'nloc': 3, 'token_count': 17, 'name': '', 'long_name': '()(repo.Repo,error)', 'start_line': 109, 'end_line': 111, 'full_parameters': [], 'filename': '/home/dimi/Documents/Informatik_Studium/FSS/SoftEvo/DataCollection/FFS_SoftEvo/go-ipfs/repo/fsrepo/fsrepo.go', 'top_nesting_level': 0, 'length': 3, 'fan_in': 0, 'fan_out': 0, 'general_fan_out': 0}, {'cyclomatic_complexity': 1, 'nloc': 4, 'token_count': 27, 'name': 'Open', 'long_name': 'Open repoPath string', 'start_line': 108, 'end_line': 113, 'full_parameters': ['repoPath string'], 'filename': '/home/dimi/Documents/Informatik_Studium/FSS/SoftEvo/DataCollection/FFS_SoftEvo/go-ipfs/repo/fsrepo/fsrepo.go', 'top_nesting_level': 0, 'length': 6, 'fan_in': 0, 'fan_out': 0, 'general_fan_out': 0}, {'cyclomatic_complexity': 2, 'nloc': 5, 'token_count': 17, 'name': '', 'long_name': '()', 'start_line': 134, 'end_line': 139, 'full_parameters': [], 'filename': '/home/dimi/Documents/Informatik_Studium/FSS/SoftEvo/DataCollection/FFS_SoftEvo/go-ipfs/repo/fsrepo/fsrepo.go', 'top_nesting_level': 0, 'length': 6, 'fan_in': 0, 'fan_out': 0, 'general_fan_out': 0}, {'cyclomatic_complexity': 13, 'nloc': 46, 'token_count': 276, 'name': 'open', 'long_name': 'open repoPath string', 'start_line': 115, 'end_line': 180, 'full_parameters': ['repoPath string'], 'filename': '/home/dimi/Documents/Informatik_Studium/FSS/SoftEvo/DataCollection/FFS_SoftEvo/go-ipfs/repo/fsrepo/fsrepo.go', 'top_nesting_level': 0, 'length': 66, 'fan_in': 0, 'fan_out': 0, 'general_fan_out': 0}, {'cyclomatic_complexity': 2, 'nloc': 7, 'token_count': 49, 'name': 'newFSRepo', 'long_name': 'newFSRepo rpath string', 'start_line': 182, 'end_line': 189, 'full_parameters': ['rpath string'], 'filename': '/home/dimi/Documents/Informatik_Studium/FSS/SoftEvo/DataCollection/FFS_SoftEvo/go-ipfs/repo/fsrepo/fsrepo.go', 'top_nesting_level': 0, 'length': 8, 'fan_in': 0, 'fan_out': 0, 'general_fan_out': 0}, {'cyclomatic_complexity': 3, 'nloc': 10, 'token_count': 49, 'name': 'checkInitialized', 'long_name': 'checkInitialized path string', 'start_line': 191, 'end_line': 200, 'full_parameters': ['path string'], 'filename': '/home/dimi/Documents/Informatik_Studium/FSS/SoftEvo/DataCollection/FFS_SoftEvo/go-ipfs/repo/fsrepo/fsrepo.go', 'top_nesting_level': 0, 'length': 10, 'fan_in': 0, 'fan_out': 0, 'general_fan_out': 0}, {'cyclomatic_complexity': 2, 'nloc': 9, 'token_count': 54, 'name': 'ConfigAt', 'long_name': 'ConfigAt repoPath string', 'start_line': 205, 'end_line': 216, 'full_parameters': ['repoPath string'], 'filename': '/home/dimi/Documents/Informatik_Studium/FSS/SoftEvo/DataCollection/FFS_SoftEvo/go-ipfs/repo/fsrepo/fsrepo.go', 'top_nesting_level': 0, 'length': 12, 'fan_in': 0, 'fan_out': 0, 'general_fan_out': 0}, {'cyclomatic_complexity': 3, 'nloc': 10, 'token_count': 41, 'name': 'configIsInitialized', 'long_name': 'configIsInitialized path string', 'start_line': 220, 'end_line': 229, 'full_parameters': ['path string'], 'filename': '/home/dimi/Documents/Informatik_Studium/FSS/SoftEvo/DataCollection/FFS_SoftEvo/go-ipfs/repo/fsrepo/fsrepo.go', 'top_nesting_level': 0, 'length': 10, 'fan_in': 0, 'fan_out': 0, 'general_fan_out': 0}, {'cyclomatic_complexity': 4, 'nloc': 13, 'token_count': 63, 'name': 'initConfig', 'long_name': 'initConfig path string , conf * config . Config', 'start_line': 231, 'end_line': 247, 'full_parameters': ['path string', ' conf * config . Config'], 'filename': '/home/dimi/Documents/Informatik_Studium/FSS/SoftEvo/DataCollection/FFS_SoftEvo/go-ipfs/repo/fsrepo/fsrepo.go', 'top_nesting_level': 0, 'length': 17, 'fan_in': 0, 'fan_out': 0, 'general_fan_out': 0}, {'cyclomatic_complexity': 4, 'nloc': 15, 'token_count': 87, 'name': 'initSpec', 'long_name': 'initSpec path string , conf map [ string ] interface { }', 'start_line': 249, 'end_line': 266, 'full_parameters': ['path string', ' conf map [ string ] interface { }'], 'filename': '/home/dimi/Documents/Informatik_Studium/FSS/SoftEvo/DataCollection/FFS_SoftEvo/go-ipfs/repo/fsrepo/fsrepo.go', 'top_nesting_level': 0, 'length': 18, 'fan_in': 0, 'fan_out': 0, 'general_fan_out': 0}, {'cyclomatic_complexity': 5, 'nloc': 17, 'token_count': 97, 'name': 'Init', 'long_name': 'Init repoPath string , conf * config . Config', 'start_line': 270, 'end_line': 294, 'full_parameters': ['repoPath string', ' conf * config . Config'], 'filename': '/home/dimi/Documents/Informatik_Studium/FSS/SoftEvo/DataCollection/FFS_SoftEvo/go-ipfs/repo/fsrepo/fsrepo.go', 'top_nesting_level': 0, 'length': 25, 'fan_in': 0, 'fan_out': 0, 'general_fan_out': 0}, {'cyclomatic_complexity': 2, 'nloc': 8, 'token_count': 49, 'name': 'LockedByOtherProcess', 'long_name': 'LockedByOtherProcess repoPath string', 'start_line': 298, 'end_line': 305, 'full_parameters': ['repoPath string'], 'filename': '/home/dimi/Documents/Informatik_Studium/FSS/SoftEvo/DataCollection/FFS_SoftEvo/go-ipfs/repo/fsrepo/fsrepo.go', 'top_nesting_level': 0, 'length': 8, 'fan_in': 0, 'fan_out': 0, 'general_fan_out': 0}, {'cyclomatic_complexity': 5, 'nloc': 20, 'token_count': 135, 'name': 'APIAddr', 'long_name': 'APIAddr repoPath string', 'start_line': 311, 'end_line': 336, 'full_parameters': ['repoPath string'], 'filename': '/home/dimi/Documents/Informatik_Studium/FSS/SoftEvo/DataCollection/FFS_SoftEvo/go-ipfs/repo/fsrepo/fsrepo.go', 'top_nesting_level': 0, 'length': 26, 'fan_in': 0, 'fan_out': 0, 'general_fan_out': 0}, {'cyclomatic_complexity': 1, 'nloc': 3, 'token_count': 18, 'name': 'Keystore', 'long_name': '(r*FSRepo)Keystore', 'start_line': 338, 'end_line': 340, 'full_parameters': [], 'filename': '/home/dimi/Documents/Informatik_Studium/FSS/SoftEvo/DataCollection/FFS_SoftEvo/go-ipfs/repo/fsrepo/fsrepo.go', 'top_nesting_level': 0, 'length': 3, 'fan_in': 0, 'fan_out': 0, 'general_fan_out': 0}, {'cyclomatic_complexity': 1, 'nloc': 3, 'token_count': 16, 'name': 'Path', 'long_name': '(r*FSRepo)Path', 'start_line': 342, 'end_line': 344, 'full_parameters': [], 'filename': '/home/dimi/Documents/Informatik_Studium/FSS/SoftEvo/DataCollection/FFS_SoftEvo/go-ipfs/repo/fsrepo/fsrepo.go', 'top_nesting_level': 0, 'length': 3, 'fan_in': 0, 'fan_out': 0, 'general_fan_out': 0}, {'cyclomatic_complexity': 2, 'nloc': 9, 'token_count': 65, 'name': 'SetAPIAddr', 'long_name': '(r*FSRepo)SetAPIAddr addr ma . Multiaddr', 'start_line': 347, 'end_line': 356, 'full_parameters': ['addr ma . Multiaddr'], 'filename': '/home/dimi/Documents/Informatik_Studium/FSS/SoftEvo/DataCollection/FFS_SoftEvo/go-ipfs/repo/fsrepo/fsrepo.go', 'top_nesting_level': 0, 'length': 10, 'fan_in': 0, 'fan_out': 0, 'general_fan_out': 0}, {'cyclomatic_complexity': 3, 'nloc': 12, 'token_count': 57, 'name': 'openConfig', 'long_name': '(r*FSRepo)openConfig', 'start_line': 359, 'end_line': 370, 'full_parameters': [], 'filename': '/home/dimi/Documents/Informatik_Studium/FSS/SoftEvo/DataCollection/FFS_SoftEvo/go-ipfs/repo/fsrepo/fsrepo.go', 'top_nesting_level': 0, 'length': 12, 'fan_in': 0, 'fan_out': 0, 'general_fan_out': 0}, {'cyclomatic_complexity': 2, 'nloc': 9, 'token_count': 49, 'name': 'openKeystore', 'long_name': '(r*FSRepo)openKeystore', 'start_line': 372, 'end_line': 382, 'full_parameters': [], 'filename': '/home/dimi/Documents/Informatik_Studium/FSS/SoftEvo/DataCollection/FFS_SoftEvo/go-ipfs/repo/fsrepo/fsrepo.go', 'top_nesting_level': 0, 'length': 11, 'fan_in': 0, 'fan_out': 0, 'general_fan_out': 0}, {'cyclomatic_complexity': 8, 'nloc': 28, 'token_count': 176, 'name': 'openDatastore', 'long_name': '(r*FSRepo)openDatastore', 'start_line': 385, 'end_line': 418, 'full_parameters': [], 'filename': '/home/dimi/Documents/Informatik_Studium/FSS/SoftEvo/DataCollection/FFS_SoftEvo/go-ipfs/repo/fsrepo/fsrepo.go', 'top_nesting_level': 0, 'length': 34, 'fan_in': 0, 'fan_out': 0, 'general_fan_out': 0}, {'cyclomatic_complexity': 3, 'nloc': 11, 'token_count': 72, 'name': 'readSpec', 'long_name': '(r*FSRepo)readSpec', 'start_line': 420, 'end_line': 430, 'full_parameters': [], 'filename': '/home/dimi/Documents/Informatik_Studium/FSS/SoftEvo/DataCollection/FFS_SoftEvo/go-ipfs/repo/fsrepo/fsrepo.go', 'top_nesting_level': 0, 'length': 11, 'fan_in': 0, 'fan_out': 0, 'general_fan_out': 0}, {'cyclomatic_complexity': 5, 'nloc': 16, 'token_count': 106, 'name': 'Close', 'long_name': '(r*FSRepo)Close', 'start_line': 433, 'end_line': 460, 'full_parameters': [], 'filename': '/home/dimi/Documents/Informatik_Studium/FSS/SoftEvo/DataCollection/FFS_SoftEvo/go-ipfs/repo/fsrepo/fsrepo.go', 'top_nesting_level': 0, 'length': 28, 'fan_in': 0, 'fan_out': 0, 'general_fan_out': 0}, {'cyclomatic_complexity': 2, 'nloc': 8, 'token_count': 51, 'name': 'Config', 'long_name': '(r*FSRepo)Config', 'start_line': 463, 'end_line': 477, 'full_parameters': [], 'filename': '/home/dimi/Documents/Informatik_Studium/FSS/SoftEvo/DataCollection/FFS_SoftEvo/go-ipfs/repo/fsrepo/fsrepo.go', 'top_nesting_level': 0, 'length': 15, 'fan_in': 0, 'fan_out': 0, 'general_fan_out': 0}, {'cyclomatic_complexity': 1, 'nloc': 3, 'token_count': 19, 'name': 'FileManager', 'long_name': '(r*FSRepo)FileManager', 'start_line': 479, 'end_line': 481, 'full_parameters': [], 'filename': '/home/dimi/Documents/Informatik_Studium/FSS/SoftEvo/DataCollection/FFS_SoftEvo/go-ipfs/repo/fsrepo/fsrepo.go', 'top_nesting_level': 0, 'length': 3, 'fan_in': 0, 'fan_out': 0, 'general_fan_out': 0}, {'cyclomatic_complexity': 6, 'nloc': 22, 'token_count': 127, 'name': 'setConfigUnsynced', 'long_name': '(r*FSRepo)setConfigUnsynced updated * config . Config', 'start_line': 484, 'end_line': 508, 'full_parameters': ['updated * config . Config'], 'filename': '/home/dimi/Documents/Informatik_Studium/FSS/SoftEvo/DataCollection/FFS_SoftEvo/go-ipfs/repo/fsrepo/fsrepo.go', 'top_nesting_level': 0, 'length': 25, 'fan_in': 0, 'fan_out': 0, 'general_fan_out': 0}, {'cyclomatic_complexity': 1, 'nloc': 5, 'token_count': 35, 'name': 'SetConfig', 'long_name': '(r*FSRepo)SetConfig updated * config . Config', 'start_line': 511, 'end_line': 518, 'full_parameters': ['updated * config . Config'], 'filename': '/home/dimi/Documents/Informatik_Studium/FSS/SoftEvo/DataCollection/FFS_SoftEvo/go-ipfs/repo/fsrepo/fsrepo.go', 'top_nesting_level': 0, 'length': 8, 'fan_in': 0, 'fan_out': 0, 'general_fan_out': 0}, {'cyclomatic_complexity': 1, 'nloc': 1, 'token_count': 15, 'name': 'GetConfigKey', 'long_name': '(r*FSRepo)GetConfigKey key string', 'start_line': 521, 'end_line': 521, 'full_parameters': ['key string'], 'filename': '/home/dimi/Documents/Informatik_Studium/FSS/SoftEvo/DataCollection/FFS_SoftEvo/go-ipfs/repo/fsrepo/fsrepo.go', 'top_nesting_level': 0, 'length': 1, 'fan_in': 0, 'fan_out': 0, 'general_fan_out': 0}, {'cyclomatic_complexity': 19, 'nloc': 67, 'token_count': 369, 'name': 'SetConfigKey', 'long_name': '(r*FSRepo)SetConfigKey key string , value interface { }', 'start_line': 541, 'end_line': 622, 'full_parameters': ['key string', ' value interface { }'], 'filename': '/home/dimi/Documents/Informatik_Studium/FSS/SoftEvo/DataCollection/FFS_SoftEvo/go-ipfs/repo/fsrepo/fsrepo.go', 'top_nesting_level': 0, 'length': 82, 'fan_in': 0, 'fan_out': 0, 'general_fan_out': 0}, {'cyclomatic_complexity': 1, 'nloc': 6, 'token_count': 31, 'name': 'Datastore', 'long_name': '(r*FSRepo)Datastore', 'start_line': 626, 'end_line': 631, 'full_parameters': [], 'filename': '/home/dimi/Documents/Informatik_Studium/FSS/SoftEvo/DataCollection/FFS_SoftEvo/go-ipfs/repo/fsrepo/fsrepo.go', 'top_nesting_level': 0, 'length': 6, 'fan_in': 0, 'fan_out': 0, 'general_fan_out': 0}, {'cyclomatic_complexity': 3, 'nloc': 10, 'token_count': 50, 'name': 'error', 'long_name': '(p string,f os.FileInfo,err error)error', 'start_line': 641, 'end_line': 650, 'full_parameters': [], 'filename': '/home/dimi/Documents/Informatik_Studium/FSS/SoftEvo/DataCollection/FFS_SoftEvo/go-ipfs/repo/fsrepo/fsrepo.go', 'top_nesting_level': 0, 'length': 10, 'fan_in': 0, 'fan_out': 0, 'general_fan_out': 0}, {'cyclomatic_complexity': 1, 'nloc': 1, 'token_count': 2, 'name': '', 'long_name': '(', 'start_line': 654, 'end_line': 654, 'full_parameters': [], 'filename': '/home/dimi/Documents/Informatik_Studium/FSS/SoftEvo/DataCollection/FFS_SoftEvo/go-ipfs/repo/fsrepo/fsrepo.go', 'top_nesting_level': 0, 'length': 1, 'fan_in': 0, 'fan_out': 0, 'general_fan_out': 0}]",479,2814,34,"[{'cyclomatic_complexity': 1, 'nloc': 3, 'token_count': 22, 'name': 'Error', 'long_name': '(err NoRepoError)Error', 'start_line': 61, 'end_line': 63, 'full_parameters': [], 'filename': '/home/dimi/Documents/Informatik_Studium/FSS/SoftEvo/DataCollection/FFS_SoftEvo/go-ipfs/repo/fsrepo/fsrepo.go', 'top_nesting_level': 0, 'length': 3, 'fan_in': 0, 'fan_out': 0, 'general_fan_out': 0}, {'cyclomatic_complexity': 1, 'nloc': 3, 'token_count': 17, 'name': '', 'long_name': '()(repo.Repo,error)', 'start_line': 112, 'end_line': 114, 'full_parameters': [], 'filename': '/home/dimi/Documents/Informatik_Studium/FSS/SoftEvo/DataCollection/FFS_SoftEvo/go-ipfs/repo/fsrepo/fsrepo.go', 'top_nesting_level': 0, 'length': 3, 'fan_in': 0, 'fan_out': 0, 'general_fan_out': 0}, {'cyclomatic_complexity': 1, 'nloc': 4, 'token_count': 27, 'name': 'Open', 'long_name': 'Open repoPath string', 'start_line': 111, 'end_line': 116, 'full_parameters': ['repoPath string'], 'filename': '/home/dimi/Documents/Informatik_Studium/FSS/SoftEvo/DataCollection/FFS_SoftEvo/go-ipfs/repo/fsrepo/fsrepo.go', 'top_nesting_level': 0, 'length': 6, 'fan_in': 0, 'fan_out': 0, 'general_fan_out': 0}, {'cyclomatic_complexity': 2, 'nloc': 5, 'token_count': 17, 'name': '', 'long_name': '()', 'start_line': 137, 'end_line': 142, 'full_parameters': [], 'filename': '/home/dimi/Documents/Informatik_Studium/FSS/SoftEvo/DataCollection/FFS_SoftEvo/go-ipfs/repo/fsrepo/fsrepo.go', 'top_nesting_level': 0, 'length': 6, 'fan_in': 0, 'fan_out': 0, 'general_fan_out': 0}, {'cyclomatic_complexity': 14, 'nloc': 48, 'token_count': 308, 'name': 'open', 'long_name': 'open repoPath string', 'start_line': 118, 'end_line': 185, 'full_parameters': ['repoPath string'], 'filename': '/home/dimi/Documents/Informatik_Studium/FSS/SoftEvo/DataCollection/FFS_SoftEvo/go-ipfs/repo/fsrepo/fsrepo.go', 'top_nesting_level': 0, 'length': 68, 'fan_in': 0, 'fan_out': 0, 'general_fan_out': 0}, {'cyclomatic_complexity': 2, 'nloc': 7, 'token_count': 49, 'name': 'newFSRepo', 'long_name': 'newFSRepo rpath string', 'start_line': 187, 'end_line': 194, 'full_parameters': ['rpath string'], 'filename': '/home/dimi/Documents/Informatik_Studium/FSS/SoftEvo/DataCollection/FFS_SoftEvo/go-ipfs/repo/fsrepo/fsrepo.go', 'top_nesting_level': 0, 'length': 8, 'fan_in': 0, 'fan_out': 0, 'general_fan_out': 0}, {'cyclomatic_complexity': 3, 'nloc': 10, 'token_count': 49, 'name': 'checkInitialized', 'long_name': 'checkInitialized path string', 'start_line': 196, 'end_line': 205, 'full_parameters': ['path string'], 'filename': '/home/dimi/Documents/Informatik_Studium/FSS/SoftEvo/DataCollection/FFS_SoftEvo/go-ipfs/repo/fsrepo/fsrepo.go', 'top_nesting_level': 0, 'length': 10, 'fan_in': 0, 'fan_out': 0, 'general_fan_out': 0}, {'cyclomatic_complexity': 2, 'nloc': 9, 'token_count': 54, 'name': 'ConfigAt', 'long_name': 'ConfigAt repoPath string', 'start_line': 210, 'end_line': 221, 'full_parameters': ['repoPath string'], 'filename': '/home/dimi/Documents/Informatik_Studium/FSS/SoftEvo/DataCollection/FFS_SoftEvo/go-ipfs/repo/fsrepo/fsrepo.go', 'top_nesting_level': 0, 'length': 12, 'fan_in': 0, 'fan_out': 0, 'general_fan_out': 0}, {'cyclomatic_complexity': 3, 'nloc': 10, 'token_count': 41, 'name': 'configIsInitialized', 'long_name': 'configIsInitialized path string', 'start_line': 225, 'end_line': 234, 'full_parameters': ['path string'], 'filename': '/home/dimi/Documents/Informatik_Studium/FSS/SoftEvo/DataCollection/FFS_SoftEvo/go-ipfs/repo/fsrepo/fsrepo.go', 'top_nesting_level': 0, 'length': 10, 'fan_in': 0, 'fan_out': 0, 'general_fan_out': 0}, {'cyclomatic_complexity': 4, 'nloc': 13, 'token_count': 63, 'name': 'initConfig', 'long_name': 'initConfig path string , conf * config . Config', 'start_line': 236, 'end_line': 252, 'full_parameters': ['path string', ' conf * config . Config'], 'filename': '/home/dimi/Documents/Informatik_Studium/FSS/SoftEvo/DataCollection/FFS_SoftEvo/go-ipfs/repo/fsrepo/fsrepo.go', 'top_nesting_level': 0, 'length': 17, 'fan_in': 0, 'fan_out': 0, 'general_fan_out': 0}, {'cyclomatic_complexity': 4, 'nloc': 15, 'token_count': 87, 'name': 'initSpec', 'long_name': 'initSpec path string , conf map [ string ] interface { }', 'start_line': 254, 'end_line': 271, 'full_parameters': ['path string', ' conf map [ string ] interface { }'], 'filename': '/home/dimi/Documents/Informatik_Studium/FSS/SoftEvo/DataCollection/FFS_SoftEvo/go-ipfs/repo/fsrepo/fsrepo.go', 'top_nesting_level': 0, 'length': 18, 'fan_in': 0, 'fan_out': 0, 'general_fan_out': 0}, {'cyclomatic_complexity': 5, 'nloc': 17, 'token_count': 94, 'name': 'Init', 'long_name': 'Init repoPath string , conf * config . Config', 'start_line': 275, 'end_line': 299, 'full_parameters': ['repoPath string', ' conf * config . Config'], 'filename': '/home/dimi/Documents/Informatik_Studium/FSS/SoftEvo/DataCollection/FFS_SoftEvo/go-ipfs/repo/fsrepo/fsrepo.go', 'top_nesting_level': 0, 'length': 25, 'fan_in': 0, 'fan_out': 0, 'general_fan_out': 0}, {'cyclomatic_complexity': 2, 'nloc': 8, 'token_count': 51, 'name': 'LockedByOtherProcess', 'long_name': 'LockedByOtherProcess repoPath string', 'start_line': 303, 'end_line': 310, 'full_parameters': ['repoPath string'], 'filename': '/home/dimi/Documents/Informatik_Studium/FSS/SoftEvo/DataCollection/FFS_SoftEvo/go-ipfs/repo/fsrepo/fsrepo.go', 'top_nesting_level': 0, 'length': 8, 'fan_in': 0, 'fan_out': 0, 'general_fan_out': 0}, {'cyclomatic_complexity': 5, 'nloc': 22, 'token_count': 142, 'name': 'APIAddr', 'long_name': 'APIAddr repoPath string', 'start_line': 316, 'end_line': 349, 'full_parameters': ['repoPath string'], 'filename': '/home/dimi/Documents/Informatik_Studium/FSS/SoftEvo/DataCollection/FFS_SoftEvo/go-ipfs/repo/fsrepo/fsrepo.go', 'top_nesting_level': 0, 'length': 34, 'fan_in': 0, 'fan_out': 0, 'general_fan_out': 0}, {'cyclomatic_complexity': 1, 'nloc': 3, 'token_count': 18, 'name': 'Keystore', 'long_name': '(r*FSRepo)Keystore', 'start_line': 351, 'end_line': 353, 'full_parameters': [], 'filename': '/home/dimi/Documents/Informatik_Studium/FSS/SoftEvo/DataCollection/FFS_SoftEvo/go-ipfs/repo/fsrepo/fsrepo.go', 'top_nesting_level': 0, 'length': 3, 'fan_in': 0, 'fan_out': 0, 'general_fan_out': 0}, {'cyclomatic_complexity': 1, 'nloc': 3, 'token_count': 16, 'name': 'Path', 'long_name': '(r*FSRepo)Path', 'start_line': 355, 'end_line': 357, 'full_parameters': [], 'filename': '/home/dimi/Documents/Informatik_Studium/FSS/SoftEvo/DataCollection/FFS_SoftEvo/go-ipfs/repo/fsrepo/fsrepo.go', 'top_nesting_level': 0, 'length': 3, 'fan_in': 0, 'fan_out': 0, 'general_fan_out': 0}, {'cyclomatic_complexity': 6, 'nloc': 21, 'token_count': 176, 'name': 'SetAPIAddr', 'long_name': '(r*FSRepo)SetAPIAddr addr ma . Multiaddr', 'start_line': 360, 'end_line': 386, 'full_parameters': ['addr ma . Multiaddr'], 'filename': '/home/dimi/Documents/Informatik_Studium/FSS/SoftEvo/DataCollection/FFS_SoftEvo/go-ipfs/repo/fsrepo/fsrepo.go', 'top_nesting_level': 0, 'length': 27, 'fan_in': 0, 'fan_out': 0, 'general_fan_out': 0}, {'cyclomatic_complexity': 3, 'nloc': 12, 'token_count': 57, 'name': 'openConfig', 'long_name': '(r*FSRepo)openConfig', 'start_line': 389, 'end_line': 400, 'full_parameters': [], 'filename': '/home/dimi/Documents/Informatik_Studium/FSS/SoftEvo/DataCollection/FFS_SoftEvo/go-ipfs/repo/fsrepo/fsrepo.go', 'top_nesting_level': 0, 'length': 12, 'fan_in': 0, 'fan_out': 0, 'general_fan_out': 0}, {'cyclomatic_complexity': 2, 'nloc': 9, 'token_count': 49, 'name': 'openKeystore', 'long_name': '(r*FSRepo)openKeystore', 'start_line': 402, 'end_line': 412, 'full_parameters': [], 'filename': '/home/dimi/Documents/Informatik_Studium/FSS/SoftEvo/DataCollection/FFS_SoftEvo/go-ipfs/repo/fsrepo/fsrepo.go', 'top_nesting_level': 0, 'length': 11, 'fan_in': 0, 'fan_out': 0, 'general_fan_out': 0}, {'cyclomatic_complexity': 9, 'nloc': 31, 'token_count': 192, 'name': 'openDatastore', 'long_name': '(r*FSRepo)openDatastore', 'start_line': 415, 'end_line': 451, 'full_parameters': [], 'filename': '/home/dimi/Documents/Informatik_Studium/FSS/SoftEvo/DataCollection/FFS_SoftEvo/go-ipfs/repo/fsrepo/fsrepo.go', 'top_nesting_level': 0, 'length': 37, 'fan_in': 0, 'fan_out': 0, 'general_fan_out': 0}, {'cyclomatic_complexity': 3, 'nloc': 11, 'token_count': 72, 'name': 'readSpec', 'long_name': '(r*FSRepo)readSpec', 'start_line': 453, 'end_line': 463, 'full_parameters': [], 'filename': '/home/dimi/Documents/Informatik_Studium/FSS/SoftEvo/DataCollection/FFS_SoftEvo/go-ipfs/repo/fsrepo/fsrepo.go', 'top_nesting_level': 0, 'length': 11, 'fan_in': 0, 'fan_out': 0, 'general_fan_out': 0}, {'cyclomatic_complexity': 5, 'nloc': 16, 'token_count': 106, 'name': 'Close', 'long_name': '(r*FSRepo)Close', 'start_line': 466, 'end_line': 493, 'full_parameters': [], 'filename': '/home/dimi/Documents/Informatik_Studium/FSS/SoftEvo/DataCollection/FFS_SoftEvo/go-ipfs/repo/fsrepo/fsrepo.go', 'top_nesting_level': 0, 'length': 28, 'fan_in': 0, 'fan_out': 0, 'general_fan_out': 0}, {'cyclomatic_complexity': 2, 'nloc': 8, 'token_count': 51, 'name': 'Config', 'long_name': '(r*FSRepo)Config', 'start_line': 499, 'end_line': 512, 'full_parameters': [], 'filename': '/home/dimi/Documents/Informatik_Studium/FSS/SoftEvo/DataCollection/FFS_SoftEvo/go-ipfs/repo/fsrepo/fsrepo.go', 'top_nesting_level': 0, 'length': 14, 'fan_in': 0, 'fan_out': 0, 'general_fan_out': 0}, {'cyclomatic_complexity': 1, 'nloc': 3, 'token_count': 19, 'name': 'FileManager', 'long_name': '(r*FSRepo)FileManager', 'start_line': 514, 'end_line': 516, 'full_parameters': [], 'filename': '/home/dimi/Documents/Informatik_Studium/FSS/SoftEvo/DataCollection/FFS_SoftEvo/go-ipfs/repo/fsrepo/fsrepo.go', 'top_nesting_level': 0, 'length': 3, 'fan_in': 0, 'fan_out': 0, 'general_fan_out': 0}, {'cyclomatic_complexity': 5, 'nloc': 21, 'token_count': 134, 'name': 'BackupConfig', 'long_name': '(r*FSRepo)BackupConfig prefix string', 'start_line': 518, 'end_line': 542, 'full_parameters': ['prefix string'], 'filename': '/home/dimi/Documents/Informatik_Studium/FSS/SoftEvo/DataCollection/FFS_SoftEvo/go-ipfs/repo/fsrepo/fsrepo.go', 'top_nesting_level': 0, 'length': 25, 'fan_in': 0, 'fan_out': 0, 'general_fan_out': 0}, {'cyclomatic_complexity': 6, 'nloc': 22, 'token_count': 125, 'name': 'setConfigUnsynced', 'long_name': '(r*FSRepo)setConfigUnsynced updated * config . Config', 'start_line': 545, 'end_line': 571, 'full_parameters': ['updated * config . Config'], 'filename': '/home/dimi/Documents/Informatik_Studium/FSS/SoftEvo/DataCollection/FFS_SoftEvo/go-ipfs/repo/fsrepo/fsrepo.go', 'top_nesting_level': 0, 'length': 27, 'fan_in': 0, 'fan_out': 0, 'general_fan_out': 0}, {'cyclomatic_complexity': 1, 'nloc': 5, 'token_count': 35, 'name': 'SetConfig', 'long_name': '(r*FSRepo)SetConfig updated * config . Config', 'start_line': 575, 'end_line': 582, 'full_parameters': ['updated * config . Config'], 'filename': '/home/dimi/Documents/Informatik_Studium/FSS/SoftEvo/DataCollection/FFS_SoftEvo/go-ipfs/repo/fsrepo/fsrepo.go', 'top_nesting_level': 0, 'length': 8, 'fan_in': 0, 'fan_out': 0, 'general_fan_out': 0}, {'cyclomatic_complexity': 1, 'nloc': 1, 'token_count': 15, 'name': 'GetConfigKey', 'long_name': '(r*FSRepo)GetConfigKey key string', 'start_line': 585, 'end_line': 585, 'full_parameters': ['key string'], 'filename': '/home/dimi/Documents/Informatik_Studium/FSS/SoftEvo/DataCollection/FFS_SoftEvo/go-ipfs/repo/fsrepo/fsrepo.go', 'top_nesting_level': 0, 'length': 1, 'fan_in': 0, 'fan_out': 0, 'general_fan_out': 0}, {'cyclomatic_complexity': 9, 'nloc': 33, 'token_count': 202, 'name': 'SetConfigKey', 'long_name': '(r*FSRepo)SetConfigKey key string , value interface { }', 'start_line': 605, 'end_line': 651, 'full_parameters': ['key string', ' value interface { }'], 'filename': '/home/dimi/Documents/Informatik_Studium/FSS/SoftEvo/DataCollection/FFS_SoftEvo/go-ipfs/repo/fsrepo/fsrepo.go', 'top_nesting_level': 0, 'length': 47, 'fan_in': 0, 'fan_out': 0, 'general_fan_out': 0}, {'cyclomatic_complexity': 1, 'nloc': 6, 'token_count': 31, 'name': 'Datastore', 'long_name': '(r*FSRepo)Datastore', 'start_line': 655, 'end_line': 660, 'full_parameters': [], 'filename': '/home/dimi/Documents/Informatik_Studium/FSS/SoftEvo/DataCollection/FFS_SoftEvo/go-ipfs/repo/fsrepo/fsrepo.go', 'top_nesting_level': 0, 'length': 6, 'fan_in': 0, 'fan_out': 0, 'general_fan_out': 0}, {'cyclomatic_complexity': 1, 'nloc': 3, 'token_count': 27, 'name': 'GetStorageUsage', 'long_name': '(r*FSRepo)GetStorageUsage', 'start_line': 663, 'end_line': 665, 'full_parameters': [], 'filename': '/home/dimi/Documents/Informatik_Studium/FSS/SoftEvo/DataCollection/FFS_SoftEvo/go-ipfs/repo/fsrepo/fsrepo.go', 'top_nesting_level': 0, 'length': 3, 'fan_in': 0, 'fan_out': 0, 'general_fan_out': 0}, {'cyclomatic_complexity': 3, 'nloc': 13, 'token_count': 83, 'name': 'SwarmKey', 'long_name': '(r*FSRepo)SwarmKey', 'start_line': 667, 'end_line': 681, 'full_parameters': [], 'filename': '/home/dimi/Documents/Informatik_Studium/FSS/SoftEvo/DataCollection/FFS_SoftEvo/go-ipfs/repo/fsrepo/fsrepo.go', 'top_nesting_level': 0, 'length': 15, 'fan_in': 0, 'fan_out': 0, 'general_fan_out': 0}, {'cyclomatic_complexity': 1, 'nloc': 5, 'token_count': 25, 'name': 'IsInitialized', 'long_name': 'IsInitialized path string', 'start_line': 687, 'end_line': 694, 'full_parameters': ['path string'], 'filename': '/home/dimi/Documents/Informatik_Studium/FSS/SoftEvo/DataCollection/FFS_SoftEvo/go-ipfs/repo/fsrepo/fsrepo.go', 'top_nesting_level': 0, 'length': 8, 'fan_in': 0, 'fan_out': 0, 'general_fan_out': 0}, {'cyclomatic_complexity': 1, 'nloc': 3, 'token_count': 14, 'name': 'isInitializedUnsynced', 'long_name': 'isInitializedUnsynced repoPath string', 'start_line': 700, 'end_line': 702, 'full_parameters': ['repoPath string'], 'filename': '/home/dimi/Documents/Informatik_Studium/FSS/SoftEvo/DataCollection/FFS_SoftEvo/go-ipfs/repo/fsrepo/fsrepo.go', 'top_nesting_level': 0, 'length': 3, 'fan_in': 0, 'fan_out': 0, 'general_fan_out': 0}]",-12,47,3,69,69,"[{'timestamp': 1507989564.0, 'added_lines': 7, 'deleted_lines': 1, 'nloc': 496}, {'timestamp': 1508628147.0, 'added_lines': 2, 'deleted_lines': 2, 'nloc': 496}, {'timestamp': 1511062375.0, 'added_lines': 1, 'deleted_lines': 1, 'nloc': 496}, {'timestamp': 1512365669.0, 'added_lines': 2, 'deleted_lines': 2, 'nloc': 496}, {'timestamp': 1513367731.0, 'added_lines': 26, 'deleted_lines': 0, 'nloc': 517}, {'timestamp': 1516838128.0, 'added_lines': 3, 'deleted_lines': 3, 'nloc': 517}, {'timestamp': 1517453697.0, 'added_lines': 1, 'deleted_lines': 1, 'nloc': 517}, {'timestamp': 1521687673.0, 'added_lines': 0, 'deleted_lines': 1, 'nloc': 516}, {'timestamp': 1520477499.0, 'added_lines': 12, 'deleted_lines': 4, 'nloc': 519}, {'timestamp': 1519761835.0, 'added_lines': 1, 'deleted_lines': 1, 'nloc': 518}, {'timestamp': 1517406188.0, 'added_lines': 7, 'deleted_lines': 3, 'nloc': 519}, {'timestamp': 1520597581.0, 'added_lines': 1, 'deleted_lines': 1, 'nloc': 519}, {'timestamp': 1521399286.0, 'added_lines': 3, 'deleted_lines': 3, 'nloc': 519}, {'timestamp': 1521427288.0, 'added_lines': 1, 'deleted_lines': 1, 'nloc': 519}, {'timestamp': 1523452491.0, 'added_lines': 1, 'deleted_lines': 1, 'nloc': 519}, {'timestamp': 1524184298.0, 'added_lines': 2, 'deleted_lines': 6, 'nloc': 515}, {'timestamp': 1527364276.0, 'added_lines': 3, 'deleted_lines': 0, 'nloc': 518}, {'timestamp': 1525408792.0, 'added_lines': 3, 'deleted_lines': 3, 'nloc': 518}, {'timestamp': 1527822202.0, 'added_lines': 1, 'deleted_lines': 1, 'nloc': 518}, {'timestamp': 1528520460.0, 'added_lines': 4, 'deleted_lines': 4, 'nloc': 518}, {'timestamp': 1529984485.0, 'added_lines': 3, 'deleted_lines': 3, 'nloc': 518}, {'timestamp': 1515171178.0, 'added_lines': 2, 'deleted_lines': 23, 'nloc': 499}, {'timestamp': 1529787837.0, 'added_lines': 3, 'deleted_lines': 1, 'nloc': 520}, {'timestamp': 1532146078.0, 'added_lines': 1, 'deleted_lines': 1, 'nloc': 501}, {'timestamp': 1533779477.0, 'added_lines': 2, 'deleted_lines': 2, 'nloc': 501}, {'timestamp': 1532287909.0, 'added_lines': 1, 'deleted_lines': 1, 'nloc': 501}, {'timestamp': 1532357069.0, 'added_lines': 2, 'deleted_lines': 2, 'nloc': 501}, {'timestamp': 1532365899.0, 'added_lines': 2, 'deleted_lines': 2, 'nloc': 501}, {'timestamp': 1532388583.0, 'added_lines': 1, 'deleted_lines': 1, 'nloc': 501}, {'timestamp': 1533809170.0, 'added_lines': 2, 'deleted_lines': 2, 'nloc': 501}, {'timestamp': 1534195762.0, 'added_lines': 2, 'deleted_lines': 2, 'nloc': 501}, {'timestamp': 1534072974.0, 'added_lines': 2, 'deleted_lines': 2, 'nloc': 501}, {'timestamp': 1534896611.0, 'added_lines': 2, 'deleted_lines': 2, 'nloc': 501}, {'timestamp': 1535255498.0, 'added_lines': 2, 'deleted_lines': 2, 'nloc': 501}, {'timestamp': 1535601896.0, 'added_lines': 2, 'deleted_lines': 2, 'nloc': 501}, {'timestamp': 1536388808.0, 'added_lines': 4, 'deleted_lines': 4, 'nloc': 501}, {'timestamp': 1536357700.0, 'added_lines': 1, 'deleted_lines': 2, 'nloc': 501}, {'timestamp': 1537792589.0, 'added_lines': 6, 'deleted_lines': 6, 'nloc': 501}, {'timestamp': 1538544957.0, 'added_lines': 4, 'deleted_lines': 4, 'nloc': 501}, {'timestamp': 1538547366.0, 'added_lines': 2, 'deleted_lines': 2, 'nloc': 501}, {'timestamp': 1538773916.0, 'added_lines': 2, 'deleted_lines': 2, 'nloc': 501}, {'timestamp': 1540400358.0, 'added_lines': 3, 'deleted_lines': 3, 'nloc': 501}, {'timestamp': 1540489644.0, 'added_lines': 2, 'deleted_lines': 2, 'nloc': 501}, {'timestamp': 1541204121.0, 'added_lines': 6, 'deleted_lines': 6, 'nloc': 501}, {'timestamp': 1541903826.0, 'added_lines': 2, 'deleted_lines': 2, 'nloc': 501}, {'timestamp': 1543282933.0, 'added_lines': 2, 'deleted_lines': 2, 'nloc': 501}, {'timestamp': 1544225843.0, 'added_lines': 2, 'deleted_lines': 2, 'nloc': 501}, {'timestamp': 1545323704.0, 'added_lines': 2, 'deleted_lines': 2, 'nloc': 501}, {'timestamp': 1540314216.0, 'added_lines': 8, 'deleted_lines': 3, 'nloc': 501}, {'timestamp': 1546553605.0, 'added_lines': 2, 'deleted_lines': 2, 'nloc': 501}, {'timestamp': 1547003974.0, 'added_lines': 3, 'deleted_lines': 3, 'nloc': 501}, {'timestamp': 1549588289.0, 'added_lines': 2, 'deleted_lines': 2, 'nloc': 501}, {'timestamp': 1550507829.0, 'added_lines': 6, 'deleted_lines': 6, 'nloc': 501}, {'timestamp': 1551229859.0, 'added_lines': 3, 'deleted_lines': 3, 'nloc': 501}, {'timestamp': 1551551196.0, 'added_lines': 9, 'deleted_lines': 9, 'nloc': 501}, {'timestamp': 1563198626.0, 'added_lines': 1, 'deleted_lines': 1, 'nloc': 501}, {'timestamp': 1579218500.0, 'added_lines': 2, 'deleted_lines': 2, 'nloc': 501}, {'timestamp': 1550778824.0, 'added_lines': 2, 'deleted_lines': 2, 'nloc': 501}, {'timestamp': 1583414882.0, 'added_lines': 2, 'deleted_lines': 2, 'nloc': 501}, {'timestamp': 1588785137.0, 'added_lines': 12, 'deleted_lines': 4, 'nloc': 505}, {'timestamp': 1588874682.0, 'added_lines': 2, 'deleted_lines': 2, 'nloc': 505}, {'timestamp': 1589114083.0, 'added_lines': 10, 'deleted_lines': 1, 'nloc': 513}, {'timestamp': 1591633238.0, 'added_lines': 1, 'deleted_lines': 1, 'nloc': 513}, {'timestamp': 1591633238.0, 'added_lines': 1, 'deleted_lines': 1, 'nloc': 513}, {'timestamp': 1592343089.0, 'added_lines': 2, 'deleted_lines': 37, 'nloc': 479}, {'timestamp': 1607113804.0, 'added_lines': 1, 'deleted_lines': 1, 'nloc': 479}, {'timestamp': 1608173236.0, 'added_lines': 3, 'deleted_lines': 3, 'nloc': 479}, {'timestamp': 1613691223.0, 'added_lines': 1, 'deleted_lines': 1, 'nloc': 479}, {'timestamp': 1620837194.0, 'added_lines': 1, 'deleted_lines': 1, 'nloc': 479}]","{'test/sharness/t0088-repo-stat-symlink.sh': 1, 'blocks/blockstore/arc_cache.go': 3, 'blocks/blockstore/arc_cache_test.go': 3, 'blocks/blockstore/blockstore.go': 4, 'blocks/blockstore/blockstore_test.go': 3, 'blocks/blockstore/bloom_cache_test.go': 3, 'blocks/blockstore/util/remove.go': 3, 'blockservice/blockservice_test.go': 8, 'blockservice/test/blocks_test.go': 8, 'core/builder.go': 40, 'core/commands/dht.go': 26, 'core/core.go': 41, 'core/coreunix/add.go': 26, 'core/coreunix/metadata_test.go': 25, 'exchange/bitswap/decision/engine_test.go': 9, 'exchange/bitswap/testnet/peernet.go': 9, 'exchange/bitswap/testutils.go': 9, 'exchange/offline/offline_test.go': 4, 'exchange/reprovide/reprovide_test.go': 26, 'filestore/filestore.go': 20, 'filestore/filestore_test.go': 26, 'filestore/fsrefstore.go': 21, 'filestore/util.go': 19, 'merkledag/test/utils.go': 7, 'merkledag/utils/utils.go': 8, 'mfs/mfs_test.go': 11, 'namesys/namesys.go': 25, 'namesys/namesys_test.go': 24, 'namesys/publisher.go': 25, 'namesys/publisher_test.go': 25, 'namesys/pubsub.go': 8, 'namesys/pubsub_test.go': 6, 'namesys/republisher/repub.go': 25, 'namesys/resolve_test.go': 26, 'package.json': 38, 'pin/pin.go': 27, 'pin/pin_test.go': 25, 'pin/set_test.go': 25, 'repo/fsrepo/datastores.go': 18, 'repo/fsrepo/fsrepo_test.go': 30, 'repo/repo.go': 37, 'routing/mock/centralized_client.go': 4, 'routing/mock/centralized_server.go': 4, 'routing/mock/interface.go': 4, 'routing/offline/offline.go': 4, 'routing/offline/offline_test.go': 4, 'thirdparty/datastore2/datastore_closer.go': 3, 'thirdparty/datastore2/delayed.go': 3, 'thirdparty/datastore2/threadsafe.go': 3, 'thirdparty/ds-help/key.go': 3, 'assets/assets.go': 19, 'blocks/blockstore/bloom_cache.go': 2, 'blocks/blocksutil/block_generator.go': 2, 'blockservice/blockservice.go': 8, 'cmd/ipfs/daemon.go': 19, 'cmd/ipfs/init.go': 32, 'cmd/ipfs/ipfs.go': 12, 'cmd/ipfs/main.go': 32, 'cmd/ipfs/main_test.go': 1, 'cmd/ipfswatch/main.go': 27, 'cmd/seccat/seccat.go': 24, 'commands/command.go': 10, 'commands/command_test.go': 3, 'commands/request.go': 24, 'commands/response.go': 5, 'commands/response_test.go': 3, 'core/bootstrap.go': 33, 'core/bootstrap_test.go': 32, 'core/commands/active.go': 5, 'core/commands/add.go': 21, 'core/commands/bitswap.go': 23, 'core/commands/block.go': 14, 'core/commands/bootstrap.go': 26, 'core/commands/cat.go': 15, 'core/commands/commands.go': 12, 'core/commands/config.go': 29, 'core/commands/dag/dag.go': 22, 'core/commands/dht_test.go': 22, 'core/commands/diag.go': 5, 'core/commands/dns.go': 8, 'core/commands/external.go': 5, 'core/commands/files/files.go': 3, 'core/commands/filestore.go': 13, 'core/commands/get.go': 23, 'core/commands/get_test.go': 12, 'core/commands/helptext_test.go': 12, 'core/commands/id.go': 24, 'core/commands/ipns.go': 8, 'core/commands/ipnsps.go': 5, 'core/commands/keystore.go': 13, 'core/commands/log.go': 11, 'core/commands/ls.go': 22, 'core/commands/mount_nofuse.go': 5, 'core/commands/mount_unix.go': 27, 'core/commands/mount_windows.go': 5, 'core/commands/name.go': 3, 'core/commands/object/diff.go': 7, 'core/commands/object/object.go': 23, 'core/commands/object/patch.go': 12, 'core/commands/p2p.go': 17, 'core/commands/pin.go': 24, 'core/commands/ping.go': 21, 'core/commands/publish.go': 10, 'core/commands/pubsub.go': 18, 'core/commands/refs.go': 21, 'core/commands/repo.go': 38, 'core/commands/resolve.go': 20, 'core/commands/root.go': 12, 'core/commands/shutdown.go': 8, 'core/commands/stat.go': 16, 'core/commands/swarm.go': 34, 'core/commands/sysdiag.go': 13, 'core/commands/tar.go': 19, 'core/commands/unixfs/ls.go': 19, 'core/commands/unixfs/unixfs.go': 5, 'core/commands/version.go': 8, 'core/coreapi/coreapi.go': 14, 'core/coreapi/interface/interface.go': 2, 'core/coreapi/unixfs.go': 20, 'core/coreapi/unixfs_test.go': 27, 'core/coredag/cbor.go': 7, 'core/coredag/dagpb.go': 20, 'core/coredag/dagtransl.go': 7, 'core/coredag/raw.go': 20, 'core/corehttp/commands.go': 35, 'core/corehttp/corehttp.go': 14, 'core/corehttp/gateway.go': 25, 'core/corehttp/gateway_handler.go': 24, 'core/corehttp/gateway_test.go': 35, 'core/corehttp/metrics_test.go': 23, 'core/corerepo/gc.go': 24, 'core/corerepo/pinning.go': 11, 'core/coreunix/add_test.go': 34, 'core/coreunix/metadata.go': 20, 'core/mock/mock.go': 34, 'core/pathresolver.go': 24, 'exchange/bitswap/bitswap.go': 9, 'exchange/bitswap/bitswap_test.go': 8, 'exchange/bitswap/decision/bench_test.go': 6, 'exchange/bitswap/decision/engine.go': 8, 'exchange/bitswap/decision/ledger.go': 7, 'exchange/bitswap/decision/peer_request_queue.go': 6, 'exchange/bitswap/decision/peer_request_queue_test.go': 6, 'exchange/bitswap/get.go': 7, 'exchange/bitswap/message/message.go': 6, 'exchange/bitswap/message/message_test.go': 3, 'exchange/bitswap/network/interface.go': 6, 'exchange/bitswap/network/ipfs_impl.go': 6, 'exchange/bitswap/notifications/notifications.go': 3, 'exchange/bitswap/notifications/notifications_test.go': 3, 'exchange/bitswap/session.go': 6, 'exchange/bitswap/session_test.go': 5, 'exchange/bitswap/stat.go': 3, 'exchange/bitswap/testnet/interface.go': 6, 'exchange/bitswap/testnet/network_test.go': 7, 'exchange/bitswap/testnet/virtual.go': 8, 'exchange/bitswap/wantlist/wantlist.go': 3, 'exchange/bitswap/wantlist/wantlist_test.go': 3, 'exchange/bitswap/wantmanager.go': 7, 'exchange/bitswap/workers.go': 6, 'exchange/interface.go': 2, 'exchange/offline/offline.go': 3, 'exchange/reprovide/providers.go': 24, 'exchange/reprovide/reprovide.go': 22, 'fuse/ipns/ipns_test.go': 24, 'fuse/ipns/ipns_unix.go': 25, 'fuse/node/mount_test.go': 24, 'fuse/readonly/ipfs_test.go': 24, 'fuse/readonly/readonly_unix.go': 25, 'importer/balanced/balanced_test.go': 6, 'importer/balanced/builder.go': 3, 'importer/chunk/rabin_test.go': 2, 'importer/chunk/splitting_test.go': 2, 'importer/helpers/dagbuilder.go': 6, 'importer/helpers/helpers.go': 3, 'importer/importer.go': 5, 'importer/importer_test.go': 5, 'importer/trickle/trickle_test.go': 6, 'importer/trickle/trickledag.go': 5, 'merkledag/batch.go': 2, 'merkledag/coding.go': 4, 'merkledag/merkledag.go': 4, 'merkledag/merkledag_test.go': 7, 'merkledag/node.go': 3, 'merkledag/node_test.go': 3, 'merkledag/raw.go': 4, 'merkledag/traverse/traverse.go': 3, 'merkledag/traverse/traverse_test.go': 3, 'merkledag/utils/diff.go': 3, 'merkledag/utils/diffenum.go': 3, 'merkledag/utils/diffenum_test.go': 3, 'merkledag/utils/utils_test.go': 3, 'mfs/dir.go': 5, 'mfs/file.go': 7, 'mfs/ops.go': 5, 'mfs/repub_test.go': 7, 'mfs/system.go': 8, 'namesys/ipns_select_test.go': 4, 'namesys/republisher/repub_test.go': 24, 'namesys/routing.go': 24, 'p2p/p2p.go': 22, 'p2p/registry.go': 10, 'path/path.go': 3, 'path/resolver.go': 3, 'path/resolver_test.go': 2, 'pin/gc/gc.go': 25, 'pin/set.go': 21, 'plugin/ipld.go': 6, 'plugin/loader/initializer.go': 5, 'plugin/plugins/git/git.go': 6, 'repo/config/bootstrap_peers.go': 8, 'repo/config/init.go': 8, 'repo/fsrepo/lock/lock.go': 3, 'repo/fsrepo/serialize/serialize.go': 4, 'repo/mock.go': 31, 'routing/mock/centralized_test.go': 3, 'routing/none/none_client.go': 3, 'tar/format.go': 23, 'test/dependencies/ma-pipe-unidir/main.go': 9, 'test/integration/addcat_test.go': 24, 'test/integration/bench_cat_test.go': 23, 'test/integration/bench_test.go': 17, 'test/integration/bitswap_wo_routing_test.go': 23, 'test/integration/three_legged_cat_test.go': 23, 'thirdparty/pollEndpoint/main.go': 15, 'thirdparty/posinfo/posinfo.go': 2, 'unixfs/archive/archive.go': 3, 'unixfs/archive/tar/writer.go': 3, 'unixfs/hamt/hamt.go': 3, 'unixfs/io/dagreader.go': 3, 'unixfs/io/dirbuilder.go': 3, 'unixfs/io/resolve.go': 3, 'unixfs/mod/dagmodifier.go': 6, 'unixfs/mod/dagmodifier_test.go': 3, 'unixfs/test/utils.go': 6, 'test/sharness/t0021-config.sh': 1, 'commands/legacy/command.go': 9, 'commands/legacy/legacy.go': 9, 'commands/legacy/legacy_test.go': 9, 'commands/legacy/request.go': 10, 'commands/legacy/response.go': 9, 'core/commands/commands_test.go': 11, 'core/coreapi/dag.go': 5, 'core/coreapi/dag_test.go': 3, 'core/coreapi/interface/options/dag.go': 4, 'core/coreapi/key.go': 22, 'core/coreapi/name.go': 24, 'unixfs/io/pbdagreader.go': 3, 'cmd/ipfs/util/ulimit.go': 9, 'cmd/seccat/util.go': 9, 'core/corehttp/logs.go': 9, 'fuse/mount/mount.go': 11, 'fuse/node/mount_unix.go': 9, 'importer/chunk/splitting.go': 1, 'namesys/ipns_validate_test.go': 4, 'plugin/loader/load.go': 7, 'test/dependencies/go-timeout/main.go': 1, 'thirdparty/notifier/notifier.go': 2, 'blocks/blockstoreutil/remove.go': 16, 'blockservice/test/mock.go': 4, 'namesys/validator.go': 3, None: 52, 'core/coreapi/object.go': 19, 'fuse/mount/fuse.go': 4, 'keystore/keystore_test.go': 8, 'namesys/dns_test.go': 4, 'namesys/interface.go': 19, 'repo/config/config.go': 1, 'unixfs/unixfs.go': 1, 'CHANGELOG.md': 1, 'README.md': 1, 'bin/dist_get': 1, 'cmd/ipfs/util/ulimit_freebsd.go': 3, 'contribute.md': 1, 'core/coreapi/interface/options/pin.go': 1, 'docs/experimental-features.md': 2, 'docs/file-transfer.md': 1, 'docs/releases.md': 2, 'exchange/bitswap/README.md': 1, 'plugin/plugin.go': 1, 'repo/fsrepo/migrations/mfsr_test.go': 1, 'repo/fsrepo/migrations/migrations.go': 6, 'test/sharness/README.md': 1, 'thirdparty/dir/dir.go': 1, 'core/commands/files.go': 21, 'core/core_test.go': 27, 'core/coreapi/pin.go': 21, 'fuse/ipns/common.go': 19, 'keystore/keystore.go': 11, 'keystore/memkeystore.go': 6, 'path/resolver/resolver.go': 3, 'repo/config/identity.go': 2, 'thirdparty/verifbs/verifbs.go': 15, 'cmd/ipfs/util/ulimit_unix.go': 2, 'core/coreapi/block.go': 6, 'core/coreapi/block_test.go': 2, 'core/coreapi/interface/coreapi.go': 3, 'core/coreapi/interface/dag.go': 3, 'core/coreapi/interface/object.go': 3, 'core/coreapi/interface/options/block.go': 2, 'core/coreapi/interface/path.go': 15, 'core/coreapi/interface/unixfs.go': 4, 'fuse/ipns/link_unix.go': 2, 'fuse/node/mount_darwin.go': 2, 'merkledag/errservice.go': 1, 'merkledag/readonly.go': 1, 'merkledag/readonly_test.go': 1, 'merkledag/rwservice.go': 1, 'merkledag/session.go': 1, 'path/resolver/resolver_test.go': 1, 'thirdparty/verifcid/validate.go': 1, 'thirdparty/verifcid/validate_test.go': 1, 'unixfs/hamt/hamt_stress_test.go': 1, 'unixfs/hamt/hamt_test.go': 1, 'namesys/ipns_resolver_validation_test.go': 18, 'test/sharness/t0170-dht.sh': 1, 'core/corerepo/stat.go': 2, 'repo/config/experiments.go': 1, 'core/corehttp/metrics.go': 2, 'core/commands/env.go': 7, 'core/commands/urlstore.go': 18, 'core/coreapi/interface/key.go': 7, 'core/coreapi/name_test.go': 12, 'core/coreapi/path.go': 18, 'core/coreunix/cat.go': 6, 'core/pathresolver_test.go': 17, 'dagutils/diff.go': 17, 'dagutils/diffenum.go': 17, 'dagutils/diffenum_test.go': 17, 'dagutils/utils.go': 17, 'dagutils/utils_test.go': 17, 'filestore/pb/dataobj.pb.go': 3, 'mfs/fd.go': 2, 'namesys/base.go': 17, 'namesys/cache.go': 17, 'namesys/dns.go': 17, 'namesys/proquint.go': 17, 'pin/internal/pb/header.pb.go': 3, 'thirdparty/cidv0v1/blockstore.go': 11, 'repo/config/serialize/serialize.go': 1, 'repo/config/serialize/serialize_test.go': 1, 'repo/fsrepo/misc.go': 25, 'cmd/ipfs/Rules.mk': 2, 'core/corehttp/option_test.go': 1, 'docs/windows.md': 1, 'repo/fsrepo/config_test.go': 23, 'repo/version.go': 1, 'test/bench/bench_cli_ipfs_add/main.go': 24, 'test/bench/offline_add/main.go': 24, 'core/commands/cmdenv/env.go': 18, 'core/commands/name/ipns.go': 15, 'core/commands/name/publish.go': 8, 'coverage/Rules.mk': 1, 'mk/golang.mk': 1, 'pin/internal/pb/doc.go': 1, 'test/3nodetest/Makefile': 1, 'test/bin/Rules.mk': 1, 'test/bin/verify-go-fmt.sh': 1, 'core/commands/name/ipnsps.go': 8, 'core/commands/name/name.go': 4, 'core/coreapi/dht.go': 12, 'core/coreapi/dht_test.go': 4, 'core/coreapi/interface/dht.go': 9, 'p2p/listener.go': 12, 'p2p/local.go': 13, 'p2p/remote.go': 12, 'p2p/stream.go': 12, 'core/coreapi/interface/swarm.go': 8, 'core/coreapi/swarm.go': 11, 'core/coreapi/interface/options/unixfs.go': 7, 'core/coreapi/pubsub.go': 11, 'core/coreapi/unixfile.go': 6, 'cmd/ipfs/dnsresolve_test.go': 5, 'core/coreapi/interface/pubsub.go': 4, 'test/sharness/t0180-pubsub.sh': 1, 'core/commands/cid.go': 3, 'test/dependencies/iptb/iptb.go': 11, 'plugin/plugins/badgerds/badgerds.go': 3, 'plugin/plugins/flatfs/flatfs.go': 3, 'plugin/plugins/levelds/levelds.go': 3, 'commands/context.go': 8, 'core/corehttp/proxy.go': 6, 'core/coreapi/test/api_test.go': 8, 'core/coreapi/interface/tests/name.go': 2, 'core/coreapi/interface/tests/unixfs.go': 2, 'core/commands/cmdenv/cidbase.go': 2, 'core/corehttp/ipns_hostname.go': 3, 'plugin/daemon.go': 3, 'plugin/loader/loader.go': 3, 'core/commands/cmdenv/cidbase_test.go': 1, 'core/commands/cmdenv/file.go': 1, 'core/corehttp/proxy_test.go': 1, 'plugin/tracer.go': 1, 'core/node/storage.go': 1, 'go.mod': 4, 'go.sum': 4, 'core/bootstrap/bootstrap.go': 1, 'core/node/libp2p/discovery.go': 1, 'core/node/libp2p/pnet.go': 1, 'core/node/libp2p/smux.go': 1, 'core/node/libp2p/transport.go': 1, 'plugin/loader/load_unix.go': 1, 'keystore/memkeystore_test.go': 1, 'repo/fsrepo/migrations/fetch.go': 2, 'repo/fsrepo/migrations/fetch_test.go': 2, 'repo/fsrepo/migrations/ipfsdir.go': 1, 'repo/fsrepo/migrations/ipfsdir_test.go': 1, 'repo/fsrepo/migrations/migrations_test.go': 2, 'repo/fsrepo/migrations/unpack.go': 2, 'repo/fsrepo/migrations/versions.go': 1, 'repo/fsrepo/migrations/versions_test.go': 1, 'core/corehttp/hostname.go': 1, 'core/node/ipns.go': 1, 'cmd/ipfs/migration.go': 1, 'cmd/ipfs/migration_test.go': 1, 'docs/config.md': 1, 'repo/fsrepo/migrations/fetcher.go': 1, 'repo/fsrepo/migrations/httpfetcher.go': 1, 'repo/fsrepo/migrations/ipfsfetcher/ipfsfetcher.go': 1, 'repo/fsrepo/migrations/ipfsfetcher/ipfsfetcher_test.go': 1}","('core/core.go', 0.5942028985507246, 0.22905027932960895)"
repo/fsrepo/fsrepo_test.go,96,866,7,"[{'cyclomatic_complexity': 2, 'nloc': 7, 'token_count': 41, 'name': 'testRepoPath', 'long_name': 'testRepoPath p string , t * testing . T', 'start_line': 16, 'end_line': 22, 'full_parameters': ['p string', ' t * testing . T'], 'filename': '/home/dimi/Documents/Informatik_Studium/FSS/SoftEvo/DataCollection/FFS_SoftEvo/go-ipfs/repo/fsrepo/fsrepo_test.go', 'top_nesting_level': 0, 'length': 7, 'fan_in': 0, 'fan_out': 0, 'general_fan_out': 0}, {'cyclomatic_complexity': 2, 'nloc': 7, 'token_count': 64, 'name': 'TestInitIdempotence', 'long_name': 'TestInitIdempotence t * testing . T', 'start_line': 24, 'end_line': 30, 'full_parameters': ['t * testing . T'], 'filename': '/home/dimi/Documents/Informatik_Studium/FSS/SoftEvo/DataCollection/FFS_SoftEvo/go-ipfs/repo/fsrepo/fsrepo_test.go', 'top_nesting_level': 0, 'length': 7, 'fan_in': 0, 'fan_out': 0, 'general_fan_out': 0}, {'cyclomatic_complexity': 1, 'nloc': 4, 'token_count': 24, 'name': 'Remove', 'long_name': 'Remove repoPath string', 'start_line': 32, 'end_line': 35, 'full_parameters': ['repoPath string'], 'filename': '/home/dimi/Documents/Informatik_Studium/FSS/SoftEvo/DataCollection/FFS_SoftEvo/go-ipfs/repo/fsrepo/fsrepo_test.go', 'top_nesting_level': 0, 'length': 4, 'fan_in': 0, 'fan_out': 0, 'general_fan_out': 0}, {'cyclomatic_complexity': 1, 'nloc': 22, 'token_count': 232, 'name': 'TestCanManageReposIndependently', 'long_name': 'TestCanManageReposIndependently t * testing . T', 'start_line': 37, 'end_line': 63, 'full_parameters': ['t * testing . T'], 'filename': '/home/dimi/Documents/Informatik_Studium/FSS/SoftEvo/DataCollection/FFS_SoftEvo/go-ipfs/repo/fsrepo/fsrepo_test.go', 'top_nesting_level': 0, 'length': 27, 'fan_in': 0, 'fan_out': 0, 'general_fan_out': 0}, {'cyclomatic_complexity': 1, 'nloc': 14, 'token_count': 161, 'name': 'TestDatastoreGetNotAllowedAfterClose', 'long_name': 'TestDatastoreGetNotAllowedAfterClose t * testing . T', 'start_line': 65, 'end_line': 81, 'full_parameters': ['t * testing . T'], 'filename': '/home/dimi/Documents/Informatik_Studium/FSS/SoftEvo/DataCollection/FFS_SoftEvo/go-ipfs/repo/fsrepo/fsrepo_test.go', 'top_nesting_level': 0, 'length': 17, 'fan_in': 0, 'fan_out': 0, 'general_fan_out': 0}, {'cyclomatic_complexity': 1, 'nloc': 19, 'token_count': 209, 'name': 'TestDatastorePersistsFromRepoToRepo', 'long_name': 'TestDatastorePersistsFromRepoToRepo t * testing . T', 'start_line': 83, 'end_line': 104, 'full_parameters': ['t * testing . T'], 'filename': '/home/dimi/Documents/Informatik_Studium/FSS/SoftEvo/DataCollection/FFS_SoftEvo/go-ipfs/repo/fsrepo/fsrepo_test.go', 'top_nesting_level': 0, 'length': 22, 'fan_in': 0, 'fan_out': 0, 'general_fan_out': 0}, {'cyclomatic_complexity': 1, 'nloc': 12, 'token_count': 121, 'name': 'TestOpenMoreThanOnceInSameProcess', 'long_name': 'TestOpenMoreThanOnceInSameProcess t * testing . T', 'start_line': 106, 'end_line': 119, 'full_parameters': ['t * testing . T'], 'filename': '/home/dimi/Documents/Informatik_Studium/FSS/SoftEvo/DataCollection/FFS_SoftEvo/go-ipfs/repo/fsrepo/fsrepo_test.go', 'top_nesting_level': 0, 'length': 14, 'fan_in': 0, 'fan_out': 0, 'general_fan_out': 0}]",94,846,7,"[{'cyclomatic_complexity': 2, 'nloc': 7, 'token_count': 41, 'name': 'testRepoPath', 'long_name': 'testRepoPath p string , t * testing . T', 'start_line': 17, 'end_line': 23, 'full_parameters': ['p string', ' t * testing . T'], 'filename': '/home/dimi/Documents/Informatik_Studium/FSS/SoftEvo/DataCollection/FFS_SoftEvo/go-ipfs/repo/fsrepo/fsrepo_test.go', 'top_nesting_level': 0, 'length': 7, 'fan_in': 0, 'fan_out': 0, 'general_fan_out': 0}, {'cyclomatic_complexity': 2, 'nloc': 7, 'token_count': 64, 'name': 'TestInitIdempotence', 'long_name': 'TestInitIdempotence t * testing . T', 'start_line': 25, 'end_line': 31, 'full_parameters': ['t * testing . T'], 'filename': '/home/dimi/Documents/Informatik_Studium/FSS/SoftEvo/DataCollection/FFS_SoftEvo/go-ipfs/repo/fsrepo/fsrepo_test.go', 'top_nesting_level': 0, 'length': 7, 'fan_in': 0, 'fan_out': 0, 'general_fan_out': 0}, {'cyclomatic_complexity': 1, 'nloc': 4, 'token_count': 24, 'name': 'Remove', 'long_name': 'Remove repoPath string', 'start_line': 33, 'end_line': 36, 'full_parameters': ['repoPath string'], 'filename': '/home/dimi/Documents/Informatik_Studium/FSS/SoftEvo/DataCollection/FFS_SoftEvo/go-ipfs/repo/fsrepo/fsrepo_test.go', 'top_nesting_level': 0, 'length': 4, 'fan_in': 0, 'fan_out': 0, 'general_fan_out': 0}, {'cyclomatic_complexity': 1, 'nloc': 22, 'token_count': 232, 'name': 'TestCanManageReposIndependently', 'long_name': 'TestCanManageReposIndependently t * testing . T', 'start_line': 38, 'end_line': 64, 'full_parameters': ['t * testing . T'], 'filename': '/home/dimi/Documents/Informatik_Studium/FSS/SoftEvo/DataCollection/FFS_SoftEvo/go-ipfs/repo/fsrepo/fsrepo_test.go', 'top_nesting_level': 0, 'length': 27, 'fan_in': 0, 'fan_out': 0, 'general_fan_out': 0}, {'cyclomatic_complexity': 1, 'nloc': 14, 'token_count': 161, 'name': 'TestDatastoreGetNotAllowedAfterClose', 'long_name': 'TestDatastoreGetNotAllowedAfterClose t * testing . T', 'start_line': 66, 'end_line': 82, 'full_parameters': ['t * testing . T'], 'filename': '/home/dimi/Documents/Informatik_Studium/FSS/SoftEvo/DataCollection/FFS_SoftEvo/go-ipfs/repo/fsrepo/fsrepo_test.go', 'top_nesting_level': 0, 'length': 17, 'fan_in': 0, 'fan_out': 0, 'general_fan_out': 0}, {'cyclomatic_complexity': 1, 'nloc': 17, 'token_count': 188, 'name': 'TestDatastorePersistsFromRepoToRepo', 'long_name': 'TestDatastorePersistsFromRepoToRepo t * testing . T', 'start_line': 84, 'end_line': 103, 'full_parameters': ['t * testing . T'], 'filename': '/home/dimi/Documents/Informatik_Studium/FSS/SoftEvo/DataCollection/FFS_SoftEvo/go-ipfs/repo/fsrepo/fsrepo_test.go', 'top_nesting_level': 0, 'length': 20, 'fan_in': 0, 'fan_out': 0, 'general_fan_out': 0}, {'cyclomatic_complexity': 1, 'nloc': 12, 'token_count': 121, 'name': 'TestOpenMoreThanOnceInSameProcess', 'long_name': 'TestOpenMoreThanOnceInSameProcess t * testing . T', 'start_line': 105, 'end_line': 118, 'full_parameters': ['t * testing . T'], 'filename': '/home/dimi/Documents/Informatik_Studium/FSS/SoftEvo/DataCollection/FFS_SoftEvo/go-ipfs/repo/fsrepo/fsrepo_test.go', 'top_nesting_level': 0, 'length': 14, 'fan_in': 0, 'fan_out': 0, 'general_fan_out': 0}]",-2,-20,0,30,30,"[{'timestamp': 1511062375.0, 'added_lines': 1, 'deleted_lines': 1, 'nloc': 96}, {'timestamp': 1516838128.0, 'added_lines': 1, 'deleted_lines': 1, 'nloc': 96}, {'timestamp': 1519761835.0, 'added_lines': 1, 'deleted_lines': 1, 'nloc': 96}, {'timestamp': 1525408792.0, 'added_lines': 1, 'deleted_lines': 1, 'nloc': 96}, {'timestamp': 1532365899.0, 'added_lines': 2, 'deleted_lines': 1, 'nloc': 96}, {'timestamp': 1532388583.0, 'added_lines': 1, 'deleted_lines': 1, 'nloc': 96}, {'timestamp': 1533809170.0, 'added_lines': 1, 'deleted_lines': 1, 'nloc': 96}, {'timestamp': 1534195762.0, 'added_lines': 2, 'deleted_lines': 4, 'nloc': 94}, {'timestamp': 1534072974.0, 'added_lines': 1, 'deleted_lines': 1, 'nloc': 94}, {'timestamp': 1534896611.0, 'added_lines': 1, 'deleted_lines': 1, 'nloc': 94}, {'timestamp': 1535255498.0, 'added_lines': 1, 'deleted_lines': 1, 'nloc': 94}, {'timestamp': 1535601896.0, 'added_lines': 1, 'deleted_lines': 1, 'nloc': 94}, {'timestamp': 1536388808.0, 'added_lines': 2, 'deleted_lines': 2, 'nloc': 94}, {'timestamp': 1537792589.0, 'added_lines': 2, 'deleted_lines': 2, 'nloc': 94}, {'timestamp': 1538544957.0, 'added_lines': 2, 'deleted_lines': 2, 'nloc': 94}, {'timestamp': 1538547366.0, 'added_lines': 1, 'deleted_lines': 1, 'nloc': 94}, {'timestamp': 1538773916.0, 'added_lines': 1, 'deleted_lines': 1, 'nloc': 94}, {'timestamp': 1540400358.0, 'added_lines': 1, 'deleted_lines': 1, 'nloc': 94}, {'timestamp': 1540489644.0, 'added_lines': 1, 'deleted_lines': 1, 'nloc': 94}, {'timestamp': 1541204121.0, 'added_lines': 1, 'deleted_lines': 1, 'nloc': 94}, {'timestamp': 1541903826.0, 'added_lines': 1, 'deleted_lines': 1, 'nloc': 94}, {'timestamp': 1543282933.0, 'added_lines': 1, 'deleted_lines': 1, 'nloc': 94}, {'timestamp': 1544225843.0, 'added_lines': 1, 'deleted_lines': 1, 'nloc': 94}, {'timestamp': 1545323704.0, 'added_lines': 1, 'deleted_lines': 1, 'nloc': 94}, {'timestamp': 1546553605.0, 'added_lines': 1, 'deleted_lines': 1, 'nloc': 94}, {'timestamp': 1547003974.0, 'added_lines': 1, 'deleted_lines': 1, 'nloc': 94}, {'timestamp': 1549588289.0, 'added_lines': 1, 'deleted_lines': 1, 'nloc': 94}, {'timestamp': 1550507829.0, 'added_lines': 2, 'deleted_lines': 2, 'nloc': 94}, {'timestamp': 1551229859.0, 'added_lines': 1, 'deleted_lines': 1, 'nloc': 94}, {'timestamp': 1551551196.0, 'added_lines': 2, 'deleted_lines': 2, 'nloc': 94}]","{'blocks/blockstore/arc_cache.go': 2, 'blocks/blockstore/arc_cache_test.go': 2, 'blocks/blockstore/blockstore.go': 2, 'blocks/blockstore/blockstore_test.go': 2, 'blocks/blockstore/bloom_cache_test.go': 2, 'blocks/blockstore/util/remove.go': 2, 'blockservice/blockservice_test.go': 4, 'blockservice/test/blocks_test.go': 4, 'core/builder.go': 30, 'core/commands/dht.go': 20, 'core/core.go': 30, 'core/coreunix/add.go': 20, 'core/coreunix/metadata_test.go': 20, 'exchange/bitswap/decision/engine_test.go': 4, 'exchange/bitswap/testnet/peernet.go': 4, 'exchange/bitswap/testutils.go': 4, 'exchange/offline/offline_test.go': 3, 'exchange/reprovide/reprovide_test.go': 20, 'filestore/filestore.go': 14, 'filestore/filestore_test.go': 20, 'filestore/fsrefstore.go': 14, 'filestore/util.go': 14, 'merkledag/test/utils.go': 4, 'merkledag/utils/utils.go': 4, 'mfs/mfs_test.go': 5, 'namesys/namesys.go': 20, 'namesys/namesys_test.go': 20, 'namesys/publisher.go': 20, 'namesys/publisher_test.go': 20, 'namesys/pubsub.go': 4, 'namesys/pubsub_test.go': 4, 'namesys/republisher/repub.go': 20, 'namesys/resolve_test.go': 20, 'package.json': 29, 'pin/pin.go': 20, 'pin/pin_test.go': 20, 'pin/set_test.go': 20, 'repo/fsrepo/datastores.go': 13, 'repo/fsrepo/fsrepo.go': 30, 'repo/repo.go': 30, 'routing/mock/centralized_client.go': 2, 'routing/mock/centralized_server.go': 2, 'routing/mock/interface.go': 2, 'routing/offline/offline.go': 2, 'routing/offline/offline_test.go': 2, 'thirdparty/datastore2/datastore_closer.go': 3, 'thirdparty/datastore2/delayed.go': 3, 'thirdparty/datastore2/threadsafe.go': 3, 'thirdparty/ds-help/key.go': 2, 'assets/assets.go': 16, 'blocks/blockstore/bloom_cache.go': 1, 'blocks/blocksutil/block_generator.go': 1, 'blockservice/blockservice.go': 3, 'cmd/ipfs/daemon.go': 10, 'cmd/ipfs/ipfs.go': 7, 'cmd/ipfs/main.go': 25, 'cmd/seccat/seccat.go': 17, 'commands/command.go': 5, 'commands/command_test.go': 1, 'commands/legacy/command.go': 5, 'commands/legacy/legacy.go': 5, 'commands/legacy/legacy_test.go': 5, 'commands/legacy/request.go': 5, 'commands/legacy/response.go': 5, 'commands/request.go': 17, 'commands/response.go': 2, 'commands/response_test.go': 1, 'core/bootstrap.go': 27, 'core/bootstrap_test.go': 27, 'core/commands/add.go': 13, 'core/commands/bitswap.go': 18, 'core/commands/block.go': 8, 'core/commands/cat.go': 8, 'core/commands/commands.go': 7, 'core/commands/commands_test.go': 7, 'core/commands/dag/dag.go': 17, 'core/commands/dht_test.go': 16, 'core/commands/files/files.go': 1, 'core/commands/filestore.go': 7, 'core/commands/get.go': 17, 'core/commands/get_test.go': 7, 'core/commands/helptext_test.go': 7, 'core/commands/id.go': 17, 'core/commands/keystore.go': 8, 'core/commands/ls.go': 17, 'core/commands/object/object.go': 18, 'core/commands/p2p.go': 14, 'core/commands/pin.go': 18, 'core/commands/ping.go': 16, 'core/commands/publish.go': 4, 'core/commands/pubsub.go': 11, 'core/commands/refs.go': 17, 'core/commands/repo.go': 29, 'core/commands/root.go': 7, 'core/commands/stat.go': 11, 'core/commands/swarm.go': 27, 'core/commands/sysdiag.go': 9, 'core/coreapi/coreapi.go': 10, 'core/coreapi/dag.go': 4, 'core/coreapi/dag_test.go': 2, 'core/coreapi/interface/interface.go': 1, 'core/coreapi/interface/options/dag.go': 3, 'core/coreapi/key.go': 18, 'core/coreapi/name.go': 19, 'core/coreapi/unixfs.go': 17, 'core/coreapi/unixfs_test.go': 22, 'core/coredag/cbor.go': 5, 'core/coredag/dagpb.go': 17, 'core/coredag/dagtransl.go': 4, 'core/coredag/raw.go': 17, 'core/corehttp/commands.go': 28, 'core/corehttp/corehttp.go': 9, 'core/corehttp/gateway.go': 18, 'core/corehttp/gateway_handler.go': 18, 'core/corehttp/gateway_test.go': 28, 'core/corehttp/metrics_test.go': 17, 'core/corerepo/gc.go': 17, 'core/corerepo/pinning.go': 7, 'core/coreunix/add_test.go': 29, 'core/coreunix/metadata.go': 17, 'core/mock/mock.go': 28, 'core/pathresolver.go': 18, 'exchange/bitswap/bitswap.go': 3, 'exchange/bitswap/bitswap_test.go': 3, 'exchange/bitswap/decision/bench_test.go': 2, 'exchange/bitswap/decision/engine.go': 3, 'exchange/bitswap/decision/ledger.go': 2, 'exchange/bitswap/decision/peer_request_queue.go': 2, 'exchange/bitswap/decision/peer_request_queue_test.go': 2, 'exchange/bitswap/get.go': 3, 'exchange/bitswap/message/message.go': 2, 'exchange/bitswap/message/message_test.go': 1, 'exchange/bitswap/network/interface.go': 2, 'exchange/bitswap/network/ipfs_impl.go': 2, 'exchange/bitswap/notifications/notifications.go': 1, 'exchange/bitswap/notifications/notifications_test.go': 1, 'exchange/bitswap/session.go': 2, 'exchange/bitswap/session_test.go': 2, 'exchange/bitswap/stat.go': 1, 'exchange/bitswap/testnet/interface.go': 2, 'exchange/bitswap/testnet/network_test.go': 3, 'exchange/bitswap/testnet/virtual.go': 3, 'exchange/bitswap/wantlist/wantlist.go': 1, 'exchange/bitswap/wantlist/wantlist_test.go': 1, 'exchange/bitswap/wantmanager.go': 2, 'exchange/bitswap/workers.go': 2, 'exchange/interface.go': 1, 'exchange/offline/offline.go': 2, 'exchange/reprovide/providers.go': 19, 'exchange/reprovide/reprovide.go': 16, 'fuse/ipns/ipns_test.go': 19, 'fuse/ipns/ipns_unix.go': 18, 'fuse/node/mount_test.go': 19, 'fuse/readonly/ipfs_test.go': 18, 'fuse/readonly/readonly_unix.go': 18, 'importer/balanced/balanced_test.go': 2, 'importer/balanced/builder.go': 1, 'importer/chunk/rabin_test.go': 1, 'importer/chunk/splitting_test.go': 1, 'importer/helpers/dagbuilder.go': 2, 'importer/helpers/helpers.go': 1, 'importer/importer.go': 2, 'importer/importer_test.go': 2, 'importer/trickle/trickle_test.go': 2, 'importer/trickle/trickledag.go': 1, 'merkledag/batch.go': 1, 'merkledag/coding.go': 1, 'merkledag/merkledag.go': 1, 'merkledag/merkledag_test.go': 2, 'merkledag/node.go': 1, 'merkledag/node_test.go': 1, 'merkledag/raw.go': 1, 'merkledag/traverse/traverse.go': 1, 'merkledag/traverse/traverse_test.go': 1, 'merkledag/utils/diff.go': 1, 'merkledag/utils/diffenum.go': 1, 'merkledag/utils/diffenum_test.go': 1, 'merkledag/utils/utils_test.go': 1, 'mfs/dir.go': 2, 'mfs/file.go': 3, 'mfs/ops.go': 2, 'mfs/repub_test.go': 2, 'mfs/system.go': 3, 'namesys/ipns_select_test.go': 2, 'namesys/republisher/repub_test.go': 18, 'namesys/routing.go': 18, 'p2p/p2p.go': 17, 'p2p/registry.go': 5, 'path/path.go': 1, 'path/resolver.go': 1, 'path/resolver_test.go': 1, 'pin/gc/gc.go': 19, 'pin/set.go': 17, 'plugin/ipld.go': 4, 'plugin/loader/initializer.go': 3, 'plugin/plugins/git/git.go': 4, 'repo/config/bootstrap_peers.go': 2, 'repo/config/init.go': 2, 'repo/fsrepo/lock/lock.go': 1, 'repo/fsrepo/serialize/serialize.go': 1, 'repo/mock.go': 24, 'routing/mock/centralized_test.go': 1, 'routing/none/none_client.go': 1, 'tar/format.go': 18, 'test/dependencies/ma-pipe-unidir/main.go': 6, 'test/integration/addcat_test.go': 17, 'test/integration/bench_cat_test.go': 17, 'test/integration/bench_test.go': 12, 'test/integration/bitswap_wo_routing_test.go': 17, 'test/integration/three_legged_cat_test.go': 17, 'thirdparty/pollEndpoint/main.go': 9, 'thirdparty/posinfo/posinfo.go': 1, 'unixfs/archive/archive.go': 1, 'unixfs/archive/tar/writer.go': 1, 'unixfs/hamt/hamt.go': 1, 'unixfs/io/dagreader.go': 1, 'unixfs/io/dirbuilder.go': 1, 'unixfs/io/pbdagreader.go': 1, 'unixfs/io/resolve.go': 1, 'unixfs/mod/dagmodifier.go': 2, 'unixfs/mod/dagmodifier_test.go': 1, 'unixfs/test/utils.go': 2, 'blocks/blockstoreutil/remove.go': 12, 'blockservice/test/mock.go': 2, 'core/commands/ipns.go': 4, 'namesys/ipns_validate_test.go': 2, 'namesys/validator.go': 2, 'cmd/ipfs/init.go': 24, 'cmd/ipfs/util/ulimit.go': 5, 'cmd/seccat/util.go': 5, 'core/commands/files.go': 17, 'core/commands/log.go': 6, 'core/commands/object/patch.go': 7, 'core/core_test.go': 27, 'core/coreapi/pin.go': 17, 'core/corehttp/logs.go': 5, 'fuse/ipns/common.go': 17, 'fuse/mount/mount.go': 5, 'fuse/node/mount_unix.go': 5, 'keystore/keystore.go': 5, 'keystore/keystore_test.go': 4, 'keystore/memkeystore.go': 4, 'namesys/interface.go': 17, 'path/resolver/resolver.go': 1, 'plugin/loader/load.go': 3, 'repo/config/identity.go': 1, 'thirdparty/verifbs/verifbs.go': 11, 'cmd/ipfs/Rules.mk': 1, 'cmd/ipfswatch/main.go': 23, 'core/commands/bootstrap.go': 23, 'core/commands/config.go': 23, 'core/commands/env.go': 5, 'core/commands/mount_unix.go': 23, 'core/commands/version.go': 5, 'core/corehttp/option_test.go': 1, 'docs/releases.md': 1, 'docs/windows.md': 1, 'repo/fsrepo/config_test.go': 23, 'repo/fsrepo/misc.go': 23, 'repo/version.go': 1, 'test/bench/bench_cli_ipfs_add/main.go': 23, 'test/bench/offline_add/main.go': 23, 'core/commands/resolve.go': 16, 'core/commands/tar.go': 16, 'core/commands/unixfs/ls.go': 16, 'core/commands/urlstore.go': 16, 'core/coreapi/interface/path.go': 13, 'core/coreapi/name_test.go': 11, 'core/coreapi/object.go': 16, 'core/coreapi/path.go': 16, 'core/coreunix/cat.go': 5, 'core/pathresolver_test.go': 16, 'dagutils/diff.go': 16, 'dagutils/diffenum.go': 16, 'dagutils/diffenum_test.go': 16, 'dagutils/utils.go': 16, 'dagutils/utils_test.go': 16, 'mfs/fd.go': 1, 'namesys/base.go': 16, 'namesys/cache.go': 16, 'namesys/dns.go': 16, 'namesys/ipns_resolver_validation_test.go': 16, 'namesys/proquint.go': 16, 'thirdparty/cidv0v1/blockstore.go': 10, 'core/commands/active.go': 3, 'core/commands/diag.go': 3, 'core/commands/dns.go': 5, 'core/commands/external.go': 3, 'core/commands/ipnsps.go': 1, 'core/commands/mount_nofuse.go': 3, 'core/commands/mount_windows.go': 3, 'core/commands/name.go': 1, 'core/commands/object/diff.go': 5, 'core/commands/shutdown.go': 5, 'core/commands/unixfs/unixfs.go': 3, 'core/coreapi/block.go': 5, 'core/coreapi/interface/coreapi.go': 2, 'core/coreapi/interface/dag.go': 2, 'core/coreapi/interface/key.go': 6, 'core/coreapi/interface/object.go': 2, 'core/coreapi/interface/unixfs.go': 3, 'core/commands/cmdenv/env.go': 18, 'core/commands/name/ipns.go': 14, 'core/commands/name/publish.go': 8, 'core/commands/name/ipnsps.go': 8, 'core/commands/name/name.go': 4, 'core/coreapi/dht.go': 12, 'core/coreapi/dht_test.go': 4, 'core/coreapi/interface/dht.go': 9, 'p2p/listener.go': 12, 'p2p/local.go': 12, 'p2p/remote.go': 12, 'p2p/stream.go': 12, 'core/coreapi/interface/swarm.go': 8, 'core/coreapi/swarm.go': 11, 'core/coreapi/interface/options/unixfs.go': 7, 'core/coreapi/pubsub.go': 11, 'core/coreapi/unixfile.go': 6, 'cmd/ipfs/dnsresolve_test.go': 5, 'core/coreapi/interface/pubsub.go': 4, 'test/sharness/t0180-pubsub.sh': 1, 'core/commands/cid.go': 3, 'core/coreapi/block_test.go': 1, 'core/coreapi/interface/options/block.go': 1, 'test/dependencies/iptb/iptb.go': 11, 'plugin/plugins/badgerds/badgerds.go': 3, 'plugin/plugins/flatfs/flatfs.go': 3, 'plugin/plugins/levelds/levelds.go': 3, 'commands/context.go': 8, 'core/corehttp/proxy.go': 6, 'core/coreapi/test/api_test.go': 6, 'core/coreapi/interface/tests/name.go': 2, 'core/coreapi/interface/tests/unixfs.go': 2, 'core/commands/cmdenv/cidbase.go': 2, 'core/corehttp/ipns_hostname.go': 3, 'filestore/pb/dataobj.pb.go': 2, 'namesys/dns_test.go': 3, 'pin/internal/pb/header.pb.go': 2, 'plugin/daemon.go': 3, 'plugin/loader/loader.go': 3, 'cmd/ipfs/util/ulimit_freebsd.go': 1, 'cmd/ipfs/util/ulimit_unix.go': 1, 'core/commands/cmdenv/cidbase_test.go': 1, 'core/commands/cmdenv/file.go': 1, 'core/corehttp/metrics.go': 1, 'core/corehttp/proxy_test.go': 1, 'core/corerepo/stat.go': 1, 'fuse/ipns/link_unix.go': 1, 'fuse/mount/fuse.go': 1, 'fuse/node/mount_darwin.go': 1, 'plugin/tracer.go': 1, 'thirdparty/notifier/notifier.go': 1}","('core/core.go', 1.0, 0.16759776536312848)"
repo/fsrepo/misc.go,17,72,1,"[{'cyclomatic_complexity': 3, 'nloc': 11, 'token_count': 63, 'name': 'BestKnownPath', 'long_name': 'BestKnownPath', 'start_line': 13, 'end_line': 23, 'full_parameters': [], 'filename': '/home/dimi/Documents/Informatik_Studium/FSS/SoftEvo/DataCollection/FFS_SoftEvo/go-ipfs/repo/fsrepo/misc.go', 'top_nesting_level': 0, 'length': 11, 'fan_in': 0, 'fan_out': 0, 'general_fan_out': 0}]",17,73,1,"[{'cyclomatic_complexity': 3, 'nloc': 11, 'token_count': 63, 'name': 'BestKnownPath', 'long_name': 'BestKnownPath', 'start_line': 13, 'end_line': 23, 'full_parameters': [], 'filename': '/home/dimi/Documents/Informatik_Studium/FSS/SoftEvo/DataCollection/FFS_SoftEvo/go-ipfs/repo/fsrepo/misc.go', 'top_nesting_level': 0, 'length': 11, 'fan_in': 0, 'fan_out': 0, 'general_fan_out': 0}]",0,1,0,25,25,"[{'timestamp': 1532357069.0, 'added_lines': 2, 'deleted_lines': 1, 'nloc': 17}, {'timestamp': 1532365899.0, 'added_lines': 1, 'deleted_lines': 1, 'nloc': 17}, {'timestamp': 1532388583.0, 'added_lines': 1, 'deleted_lines': 1, 'nloc': 17}, {'timestamp': 1533809170.0, 'added_lines': 1, 'deleted_lines': 1, 'nloc': 17}, {'timestamp': 1534072974.0, 'added_lines': 1, 'deleted_lines': 1, 'nloc': 17}, {'timestamp': 1534896611.0, 'added_lines': 1, 'deleted_lines': 1, 'nloc': 17}, {'timestamp': 1535255498.0, 'added_lines': 1, 'deleted_lines': 1, 'nloc': 17}, {'timestamp': 1535601896.0, 'added_lines': 1, 'deleted_lines': 1, 'nloc': 17}, {'timestamp': 1536388808.0, 'added_lines': 1, 'deleted_lines': 1, 'nloc': 17}, {'timestamp': 1536357700.0, 'added_lines': 1, 'deleted_lines': 2, 'nloc': 17}, {'timestamp': 1537792589.0, 'added_lines': 1, 'deleted_lines': 1, 'nloc': 17}, {'timestamp': 1538544957.0, 'added_lines': 1, 'deleted_lines': 1, 'nloc': 17}, {'timestamp': 1538547366.0, 'added_lines': 1, 'deleted_lines': 1, 'nloc': 17}, {'timestamp': 1540400358.0, 'added_lines': 1, 'deleted_lines': 1, 'nloc': 17}, {'timestamp': 1540489644.0, 'added_lines': 1, 'deleted_lines': 1, 'nloc': 17}, {'timestamp': 1541204121.0, 'added_lines': 1, 'deleted_lines': 1, 'nloc': 17}, {'timestamp': 1543282933.0, 'added_lines': 1, 'deleted_lines': 1, 'nloc': 17}, {'timestamp': 1544225843.0, 'added_lines': 1, 'deleted_lines': 1, 'nloc': 17}, {'timestamp': 1545323704.0, 'added_lines': 1, 'deleted_lines': 1, 'nloc': 17}, {'timestamp': 1546553605.0, 'added_lines': 1, 'deleted_lines': 1, 'nloc': 17}, {'timestamp': 1547003974.0, 'added_lines': 1, 'deleted_lines': 1, 'nloc': 17}, {'timestamp': 1549588289.0, 'added_lines': 1, 'deleted_lines': 1, 'nloc': 17}, {'timestamp': 1550507829.0, 'added_lines': 1, 'deleted_lines': 1, 'nloc': 17}, {'timestamp': 1551229859.0, 'added_lines': 1, 'deleted_lines': 1, 'nloc': 17}, {'timestamp': 1551551196.0, 'added_lines': 2, 'deleted_lines': 2, 'nloc': 17}]","{'cmd/ipfs/init.go': 24, 'cmd/ipfs/main.go': 24, 'cmd/ipfswatch/main.go': 25, 'commands/request.go': 16, 'core/bootstrap.go': 24, 'core/builder.go': 24, 'core/commands/bootstrap.go': 24, 'core/commands/config.go': 24, 'core/commands/env.go': 6, 'core/commands/mount_unix.go': 24, 'core/commands/repo.go': 24, 'core/commands/swarm.go': 24, 'core/commands/sysdiag.go': 9, 'core/commands/version.go': 6, 'core/core.go': 24, 'core/corehttp/commands.go': 24, 'core/corehttp/gateway.go': 15, 'package.json': 24, 'repo/fsrepo/fsrepo.go': 25, 'repo/mock.go': 24, 'repo/repo.go': 24, 'cmd/ipfs/Rules.mk': 2, 'core/bootstrap_test.go': 23, 'core/core_test.go': 23, 'core/coreapi/unixfs_test.go': 17, 'core/corehttp/gateway_test.go': 23, 'core/corehttp/option_test.go': 1, 'core/coreunix/add_test.go': 23, 'core/mock/mock.go': 23, 'docs/releases.md': 1, 'docs/windows.md': 1, 'repo/fsrepo/config_test.go': 23, 'repo/fsrepo/fsrepo_test.go': 23, 'repo/version.go': 1, 'test/bench/bench_cli_ipfs_add/main.go': 24, 'test/bench/offline_add/main.go': 24, 'assets/assets.go': 12, 'blocks/blockstoreutil/remove.go': 7, 'cmd/ipfs/daemon.go': 8, 'cmd/ipfs/ipfs.go': 5, 'cmd/seccat/seccat.go': 13, 'commands/command.go': 3, 'commands/legacy/command.go': 3, 'commands/legacy/legacy.go': 3, 'commands/legacy/legacy_test.go': 3, 'commands/legacy/request.go': 3, 'commands/legacy/response.go': 3, 'commands/response.go': 1, 'core/commands/active.go': 3, 'core/commands/add.go': 9, 'core/commands/bitswap.go': 13, 'core/commands/block.go': 6, 'core/commands/cat.go': 6, 'core/commands/commands.go': 5, 'core/commands/commands_test.go': 5, 'core/commands/dag/dag.go': 13, 'core/commands/dht.go': 13, 'core/commands/dht_test.go': 12, 'core/commands/diag.go': 3, 'core/commands/dns.go': 5, 'core/commands/external.go': 3, 'core/commands/files.go': 13, 'core/commands/filestore.go': 5, 'core/commands/get.go': 12, 'core/commands/get_test.go': 5, 'core/commands/helptext_test.go': 5, 'core/commands/id.go': 13, 'core/commands/ipns.go': 1, 'core/commands/ipnsps.go': 1, 'core/commands/keystore.go': 6, 'core/commands/log.go': 5, 'core/commands/ls.go': 12, 'core/commands/mount_nofuse.go': 3, 'core/commands/mount_windows.go': 3, 'core/commands/name.go': 1, 'core/commands/object/diff.go': 5, 'core/commands/object/object.go': 13, 'core/commands/object/patch.go': 6, 'core/commands/p2p.go': 11, 'core/commands/pin.go': 13, 'core/commands/ping.go': 12, 'core/commands/publish.go': 1, 'core/commands/pubsub.go': 9, 'core/commands/refs.go': 13, 'core/commands/resolve.go': 13, 'core/commands/root.go': 5, 'core/commands/shutdown.go': 5, 'core/commands/stat.go': 9, 'core/commands/tar.go': 13, 'core/commands/unixfs/ls.go': 13, 'core/commands/unixfs/unixfs.go': 3, 'core/commands/urlstore.go': 13, 'core/coreapi/block.go': 5, 'core/coreapi/dag.go': 3, 'core/coreapi/interface/coreapi.go': 2, 'core/coreapi/interface/dag.go': 2, 'core/coreapi/interface/key.go': 6, 'core/coreapi/interface/object.go': 2, 'core/coreapi/interface/options/dag.go': 2, 'core/coreapi/interface/path.go': 10, 'core/coreapi/interface/unixfs.go': 3, 'core/coreapi/key.go': 13, 'core/coreapi/name.go': 13, 'core/coreapi/name_test.go': 8, 'core/coreapi/object.go': 13, 'core/coreapi/path.go': 13, 'core/coreapi/pin.go': 13, 'core/coreapi/unixfs.go': 13, 'core/coredag/cbor.go': 4, 'core/coredag/dagpb.go': 13, 'core/coredag/dagtransl.go': 3, 'core/coredag/raw.go': 13, 'core/corehttp/gateway_handler.go': 13, 'core/corehttp/metrics_test.go': 13, 'core/corerepo/gc.go': 13, 'core/corerepo/pinning.go': 5, 'core/coreunix/add.go': 13, 'core/coreunix/cat.go': 4, 'core/coreunix/metadata.go': 13, 'core/coreunix/metadata_test.go': 13, 'core/pathresolver.go': 13, 'core/pathresolver_test.go': 13, 'dagutils/diff.go': 13, 'dagutils/diffenum.go': 13, 'dagutils/diffenum_test.go': 13, 'dagutils/utils.go': 13, 'dagutils/utils_test.go': 13, 'exchange/reprovide/providers.go': 13, 'exchange/reprovide/reprovide.go': 12, 'exchange/reprovide/reprovide_test.go': 13, 'filestore/filestore.go': 7, 'filestore/filestore_test.go': 13, 'filestore/fsrefstore.go': 7, 'filestore/util.go': 7, 'fuse/ipns/common.go': 13, 'fuse/ipns/ipns_test.go': 13, 'fuse/ipns/ipns_unix.go': 13, 'fuse/node/mount_test.go': 13, 'fuse/readonly/ipfs_test.go': 13, 'fuse/readonly/readonly_unix.go': 13, 'namesys/base.go': 13, 'namesys/cache.go': 13, 'namesys/dns.go': 13, 'namesys/interface.go': 13, 'namesys/ipns_resolver_validation_test.go': 13, 'namesys/namesys.go': 13, 'namesys/namesys_test.go': 13, 'namesys/proquint.go': 13, 'namesys/publisher.go': 13, 'namesys/publisher_test.go': 13, 'namesys/republisher/repub.go': 13, 'namesys/republisher/repub_test.go': 13, 'namesys/resolve_test.go': 13, 'namesys/routing.go': 13, 'p2p/p2p.go': 13, 'p2p/registry.go': 3, 'pin/gc/gc.go': 13, 'pin/pin.go': 13, 'pin/pin_test.go': 13, 'pin/set.go': 13, 'pin/set_test.go': 13, 'plugin/ipld.go': 3, 'plugin/loader/initializer.go': 2, 'plugin/plugins/git/git.go': 3, 'tar/format.go': 13, 'test/integration/addcat_test.go': 14, 'test/integration/bench_cat_test.go': 13, 'test/integration/bench_test.go': 10, 'test/integration/bitswap_wo_routing_test.go': 13, 'test/integration/three_legged_cat_test.go': 13, 'thirdparty/cidv0v1/blockstore.go': 7, 'thirdparty/verifbs/verifbs.go': 7, 'core/commands/cmdenv/env.go': 18, 'core/commands/name/ipns.go': 12, 'core/commands/name/publish.go': 8, 'repo/fsrepo/datastores.go': 6, None: 29, 'coverage/Rules.mk': 1, 'mk/golang.mk': 1, 'pin/internal/pb/doc.go': 1, 'test/3nodetest/Makefile': 1, 'test/bin/Rules.mk': 1, 'test/bin/verify-go-fmt.sh': 1, 'cmd/ipfs/util/ulimit.go': 4, 'cmd/seccat/util.go': 4, 'core/commands/name/ipnsps.go': 8, 'core/commands/name/name.go': 4, 'core/coreapi/dht.go': 10, 'core/coreapi/dht_test.go': 4, 'core/coreapi/interface/dht.go': 7, 'core/corehttp/corehttp.go': 7, 'core/corehttp/logs.go': 4, 'fuse/mount/mount.go': 4, 'fuse/node/mount_unix.go': 4, 'keystore/keystore.go': 4, 'p2p/listener.go': 10, 'p2p/local.go': 10, 'p2p/remote.go': 10, 'p2p/stream.go': 10, 'plugin/loader/load.go': 2, 'thirdparty/pollEndpoint/main.go': 7, 'core/coreapi/interface/swarm.go': 6, 'core/coreapi/swarm.go': 9, 'cmd/ipfs/dnsresolve_test.go': 5, 'core/coreapi/coreapi.go': 8, 'core/coreapi/interface/options/unixfs.go': 5, 'core/coreapi/interface/pubsub.go': 4, 'core/coreapi/pubsub.go': 9, 'core/coreapi/unixfile.go': 4, 'test/dependencies/ma-pipe-unidir/main.go': 5, 'test/sharness/t0180-pubsub.sh': 1, 'core/commands/cid.go': 3, 'core/coreapi/block_test.go': 1, 'core/coreapi/dag_test.go': 1, 'core/coreapi/interface/options/block.go': 1, 'keystore/keystore_test.go': 3, 'keystore/memkeystore.go': 3, 'test/dependencies/iptb/iptb.go': 10, 'commands/context.go': 8, 'core/corehttp/proxy.go': 6, 'core/coreapi/test/api_test.go': 6, 'core/coreapi/interface/tests/name.go': 2, 'core/coreapi/interface/tests/unixfs.go': 2, 'core/commands/cmdenv/cidbase.go': 2, 'core/corehttp/ipns_hostname.go': 3, 'filestore/pb/dataobj.pb.go': 2, 'namesys/dns_test.go': 3, 'pin/internal/pb/header.pb.go': 2, 'plugin/daemon.go': 3, 'plugin/loader/loader.go': 3, 'plugin/plugins/badgerds/badgerds.go': 2, 'plugin/plugins/flatfs/flatfs.go': 2, 'plugin/plugins/levelds/levelds.go': 2, 'cmd/ipfs/util/ulimit_freebsd.go': 1, 'cmd/ipfs/util/ulimit_unix.go': 1, 'core/commands/cmdenv/cidbase_test.go': 1, 'core/commands/cmdenv/file.go': 1, 'core/corehttp/metrics.go': 1, 'core/corehttp/proxy_test.go': 1, 'core/corerepo/stat.go': 1, 'fuse/ipns/link_unix.go': 1, 'fuse/mount/fuse.go': 1, 'fuse/node/mount_darwin.go': 1, 'plugin/tracer.go': 1, 'thirdparty/notifier/notifier.go': 1}","('repo/fsrepo/fsrepo.go', 1.0, 0.36231884057971014)"
repo/fsrepo/migrations/migrations.go,212,1202,12,"[{'cyclomatic_complexity': 2, 'nloc': 5, 'token_count': 24, 'name': 'init', 'long_name': 'init', 'start_line': 20, 'end_line': 24, 'full_parameters': [], 'filename': '/home/dimi/Documents/Informatik_Studium/FSS/SoftEvo/DataCollection/FFS_SoftEvo/go-ipfs/repo/fsrepo/migrations/migrations.go', 'top_nesting_level': 0, 'length': 5, 'fan_in': 0, 'fan_out': 0, 'general_fan_out': 0}, {'cyclomatic_complexity': 2, 'nloc': 8, 'token_count': 24, 'name': 'migrationsBinName', 'long_name': 'migrationsBinName', 'start_line': 28, 'end_line': 35, 'full_parameters': [], 'filename': '/home/dimi/Documents/Informatik_Studium/FSS/SoftEvo/DataCollection/FFS_SoftEvo/go-ipfs/repo/fsrepo/migrations/migrations.go', 'top_nesting_level': 0, 'length': 8, 'fan_in': 0, 'fan_out': 0, 'general_fan_out': 0}, {'cyclomatic_complexity': 6, 'nloc': 33, 'token_count': 193, 'name': 'RunMigration', 'long_name': 'RunMigration newv int', 'start_line': 37, 'end_line': 81, 'full_parameters': ['newv int'], 'filename': '/home/dimi/Documents/Informatik_Studium/FSS/SoftEvo/DataCollection/FFS_SoftEvo/go-ipfs/repo/fsrepo/migrations/migrations.go', 'top_nesting_level': 0, 'length': 45, 'fan_in': 0, 'fan_out': 0, 'general_fan_out': 0}, {'cyclomatic_complexity': 5, 'nloc': 20, 'token_count': 134, 'name': 'GetMigrations', 'long_name': 'GetMigrations', 'start_line': 83, 'end_line': 107, 'full_parameters': [], 'filename': '/home/dimi/Documents/Informatik_Studium/FSS/SoftEvo/DataCollection/FFS_SoftEvo/go-ipfs/repo/fsrepo/migrations/migrations.go', 'top_nesting_level': 0, 'length': 25, 'fan_in': 0, 'fan_out': 0, 'general_fan_out': 0}, {'cyclomatic_complexity': 3, 'nloc': 10, 'token_count': 47, 'name': 'verifyMigrationSupportsVersion', 'long_name': 'verifyMigrationSupportsVersion fsrbin string , vn int', 'start_line': 109, 'end_line': 120, 'full_parameters': ['fsrbin string', ' vn int'], 'filename': '/home/dimi/Documents/Informatik_Studium/FSS/SoftEvo/DataCollection/FFS_SoftEvo/go-ipfs/repo/fsrepo/migrations/migrations.go', 'top_nesting_level': 0, 'length': 12, 'fan_in': 0, 'fan_out': 0, 'general_fan_out': 0}, {'cyclomatic_complexity': 3, 'nloc': 12, 'token_count': 90, 'name': 'migrationsVersion', 'long_name': 'migrationsVersion bin string', 'start_line': 122, 'end_line': 135, 'full_parameters': ['bin string'], 'filename': '/home/dimi/Documents/Informatik_Studium/FSS/SoftEvo/DataCollection/FFS_SoftEvo/go-ipfs/repo/fsrepo/migrations/migrations.go', 'top_nesting_level': 0, 'length': 14, 'fan_in': 0, 'fan_out': 0, 'general_fan_out': 0}, {'cyclomatic_complexity': 3, 'nloc': 13, 'token_count': 84, 'name': 'GetVersions', 'long_name': 'GetVersions ipfspath , dist string', 'start_line': 137, 'end_line': 151, 'full_parameters': ['ipfspath', ' dist string'], 'filename': '/home/dimi/Documents/Informatik_Studium/FSS/SoftEvo/DataCollection/FFS_SoftEvo/go-ipfs/repo/fsrepo/migrations/migrations.go', 'top_nesting_level': 0, 'length': 15, 'fan_in': 0, 'fan_out': 0, 'general_fan_out': 0}, {'cyclomatic_complexity': 5, 'nloc': 17, 'token_count': 105, 'name': 'GetLatestVersion', 'long_name': 'GetLatestVersion ipfspath , dist string', 'start_line': 153, 'end_line': 169, 'full_parameters': ['ipfspath', ' dist string'], 'filename': '/home/dimi/Documents/Informatik_Studium/FSS/SoftEvo/DataCollection/FFS_SoftEvo/go-ipfs/repo/fsrepo/migrations/migrations.go', 'top_nesting_level': 0, 'length': 17, 'fan_in': 0, 'fan_out': 0, 'general_fan_out': 0}, {'cyclomatic_complexity': 3, 'nloc': 12, 'token_count': 90, 'name': 'httpGet', 'long_name': 'httpGet url string', 'start_line': 171, 'end_line': 185, 'full_parameters': ['url string'], 'filename': '/home/dimi/Documents/Informatik_Studium/FSS/SoftEvo/DataCollection/FFS_SoftEvo/go-ipfs/repo/fsrepo/migrations/migrations.go', 'top_nesting_level': 0, 'length': 15, 'fan_in': 0, 'fan_out': 0, 'general_fan_out': 0}, {'cyclomatic_complexity': 4, 'nloc': 14, 'token_count': 96, 'name': 'httpFetch', 'long_name': 'httpFetch url string', 'start_line': 187, 'end_line': 203, 'full_parameters': ['url string'], 'filename': '/home/dimi/Documents/Informatik_Studium/FSS/SoftEvo/DataCollection/FFS_SoftEvo/go-ipfs/repo/fsrepo/migrations/migrations.go', 'top_nesting_level': 0, 'length': 17, 'fan_in': 0, 'fan_out': 0, 'general_fan_out': 0}, {'cyclomatic_complexity': 7, 'nloc': 35, 'token_count': 193, 'name': 'GetBinaryForVersion', 'long_name': 'GetBinaryForVersion distname , binnom , root , vers , out string', 'start_line': 205, 'end_line': 244, 'full_parameters': ['distname', ' binnom', ' root', ' vers', ' out string'], 'filename': '/home/dimi/Documents/Informatik_Studium/FSS/SoftEvo/DataCollection/FFS_SoftEvo/go-ipfs/repo/fsrepo/migrations/migrations.go', 'top_nesting_level': 0, 'length': 40, 'fan_in': 0, 'fan_out': 0, 'general_fan_out': 0}, {'cyclomatic_complexity': 5, 'nloc': 16, 'token_count': 97, 'name': 'osWithVariant', 'long_name': 'osWithVariant', 'start_line': 248, 'end_line': 277, 'full_parameters': [], 'filename': '/home/dimi/Documents/Informatik_Studium/FSS/SoftEvo/DataCollection/FFS_SoftEvo/go-ipfs/repo/fsrepo/migrations/migrations.go', 'top_nesting_level': 0, 'length': 30, 'fan_in': 0, 'fan_out': 0, 'general_fan_out': 0}]",247,1484,10,"[{'cyclomatic_complexity': 16, 'nloc': 57, 'token_count': 359, 'name': 'RunMigration', 'long_name': 'RunMigration ctx context . Context , fetcher Fetcher , targetVer int , ipfsDir string , allowDowngrade bool', 'start_line': 29, 'end_line': 97, 'full_parameters': ['ctx context . Context', ' fetcher Fetcher', ' targetVer int', ' ipfsDir string', ' allowDowngrade bool'], 'filename': '/home/dimi/Documents/Informatik_Studium/FSS/SoftEvo/DataCollection/FFS_SoftEvo/go-ipfs/repo/fsrepo/migrations/migrations.go', 'top_nesting_level': 0, 'length': 69, 'fan_in': 0, 'fan_out': 0, 'general_fan_out': 0}, {'cyclomatic_complexity': 2, 'nloc': 7, 'token_count': 44, 'name': 'NeedMigration', 'long_name': 'NeedMigration target int', 'start_line': 99, 'end_line': 106, 'full_parameters': ['target int'], 'filename': '/home/dimi/Documents/Informatik_Studium/FSS/SoftEvo/DataCollection/FFS_SoftEvo/go-ipfs/repo/fsrepo/migrations/migrations.go', 'top_nesting_level': 0, 'length': 8, 'fan_in': 0, 'fan_out': 0, 'general_fan_out': 0}, {'cyclomatic_complexity': 2, 'nloc': 6, 'token_count': 23, 'name': 'ExeName', 'long_name': 'ExeName name string', 'start_line': 108, 'end_line': 113, 'full_parameters': ['name string'], 'filename': '/home/dimi/Documents/Informatik_Studium/FSS/SoftEvo/DataCollection/FFS_SoftEvo/go-ipfs/repo/fsrepo/migrations/migrations.go', 'top_nesting_level': 0, 'length': 6, 'fan_in': 0, 'fan_out': 0, 'general_fan_out': 0}, {'cyclomatic_complexity': 7, 'nloc': 29, 'token_count': 162, 'name': 'ReadMigrationConfig', 'long_name': 'ReadMigrationConfig repoRoot string', 'start_line': 118, 'end_line': 152, 'full_parameters': ['repoRoot string'], 'filename': '/home/dimi/Documents/Informatik_Studium/FSS/SoftEvo/DataCollection/FFS_SoftEvo/go-ipfs/repo/fsrepo/migrations/migrations.go', 'top_nesting_level': 0, 'length': 35, 'fan_in': 0, 'fan_out': 0, 'general_fan_out': 0}, {'cyclomatic_complexity': 11, 'nloc': 36, 'token_count': 223, 'name': 'GetMigrationFetcher', 'long_name': 'GetMigrationFetcher downloadSources [ ] string , distPath string , newIpfsFetcher func string Fetcher', 'start_line': 156, 'end_line': 196, 'full_parameters': ['downloadSources [ ] string', ' distPath string', ' newIpfsFetcher func string Fetcher'], 'filename': '/home/dimi/Documents/Informatik_Studium/FSS/SoftEvo/DataCollection/FFS_SoftEvo/go-ipfs/repo/fsrepo/migrations/migrations.go', 'top_nesting_level': 0, 'length': 41, 'fan_in': 0, 'fan_out': 0, 'general_fan_out': 0}, {'cyclomatic_complexity': 1, 'nloc': 3, 'token_count': 22, 'name': 'migrationName', 'long_name': 'migrationName from , to int', 'start_line': 198, 'end_line': 200, 'full_parameters': ['from', ' to int'], 'filename': '/home/dimi/Documents/Informatik_Studium/FSS/SoftEvo/DataCollection/FFS_SoftEvo/go-ipfs/repo/fsrepo/migrations/migrations.go', 'top_nesting_level': 0, 'length': 3, 'fan_in': 0, 'fan_out': 0, 'general_fan_out': 0}, {'cyclomatic_complexity': 6, 'nloc': 28, 'token_count': 179, 'name': 'findMigrations', 'long_name': 'findMigrations ctx context . Context , from , to int', 'start_line': 205, 'end_line': 234, 'full_parameters': ['ctx context . Context', ' from', ' to int'], 'filename': '/home/dimi/Documents/Informatik_Studium/FSS/SoftEvo/DataCollection/FFS_SoftEvo/go-ipfs/repo/fsrepo/migrations/migrations.go', 'top_nesting_level': 0, 'length': 30, 'fan_in': 0, 'fan_out': 0, 'general_fan_out': 0}, {'cyclomatic_complexity': 2, 'nloc': 14, 'token_count': 122, 'name': 'runMigration', 'long_name': 'runMigration ctx context . Context , binPath , ipfsDir string , revert bool , logger * log . Logger', 'start_line': 236, 'end_line': 249, 'full_parameters': ['ctx context . Context', ' binPath', ' ipfsDir string', ' revert bool', ' logger * log . Logger'], 'filename': '/home/dimi/Documents/Informatik_Studium/FSS/SoftEvo/DataCollection/FFS_SoftEvo/go-ipfs/repo/fsrepo/migrations/migrations.go', 'top_nesting_level': 0, 'length': 14, 'fan_in': 0, 'fan_out': 0, 'general_fan_out': 0}, {'cyclomatic_complexity': 3, 'nloc': 16, 'token_count': 108, 'name': '', 'long_name': '(i int,name string)', 'start_line': 268, 'end_line': 283, 'full_parameters': [], 'filename': '/home/dimi/Documents/Informatik_Studium/FSS/SoftEvo/DataCollection/FFS_SoftEvo/go-ipfs/repo/fsrepo/migrations/migrations.go', 'top_nesting_level': 0, 'length': 16, 'fan_in': 0, 'fan_out': 0, 'general_fan_out': 0}, {'cyclomatic_complexity': 8, 'nloc': 31, 'token_count': 214, 'name': 'fetchMigrations', 'long_name': 'fetchMigrations ctx context . Context , fetcher Fetcher , needed [ ] string , destDir string , logger * log . Logger', 'start_line': 253, 'end_line': 302, 'full_parameters': ['ctx context . Context', ' fetcher Fetcher', ' needed [ ] string', ' destDir string', ' logger * log . Logger'], 'filename': '/home/dimi/Documents/Informatik_Studium/FSS/SoftEvo/DataCollection/FFS_SoftEvo/go-ipfs/repo/fsrepo/migrations/migrations.go', 'top_nesting_level': 0, 'length': 50, 'fan_in': 0, 'fan_out': 0, 'general_fan_out': 0}]",35,282,-2,27,27,"[{'timestamp': 1521427288.0, 'added_lines': 1, 'deleted_lines': 1, 'nloc': 212}, {'timestamp': 1527822202.0, 'added_lines': 1, 'deleted_lines': 1, 'nloc': 212}, {'timestamp': 1551228784.0, 'added_lines': 1, 'deleted_lines': 1, 'nloc': 212}, {'timestamp': 1585005266.0, 'added_lines': 1, 'deleted_lines': 1, 'nloc': 212}, {'timestamp': 1587221101.0, 'added_lines': 2, 'deleted_lines': 2, 'nloc': 212}, {'timestamp': 1589380943.0, 'added_lines': 1, 'deleted_lines': 1, 'nloc': 212}, {'timestamp': 1591633238.0, 'added_lines': 1, 'deleted_lines': 1, 'nloc': 212}, {'timestamp': 1591633238.0, 'added_lines': 1, 'deleted_lines': 1, 'nloc': 212}, {'timestamp': 1591718030.0, 'added_lines': 1, 'deleted_lines': 1, 'nloc': 212}, {'timestamp': 1591725959.0, 'added_lines': 1, 'deleted_lines': 1, 'nloc': 212}, {'timestamp': 1591718030.0, 'added_lines': 1, 'deleted_lines': 1, 'nloc': 212}, {'timestamp': 1591725959.0, 'added_lines': 1, 'deleted_lines': 1, 'nloc': 212}, {'timestamp': 1603488587.0, 'added_lines': 5, 'deleted_lines': 0, 'nloc': 215}, {'timestamp': 1607456760.0, 'added_lines': 1, 'deleted_lines': 1, 'nloc': 215}, {'timestamp': 1611888175.0, 'added_lines': 1, 'deleted_lines': 1, 'nloc': 215}, {'timestamp': 1608173236.0, 'added_lines': 142, 'deleted_lines': 221, 'nloc': 169}, {'timestamp': 1610424366.0, 'added_lines': 2, 'deleted_lines': 2, 'nloc': 169}, {'timestamp': 1610667798.0, 'added_lines': 1, 'deleted_lines': 1, 'nloc': 169}, {'timestamp': 1610677897.0, 'added_lines': 6, 'deleted_lines': 1, 'nloc': 174}, {'timestamp': 1612226929.0, 'added_lines': 1, 'deleted_lines': 1, 'nloc': 174}, {'timestamp': 1613168016.0, 'added_lines': 2, 'deleted_lines': 2, 'nloc': 174}, {'timestamp': 1614357668.0, 'added_lines': 9, 'deleted_lines': 6, 'nloc': 177}, {'timestamp': 1616692226.0, 'added_lines': 1, 'deleted_lines': 1, 'nloc': 177}, {'timestamp': 1616744893.0, 'added_lines': 1, 'deleted_lines': 1, 'nloc': 177}, {'timestamp': 1617679149.0, 'added_lines': 17, 'deleted_lines': 15, 'nloc': 178}, {'timestamp': 1620837194.0, 'added_lines': 2, 'deleted_lines': 1, 'nloc': 178}, {'timestamp': 1627669677.0, 'added_lines': 88, 'deleted_lines': 0, 'nloc': 247}]","{'CHANGELOG.md': 2, 'README.md': 2, 'bin/dist_get': 1, 'cmd/ipfs/init.go': 1, 'cmd/ipfs/main.go': 1, 'cmd/ipfs/util/ulimit_freebsd.go': 1, 'cmd/seccat/seccat.go': 1, 'commands/request.go': 1, 'contribute.md': 1, 'core/builder.go': 1, 'core/commands/add.go': 1, 'core/commands/block.go': 1, 'core/commands/dag/dag.go': 2, 'core/commands/mount_unix.go': 1, 'core/commands/refs.go': 1, 'core/coreapi/coreapi.go': 1, 'core/coreapi/interface/options/pin.go': 1, 'core/coredag/dagtransl.go': 1, 'core/corerepo/pinning.go': 1, 'core/pathresolver.go': 1, 'docs/experimental-features.md': 1, 'docs/file-transfer.md': 1, 'docs/releases.md': 1, 'exchange/bitswap/README.md': 1, 'exchange/bitswap/bitswap.go': 1, 'exchange/bitswap/decision/ledger.go': 1, 'importer/helpers/dagbuilder.go': 1, 'importer/trickle/trickledag.go': 1, 'merkledag/raw.go': 1, 'namesys/pubsub.go': 1, 'pin/pin.go': 1, 'pin/set.go': 1, 'plugin/plugin.go': 1, 'repo/fsrepo/fsrepo.go': 6, 'repo/fsrepo/migrations/mfsr_test.go': 1, 'test/sharness/README.md': 2, 'thirdparty/dir/dir.go': 1, 'unixfs/mod/dagmodifier.go': 1, 'core/corehttp/commands.go': 1, 'core/corehttp/gateway.go': 1, 'core/corehttp/gateway_handler.go': 2, 'core/corehttp/gateway_test.go': 1, 'core/corehttp/option_test.go': 1, 'core/corehttp/proxy_test.go': 1, 'Dockerfile': 1, 'bin/check_go_version': 1, 'blocks/blockstoreutil/remove.go': 1, 'cmd/ipfs/daemon.go': 5, 'cmd/ipfs/util/ulimit.go': 1, 'core/commands/cid.go': 1, 'core/commands/commands.go': 1, 'core/commands/files.go': 1, 'core/commands/get.go': 1, 'core/commands/pin.go': 1, 'core/corehttp/corehttp.go': 1, 'core/coreunix/add_test.go': 1, 'coverage/Rules.mk': 1, 'docs/config.md': 2, 'docs/debug-guide.md': 1, 'docs/environment-variables.md': 1, 'fuse/ipns/ipns_test.go': 1, 'fuse/node/mount_darwin.go': 1, 'fuse/readonly/readonly_unix.go': 1, 'gc/gc.go': 1, 'keystore/keystore.go': 1, 'keystore/keystore_test.go': 1, 'keystore/memkeystore.go': 1, 'keystore/memkeystore_test.go': 1, 'misc/completion/ipfs-completion.bash': 1, 'namesys/namesys.go': 1, 'namesys/republisher/repub_test.go': 1, 'plugin/plugins/gen_main.sh': 1, 'repo/onlyone.go': 1, 'test/3nodetest/run-test-on-img.sh': 1, 'test/ipfs-test-lib.sh': 1, 'test/sharness/lib/iptb-lib.sh': 1, 'test/sharness/t0010-basic-commands.sh': 1, 'test/sharness/t0020-init.sh': 1, 'test/sharness/t0030-mount.sh': 1, 'test/sharness/t0031-mount-publish.sh': 1, 'test/sharness/t0040-add-and-cat.sh': 1, 'test/sharness/t0050-block.sh': 1, 'test/sharness/t0051-object.sh': 1, 'test/sharness/t0053-dag.sh': 1, 'test/sharness/t0060-daemon.sh': 1, 'test/sharness/t0062-daemon-api.sh': 1, 'test/sharness/t0080-repo.sh': 1, 'test/sharness/t0087-repo-robust-gc.sh': 1, 'test/sharness/t0090-get.sh': 1, 'test/sharness/t0110-gateway.sh': 1, 'test/sharness/t0114-gateway-subdomains.sh': 1, 'test/sharness/t0131-multinode-client-routing.sh': 1, 'test/sharness/t0140-swarm.sh': 1, 'test/sharness/t0183-namesys-pubsub.sh': 1, 'test/sharness/t0250-files-api.sh': 1, 'test/sharness/t0270-filestore.sh': 1, 'test/sharness/t0272-urlstore.sh': 1, 'test/sharness/t0410-api-add.sh': 1, 'test/sharness/t0600-issues-and-regressions-online.sh': 1, 'test/sharness_test_coverage_helper.sh': 1, 'thirdparty/README.md': 1, 'thirdparty/notifier/notifier.go': 1, 'go.mod': 2, 'go.sum': 2, 'repo/fsrepo/migrations/fetch.go': 4, 'repo/fsrepo/migrations/fetch_test.go': 5, 'repo/fsrepo/migrations/ipfsdir.go': 4, 'repo/fsrepo/migrations/ipfsdir_test.go': 4, None: 3, 'repo/fsrepo/migrations/migrations_test.go': 10, 'repo/fsrepo/migrations/unpack.go': 3, 'repo/fsrepo/migrations/versions.go': 3, 'repo/fsrepo/migrations/versions_test.go': 2, 'repo/fsrepo/migrations/fetcher.go': 3, 'repo/fsrepo/migrations/httpfetcher.go': 2, 'repo/fsrepo/migrations/unpack_test.go': 2, 'cmd/ipfs/migration.go': 1, 'cmd/ipfs/migration_test.go': 1, 'repo/fsrepo/migrations/ipfsfetcher/ipfsfetcher.go': 2, 'repo/fsrepo/migrations/ipfsfetcher/ipfsfetcher_test.go': 2, 'cmd/ipfs/add_migrations.go': 1}","('repo/fsrepo/fsrepo.go', 0.2222222222222222, 0.08695652173913043)"
repo/fsrepo/migrations/unpack.go,79,384,4,"[{'cyclomatic_complexity': 3, 'nloc': 10, 'token_count': 60, 'name': 'unpackArchive', 'long_name': 'unpackArchive dist , binnom , path , out , atype string', 'start_line': 12, 'end_line': 21, 'full_parameters': ['dist', ' binnom', ' path', ' out', ' atype string'], 'filename': '/home/dimi/Documents/Informatik_Studium/FSS/SoftEvo/DataCollection/FFS_SoftEvo/go-ipfs/repo/fsrepo/migrations/unpack.go', 'top_nesting_level': 0, 'length': 10, 'fan_in': 0, 'fan_out': 0, 'general_fan_out': 0}, {'cyclomatic_complexity': 8, 'nloc': 33, 'token_count': 144, 'name': 'unpackTgz', 'long_name': 'unpackTgz dist , binnom , path , out string', 'start_line': 23, 'end_line': 63, 'full_parameters': ['dist', ' binnom', ' path', ' out string'], 'filename': '/home/dimi/Documents/Informatik_Studium/FSS/SoftEvo/DataCollection/FFS_SoftEvo/go-ipfs/repo/fsrepo/migrations/unpack.go', 'top_nesting_level': 0, 'length': 41, 'fan_in': 0, 'fan_out': 0, 'general_fan_out': 0}, {'cyclomatic_complexity': 2, 'nloc': 9, 'token_count': 61, 'name': 'writeToPath', 'long_name': 'writeToPath rc io . Reader , out string', 'start_line': 65, 'end_line': 75, 'full_parameters': ['rc io . Reader', ' out string'], 'filename': '/home/dimi/Documents/Informatik_Studium/FSS/SoftEvo/DataCollection/FFS_SoftEvo/go-ipfs/repo/fsrepo/migrations/unpack.go', 'top_nesting_level': 0, 'length': 11, 'fan_in': 0, 'fan_out': 0, 'general_fan_out': 0}, {'cyclomatic_complexity': 5, 'nloc': 18, 'token_count': 108, 'name': 'unpackZip', 'long_name': 'unpackZip dist , binnom , path , out string', 'start_line': 77, 'end_line': 98, 'full_parameters': ['dist', ' binnom', ' path', ' out string'], 'filename': '/home/dimi/Documents/Informatik_Studium/FSS/SoftEvo/DataCollection/FFS_SoftEvo/go-ipfs/repo/fsrepo/migrations/unpack.go', 'top_nesting_level': 0, 'length': 22, 'fan_in': 0, 'fan_out': 0, 'general_fan_out': 0}]",89,439,4,"[{'cyclomatic_complexity': 4, 'nloc': 15, 'token_count': 76, 'name': 'unpackArchive', 'long_name': 'unpackArchive arcPath , atype , root , name , out string', 'start_line': 13, 'end_line': 27, 'full_parameters': ['arcPath', ' atype', ' root', ' name', ' out string'], 'filename': '/home/dimi/Documents/Informatik_Studium/FSS/SoftEvo/DataCollection/FFS_SoftEvo/go-ipfs/repo/fsrepo/migrations/unpack.go', 'top_nesting_level': 0, 'length': 15, 'fan_in': 0, 'fan_out': 0, 'general_fan_out': 0}, {'cyclomatic_complexity': 8, 'nloc': 32, 'token_count': 165, 'name': 'unpackTgz', 'long_name': 'unpackTgz arcPath , root , name , out string', 'start_line': 29, 'end_line': 66, 'full_parameters': ['arcPath', ' root', ' name', ' out string'], 'filename': '/home/dimi/Documents/Informatik_Studium/FSS/SoftEvo/DataCollection/FFS_SoftEvo/go-ipfs/repo/fsrepo/migrations/unpack.go', 'top_nesting_level': 0, 'length': 38, 'fan_in': 0, 'fan_out': 0, 'general_fan_out': 0}, {'cyclomatic_complexity': 6, 'nloc': 23, 'token_count': 125, 'name': 'unpackZip', 'long_name': 'unpackZip arcPath , root , name , out string', 'start_line': 68, 'end_line': 94, 'full_parameters': ['arcPath', ' root', ' name', ' out string'], 'filename': '/home/dimi/Documents/Informatik_Studium/FSS/SoftEvo/DataCollection/FFS_SoftEvo/go-ipfs/repo/fsrepo/migrations/unpack.go', 'top_nesting_level': 0, 'length': 27, 'fan_in': 0, 'fan_out': 0, 'general_fan_out': 0}, {'cyclomatic_complexity': 2, 'nloc': 9, 'token_count': 61, 'name': 'writeToPath', 'long_name': 'writeToPath rc io . Reader , out string', 'start_line': 96, 'end_line': 106, 'full_parameters': ['rc io . Reader', ' out string'], 'filename': '/home/dimi/Documents/Informatik_Studium/FSS/SoftEvo/DataCollection/FFS_SoftEvo/go-ipfs/repo/fsrepo/migrations/unpack.go', 'top_nesting_level': 0, 'length': 11, 'fan_in': 0, 'fan_out': 0, 'general_fan_out': 0}]",10,55,0,4,4,"[{'timestamp': 1608173236.0, 'added_lines': 42, 'deleted_lines': 38, 'nloc': 86}, {'timestamp': 1611808363.0, 'added_lines': 5, 'deleted_lines': 0, 'nloc': 90}, {'timestamp': 1614357668.0, 'added_lines': 6, 'deleted_lines': 6, 'nloc': 90}, {'timestamp': 1620837194.0, 'added_lines': 0, 'deleted_lines': 1, 'nloc': 89}]","{'cmd/ipfs/daemon.go': 3, 'go.mod': 2, 'go.sum': 2, 'repo/fsrepo/fsrepo.go': 2, 'repo/fsrepo/migrations/fetch.go': 4, 'repo/fsrepo/migrations/fetch_test.go': 4, 'repo/fsrepo/migrations/ipfsdir.go': 2, 'repo/fsrepo/migrations/ipfsdir_test.go': 3, None: 2, 'repo/fsrepo/migrations/migrations.go': 3, 'repo/fsrepo/migrations/migrations_test.go': 4, 'repo/fsrepo/migrations/versions.go': 2, 'repo/fsrepo/migrations/versions_test.go': 2, 'repo/fsrepo/migrations/unpack_test.go': 2, 'repo/fsrepo/migrations/fetcher.go': 2, 'repo/fsrepo/migrations/httpfetcher.go': 2, 'cmd/ipfs/migration.go': 1, 'cmd/ipfs/migration_test.go': 1, 'docs/config.md': 1, 'repo/fsrepo/migrations/ipfsfetcher/ipfsfetcher.go': 1, 'repo/fsrepo/migrations/ipfsfetcher/ipfsfetcher_test.go': 1}","('cmd/ipfs/daemon.go', 0.75, 0.0196078431372549)"
tar/format.go,176,1041,7,"[{'cyclomatic_complexity': 2, 'nloc': 9, 'token_count': 60, 'name': 'marshalHeader', 'long_name': 'marshalHeader h * tar . Header', 'start_line': 27, 'end_line': 35, 'full_parameters': ['h * tar . Header'], 'filename': '/home/dimi/Documents/Informatik_Studium/FSS/SoftEvo/DataCollection/FFS_SoftEvo/go-ipfs/tar/format.go', 'top_nesting_level': 0, 'length': 9, 'fan_in': 0, 'fan_out': 0, 'general_fan_out': 0}, {'cyclomatic_complexity': 2, 'nloc': 7, 'token_count': 36, 'name': '*', 'long_name': '()*', 'start_line': 82, 'end_line': 89, 'full_parameters': [], 'filename': '/home/dimi/Documents/Informatik_Studium/FSS/SoftEvo/DataCollection/FFS_SoftEvo/go-ipfs/tar/format.go', 'top_nesting_level': 0, 'length': 8, 'fan_in': 0, 'fan_out': 0, 'general_fan_out': 0}, {'cyclomatic_complexity': 2, 'nloc': 7, 'token_count': 48, 'name': 'escapePath', 'long_name': 'escapePath pth string', 'start_line': 93, 'end_line': 99, 'full_parameters': ['pth string'], 'filename': '/home/dimi/Documents/Informatik_Studium/FSS/SoftEvo/DataCollection/FFS_SoftEvo/go-ipfs/tar/format.go', 'top_nesting_level': 0, 'length': 7, 'fan_in': 0, 'fan_out': 0, 'general_fan_out': 0}, {'cyclomatic_complexity': 16, 'nloc': 67, 'token_count': 438, 'name': 'Read', 'long_name': '(tr*tarReader)Read b [ ] byte', 'start_line': 113, 'end_line': 195, 'full_parameters': ['b [ ] byte'], 'filename': '/home/dimi/Documents/Informatik_Studium/FSS/SoftEvo/DataCollection/FFS_SoftEvo/go-ipfs/tar/format.go', 'top_nesting_level': 0, 'length': 83, 'fan_in': 0, 'fan_out': 0, 'general_fan_out': 0}, {'cyclomatic_complexity': 2, 'nloc': 10, 'token_count': 73, 'name': 'ExportTar', 'long_name': 'ExportTar ctx context . Context , root * dag . ProtoNode , ds dag . DAGService', 'start_line': 197, 'end_line': 206, 'full_parameters': ['ctx context . Context', ' root * dag . ProtoNode', ' ds dag . DAGService'], 'filename': '/home/dimi/Documents/Informatik_Studium/FSS/SoftEvo/DataCollection/FFS_SoftEvo/go-ipfs/tar/format.go', 'top_nesting_level': 0, 'length': 10, 'fan_in': 0, 'fan_out': 0, 'general_fan_out': 0}, {'cyclomatic_complexity': 1, 'nloc': 5, 'token_count': 41, 'name': 'Read', 'long_name': '(r*countReader)Read b [ ] byte', 'start_line': 213, 'end_line': 217, 'full_parameters': ['b [ ] byte'], 'filename': '/home/dimi/Documents/Informatik_Studium/FSS/SoftEvo/DataCollection/FFS_SoftEvo/go-ipfs/tar/format.go', 'top_nesting_level': 0, 'length': 5, 'fan_in': 0, 'fan_out': 0, 'general_fan_out': 0}, {'cyclomatic_complexity': 1, 'nloc': 3, 'token_count': 20, 'name': 'Close', 'long_name': '(r*countReader)Close', 'start_line': 219, 'end_line': 221, 'full_parameters': [], 'filename': '/home/dimi/Documents/Informatik_Studium/FSS/SoftEvo/DataCollection/FFS_SoftEvo/go-ipfs/tar/format.go', 'top_nesting_level': 0, 'length': 3, 'fan_in': 0, 'fan_out': 0, 'general_fan_out': 0}]",176,1047,7,"[{'cyclomatic_complexity': 2, 'nloc': 9, 'token_count': 60, 'name': 'marshalHeader', 'long_name': 'marshalHeader h * tar . Header', 'start_line': 27, 'end_line': 35, 'full_parameters': ['h * tar . Header'], 'filename': '/home/dimi/Documents/Informatik_Studium/FSS/SoftEvo/DataCollection/FFS_SoftEvo/go-ipfs/tar/format.go', 'top_nesting_level': 0, 'length': 9, 'fan_in': 0, 'fan_out': 0, 'general_fan_out': 0}, {'cyclomatic_complexity': 2, 'nloc': 7, 'token_count': 38, 'name': '*', 'long_name': '()*', 'start_line': 84, 'end_line': 91, 'full_parameters': [], 'filename': '/home/dimi/Documents/Informatik_Studium/FSS/SoftEvo/DataCollection/FFS_SoftEvo/go-ipfs/tar/format.go', 'top_nesting_level': 0, 'length': 8, 'fan_in': 0, 'fan_out': 0, 'general_fan_out': 0}, {'cyclomatic_complexity': 2, 'nloc': 7, 'token_count': 48, 'name': 'escapePath', 'long_name': 'escapePath pth string', 'start_line': 95, 'end_line': 101, 'full_parameters': ['pth string'], 'filename': '/home/dimi/Documents/Informatik_Studium/FSS/SoftEvo/DataCollection/FFS_SoftEvo/go-ipfs/tar/format.go', 'top_nesting_level': 0, 'length': 7, 'fan_in': 0, 'fan_out': 0, 'general_fan_out': 0}, {'cyclomatic_complexity': 16, 'nloc': 67, 'token_count': 438, 'name': 'Read', 'long_name': '(tr*tarReader)Read b [ ] byte', 'start_line': 115, 'end_line': 197, 'full_parameters': ['b [ ] byte'], 'filename': '/home/dimi/Documents/Informatik_Studium/FSS/SoftEvo/DataCollection/FFS_SoftEvo/go-ipfs/tar/format.go', 'top_nesting_level': 0, 'length': 83, 'fan_in': 0, 'fan_out': 0, 'general_fan_out': 0}, {'cyclomatic_complexity': 2, 'nloc': 10, 'token_count': 73, 'name': 'ExportTar', 'long_name': 'ExportTar ctx context . Context , root * dag . ProtoNode , ds ipld . DAGService', 'start_line': 201, 'end_line': 210, 'full_parameters': ['ctx context . Context', ' root * dag . ProtoNode', ' ds ipld . DAGService'], 'filename': '/home/dimi/Documents/Informatik_Studium/FSS/SoftEvo/DataCollection/FFS_SoftEvo/go-ipfs/tar/format.go', 'top_nesting_level': 0, 'length': 10, 'fan_in': 0, 'fan_out': 0, 'general_fan_out': 0}, {'cyclomatic_complexity': 1, 'nloc': 5, 'token_count': 41, 'name': 'Read', 'long_name': '(r*countReader)Read b [ ] byte', 'start_line': 217, 'end_line': 221, 'full_parameters': ['b [ ] byte'], 'filename': '/home/dimi/Documents/Informatik_Studium/FSS/SoftEvo/DataCollection/FFS_SoftEvo/go-ipfs/tar/format.go', 'top_nesting_level': 0, 'length': 5, 'fan_in': 0, 'fan_out': 0, 'general_fan_out': 0}, {'cyclomatic_complexity': 1, 'nloc': 3, 'token_count': 20, 'name': 'Close', 'long_name': '(r*countReader)Close', 'start_line': 223, 'end_line': 225, 'full_parameters': [], 'filename': '/home/dimi/Documents/Informatik_Studium/FSS/SoftEvo/DataCollection/FFS_SoftEvo/go-ipfs/tar/format.go', 'top_nesting_level': 0, 'length': 3, 'fan_in': 0, 'fan_out': 0, 'general_fan_out': 0}]",0,6,0,66,66,"[{'timestamp': 1512365669.0, 'added_lines': 1, 'deleted_lines': 1, 'nloc': 176}, {'timestamp': 1516838128.0, 'added_lines': 1, 'deleted_lines': 1, 'nloc': 176}, {'timestamp': 1516911711.0, 'added_lines': 5, 'deleted_lines': 5, 'nloc': 176}, {'timestamp': 1516921807.0, 'added_lines': 4, 'deleted_lines': 0, 'nloc': 176}, {'timestamp': 1517255734.0, 'added_lines': 5, 'deleted_lines': 5, 'nloc': 176}, {'timestamp': 1517453697.0, 'added_lines': 1, 'deleted_lines': 1, 'nloc': 176}, {'timestamp': 1517858907.0, 'added_lines': 1, 'deleted_lines': 1, 'nloc': 176}, {'timestamp': 1517996381.0, 'added_lines': 1, 'deleted_lines': 1, 'nloc': 176}, {'timestamp': 1518090209.0, 'added_lines': 1, 'deleted_lines': 1, 'nloc': 176}, {'timestamp': 1518090579.0, 'added_lines': 2, 'deleted_lines': 2, 'nloc': 176}, {'timestamp': 1523911794.0, 'added_lines': 1, 'deleted_lines': 1, 'nloc': 176}, {'timestamp': 1524132813.0, 'added_lines': 1, 'deleted_lines': 1, 'nloc': 176}, {'timestamp': 1525408792.0, 'added_lines': 2, 'deleted_lines': 2, 'nloc': 176}, {'timestamp': 1528520460.0, 'added_lines': 3, 'deleted_lines': 3, 'nloc': 176}, {'timestamp': 1529984485.0, 'added_lines': 2, 'deleted_lines': 2, 'nloc': 176}, {'timestamp': 1531779409.0, 'added_lines': 2, 'deleted_lines': 2, 'nloc': 176}, {'timestamp': 1532722333.0, 'added_lines': 2, 'deleted_lines': 2, 'nloc': 176}, {'timestamp': 1532764253.0, 'added_lines': 1, 'deleted_lines': 1, 'nloc': 176}, {'timestamp': 1532847462.0, 'added_lines': 1, 'deleted_lines': 1, 'nloc': 176}, {'timestamp': 1532986515.0, 'added_lines': 2, 'deleted_lines': 2, 'nloc': 176}, {'timestamp': 1533500571.0, 'added_lines': 4, 'deleted_lines': 4, 'nloc': 176}, {'timestamp': 1533618653.0, 'added_lines': 4, 'deleted_lines': 4, 'nloc': 176}, {'timestamp': 1533779477.0, 'added_lines': 6, 'deleted_lines': 6, 'nloc': 176}, {'timestamp': 1533946888.0, 'added_lines': 2, 'deleted_lines': 2, 'nloc': 176}, {'timestamp': 1534115707.0, 'added_lines': 6, 'deleted_lines': 6, 'nloc': 176}, {'timestamp': 1534195762.0, 'added_lines': 4, 'deleted_lines': 4, 'nloc': 176}, {'timestamp': 1534347022.0, 'added_lines': 6, 'deleted_lines': 6, 'nloc': 176}, {'timestamp': 1534896611.0, 'added_lines': 6, 'deleted_lines': 6, 'nloc': 176}, {'timestamp': 1535601896.0, 'added_lines': 4, 'deleted_lines': 4, 'nloc': 176}, {'timestamp': 1536388808.0, 'added_lines': 4, 'deleted_lines': 4, 'nloc': 176}, {'timestamp': 1536718784.0, 'added_lines': 6, 'deleted_lines': 6, 'nloc': 176}, {'timestamp': 1536723292.0, 'added_lines': 4, 'deleted_lines': 4, 'nloc': 176}, {'timestamp': 1537790637.0, 'added_lines': 4, 'deleted_lines': 4, 'nloc': 176}, {'timestamp': 1537792589.0, 'added_lines': 6, 'deleted_lines': 6, 'nloc': 176}, {'timestamp': 1538544957.0, 'added_lines': 4, 'deleted_lines': 4, 'nloc': 176}, {'timestamp': 1538694687.0, 'added_lines': 4, 'deleted_lines': 4, 'nloc': 176}, {'timestamp': 1538695953.0, 'added_lines': 4, 'deleted_lines': 4, 'nloc': 176}, {'timestamp': 1538773916.0, 'added_lines': 5, 'deleted_lines': 5, 'nloc': 176}, {'timestamp': 1539176817.0, 'added_lines': 5, 'deleted_lines': 5, 'nloc': 176}, {'timestamp': 1539357340.0, 'added_lines': 4, 'deleted_lines': 4, 'nloc': 176}, {'timestamp': 1539850591.0, 'added_lines': 2, 'deleted_lines': 2, 'nloc': 176}, {'timestamp': 1540400358.0, 'added_lines': 4, 'deleted_lines': 4, 'nloc': 176}, {'timestamp': 1540410565.0, 'added_lines': 4, 'deleted_lines': 4, 'nloc': 176}, {'timestamp': 1540418491.0, 'added_lines': 4, 'deleted_lines': 4, 'nloc': 176}, {'timestamp': 1540603818.0, 'added_lines': 5, 'deleted_lines': 5, 'nloc': 176}, {'timestamp': 1540916861.0, 'added_lines': 1, 'deleted_lines': 1, 'nloc': 176}, {'timestamp': 1541106379.0, 'added_lines': 2, 'deleted_lines': 2, 'nloc': 176}, {'timestamp': 1541189794.0, 'added_lines': 4, 'deleted_lines': 4, 'nloc': 176}, {'timestamp': 1541204121.0, 'added_lines': 8, 'deleted_lines': 8, 'nloc': 176}, {'timestamp': 1541903826.0, 'added_lines': 4, 'deleted_lines': 4, 'nloc': 176}, {'timestamp': 1543443696.0, 'added_lines': 4, 'deleted_lines': 4, 'nloc': 176}, {'timestamp': 1544225843.0, 'added_lines': 4, 'deleted_lines': 4, 'nloc': 176}, {'timestamp': 1540556089.0, 'added_lines': 2, 'deleted_lines': 2, 'nloc': 176}, {'timestamp': 1547003974.0, 'added_lines': 4, 'deleted_lines': 4, 'nloc': 176}, {'timestamp': 1547499910.0, 'added_lines': 5, 'deleted_lines': 5, 'nloc': 176}, {'timestamp': 1548866534.0, 'added_lines': 2, 'deleted_lines': 2, 'nloc': 176}, {'timestamp': 1549588289.0, 'added_lines': 4, 'deleted_lines': 4, 'nloc': 176}, {'timestamp': 1549903582.0, 'added_lines': 2, 'deleted_lines': 2, 'nloc': 176}, {'timestamp': 1550185115.0, 'added_lines': 4, 'deleted_lines': 4, 'nloc': 176}, {'timestamp': 1550507829.0, 'added_lines': 6, 'deleted_lines': 6, 'nloc': 176}, {'timestamp': 1550711994.0, 'added_lines': 4, 'deleted_lines': 4, 'nloc': 176}, {'timestamp': 1550723346.0, 'added_lines': 6, 'deleted_lines': 6, 'nloc': 176}, {'timestamp': 1551229859.0, 'added_lines': 4, 'deleted_lines': 4, 'nloc': 176}, {'timestamp': 1551299964.0, 'added_lines': 4, 'deleted_lines': 4, 'nloc': 176}, {'timestamp': 1551551196.0, 'added_lines': 8, 'deleted_lines': 8, 'nloc': 176}, {'timestamp': 1574264289.0, 'added_lines': 1, 'deleted_lines': 1, 'nloc': 176}]","{'assets/assets.go': 48, 'blocks/blockstore/arc_cache.go': 2, 'blocks/blockstore/arc_cache_test.go': 2, 'blocks/blockstore/blockstore.go': 3, 'blocks/blockstore/blockstore_test.go': 2, 'blocks/blockstore/bloom_cache.go': 2, 'blocks/blockstore/bloom_cache_test.go': 2, 'blocks/blockstore/util/remove.go': 2, 'blocks/blocksutil/block_generator.go': 2, 'blockservice/blockservice.go': 9, 'blockservice/blockservice_test.go': 6, 'blockservice/test/blocks_test.go': 7, 'cmd/ipfs/daemon.go': 21, 'cmd/ipfs/init.go': 24, 'cmd/ipfs/ipfs.go': 18, 'cmd/ipfs/main.go': 26, 'cmd/ipfs/main_test.go': 1, 'cmd/ipfswatch/main.go': 17, 'cmd/seccat/seccat.go': 24, 'commands/command.go': 12, 'commands/command_test.go': 3, 'commands/request.go': 16, 'commands/response.go': 7, 'commands/response_test.go': 3, 'core/bootstrap.go': 23, 'core/bootstrap_test.go': 23, 'core/builder.go': 55, 'core/commands/active.go': 11, 'core/commands/add.go': 38, 'core/commands/bitswap.go': 47, 'core/commands/block.go': 26, 'core/commands/bootstrap.go': 21, 'core/commands/cat.go': 22, 'core/commands/commands.go': 18, 'core/commands/config.go': 21, 'core/commands/dag/dag.go': 52, 'core/commands/dht.go': 55, 'core/commands/dht_test.go': 22, 'core/commands/diag.go': 11, 'core/commands/dns.go': 16, 'core/commands/external.go': 11, 'core/commands/files/files.go': 5, 'core/commands/filestore.go': 23, 'core/commands/get.go': 53, 'core/commands/get_test.go': 18, 'core/commands/helptext_test.go': 18, 'core/commands/id.go': 35, 'core/commands/ipns.go': 11, 'core/commands/ipnsps.go': 6, 'core/commands/keystore.go': 22, 'core/commands/log.go': 17, 'core/commands/ls.go': 54, 'core/commands/mount_nofuse.go': 11, 'core/commands/mount_unix.go': 21, 'core/commands/mount_windows.go': 11, 'core/commands/name.go': 4, 'core/commands/object/diff.go': 19, 'core/commands/object/object.go': 54, 'core/commands/object/patch.go': 26, 'core/commands/p2p.go': 24, 'core/commands/pin.go': 54, 'core/commands/ping.go': 30, 'core/commands/publish.go': 15, 'core/commands/pubsub.go': 32, 'core/commands/refs.go': 51, 'core/commands/repo.go': 36, 'core/commands/resolve.go': 47, 'core/commands/root.go': 18, 'core/commands/shutdown.go': 14, 'core/commands/stat.go': 22, 'core/commands/swarm.go': 32, 'core/commands/sysdiag.go': 17, 'core/commands/tar.go': 49, 'core/commands/unixfs/ls.go': 49, 'core/commands/unixfs/unixfs.go': 11, 'core/commands/version.go': 12, 'core/core.go': 58, 'core/coreapi/coreapi.go': 25, 'core/coreapi/interface/interface.go': 2, 'core/coreapi/unixfs.go': 51, 'core/coreapi/unixfs_test.go': 42, 'core/coredag/cbor.go': 18, 'core/coredag/dagpb.go': 44, 'core/coredag/dagtransl.go': 14, 'core/coredag/raw.go': 44, 'core/corehttp/commands.go': 51, 'core/corehttp/corehttp.go': 14, 'core/corehttp/gateway.go': 32, 'core/corehttp/gateway_handler.go': 62, 'core/corehttp/gateway_test.go': 50, 'core/corehttp/metrics_test.go': 30, 'core/corerepo/gc.go': 50, 'core/corerepo/pinning.go': 21, 'core/coreunix/add.go': 61, 'core/coreunix/add_test.go': 52, 'core/coreunix/metadata.go': 53, 'core/coreunix/metadata_test.go': 58, 'core/mock/mock.go': 31, 'core/pathresolver.go': 48, 'exchange/bitswap/bitswap.go': 7, 'exchange/bitswap/bitswap_test.go': 7, 'exchange/bitswap/decision/bench_test.go': 7, 'exchange/bitswap/decision/engine.go': 7, 'exchange/bitswap/decision/engine_test.go': 7, 'exchange/bitswap/decision/ledger.go': 7, 'exchange/bitswap/decision/peer_request_queue.go': 7, 'exchange/bitswap/decision/peer_request_queue_test.go': 7, 'exchange/bitswap/get.go': 6, 'exchange/bitswap/message/message.go': 7, 'exchange/bitswap/message/message_test.go': 4, 'exchange/bitswap/network/interface.go': 7, 'exchange/bitswap/network/ipfs_impl.go': 7, 'exchange/bitswap/notifications/notifications.go': 4, 'exchange/bitswap/notifications/notifications_test.go': 4, 'exchange/bitswap/session.go': 7, 'exchange/bitswap/session_test.go': 6, 'exchange/bitswap/stat.go': 4, 'exchange/bitswap/testnet/interface.go': 6, 'exchange/bitswap/testnet/network_test.go': 7, 'exchange/bitswap/testnet/peernet.go': 7, 'exchange/bitswap/testnet/virtual.go': 7, 'exchange/bitswap/testutils.go': 7, 'exchange/bitswap/wantlist/wantlist.go': 4, 'exchange/bitswap/wantlist/wantlist_test.go': 4, 'exchange/bitswap/wantmanager.go': 7, 'exchange/bitswap/workers.go': 7, 'exchange/interface.go': 2, 'exchange/offline/offline.go': 2, 'exchange/offline/offline_test.go': 2, 'exchange/reprovide/providers.go': 47, 'exchange/reprovide/reprovide.go': 28, 'exchange/reprovide/reprovide_test.go': 32, 'filestore/filestore.go': 26, 'filestore/filestore_test.go': 45, 'filestore/fsrefstore.go': 25, 'filestore/util.go': 23, 'fuse/ipns/ipns_test.go': 30, 'fuse/ipns/ipns_unix.go': 55, 'fuse/node/mount_test.go': 30, 'fuse/readonly/ipfs_test.go': 59, 'fuse/readonly/readonly_unix.go': 57, 'importer/balanced/balanced_test.go': 13, 'importer/balanced/builder.go': 5, 'importer/chunk/rabin_test.go': 2, 'importer/chunk/splitting_test.go': 2, 'importer/helpers/dagbuilder.go': 13, 'importer/helpers/helpers.go': 10, 'importer/importer.go': 13, 'importer/importer_test.go': 13, 'importer/trickle/trickle_test.go': 13, 'importer/trickle/trickledag.go': 6, 'merkledag/batch.go': 2, 'merkledag/coding.go': 5, 'merkledag/merkledag.go': 6, 'merkledag/merkledag_test.go': 14, 'merkledag/node.go': 9, 'merkledag/node_test.go': 6, 'merkledag/raw.go': 5, 'merkledag/traverse/traverse.go': 5, 'merkledag/traverse/traverse_test.go': 6, 'merkledag/utils/diff.go': 7, 'merkledag/utils/diffenum.go': 5, 'merkledag/utils/diffenum_test.go': 6, 'merkledag/utils/utils.go': 11, 'merkledag/utils/utils_test.go': 7, 'mfs/dir.go': 16, 'mfs/file.go': 21, 'mfs/mfs_test.go': 22, 'mfs/ops.go': 12, 'mfs/repub_test.go': 10, 'mfs/system.go': 18, 'namesys/ipns_select_test.go': 4, 'namesys/namesys.go': 48, 'namesys/publisher.go': 55, 'namesys/publisher_test.go': 31, 'namesys/pubsub.go': 4, 'namesys/pubsub_test.go': 4, 'namesys/republisher/repub.go': 46, 'namesys/republisher/repub_test.go': 46, 'namesys/resolve_test.go': 47, 'namesys/routing.go': 48, 'p2p/p2p.go': 23, 'p2p/registry.go': 10, 'package.json': 58, 'path/path.go': 4, 'path/resolver.go': 6, 'path/resolver_test.go': 4, 'pin/gc/gc.go': 48, 'pin/pin.go': 49, 'pin/pin_test.go': 48, 'pin/set.go': 45, 'pin/set_test.go': 47, 'plugin/ipld.go': 14, 'plugin/loader/initializer.go': 11, 'plugin/plugins/git/git.go': 13, 'repo/config/bootstrap_peers.go': 7, 'repo/config/init.go': 7, 'repo/fsrepo/fsrepo.go': 23, 'repo/fsrepo/lock/lock.go': 3, 'repo/fsrepo/serialize/serialize.go': 3, 'repo/mock.go': 17, 'repo/repo.go': 21, 'routing/mock/centralized_client.go': 3, 'routing/mock/centralized_server.go': 3, 'routing/mock/centralized_test.go': 3, 'routing/mock/interface.go': 3, 'routing/none/none_client.go': 3, 'routing/offline/offline.go': 3, 'routing/offline/offline_test.go': 3, 'test/dependencies/ma-pipe-unidir/main.go': 9, 'test/integration/addcat_test.go': 32, 'test/integration/bench_cat_test.go': 32, 'test/integration/bench_test.go': 17, 'test/integration/bitswap_wo_routing_test.go': 34, 'test/integration/three_legged_cat_test.go': 32, 'thirdparty/ds-help/key.go': 2, 'thirdparty/pollEndpoint/main.go': 14, 'thirdparty/posinfo/posinfo.go': 3, 'unixfs/archive/archive.go': 7, 'unixfs/archive/tar/writer.go': 8, 'unixfs/hamt/hamt.go': 9, 'unixfs/io/dagreader.go': 8, 'unixfs/io/dirbuilder.go': 8, 'unixfs/io/resolve.go': 8, 'unixfs/mod/dagmodifier.go': 16, 'unixfs/mod/dagmodifier_test.go': 4, 'unixfs/test/utils.go': 15, 'commands/legacy/command.go': 11, 'commands/legacy/legacy.go': 11, 'commands/legacy/legacy_test.go': 11, 'commands/legacy/request.go': 11, 'commands/legacy/response.go': 11, 'core/commands/commands_test.go': 17, 'core/coreapi/dag.go': 14, 'core/coreapi/dag_test.go': 3, 'core/coreapi/interface/options/dag.go': 8, 'core/coreapi/key.go': 46, 'core/coreapi/name.go': 47, 'merkledag/test/utils.go': 8, 'namesys/namesys_test.go': 52, 'repo/fsrepo/datastores.go': 15, 'repo/fsrepo/fsrepo_test.go': 18, 'thirdparty/datastore2/datastore_closer.go': 1, 'thirdparty/datastore2/delayed.go': 1, 'thirdparty/datastore2/threadsafe.go': 1, 'unixfs/io/pbdagreader.go': 8, None: 41, 'mfs/fd.go': 9, 'unixfs/hamt/hamt_stress_test.go': 6, 'unixfs/hamt/hamt_test.go': 7, 'unixfs/io/dagreader_test.go': 3, 'unixfs/io/dirbuilder_test.go': 1, 'cmd/ipfs/util/ulimit.go': 9, 'cmd/seccat/util.go': 9, 'core/corehttp/logs.go': 9, 'fuse/mount/mount.go': 9, 'fuse/node/mount_unix.go': 9, 'importer/chunk/splitting.go': 1, 'namesys/ipns_validate_test.go': 3, 'plugin/loader/load.go': 7, 'blocks/blockstoreutil/remove.go': 22, 'blockservice/test/mock.go': 4, 'core/commands/files.go': 52, 'core/core_test.go': 17, 'core/coreapi/pin.go': 45, 'fuse/ipns/common.go': 48, 'keystore/keystore.go': 8, 'keystore/keystore_test.go': 5, 'keystore/memkeystore.go': 5, 'namesys/interface.go': 42, 'namesys/validator.go': 2, 'path/resolver/resolver.go': 5, 'repo/config/identity.go': 2, 'thirdparty/verifbs/verifbs.go': 21, 'cmd/ipfs/util/ulimit_freebsd.go': 2, 'cmd/ipfs/util/ulimit_unix.go': 2, 'core/coreapi/block.go': 16, 'core/coreapi/block_test.go': 2, 'core/coreapi/interface/coreapi.go': 9, 'core/coreapi/interface/dag.go': 9, 'core/coreapi/interface/object.go': 9, 'core/coreapi/interface/options/block.go': 3, 'core/coreapi/interface/path.go': 35, 'core/coreapi/interface/unixfs.go': 13, 'core/coreapi/object.go': 50, 'fuse/ipns/link_unix.go': 2, 'fuse/mount/fuse.go': 2, 'fuse/node/mount_darwin.go': 2, 'merkledag/errservice.go': 2, 'merkledag/readonly.go': 2, 'merkledag/readonly_test.go': 2, 'merkledag/rwservice.go': 2, 'merkledag/session.go': 2, 'path/resolver/resolver_test.go': 3, 'thirdparty/verifcid/validate.go': 2, 'thirdparty/verifcid/validate_test.go': 2, 'namesys/ipns_resolver_validation_test.go': 43, 'test/sharness/t0170-dht.sh': 1, 'core/commands/urlstore.go': 46, 'unixfs/io/directory.go': 3, 'dagutils/diff.go': 41, 'dagutils/diffenum.go': 40, 'dagutils/diffenum_test.go': 40, 'dagutils/utils.go': 42, 'dagutils/utils_test.go': 42, 'Rules.mk': 2, 'unixfs/io/directory_test.go': 2, 'unixfs/unixfs.go': 2, 'core/coreapi/name_test.go': 32, 'core/coreapi/path.go': 47, 'core/coreunix/cat.go': 16, 'core/pathresolver_test.go': 40, 'namesys/base.go': 41, 'namesys/cache.go': 40, 'namesys/dns.go': 41, 'namesys/proquint.go': 41, 'unixfs/importer/balanced/balanced_test.go': 1, 'unixfs/importer/balanced/builder.go': 1, 'unixfs/importer/helpers/dagbuilder.go': 1, 'unixfs/importer/helpers/helpers.go': 1, 'unixfs/importer/importer.go': 1, 'unixfs/importer/importer_test.go': 1, 'unixfs/importer/trickle/trickle_test.go': 1, 'unixfs/importer/trickle/trickledag.go': 1, 'unixfs/unixfs_test.go': 1, 'core/commands/env.go': 3, 'core/coreapi/interface/key.go': 7, 'filestore/pb/dataobj.pb.go': 3, 'pin/internal/pb/header.pb.go': 3, 'thirdparty/cidv0v1/blockstore.go': 16, 'repo/fsrepo/config_test.go': 13, 'repo/fsrepo/misc.go': 13, 'test/bench/bench_cli_ipfs_add/main.go': 13, 'test/bench/offline_add/main.go': 13, 'core/commands/cmdenv/env.go': 20, 'core/commands/name/ipns.go': 36, 'core/commands/name/publish.go': 19, 'core/coreapi/dht.go': 30, 'core/coreapi/dht_test.go': 5, 'test/sharness/t0275-cid-security.sh': 1, 'core/commands/name/ipnsps.go': 13, 'core/commands/name/name.go': 9, 'core/coreapi/interface/dht.go': 10, 'p2p/listener.go': 13, 'p2p/local.go': 13, 'p2p/remote.go': 13, 'p2p/stream.go': 13, 'core/coreapi/interface/swarm.go': 9, 'core/coreapi/swarm.go': 20, 'core/coreapi/interface/options/unixfs.go': 15, 'core/coreapi/pubsub.go': 18, 'core/coreapi/unixfile.go': 17, 'core/commands/cid.go': 9, 'cmd/ipfs/dnsresolve_test.go': 5, 'core/coreapi/interface/pubsub.go': 4, 'test/dependencies/iptb/iptb.go': 12, 'plugin/plugins/badgerds/badgerds.go': 3, 'plugin/plugins/flatfs/flatfs.go': 3, 'plugin/plugins/levelds/levelds.go': 3, 'commands/context.go': 13, 'core/corehttp/proxy.go': 9, 'core/coreapi/interface/tests/name.go': 4, 'core/coreapi/interface/tests/unixfs.go': 4, 'core/coreapi/test/api_test.go': 10, 'plugin/loader/loader.go': 9, 'core/commands/cmdenv/cidbase.go': 6, 'core/commands/cmdenv/file.go': 3, 'core/corehttp/ipns_hostname.go': 8, 'namesys/dns_test.go': 8, 'plugin/daemon.go': 8, 'core/commands/cmdenv/cidbase_test.go': 2, 'core/corehttp/metrics.go': 1, 'core/corehttp/proxy_test.go': 1, 'core/corerepo/stat.go': 1, 'plugin/tracer.go': 1, 'thirdparty/notifier/notifier.go': 1, 'core/node/core.go': 1, 'core/node/provider.go': 1, 'gc/gc.go': 1, 'go.mod': 1, 'go.sum': 1}","('core/corehttp/gateway_handler.go', 0.9393939393939394, 0.39490445859872614)"
test/api-startup/main.go,32,150,2,"[{'cyclomatic_complexity': 3, 'nloc': 13, 'token_count': 64, 'name': '', 'long_name': '(port string)', 'start_line': 16, 'end_line': 28, 'full_parameters': [], 'filename': '/home/dimi/Documents/Informatik_Studium/FSS/SoftEvo/DataCollection/FFS_SoftEvo/go-ipfs/test/api-startup/main.go', 'top_nesting_level': 0, 'length': 13, 'fan_in': 0, 'fan_out': 0, 'general_fan_out': 0}, {'cyclomatic_complexity': 2, 'nloc': 12, 'token_count': 77, 'name': 'main', 'long_name': 'main', 'start_line': 11, 'end_line': 34, 'full_parameters': [], 'filename': '/home/dimi/Documents/Informatik_Studium/FSS/SoftEvo/DataCollection/FFS_SoftEvo/go-ipfs/test/api-startup/main.go', 'top_nesting_level': 0, 'length': 24, 'fan_in': 0, 'fan_out': 0, 'general_fan_out': 0}]",32,148,2,"[{'cyclomatic_complexity': 3, 'nloc': 13, 'token_count': 64, 'name': '', 'long_name': '(port string)', 'start_line': 16, 'end_line': 28, 'full_parameters': [], 'filename': '/home/dimi/Documents/Informatik_Studium/FSS/SoftEvo/DataCollection/FFS_SoftEvo/go-ipfs/test/api-startup/main.go', 'top_nesting_level': 0, 'length': 13, 'fan_in': 0, 'fan_out': 0, 'general_fan_out': 0}, {'cyclomatic_complexity': 2, 'nloc': 12, 'token_count': 75, 'name': 'main', 'long_name': 'main', 'start_line': 11, 'end_line': 34, 'full_parameters': [], 'filename': '/home/dimi/Documents/Informatik_Studium/FSS/SoftEvo/DataCollection/FFS_SoftEvo/go-ipfs/test/api-startup/main.go', 'top_nesting_level': 0, 'length': 24, 'fan_in': 0, 'fan_out': 0, 'general_fan_out': 0}]",0,-2,0,1,1,"[{'timestamp': 1521421769.0, 'added_lines': 1, 'deleted_lines': 1, 'nloc': 32}]","{'cmd/ipfs/main.go': 1, None: 2, 'core/commands/dag/dag.go': 1, 'core/commands/filestore.go': 1, 'core/commands/object/object.go': 1, 'core/commands/pin.go': 1, 'core/core.go': 1, 'core/coreunix/add.go': 1, 'exchange/bitswap/bitswap.go': 1, 'exchange/bitswap/testutils.go': 1, 'importer/helpers/helpers.go': 1, 'importer/importer.go': 1, 'merkledag/merkledag.go': 1, 'path/path.go': 1, 'path/path_test.go': 1, 'unixfs/archive/archive.go': 1, 'unixfs/archive/tar/writer.go': 1}","('core/core.go', 1.0, 0.00558659217877095)"
test/bench/bench_cli_ipfs_add/main.go,103,558,6,"[{'cyclomatic_complexity': 2, 'nloc': 6, 'token_count': 29, 'name': 'main', 'long_name': 'main', 'start_line': 23, 'end_line': 28, 'full_parameters': [], 'filename': '/home/dimi/Documents/Informatik_Studium/FSS/SoftEvo/DataCollection/FFS_SoftEvo/go-ipfs/test/bench/bench_cli_ipfs_add/main.go', 'top_nesting_level': 0, 'length': 6, 'fan_in': 0, 'fan_out': 0, 'general_fan_out': 0}, {'cyclomatic_complexity': 3, 'nloc': 11, 'token_count': 67, 'name': 'compareResults', 'long_name': 'compareResults', 'start_line': 30, 'end_line': 40, 'full_parameters': [], 'filename': '/home/dimi/Documents/Informatik_Studium/FSS/SoftEvo/DataCollection/FFS_SoftEvo/go-ipfs/test/bench/bench_cli_ipfs_add/main.go', 'top_nesting_level': 0, 'length': 11, 'fan_in': 0, 'fan_out': 0, 'general_fan_out': 0}, {'cyclomatic_complexity': 2, 'nloc': 7, 'token_count': 34, 'name': '', 'long_name': '(cmd*exec.Cmd)', 'start_line': 59, 'end_line': 65, 'full_parameters': [], 'filename': '/home/dimi/Documents/Informatik_Studium/FSS/SoftEvo/DataCollection/FFS_SoftEvo/go-ipfs/test/bench/bench_cli_ipfs_add/main.go', 'top_nesting_level': 0, 'length': 7, 'fan_in': 0, 'fan_out': 0, 'general_fan_out': 0}, {'cyclomatic_complexity': 4, 'nloc': 20, 'token_count': 117, 'name': '', 'long_name': '()', 'start_line': 88, 'end_line': 109, 'full_parameters': [], 'filename': '/home/dimi/Documents/Informatik_Studium/FSS/SoftEvo/DataCollection/FFS_SoftEvo/go-ipfs/test/bench/bench_cli_ipfs_add/main.go', 'top_nesting_level': 0, 'length': 22, 'fan_in': 0, 'fan_out': 0, 'general_fan_out': 0}, {'cyclomatic_complexity': 6, 'nloc': 36, 'token_count': 229, 'name': '', 'long_name': '(b*testing.B)', 'start_line': 44, 'end_line': 111, 'full_parameters': [], 'filename': '/home/dimi/Documents/Informatik_Studium/FSS/SoftEvo/DataCollection/FFS_SoftEvo/go-ipfs/test/bench/bench_cli_ipfs_add/main.go', 'top_nesting_level': 0, 'length': 68, 'fan_in': 0, 'fan_out': 0, 'general_fan_out': 0}, {'cyclomatic_complexity': 2, 'nloc': 8, 'token_count': 42, 'name': 'benchmarkAdd', 'long_name': 'benchmarkAdd amount int64', 'start_line': 42, 'end_line': 116, 'full_parameters': ['amount int64'], 'filename': '/home/dimi/Documents/Informatik_Studium/FSS/SoftEvo/DataCollection/FFS_SoftEvo/go-ipfs/test/bench/bench_cli_ipfs_add/main.go', 'top_nesting_level': 0, 'length': 75, 'fan_in': 0, 'fan_out': 0, 'general_fan_out': 0}]",108,588,7,"[{'cyclomatic_complexity': 2, 'nloc': 6, 'token_count': 29, 'name': 'main', 'long_name': 'main', 'start_line': 24, 'end_line': 29, 'full_parameters': [], 'filename': '/home/dimi/Documents/Informatik_Studium/FSS/SoftEvo/DataCollection/FFS_SoftEvo/go-ipfs/test/bench/bench_cli_ipfs_add/main.go', 'top_nesting_level': 0, 'length': 6, 'fan_in': 0, 'fan_out': 0, 'general_fan_out': 0}, {'cyclomatic_complexity': 3, 'nloc': 11, 'token_count': 67, 'name': 'compareResults', 'long_name': 'compareResults', 'start_line': 31, 'end_line': 41, 'full_parameters': [], 'filename': '/home/dimi/Documents/Informatik_Studium/FSS/SoftEvo/DataCollection/FFS_SoftEvo/go-ipfs/test/bench/bench_cli_ipfs_add/main.go', 'top_nesting_level': 0, 'length': 11, 'fan_in': 0, 'fan_out': 0, 'general_fan_out': 0}, {'cyclomatic_complexity': 2, 'nloc': 7, 'token_count': 34, 'name': '', 'long_name': '(cmd*exec.Cmd)', 'start_line': 60, 'end_line': 66, 'full_parameters': [], 'filename': '/home/dimi/Documents/Informatik_Studium/FSS/SoftEvo/DataCollection/FFS_SoftEvo/go-ipfs/test/bench/bench_cli_ipfs_add/main.go', 'top_nesting_level': 0, 'length': 7, 'fan_in': 0, 'fan_out': 0, 'general_fan_out': 0}, {'cyclomatic_complexity': 1, 'nloc': 4, 'token_count': 24, 'name': '', 'long_name': '()', 'start_line': 101, 'end_line': 104, 'full_parameters': [], 'filename': '/home/dimi/Documents/Informatik_Studium/FSS/SoftEvo/DataCollection/FFS_SoftEvo/go-ipfs/test/bench/bench_cli_ipfs_add/main.go', 'top_nesting_level': 0, 'length': 4, 'fan_in': 0, 'fan_out': 0, 'general_fan_out': 0}, {'cyclomatic_complexity': 4, 'nloc': 19, 'token_count': 104, 'name': '', 'long_name': '()', 'start_line': 92, 'end_line': 115, 'full_parameters': [], 'filename': '/home/dimi/Documents/Informatik_Studium/FSS/SoftEvo/DataCollection/FFS_SoftEvo/go-ipfs/test/bench/bench_cli_ipfs_add/main.go', 'top_nesting_level': 0, 'length': 24, 'fan_in': 0, 'fan_out': 0, 'general_fan_out': 0}, {'cyclomatic_complexity': 7, 'nloc': 39, 'token_count': 247, 'name': '', 'long_name': '(b*testing.B)', 'start_line': 45, 'end_line': 117, 'full_parameters': [], 'filename': '/home/dimi/Documents/Informatik_Studium/FSS/SoftEvo/DataCollection/FFS_SoftEvo/go-ipfs/test/bench/bench_cli_ipfs_add/main.go', 'top_nesting_level': 0, 'length': 73, 'fan_in': 0, 'fan_out': 0, 'general_fan_out': 0}, {'cyclomatic_complexity': 2, 'nloc': 8, 'token_count': 42, 'name': 'benchmarkAdd', 'long_name': 'benchmarkAdd amount int64', 'start_line': 43, 'end_line': 122, 'full_parameters': ['amount int64'], 'filename': '/home/dimi/Documents/Informatik_Studium/FSS/SoftEvo/DataCollection/FFS_SoftEvo/go-ipfs/test/bench/bench_cli_ipfs_add/main.go', 'top_nesting_level': 0, 'length': 80, 'fan_in': 0, 'fan_out': 0, 'general_fan_out': 0}]",5,30,1,27,27,"[{'timestamp': 1532365899.0, 'added_lines': 2, 'deleted_lines': 1, 'nloc': 103}, {'timestamp': 1532388583.0, 'added_lines': 1, 'deleted_lines': 1, 'nloc': 103}, {'timestamp': 1533809170.0, 'added_lines': 1, 'deleted_lines': 1, 'nloc': 103}, {'timestamp': 1534072974.0, 'added_lines': 1, 'deleted_lines': 1, 'nloc': 103}, {'timestamp': 1534896611.0, 'added_lines': 1, 'deleted_lines': 1, 'nloc': 103}, {'timestamp': 1535255498.0, 'added_lines': 1, 'deleted_lines': 1, 'nloc': 103}, {'timestamp': 1535601896.0, 'added_lines': 1, 'deleted_lines': 1, 'nloc': 103}, {'timestamp': 1536388808.0, 'added_lines': 1, 'deleted_lines': 1, 'nloc': 103}, {'timestamp': 1536357700.0, 'added_lines': 1, 'deleted_lines': 1, 'nloc': 103}, {'timestamp': 1537792589.0, 'added_lines': 1, 'deleted_lines': 1, 'nloc': 103}, {'timestamp': 1538544957.0, 'added_lines': 1, 'deleted_lines': 1, 'nloc': 103}, {'timestamp': 1538547366.0, 'added_lines': 1, 'deleted_lines': 1, 'nloc': 103}, {'timestamp': 1540400358.0, 'added_lines': 1, 'deleted_lines': 1, 'nloc': 103}, {'timestamp': 1540489644.0, 'added_lines': 1, 'deleted_lines': 1, 'nloc': 103}, {'timestamp': 1541204121.0, 'added_lines': 1, 'deleted_lines': 1, 'nloc': 103}, {'timestamp': 1543282933.0, 'added_lines': 1, 'deleted_lines': 1, 'nloc': 103}, {'timestamp': 1544225843.0, 'added_lines': 1, 'deleted_lines': 1, 'nloc': 103}, {'timestamp': 1545323704.0, 'added_lines': 1, 'deleted_lines': 1, 'nloc': 103}, {'timestamp': 1546553605.0, 'added_lines': 1, 'deleted_lines': 1, 'nloc': 103}, {'timestamp': 1547003974.0, 'added_lines': 1, 'deleted_lines': 1, 'nloc': 103}, {'timestamp': 1549588289.0, 'added_lines': 1, 'deleted_lines': 1, 'nloc': 103}, {'timestamp': 1550507829.0, 'added_lines': 1, 'deleted_lines': 1, 'nloc': 103}, {'timestamp': 1550610741.0, 'added_lines': 1, 'deleted_lines': 1, 'nloc': 103}, {'timestamp': 1551229859.0, 'added_lines': 1, 'deleted_lines': 1, 'nloc': 103}, {'timestamp': 1551551196.0, 'added_lines': 2, 'deleted_lines': 2, 'nloc': 103}, {'timestamp': 1553697989.0, 'added_lines': 8, 'deleted_lines': 3, 'nloc': 108}, {'timestamp': 1564798669.0, 'added_lines': 1, 'deleted_lines': 1, 'nloc': 108}]","{'cmd/ipfs/Rules.mk': 2, 'cmd/ipfs/init.go': 24, 'cmd/ipfs/main.go': 25, 'cmd/ipfswatch/main.go': 25, 'commands/request.go': 15, 'core/bootstrap.go': 23, 'core/bootstrap_test.go': 23, 'core/builder.go': 24, 'core/commands/bootstrap.go': 24, 'core/commands/config.go': 25, 'core/commands/env.go': 5, 'core/commands/mount_unix.go': 24, 'core/commands/repo.go': 25, 'core/commands/swarm.go': 25, 'core/commands/sysdiag.go': 9, 'core/commands/version.go': 6, 'core/core.go': 24, 'core/core_test.go': 23, 'core/coreapi/unixfs_test.go': 17, 'core/corehttp/commands.go': 24, 'core/corehttp/gateway.go': 14, 'core/corehttp/gateway_test.go': 24, 'core/corehttp/option_test.go': 2, 'core/coreunix/add_test.go': 24, 'core/mock/mock.go': 23, 'docs/releases.md': 1, 'docs/windows.md': 1, 'package.json': 24, 'repo/fsrepo/config_test.go': 23, 'repo/fsrepo/fsrepo.go': 24, 'repo/fsrepo/fsrepo_test.go': 23, 'repo/fsrepo/misc.go': 24, 'repo/mock.go': 23, 'repo/repo.go': 23, 'repo/version.go': 1, 'test/bench/offline_add/main.go': 27, 'assets/assets.go': 12, 'blocks/blockstoreutil/remove.go': 7, 'cmd/ipfs/daemon.go': 10, 'cmd/ipfs/ipfs.go': 6, 'cmd/seccat/seccat.go': 14, 'commands/command.go': 3, 'commands/legacy/command.go': 3, 'commands/legacy/legacy.go': 3, 'commands/legacy/legacy_test.go': 3, 'commands/legacy/request.go': 3, 'commands/legacy/response.go': 3, 'commands/response.go': 1, 'core/commands/active.go': 4, 'core/commands/add.go': 11, 'core/commands/bitswap.go': 14, 'core/commands/block.go': 7, 'core/commands/cat.go': 7, 'core/commands/commands.go': 7, 'core/commands/commands_test.go': 6, 'core/commands/dag/dag.go': 14, 'core/commands/dht.go': 14, 'core/commands/dht_test.go': 12, 'core/commands/diag.go': 4, 'core/commands/dns.go': 6, 'core/commands/external.go': 4, 'core/commands/files.go': 15, 'core/commands/filestore.go': 6, 'core/commands/get.go': 14, 'core/commands/get_test.go': 6, 'core/commands/helptext_test.go': 6, 'core/commands/id.go': 14, 'core/commands/ipns.go': 1, 'core/commands/ipnsps.go': 1, 'core/commands/keystore.go': 7, 'core/commands/log.go': 6, 'core/commands/ls.go': 13, 'core/commands/mount_nofuse.go': 4, 'core/commands/mount_windows.go': 4, 'core/commands/name.go': 1, 'core/commands/object/diff.go': 6, 'core/commands/object/object.go': 14, 'core/commands/object/patch.go': 7, 'core/commands/p2p.go': 13, 'core/commands/pin.go': 14, 'core/commands/ping.go': 13, 'core/commands/publish.go': 1, 'core/commands/pubsub.go': 10, 'core/commands/refs.go': 14, 'core/commands/resolve.go': 14, 'core/commands/root.go': 6, 'core/commands/shutdown.go': 6, 'core/commands/stat.go': 10, 'core/commands/tar.go': 14, 'core/commands/unixfs/ls.go': 14, 'core/commands/unixfs/unixfs.go': 4, 'core/commands/urlstore.go': 14, 'core/coreapi/block.go': 5, 'core/coreapi/dag.go': 3, 'core/coreapi/interface/coreapi.go': 2, 'core/coreapi/interface/dag.go': 2, 'core/coreapi/interface/key.go': 6, 'core/coreapi/interface/object.go': 2, 'core/coreapi/interface/options/dag.go': 2, 'core/coreapi/interface/path.go': 10, 'core/coreapi/interface/unixfs.go': 3, 'core/coreapi/key.go': 13, 'core/coreapi/name.go': 13, 'core/coreapi/name_test.go': 8, 'core/coreapi/object.go': 13, 'core/coreapi/path.go': 13, 'core/coreapi/pin.go': 13, 'core/coreapi/unixfs.go': 13, 'core/coredag/cbor.go': 4, 'core/coredag/dagpb.go': 13, 'core/coredag/dagtransl.go': 3, 'core/coredag/raw.go': 13, 'core/corehttp/gateway_handler.go': 14, 'core/corehttp/metrics_test.go': 13, 'core/corerepo/gc.go': 15, 'core/corerepo/pinning.go': 5, 'core/coreunix/add.go': 13, 'core/coreunix/cat.go': 4, 'core/coreunix/metadata.go': 13, 'core/coreunix/metadata_test.go': 14, 'core/pathresolver.go': 13, 'core/pathresolver_test.go': 13, 'dagutils/diff.go': 14, 'dagutils/diffenum.go': 13, 'dagutils/diffenum_test.go': 13, 'dagutils/utils.go': 14, 'dagutils/utils_test.go': 13, 'exchange/reprovide/providers.go': 13, 'exchange/reprovide/reprovide.go': 12, 'exchange/reprovide/reprovide_test.go': 14, 'filestore/filestore.go': 7, 'filestore/filestore_test.go': 13, 'filestore/fsrefstore.go': 7, 'filestore/util.go': 7, 'fuse/ipns/common.go': 13, 'fuse/ipns/ipns_test.go': 14, 'fuse/ipns/ipns_unix.go': 13, 'fuse/node/mount_test.go': 13, 'fuse/readonly/ipfs_test.go': 14, 'fuse/readonly/readonly_unix.go': 13, 'namesys/base.go': 13, 'namesys/cache.go': 13, 'namesys/dns.go': 13, 'namesys/interface.go': 13, 'namesys/ipns_resolver_validation_test.go': 13, 'namesys/namesys.go': 14, 'namesys/namesys_test.go': 14, 'namesys/proquint.go': 13, 'namesys/publisher.go': 13, 'namesys/publisher_test.go': 13, 'namesys/republisher/repub.go': 13, 'namesys/republisher/repub_test.go': 14, 'namesys/resolve_test.go': 13, 'namesys/routing.go': 14, 'p2p/p2p.go': 13, 'p2p/registry.go': 3, 'pin/gc/gc.go': 13, 'pin/pin.go': 13, 'pin/pin_test.go': 14, 'pin/set.go': 13, 'pin/set_test.go': 13, 'plugin/ipld.go': 3, 'plugin/loader/initializer.go': 2, 'plugin/plugins/git/git.go': 3, 'tar/format.go': 13, 'test/integration/addcat_test.go': 16, 'test/integration/bench_cat_test.go': 14, 'test/integration/bench_test.go': 10, 'test/integration/bitswap_wo_routing_test.go': 14, 'test/integration/three_legged_cat_test.go': 14, 'thirdparty/cidv0v1/blockstore.go': 7, 'thirdparty/verifbs/verifbs.go': 7, 'core/commands/cmdenv/env.go': 19, 'core/commands/name/ipns.go': 13, 'core/commands/name/publish.go': 9, 'repo/fsrepo/datastores.go': 6, None: 29, 'coverage/Rules.mk': 1, 'mk/golang.mk': 1, 'pin/internal/pb/doc.go': 1, 'test/3nodetest/Makefile': 1, 'test/bin/Rules.mk': 1, 'test/bin/verify-go-fmt.sh': 1, 'cmd/ipfs/util/ulimit.go': 4, 'cmd/seccat/util.go': 4, 'core/commands/name/ipnsps.go': 9, 'core/commands/name/name.go': 5, 'core/coreapi/dht.go': 10, 'core/coreapi/dht_test.go': 4, 'core/coreapi/interface/dht.go': 7, 'core/corehttp/corehttp.go': 7, 'core/corehttp/logs.go': 4, 'fuse/mount/mount.go': 4, 'fuse/node/mount_unix.go': 5, 'keystore/keystore.go': 4, 'p2p/listener.go': 10, 'p2p/local.go': 10, 'p2p/remote.go': 11, 'p2p/stream.go': 11, 'plugin/loader/load.go': 2, 'thirdparty/pollEndpoint/main.go': 7, 'core/coreapi/interface/swarm.go': 6, 'core/coreapi/swarm.go': 10, 'cmd/ipfs/dnsresolve_test.go': 5, 'core/coreapi/coreapi.go': 8, 'core/coreapi/interface/options/unixfs.go': 5, 'core/coreapi/interface/pubsub.go': 4, 'core/coreapi/pubsub.go': 10, 'core/coreapi/unixfile.go': 4, 'test/dependencies/ma-pipe-unidir/main.go': 6, 'test/sharness/t0180-pubsub.sh': 1, 'core/commands/cid.go': 5, 'core/coreapi/block_test.go': 1, 'core/coreapi/dag_test.go': 1, 'core/coreapi/interface/options/block.go': 1, 'keystore/keystore_test.go': 4, 'keystore/memkeystore.go': 3, 'test/dependencies/iptb/iptb.go': 10, 'commands/context.go': 9, 'core/corehttp/proxy.go': 6, 'core/coreapi/test/api_test.go': 6, 'core/coreapi/interface/tests/name.go': 2, 'core/coreapi/interface/tests/unixfs.go': 2, 'core/commands/cmdenv/cidbase.go': 3, 'core/corehttp/ipns_hostname.go': 3, 'filestore/pb/dataobj.pb.go': 2, 'namesys/dns_test.go': 3, 'pin/internal/pb/header.pb.go': 2, 'plugin/daemon.go': 3, 'plugin/loader/loader.go': 4, 'plugin/plugins/badgerds/badgerds.go': 3, 'plugin/plugins/flatfs/flatfs.go': 2, 'plugin/plugins/levelds/levelds.go': 2, 'core/corerepo/stat.go': 2, 'cmd/ipfs/util/ulimit_freebsd.go': 1, 'cmd/ipfs/util/ulimit_unix.go': 1, 'core/commands/cmdenv/cidbase_test.go': 1, 'core/commands/cmdenv/file.go': 1, 'core/corehttp/metrics.go': 1, 'core/corehttp/proxy_test.go': 1, 'fuse/ipns/link_unix.go': 1, 'fuse/mount/fuse.go': 2, 'fuse/node/mount_darwin.go': 1, 'plugin/tracer.go': 1, 'thirdparty/notifier/notifier.go': 1, 'commands/reqlog.go': 1, 'core/corehttp/mutex_profile.go': 1, 'provider/queue.go': 1, 'provider/queue_test.go': 1, 'go.mod': 1, 'go.sum': 1, 'test/sharness/lib/test-lib.sh': 1, 'test/sharness/t0020-init.sh': 1, 'test/sharness/t0025-datastores.sh': 1}","('test/bench/offline_add/main.go', 1.0, 1.0)"
test/bench/offline_add/main.go,69,405,5,"[{'cyclomatic_complexity': 2, 'nloc': 5, 'token_count': 24, 'name': 'main', 'long_name': 'main', 'start_line': 17, 'end_line': 21, 'full_parameters': [], 'filename': '/home/dimi/Documents/Informatik_Studium/FSS/SoftEvo/DataCollection/FFS_SoftEvo/go-ipfs/test/bench/offline_add/main.go', 'top_nesting_level': 0, 'length': 5, 'fan_in': 0, 'fan_out': 0, 'general_fan_out': 0}, {'cyclomatic_complexity': 3, 'nloc': 11, 'token_count': 67, 'name': 'compareResults', 'long_name': 'compareResults', 'start_line': 23, 'end_line': 33, 'full_parameters': [], 'filename': '/home/dimi/Documents/Informatik_Studium/FSS/SoftEvo/DataCollection/FFS_SoftEvo/go-ipfs/test/bench/offline_add/main.go', 'top_nesting_level': 0, 'length': 11, 'fan_in': 0, 'fan_out': 0, 'general_fan_out': 0}, {'cyclomatic_complexity': 1, 'nloc': 3, 'token_count': 15, 'name': '', 'long_name': '(cmd*exec.Cmd)', 'start_line': 47, 'end_line': 49, 'full_parameters': [], 'filename': '/home/dimi/Documents/Informatik_Studium/FSS/SoftEvo/DataCollection/FFS_SoftEvo/go-ipfs/test/bench/offline_add/main.go', 'top_nesting_level': 0, 'length': 3, 'fan_in': 0, 'fan_out': 0, 'general_fan_out': 0}, {'cyclomatic_complexity': 7, 'nloc': 35, 'token_count': 257, 'name': '', 'long_name': '(b*testing.B)', 'start_line': 36, 'end_line': 77, 'full_parameters': [], 'filename': '/home/dimi/Documents/Informatik_Studium/FSS/SoftEvo/DataCollection/FFS_SoftEvo/go-ipfs/test/bench/offline_add/main.go', 'top_nesting_level': 0, 'length': 42, 'fan_in': 0, 'fan_out': 0, 'general_fan_out': 0}, {'cyclomatic_complexity': 1, 'nloc': 4, 'token_count': 29, 'name': 'benchmarkAdd', 'long_name': 'benchmarkAdd amount int64', 'start_line': 35, 'end_line': 79, 'full_parameters': ['amount int64'], 'filename': '/home/dimi/Documents/Informatik_Studium/FSS/SoftEvo/DataCollection/FFS_SoftEvo/go-ipfs/test/bench/offline_add/main.go', 'top_nesting_level': 0, 'length': 45, 'fan_in': 0, 'fan_out': 0, 'general_fan_out': 0}]",72,421,5,"[{'cyclomatic_complexity': 2, 'nloc': 5, 'token_count': 24, 'name': 'main', 'long_name': 'main', 'start_line': 18, 'end_line': 22, 'full_parameters': [], 'filename': '/home/dimi/Documents/Informatik_Studium/FSS/SoftEvo/DataCollection/FFS_SoftEvo/go-ipfs/test/bench/offline_add/main.go', 'top_nesting_level': 0, 'length': 5, 'fan_in': 0, 'fan_out': 0, 'general_fan_out': 0}, {'cyclomatic_complexity': 3, 'nloc': 11, 'token_count': 67, 'name': 'compareResults', 'long_name': 'compareResults', 'start_line': 24, 'end_line': 34, 'full_parameters': [], 'filename': '/home/dimi/Documents/Informatik_Studium/FSS/SoftEvo/DataCollection/FFS_SoftEvo/go-ipfs/test/bench/offline_add/main.go', 'top_nesting_level': 0, 'length': 11, 'fan_in': 0, 'fan_out': 0, 'general_fan_out': 0}, {'cyclomatic_complexity': 1, 'nloc': 3, 'token_count': 15, 'name': '', 'long_name': '(cmd*exec.Cmd)', 'start_line': 48, 'end_line': 50, 'full_parameters': [], 'filename': '/home/dimi/Documents/Informatik_Studium/FSS/SoftEvo/DataCollection/FFS_SoftEvo/go-ipfs/test/bench/offline_add/main.go', 'top_nesting_level': 0, 'length': 3, 'fan_in': 0, 'fan_out': 0, 'general_fan_out': 0}, {'cyclomatic_complexity': 8, 'nloc': 38, 'token_count': 271, 'name': '', 'long_name': '(b*testing.B)', 'start_line': 37, 'end_line': 81, 'full_parameters': [], 'filename': '/home/dimi/Documents/Informatik_Studium/FSS/SoftEvo/DataCollection/FFS_SoftEvo/go-ipfs/test/bench/offline_add/main.go', 'top_nesting_level': 0, 'length': 45, 'fan_in': 0, 'fan_out': 0, 'general_fan_out': 0}, {'cyclomatic_complexity': 1, 'nloc': 4, 'token_count': 29, 'name': 'benchmarkAdd', 'long_name': 'benchmarkAdd amount int64', 'start_line': 36, 'end_line': 83, 'full_parameters': ['amount int64'], 'filename': '/home/dimi/Documents/Informatik_Studium/FSS/SoftEvo/DataCollection/FFS_SoftEvo/go-ipfs/test/bench/offline_add/main.go', 'top_nesting_level': 0, 'length': 48, 'fan_in': 0, 'fan_out': 0, 'general_fan_out': 0}]",3,16,0,27,27,"[{'timestamp': 1532365899.0, 'added_lines': 2, 'deleted_lines': 1, 'nloc': 69}, {'timestamp': 1532388583.0, 'added_lines': 1, 'deleted_lines': 1, 'nloc': 69}, {'timestamp': 1533809170.0, 'added_lines': 1, 'deleted_lines': 1, 'nloc': 69}, {'timestamp': 1534072974.0, 'added_lines': 1, 'deleted_lines': 1, 'nloc': 69}, {'timestamp': 1534896611.0, 'added_lines': 1, 'deleted_lines': 1, 'nloc': 69}, {'timestamp': 1535255498.0, 'added_lines': 1, 'deleted_lines': 1, 'nloc': 69}, {'timestamp': 1535601896.0, 'added_lines': 1, 'deleted_lines': 1, 'nloc': 69}, {'timestamp': 1536388808.0, 'added_lines': 1, 'deleted_lines': 1, 'nloc': 69}, {'timestamp': 1536357700.0, 'added_lines': 1, 'deleted_lines': 1, 'nloc': 69}, {'timestamp': 1537792589.0, 'added_lines': 1, 'deleted_lines': 1, 'nloc': 69}, {'timestamp': 1538544957.0, 'added_lines': 1, 'deleted_lines': 1, 'nloc': 69}, {'timestamp': 1538547366.0, 'added_lines': 1, 'deleted_lines': 1, 'nloc': 69}, {'timestamp': 1540400358.0, 'added_lines': 1, 'deleted_lines': 1, 'nloc': 69}, {'timestamp': 1540489644.0, 'added_lines': 1, 'deleted_lines': 1, 'nloc': 69}, {'timestamp': 1541204121.0, 'added_lines': 1, 'deleted_lines': 1, 'nloc': 69}, {'timestamp': 1543282933.0, 'added_lines': 1, 'deleted_lines': 1, 'nloc': 69}, {'timestamp': 1544225843.0, 'added_lines': 1, 'deleted_lines': 1, 'nloc': 69}, {'timestamp': 1545323704.0, 'added_lines': 1, 'deleted_lines': 1, 'nloc': 69}, {'timestamp': 1546553605.0, 'added_lines': 1, 'deleted_lines': 1, 'nloc': 69}, {'timestamp': 1547003974.0, 'added_lines': 1, 'deleted_lines': 1, 'nloc': 69}, {'timestamp': 1549588289.0, 'added_lines': 1, 'deleted_lines': 1, 'nloc': 69}, {'timestamp': 1550507829.0, 'added_lines': 1, 'deleted_lines': 1, 'nloc': 69}, {'timestamp': 1550610741.0, 'added_lines': 1, 'deleted_lines': 1, 'nloc': 69}, {'timestamp': 1551229859.0, 'added_lines': 1, 'deleted_lines': 1, 'nloc': 69}, {'timestamp': 1551551196.0, 'added_lines': 2, 'deleted_lines': 2, 'nloc': 69}, {'timestamp': 1553697989.0, 'added_lines': 4, 'deleted_lines': 1, 'nloc': 72}, {'timestamp': 1564798669.0, 'added_lines': 1, 'deleted_lines': 1, 'nloc': 72}]","{'cmd/ipfs/Rules.mk': 2, 'cmd/ipfs/init.go': 24, 'cmd/ipfs/main.go': 25, 'cmd/ipfswatch/main.go': 25, 'commands/request.go': 15, 'core/bootstrap.go': 23, 'core/bootstrap_test.go': 23, 'core/builder.go': 24, 'core/commands/bootstrap.go': 24, 'core/commands/config.go': 25, 'core/commands/env.go': 5, 'core/commands/mount_unix.go': 24, 'core/commands/repo.go': 25, 'core/commands/swarm.go': 25, 'core/commands/sysdiag.go': 9, 'core/commands/version.go': 6, 'core/core.go': 24, 'core/core_test.go': 23, 'core/coreapi/unixfs_test.go': 17, 'core/corehttp/commands.go': 24, 'core/corehttp/gateway.go': 14, 'core/corehttp/gateway_test.go': 24, 'core/corehttp/option_test.go': 2, 'core/coreunix/add_test.go': 24, 'core/mock/mock.go': 23, 'docs/releases.md': 1, 'docs/windows.md': 1, 'package.json': 24, 'repo/fsrepo/config_test.go': 23, 'repo/fsrepo/fsrepo.go': 24, 'repo/fsrepo/fsrepo_test.go': 23, 'repo/fsrepo/misc.go': 24, 'repo/mock.go': 23, 'repo/repo.go': 23, 'repo/version.go': 1, 'test/bench/bench_cli_ipfs_add/main.go': 27, 'assets/assets.go': 12, 'blocks/blockstoreutil/remove.go': 7, 'cmd/ipfs/daemon.go': 10, 'cmd/ipfs/ipfs.go': 6, 'cmd/seccat/seccat.go': 14, 'commands/command.go': 3, 'commands/legacy/command.go': 3, 'commands/legacy/legacy.go': 3, 'commands/legacy/legacy_test.go': 3, 'commands/legacy/request.go': 3, 'commands/legacy/response.go': 3, 'commands/response.go': 1, 'core/commands/active.go': 4, 'core/commands/add.go': 11, 'core/commands/bitswap.go': 14, 'core/commands/block.go': 7, 'core/commands/cat.go': 7, 'core/commands/commands.go': 7, 'core/commands/commands_test.go': 6, 'core/commands/dag/dag.go': 14, 'core/commands/dht.go': 14, 'core/commands/dht_test.go': 12, 'core/commands/diag.go': 4, 'core/commands/dns.go': 6, 'core/commands/external.go': 4, 'core/commands/files.go': 15, 'core/commands/filestore.go': 6, 'core/commands/get.go': 14, 'core/commands/get_test.go': 6, 'core/commands/helptext_test.go': 6, 'core/commands/id.go': 14, 'core/commands/ipns.go': 1, 'core/commands/ipnsps.go': 1, 'core/commands/keystore.go': 7, 'core/commands/log.go': 6, 'core/commands/ls.go': 13, 'core/commands/mount_nofuse.go': 4, 'core/commands/mount_windows.go': 4, 'core/commands/name.go': 1, 'core/commands/object/diff.go': 6, 'core/commands/object/object.go': 14, 'core/commands/object/patch.go': 7, 'core/commands/p2p.go': 13, 'core/commands/pin.go': 14, 'core/commands/ping.go': 13, 'core/commands/publish.go': 1, 'core/commands/pubsub.go': 10, 'core/commands/refs.go': 14, 'core/commands/resolve.go': 14, 'core/commands/root.go': 6, 'core/commands/shutdown.go': 6, 'core/commands/stat.go': 10, 'core/commands/tar.go': 14, 'core/commands/unixfs/ls.go': 14, 'core/commands/unixfs/unixfs.go': 4, 'core/commands/urlstore.go': 14, 'core/coreapi/block.go': 5, 'core/coreapi/dag.go': 3, 'core/coreapi/interface/coreapi.go': 2, 'core/coreapi/interface/dag.go': 2, 'core/coreapi/interface/key.go': 6, 'core/coreapi/interface/object.go': 2, 'core/coreapi/interface/options/dag.go': 2, 'core/coreapi/interface/path.go': 10, 'core/coreapi/interface/unixfs.go': 3, 'core/coreapi/key.go': 13, 'core/coreapi/name.go': 13, 'core/coreapi/name_test.go': 8, 'core/coreapi/object.go': 13, 'core/coreapi/path.go': 13, 'core/coreapi/pin.go': 13, 'core/coreapi/unixfs.go': 13, 'core/coredag/cbor.go': 4, 'core/coredag/dagpb.go': 13, 'core/coredag/dagtransl.go': 3, 'core/coredag/raw.go': 13, 'core/corehttp/gateway_handler.go': 14, 'core/corehttp/metrics_test.go': 13, 'core/corerepo/gc.go': 15, 'core/corerepo/pinning.go': 5, 'core/coreunix/add.go': 13, 'core/coreunix/cat.go': 4, 'core/coreunix/metadata.go': 13, 'core/coreunix/metadata_test.go': 14, 'core/pathresolver.go': 13, 'core/pathresolver_test.go': 13, 'dagutils/diff.go': 14, 'dagutils/diffenum.go': 13, 'dagutils/diffenum_test.go': 13, 'dagutils/utils.go': 14, 'dagutils/utils_test.go': 13, 'exchange/reprovide/providers.go': 13, 'exchange/reprovide/reprovide.go': 12, 'exchange/reprovide/reprovide_test.go': 14, 'filestore/filestore.go': 7, 'filestore/filestore_test.go': 13, 'filestore/fsrefstore.go': 7, 'filestore/util.go': 7, 'fuse/ipns/common.go': 13, 'fuse/ipns/ipns_test.go': 14, 'fuse/ipns/ipns_unix.go': 13, 'fuse/node/mount_test.go': 13, 'fuse/readonly/ipfs_test.go': 14, 'fuse/readonly/readonly_unix.go': 13, 'namesys/base.go': 13, 'namesys/cache.go': 13, 'namesys/dns.go': 13, 'namesys/interface.go': 13, 'namesys/ipns_resolver_validation_test.go': 13, 'namesys/namesys.go': 14, 'namesys/namesys_test.go': 14, 'namesys/proquint.go': 13, 'namesys/publisher.go': 13, 'namesys/publisher_test.go': 13, 'namesys/republisher/repub.go': 13, 'namesys/republisher/repub_test.go': 14, 'namesys/resolve_test.go': 13, 'namesys/routing.go': 14, 'p2p/p2p.go': 13, 'p2p/registry.go': 3, 'pin/gc/gc.go': 13, 'pin/pin.go': 13, 'pin/pin_test.go': 14, 'pin/set.go': 13, 'pin/set_test.go': 13, 'plugin/ipld.go': 3, 'plugin/loader/initializer.go': 2, 'plugin/plugins/git/git.go': 3, 'tar/format.go': 13, 'test/integration/addcat_test.go': 16, 'test/integration/bench_cat_test.go': 14, 'test/integration/bench_test.go': 10, 'test/integration/bitswap_wo_routing_test.go': 14, 'test/integration/three_legged_cat_test.go': 14, 'thirdparty/cidv0v1/blockstore.go': 7, 'thirdparty/verifbs/verifbs.go': 7, 'core/commands/cmdenv/env.go': 19, 'core/commands/name/ipns.go': 13, 'core/commands/name/publish.go': 9, 'repo/fsrepo/datastores.go': 6, None: 29, 'coverage/Rules.mk': 1, 'mk/golang.mk': 1, 'pin/internal/pb/doc.go': 1, 'test/3nodetest/Makefile': 1, 'test/bin/Rules.mk': 1, 'test/bin/verify-go-fmt.sh': 1, 'cmd/ipfs/util/ulimit.go': 4, 'cmd/seccat/util.go': 4, 'core/commands/name/ipnsps.go': 9, 'core/commands/name/name.go': 5, 'core/coreapi/dht.go': 10, 'core/coreapi/dht_test.go': 4, 'core/coreapi/interface/dht.go': 7, 'core/corehttp/corehttp.go': 7, 'core/corehttp/logs.go': 4, 'fuse/mount/mount.go': 4, 'fuse/node/mount_unix.go': 5, 'keystore/keystore.go': 4, 'p2p/listener.go': 10, 'p2p/local.go': 10, 'p2p/remote.go': 11, 'p2p/stream.go': 11, 'plugin/loader/load.go': 2, 'thirdparty/pollEndpoint/main.go': 7, 'core/coreapi/interface/swarm.go': 6, 'core/coreapi/swarm.go': 10, 'cmd/ipfs/dnsresolve_test.go': 5, 'core/coreapi/coreapi.go': 8, 'core/coreapi/interface/options/unixfs.go': 5, 'core/coreapi/interface/pubsub.go': 4, 'core/coreapi/pubsub.go': 10, 'core/coreapi/unixfile.go': 4, 'test/dependencies/ma-pipe-unidir/main.go': 6, 'test/sharness/t0180-pubsub.sh': 1, 'core/commands/cid.go': 5, 'core/coreapi/block_test.go': 1, 'core/coreapi/dag_test.go': 1, 'core/coreapi/interface/options/block.go': 1, 'keystore/keystore_test.go': 4, 'keystore/memkeystore.go': 3, 'test/dependencies/iptb/iptb.go': 10, 'commands/context.go': 9, 'core/corehttp/proxy.go': 6, 'core/coreapi/test/api_test.go': 6, 'core/coreapi/interface/tests/name.go': 2, 'core/coreapi/interface/tests/unixfs.go': 2, 'core/commands/cmdenv/cidbase.go': 3, 'core/corehttp/ipns_hostname.go': 3, 'filestore/pb/dataobj.pb.go': 2, 'namesys/dns_test.go': 3, 'pin/internal/pb/header.pb.go': 2, 'plugin/daemon.go': 3, 'plugin/loader/loader.go': 4, 'plugin/plugins/badgerds/badgerds.go': 3, 'plugin/plugins/flatfs/flatfs.go': 2, 'plugin/plugins/levelds/levelds.go': 2, 'core/corerepo/stat.go': 2, 'cmd/ipfs/util/ulimit_freebsd.go': 1, 'cmd/ipfs/util/ulimit_unix.go': 1, 'core/commands/cmdenv/cidbase_test.go': 1, 'core/commands/cmdenv/file.go': 1, 'core/corehttp/metrics.go': 1, 'core/corehttp/proxy_test.go': 1, 'fuse/ipns/link_unix.go': 1, 'fuse/mount/fuse.go': 2, 'fuse/node/mount_darwin.go': 1, 'plugin/tracer.go': 1, 'thirdparty/notifier/notifier.go': 1, 'commands/reqlog.go': 1, 'core/corehttp/mutex_profile.go': 1, 'provider/queue.go': 1, 'provider/queue_test.go': 1, 'go.mod': 1, 'go.sum': 1, 'test/sharness/lib/test-lib.sh': 1, 'test/sharness/t0020-init.sh': 1, 'test/sharness/t0025-datastores.sh': 1}","('test/bench/bench_cli_ipfs_add/main.go', 1.0, 1.0)"
test/dependencies/go-sleep/go-sleep.go,23,141,2,"[{'cyclomatic_complexity': 3, 'nloc': 11, 'token_count': 62, 'name': 'main', 'long_name': 'main', 'start_line': 9, 'end_line': 20, 'full_parameters': [], 'filename': '/home/dimi/Documents/Informatik_Studium/FSS/SoftEvo/DataCollection/FFS_SoftEvo/go-ipfs/test/dependencies/go-sleep/go-sleep.go', 'top_nesting_level': 0, 'length': 12, 'fan_in': 0, 'fan_out': 0, 'general_fan_out': 0}, {'cyclomatic_complexity': 1, 'nloc': 6, 'token_count': 71, 'name': 'usageError', 'long_name': 'usageError', 'start_line': 22, 'end_line': 27, 'full_parameters': [], 'filename': '/home/dimi/Documents/Informatik_Studium/FSS/SoftEvo/DataCollection/FFS_SoftEvo/go-ipfs/test/dependencies/go-sleep/go-sleep.go', 'top_nesting_level': 0, 'length': 6, 'fan_in': 0, 'fan_out': 0, 'general_fan_out': 0}]",23,141,2,"[{'cyclomatic_complexity': 3, 'nloc': 11, 'token_count': 62, 'name': 'main', 'long_name': 'main', 'start_line': 9, 'end_line': 20, 'full_parameters': [], 'filename': '/home/dimi/Documents/Informatik_Studium/FSS/SoftEvo/DataCollection/FFS_SoftEvo/go-ipfs/test/dependencies/go-sleep/go-sleep.go', 'top_nesting_level': 0, 'length': 12, 'fan_in': 0, 'fan_out': 0, 'general_fan_out': 0}, {'cyclomatic_complexity': 1, 'nloc': 6, 'token_count': 71, 'name': 'usageError', 'long_name': 'usageError', 'start_line': 22, 'end_line': 27, 'full_parameters': [], 'filename': '/home/dimi/Documents/Informatik_Studium/FSS/SoftEvo/DataCollection/FFS_SoftEvo/go-ipfs/test/dependencies/go-sleep/go-sleep.go', 'top_nesting_level': 0, 'length': 6, 'fan_in': 0, 'fan_out': 0, 'general_fan_out': 0}]",0,0,0,0,0,[],{},()
test/dependencies/go-timeout/main.go,51,314,1,"[{'cyclomatic_complexity': 8, 'nloc': 41, 'token_count': 302, 'name': 'main', 'long_name': 'main', 'start_line': 13, 'end_line': 55, 'full_parameters': [], 'filename': '/home/dimi/Documents/Informatik_Studium/FSS/SoftEvo/DataCollection/FFS_SoftEvo/go-ipfs/test/dependencies/go-timeout/main.go', 'top_nesting_level': 0, 'length': 43, 'fan_in': 0, 'fan_out': 0, 'general_fan_out': 0}]",52,318,1,"[{'cyclomatic_complexity': 8, 'nloc': 42, 'token_count': 306, 'name': 'main', 'long_name': 'main', 'start_line': 13, 'end_line': 56, 'full_parameters': [], 'filename': '/home/dimi/Documents/Informatik_Studium/FSS/SoftEvo/DataCollection/FFS_SoftEvo/go-ipfs/test/dependencies/go-timeout/main.go', 'top_nesting_level': 0, 'length': 44, 'fan_in': 0, 'fan_out': 0, 'general_fan_out': 0}]",1,4,0,1,1,"[{'timestamp': 1521687673.0, 'added_lines': 2, 'deleted_lines': 1, 'nloc': 52}]","{'core/builder.go': 1, 'filestore/fsrefstore.go': 1, 'repo/fsrepo/fsrepo.go': 1, 'thirdparty/notifier/notifier.go': 1}","('repo/fsrepo/fsrepo.go', 1.0, 0.014492753623188406)"
test/dependencies/ma-pipe-unidir/main.go,79,362,3,"[{'cyclomatic_complexity': 1, 'nloc': 3, 'token_count': 11, 'name': '', 'long_name': '()', 'start_line': 27, 'end_line': 29, 'full_parameters': [], 'filename': '/home/dimi/Documents/Informatik_Studium/FSS/SoftEvo/DataCollection/FFS_SoftEvo/go-ipfs/test/dependencies/ma-pipe-unidir/main.go', 'top_nesting_level': 0, 'length': 3, 'fan_in': 0, 'fan_out': 0, 'general_fan_out': 0}, {'cyclomatic_complexity': 13, 'nloc': 58, 'token_count': 310, 'name': 'app', 'long_name': 'app', 'start_line': 22, 'end_line': 91, 'full_parameters': [], 'filename': '/home/dimi/Documents/Informatik_Studium/FSS/SoftEvo/DataCollection/FFS_SoftEvo/go-ipfs/test/dependencies/ma-pipe-unidir/main.go', 'top_nesting_level': 0, 'length': 70, 'fan_in': 0, 'fan_out': 0, 'general_fan_out': 0}, {'cyclomatic_complexity': 1, 'nloc': 3, 'token_count': 14, 'name': 'main', 'long_name': 'main', 'start_line': 93, 'end_line': 95, 'full_parameters': [], 'filename': '/home/dimi/Documents/Informatik_Studium/FSS/SoftEvo/DataCollection/FFS_SoftEvo/go-ipfs/test/dependencies/ma-pipe-unidir/main.go', 'top_nesting_level': 0, 'length': 3, 'fan_in': 0, 'fan_out': 0, 'general_fan_out': 0}]",90,437,3,"[{'cyclomatic_complexity': 1, 'nloc': 3, 'token_count': 11, 'name': '', 'long_name': '()', 'start_line': 27, 'end_line': 29, 'full_parameters': [], 'filename': '/home/dimi/Documents/Informatik_Studium/FSS/SoftEvo/DataCollection/FFS_SoftEvo/go-ipfs/test/dependencies/ma-pipe-unidir/main.go', 'top_nesting_level': 0, 'length': 3, 'fan_in': 0, 'fan_out': 0, 'general_fan_out': 0}, {'cyclomatic_complexity': 16, 'nloc': 69, 'token_count': 385, 'name': 'app', 'long_name': 'app', 'start_line': 22, 'end_line': 105, 'full_parameters': [], 'filename': '/home/dimi/Documents/Informatik_Studium/FSS/SoftEvo/DataCollection/FFS_SoftEvo/go-ipfs/test/dependencies/ma-pipe-unidir/main.go', 'top_nesting_level': 0, 'length': 84, 'fan_in': 0, 'fan_out': 0, 'general_fan_out': 0}, {'cyclomatic_complexity': 1, 'nloc': 3, 'token_count': 14, 'name': 'main', 'long_name': 'main', 'start_line': 107, 'end_line': 109, 'full_parameters': [], 'filename': '/home/dimi/Documents/Informatik_Studium/FSS/SoftEvo/DataCollection/FFS_SoftEvo/go-ipfs/test/dependencies/ma-pipe-unidir/main.go', 'top_nesting_level': 0, 'length': 3, 'fan_in': 0, 'fan_out': 0, 'general_fan_out': 0}]",11,75,0,12,12,"[{'timestamp': 1512365669.0, 'added_lines': 2, 'deleted_lines': 2, 'nloc': 79}, {'timestamp': 1516838128.0, 'added_lines': 2, 'deleted_lines': 2, 'nloc': 79}, {'timestamp': 1528268108.0, 'added_lines': 1, 'deleted_lines': 1, 'nloc': 79}, {'timestamp': 1528520460.0, 'added_lines': 2, 'deleted_lines': 2, 'nloc': 79}, {'timestamp': 1529984485.0, 'added_lines': 2, 'deleted_lines': 2, 'nloc': 79}, {'timestamp': 1540400358.0, 'added_lines': 2, 'deleted_lines': 2, 'nloc': 79}, {'timestamp': 1541204121.0, 'added_lines': 2, 'deleted_lines': 2, 'nloc': 79}, {'timestamp': 1547003974.0, 'added_lines': 2, 'deleted_lines': 2, 'nloc': 79}, {'timestamp': 1551229859.0, 'added_lines': 2, 'deleted_lines': 2, 'nloc': 79}, {'timestamp': 1551551196.0, 'added_lines': 2, 'deleted_lines': 2, 'nloc': 79}, {'timestamp': 1553697989.0, 'added_lines': 5, 'deleted_lines': 2, 'nloc': 82}, {'timestamp': 1572324887.0, 'added_lines': 21, 'deleted_lines': 10, 'nloc': 90}]","{'assets/assets.go': 8, 'blocks/blockstore/arc_cache.go': 2, 'blocks/blockstore/arc_cache_test.go': 2, 'blocks/blockstore/blockstore.go': 2, 'blocks/blockstore/blockstore_test.go': 2, 'blocks/blockstore/bloom_cache.go': 2, 'blocks/blockstore/bloom_cache_test.go': 2, 'blocks/blockstore/util/remove.go': 2, 'blocks/blocksutil/block_generator.go': 2, 'blockservice/blockservice.go': 4, 'blockservice/blockservice_test.go': 4, 'blockservice/test/blocks_test.go': 4, 'cmd/ipfs/daemon.go': 11, 'cmd/ipfs/init.go': 8, 'cmd/ipfs/ipfs.go': 6, 'cmd/ipfs/main.go': 11, 'cmd/ipfs/main_test.go': 1, 'cmd/ipfswatch/main.go': 8, 'cmd/seccat/seccat.go': 11, 'commands/command.go': 5, 'commands/command_test.go': 2, 'commands/request.go': 6, 'commands/response.go': 3, 'commands/response_test.go': 2, 'core/bootstrap.go': 10, 'core/bootstrap_test.go': 10, 'core/builder.go': 11, 'core/commands/active.go': 3, 'core/commands/add.go': 8, 'core/commands/bitswap.go': 9, 'core/commands/block.go': 7, 'core/commands/bootstrap.go': 7, 'core/commands/cat.go': 7, 'core/commands/commands.go': 7, 'core/commands/config.go': 8, 'core/commands/dag/dag.go': 8, 'core/commands/dht.go': 10, 'core/commands/dht_test.go': 9, 'core/commands/diag.go': 3, 'core/commands/dns.go': 5, 'core/commands/external.go': 3, 'core/commands/files/files.go': 2, 'core/commands/filestore.go': 6, 'core/commands/get.go': 10, 'core/commands/get_test.go': 6, 'core/commands/helptext_test.go': 6, 'core/commands/id.go': 10, 'core/commands/ipns.go': 4, 'core/commands/ipnsps.go': 3, 'core/commands/keystore.go': 7, 'core/commands/log.go': 5, 'core/commands/ls.go': 9, 'core/commands/mount_nofuse.go': 3, 'core/commands/mount_unix.go': 7, 'core/commands/mount_windows.go': 3, 'core/commands/name.go': 2, 'core/commands/object/diff.go': 5, 'core/commands/object/object.go': 9, 'core/commands/object/patch.go': 6, 'core/commands/p2p.go': 10, 'core/commands/pin.go': 9, 'core/commands/ping.go': 10, 'core/commands/publish.go': 4, 'core/commands/pubsub.go': 8, 'core/commands/refs.go': 8, 'core/commands/repo.go': 10, 'core/commands/resolve.go': 7, 'core/commands/root.go': 6, 'core/commands/shutdown.go': 4, 'core/commands/stat.go': 9, 'core/commands/swarm.go': 11, 'core/commands/sysdiag.go': 10, 'core/commands/tar.go': 7, 'core/commands/unixfs/ls.go': 7, 'core/commands/unixfs/unixfs.go': 3, 'core/commands/version.go': 4, 'core/core.go': 11, 'core/coreapi/coreapi.go': 8, 'core/coreapi/interface/interface.go': 2, 'core/coreapi/unixfs.go': 8, 'core/coreapi/unixfs_test.go': 6, 'core/coredag/cbor.go': 5, 'core/coredag/dagpb.go': 8, 'core/coredag/dagtransl.go': 5, 'core/coredag/raw.go': 8, 'core/corehttp/commands.go': 9, 'core/corehttp/corehttp.go': 10, 'core/corehttp/gateway.go': 10, 'core/corehttp/gateway_handler.go': 10, 'core/corehttp/gateway_test.go': 11, 'core/corehttp/metrics_test.go': 10, 'core/corerepo/gc.go': 10, 'core/corerepo/pinning.go': 4, 'core/coreunix/add.go': 9, 'core/coreunix/add_test.go': 10, 'core/coreunix/metadata.go': 8, 'core/coreunix/metadata_test.go': 10, 'core/mock/mock.go': 10, 'core/pathresolver.go': 9, 'exchange/bitswap/bitswap.go': 4, 'exchange/bitswap/bitswap_test.go': 5, 'exchange/bitswap/decision/bench_test.go': 4, 'exchange/bitswap/decision/engine.go': 4, 'exchange/bitswap/decision/engine_test.go': 4, 'exchange/bitswap/decision/ledger.go': 4, 'exchange/bitswap/decision/peer_request_queue.go': 4, 'exchange/bitswap/decision/peer_request_queue_test.go': 4, 'exchange/bitswap/get.go': 4, 'exchange/bitswap/message/message.go': 5, 'exchange/bitswap/message/message_test.go': 3, 'exchange/bitswap/network/interface.go': 5, 'exchange/bitswap/network/ipfs_impl.go': 5, 'exchange/bitswap/notifications/notifications.go': 3, 'exchange/bitswap/notifications/notifications_test.go': 3, 'exchange/bitswap/session.go': 4, 'exchange/bitswap/session_test.go': 4, 'exchange/bitswap/stat.go': 3, 'exchange/bitswap/testnet/interface.go': 4, 'exchange/bitswap/testnet/network_test.go': 5, 'exchange/bitswap/testnet/peernet.go': 5, 'exchange/bitswap/testnet/virtual.go': 5, 'exchange/bitswap/testutils.go': 5, 'exchange/bitswap/wantlist/wantlist.go': 3, 'exchange/bitswap/wantlist/wantlist_test.go': 3, 'exchange/bitswap/wantmanager.go': 4, 'exchange/bitswap/workers.go': 4, 'exchange/interface.go': 2, 'exchange/offline/offline.go': 2, 'exchange/offline/offline_test.go': 2, 'exchange/reprovide/providers.go': 9, 'exchange/reprovide/reprovide.go': 10, 'exchange/reprovide/reprovide_test.go': 11, 'filestore/filestore.go': 6, 'filestore/filestore_test.go': 9, 'filestore/fsrefstore.go': 6, 'filestore/util.go': 6, 'fuse/ipns/ipns_test.go': 11, 'fuse/ipns/ipns_unix.go': 9, 'fuse/node/mount_test.go': 10, 'fuse/readonly/ipfs_test.go': 10, 'fuse/readonly/readonly_unix.go': 9, 'importer/balanced/balanced_test.go': 4, 'importer/balanced/builder.go': 3, 'importer/chunk/rabin_test.go': 2, 'importer/chunk/splitting_test.go': 2, 'importer/helpers/dagbuilder.go': 4, 'importer/helpers/helpers.go': 3, 'importer/importer.go': 4, 'importer/importer_test.go': 4, 'importer/trickle/trickle_test.go': 4, 'importer/trickle/trickledag.go': 3, 'merkledag/batch.go': 2, 'merkledag/coding.go': 3, 'merkledag/merkledag.go': 3, 'merkledag/merkledag_test.go': 4, 'merkledag/node.go': 3, 'merkledag/node_test.go': 3, 'merkledag/raw.go': 3, 'merkledag/traverse/traverse.go': 3, 'merkledag/traverse/traverse_test.go': 3, 'merkledag/utils/diff.go': 3, 'merkledag/utils/diffenum.go': 3, 'merkledag/utils/diffenum_test.go': 3, 'merkledag/utils/utils.go': 4, 'merkledag/utils/utils_test.go': 3, 'mfs/dir.go': 3, 'mfs/file.go': 4, 'mfs/mfs_test.go': 4, 'mfs/ops.go': 3, 'mfs/repub_test.go': 4, 'mfs/system.go': 4, 'namesys/ipns_select_test.go': 3, 'namesys/namesys.go': 11, 'namesys/publisher.go': 10, 'namesys/publisher_test.go': 10, 'namesys/pubsub.go': 2, 'namesys/pubsub_test.go': 2, 'namesys/republisher/repub.go': 9, 'namesys/republisher/repub_test.go': 11, 'namesys/resolve_test.go': 10, 'namesys/routing.go': 11, 'p2p/p2p.go': 10, 'p2p/registry.go': 5, 'package.json': 9, 'path/path.go': 3, 'path/resolver.go': 2, 'path/resolver_test.go': 2, 'pin/gc/gc.go': 9, 'pin/pin.go': 9, 'pin/pin_test.go': 10, 'pin/set.go': 8, 'pin/set_test.go': 9, 'plugin/ipld.go': 5, 'plugin/loader/initializer.go': 4, 'plugin/plugins/git/git.go': 5, 'repo/config/bootstrap_peers.go': 5, 'repo/config/init.go': 4, 'repo/fsrepo/fsrepo.go': 9, 'repo/fsrepo/lock/lock.go': 2, 'repo/fsrepo/serialize/serialize.go': 3, 'repo/mock.go': 9, 'repo/repo.go': 9, 'routing/mock/centralized_client.go': 2, 'routing/mock/centralized_server.go': 2, 'routing/mock/centralized_test.go': 2, 'routing/mock/interface.go': 2, 'routing/none/none_client.go': 2, 'routing/offline/offline.go': 2, 'routing/offline/offline_test.go': 2, 'tar/format.go': 9, 'test/integration/addcat_test.go': 11, 'test/integration/bench_cat_test.go': 11, 'test/integration/bench_test.go': 9, 'test/integration/bitswap_wo_routing_test.go': 11, 'test/integration/three_legged_cat_test.go': 11, 'thirdparty/ds-help/key.go': 2, 'thirdparty/pollEndpoint/main.go': 10, 'thirdparty/posinfo/posinfo.go': 2, 'unixfs/archive/archive.go': 3, 'unixfs/archive/tar/writer.go': 3, 'unixfs/hamt/hamt.go': 3, 'unixfs/io/dagreader.go': 3, 'unixfs/io/dirbuilder.go': 3, 'unixfs/io/resolve.go': 3, 'unixfs/mod/dagmodifier.go': 4, 'unixfs/mod/dagmodifier_test.go': 3, 'unixfs/test/utils.go': 4, 'commands/legacy/command.go': 4, 'commands/legacy/legacy.go': 4, 'commands/legacy/legacy_test.go': 4, 'commands/legacy/request.go': 4, 'commands/legacy/response.go': 4, 'core/commands/commands_test.go': 5, 'core/coreapi/dag.go': 4, 'core/coreapi/dag_test.go': 3, 'core/coreapi/interface/options/dag.go': 3, 'core/coreapi/key.go': 8, 'core/coreapi/name.go': 9, 'merkledag/test/utils.go': 3, 'namesys/namesys_test.go': 10, 'repo/fsrepo/datastores.go': 5, 'repo/fsrepo/fsrepo_test.go': 6, 'thirdparty/datastore2/datastore_closer.go': 1, 'thirdparty/datastore2/delayed.go': 1, 'thirdparty/datastore2/threadsafe.go': 1, 'unixfs/io/pbdagreader.go': 2, 'blockservice/test/mock.go': 3, 'namesys/ipns_validate_test.go': 2, 'namesys/validator.go': 2, 'blocks/blockstoreutil/remove.go': 4, 'cmd/ipfs/util/ulimit.go': 4, 'cmd/ipfs/util/ulimit_freebsd.go': 2, 'cmd/ipfs/util/ulimit_unix.go': 2, 'cmd/seccat/util.go': 4, 'core/commands/files.go': 8, 'core/coreapi/block.go': 4, 'core/coreapi/block_test.go': 2, 'core/coreapi/interface/coreapi.go': 2, 'core/coreapi/interface/dag.go': 2, 'core/coreapi/interface/object.go': 2, 'core/coreapi/interface/options/block.go': 2, 'core/coreapi/interface/path.go': 4, 'core/coreapi/interface/unixfs.go': 2, 'core/coreapi/object.go': 6, 'core/coreapi/pin.go': 7, 'core/corehttp/logs.go': 4, 'fuse/ipns/link_unix.go': 2, 'fuse/mount/fuse.go': 3, 'fuse/mount/mount.go': 4, 'fuse/node/mount_darwin.go': 2, 'fuse/node/mount_unix.go': 5, 'keystore/keystore.go': 4, 'merkledag/errservice.go': 1, 'merkledag/readonly.go': 1, 'merkledag/readonly_test.go': 1, 'merkledag/rwservice.go': 1, 'merkledag/session.go': 1, 'path/resolver/resolver.go': 2, 'path/resolver/resolver_test.go': 1, 'plugin/loader/load.go': 3, 'thirdparty/verifbs/verifbs.go': 4, 'thirdparty/verifcid/validate.go': 1, 'thirdparty/verifcid/validate_test.go': 1, 'unixfs/hamt/hamt_stress_test.go': 1, 'unixfs/hamt/hamt_test.go': 1, 'namesys/ipns_resolver_validation_test.go': 6, 'test/sharness/t0170-dht.sh': 1, 'cmd/ipfs/dnsresolve_test.go': 5, 'core/commands/cmdenv/env.go': 5, 'core/commands/name/ipns.go': 5, 'core/commands/name/ipnsps.go': 4, 'core/commands/urlstore.go': 5, 'core/core_test.go': 5, 'core/coreapi/dht.go': 5, 'core/coreapi/dht_test.go': 2, 'core/coreapi/interface/dht.go': 3, 'core/coreapi/interface/key.go': 2, 'core/coreapi/interface/options/unixfs.go': 3, 'core/coreapi/interface/pubsub.go': 2, 'core/coreapi/interface/swarm.go': 3, 'core/coreapi/name_test.go': 2, 'core/coreapi/path.go': 5, 'core/coreapi/pubsub.go': 6, 'core/coreapi/swarm.go': 6, 'core/coreapi/unixfile.go': 3, 'core/pathresolver_test.go': 5, 'dagutils/diff.go': 6, 'dagutils/diffenum.go': 5, 'dagutils/diffenum_test.go': 5, 'dagutils/utils.go': 6, 'dagutils/utils_test.go': 5, 'fuse/ipns/common.go': 5, 'namesys/base.go': 5, 'namesys/cache.go': 5, 'namesys/dns.go': 5, 'namesys/interface.go': 5, 'namesys/proquint.go': 5, 'p2p/listener.go': 5, 'p2p/local.go': 5, 'p2p/remote.go': 6, 'p2p/stream.go': 6, 'repo/fsrepo/config_test.go': 5, 'repo/fsrepo/misc.go': 5, 'test/bench/bench_cli_ipfs_add/main.go': 6, 'test/bench/offline_add/main.go': 6, 'core/commands/cid.go': 3, 'core/commands/name/name.go': 2, 'core/commands/name/publish.go': 3, 'keystore/keystore_test.go': 3, 'keystore/memkeystore.go': 2, 'test/dependencies/iptb/iptb.go': 4, 'thirdparty/cidv0v1/blockstore.go': 2, 'commands/context.go': 3, 'core/coreapi/interface/tests/name.go': 1, 'core/coreapi/interface/tests/unixfs.go': 1, 'core/coreapi/test/api_test.go': 3, 'core/corehttp/proxy.go': 3, 'core/corehttp/ipns_hostname.go': 2, 'namesys/dns_test.go': 2, 'plugin/daemon.go': 2, 'plugin/loader/loader.go': 3, 'core/commands/cmdenv/cidbase.go': 1, 'core/commands/cmdenv/cidbase_test.go': 1, 'core/commands/cmdenv/file.go': 1, 'core/corehttp/metrics.go': 1, 'core/corehttp/proxy_test.go': 1, 'core/corerepo/stat.go': 1, 'filestore/pb/dataobj.pb.go': 1, 'pin/internal/pb/header.pb.go': 1, 'plugin/plugins/badgerds/badgerds.go': 1, 'plugin/plugins/flatfs/flatfs.go': 1, 'plugin/plugins/levelds/levelds.go': 1, 'plugin/tracer.go': 1, 'thirdparty/notifier/notifier.go': 1, 'commands/reqlog.go': 1, 'core/corehttp/mutex_profile.go': 1, 'core/corehttp/option_test.go': 1, 'provider/queue.go': 1, 'provider/queue_test.go': 1, 'test/sharness/t0180-p2p.sh': 1}","('core/core.go', 0.9166666666666666, 0.061452513966480445)"
test/integration/addcat_test.go,133,784,9,"[{'cyclomatic_complexity': 2, 'nloc': 10, 'token_count': 58, 'name': 'Test1KBInstantaneous', 'long_name': 'Test1KBInstantaneous t * testing . T', 'start_line': 30, 'end_line': 40, 'full_parameters': ['t * testing . T'], 'filename': '/home/dimi/Documents/Informatik_Studium/FSS/SoftEvo/DataCollection/FFS_SoftEvo/go-ipfs/test/integration/addcat_test.go', 'top_nesting_level': 0, 'length': 11, 'fan_in': 0, 'fan_out': 0, 'general_fan_out': 0}, {'cyclomatic_complexity': 2, 'nloc': 7, 'token_count': 50, 'name': 'TestDegenerateSlowBlockstore', 'long_name': 'TestDegenerateSlowBlockstore t * testing . T', 'start_line': 42, 'end_line': 48, 'full_parameters': ['t * testing . T'], 'filename': '/home/dimi/Documents/Informatik_Studium/FSS/SoftEvo/DataCollection/FFS_SoftEvo/go-ipfs/test/integration/addcat_test.go', 'top_nesting_level': 0, 'length': 7, 'fan_in': 0, 'fan_out': 0, 'general_fan_out': 0}, {'cyclomatic_complexity': 2, 'nloc': 7, 'token_count': 50, 'name': 'TestDegenerateSlowNetwork', 'long_name': 'TestDegenerateSlowNetwork t * testing . T', 'start_line': 50, 'end_line': 56, 'full_parameters': ['t * testing . T'], 'filename': '/home/dimi/Documents/Informatik_Studium/FSS/SoftEvo/DataCollection/FFS_SoftEvo/go-ipfs/test/integration/addcat_test.go', 'top_nesting_level': 0, 'length': 7, 'fan_in': 0, 'fan_out': 0, 'general_fan_out': 0}, {'cyclomatic_complexity': 2, 'nloc': 7, 'token_count': 50, 'name': 'TestDegenerateSlowRouting', 'long_name': 'TestDegenerateSlowRouting t * testing . T', 'start_line': 58, 'end_line': 64, 'full_parameters': ['t * testing . T'], 'filename': '/home/dimi/Documents/Informatik_Studium/FSS/SoftEvo/DataCollection/FFS_SoftEvo/go-ipfs/test/integration/addcat_test.go', 'top_nesting_level': 0, 'length': 7, 'fan_in': 0, 'fan_out': 0, 'general_fan_out': 0}, {'cyclomatic_complexity': 2, 'nloc': 7, 'token_count': 62, 'name': 'Test100MBMacbookCoastToCoast', 'long_name': 'Test100MBMacbookCoastToCoast t * testing . T', 'start_line': 66, 'end_line': 72, 'full_parameters': ['t * testing . T'], 'filename': '/home/dimi/Documents/Informatik_Studium/FSS/SoftEvo/DataCollection/FFS_SoftEvo/go-ipfs/test/integration/addcat_test.go', 'top_nesting_level': 0, 'length': 7, 'fan_in': 0, 'fan_out': 0, 'general_fan_out': 0}, {'cyclomatic_complexity': 3, 'nloc': 10, 'token_count': 67, 'name': 'AddCatPowers', 'long_name': 'AddCatPowers conf testutil . LatencyConfig , megabytesMax int64', 'start_line': 74, 'end_line': 83, 'full_parameters': ['conf testutil . LatencyConfig', ' megabytesMax int64'], 'filename': '/home/dimi/Documents/Informatik_Studium/FSS/SoftEvo/DataCollection/FFS_SoftEvo/go-ipfs/test/integration/addcat_test.go', 'top_nesting_level': 0, 'length': 10, 'fan_in': 0, 'fan_out': 0, 'general_fan_out': 0}, {'cyclomatic_complexity': 1, 'nloc': 5, 'token_count': 35, 'name': 'RandomBytes', 'long_name': 'RandomBytes n int64', 'start_line': 85, 'end_line': 89, 'full_parameters': ['n int64'], 'filename': '/home/dimi/Documents/Informatik_Studium/FSS/SoftEvo/DataCollection/FFS_SoftEvo/go-ipfs/test/integration/addcat_test.go', 'top_nesting_level': 0, 'length': 5, 'fan_in': 0, 'fan_out': 0, 'general_fan_out': 0}, {'cyclomatic_complexity': 9, 'nloc': 52, 'token_count': 341, 'name': 'DirectAddCat', 'long_name': 'DirectAddCat data [ ] byte , conf testutil . LatencyConfig', 'start_line': 91, 'end_line': 155, 'full_parameters': ['data [ ] byte', ' conf testutil . LatencyConfig'], 'filename': '/home/dimi/Documents/Informatik_Studium/FSS/SoftEvo/DataCollection/FFS_SoftEvo/go-ipfs/test/integration/addcat_test.go', 'top_nesting_level': 0, 'length': 65, 'fan_in': 0, 'fan_out': 0, 'general_fan_out': 0}, {'cyclomatic_complexity': 2, 'nloc': 5, 'token_count': 27, 'name': 'SkipUnlessEpic', 'long_name': 'SkipUnlessEpic t * testing . T', 'start_line': 157, 'end_line': 161, 'full_parameters': ['t * testing . T'], 'filename': '/home/dimi/Documents/Informatik_Studium/FSS/SoftEvo/DataCollection/FFS_SoftEvo/go-ipfs/test/integration/addcat_test.go', 'top_nesting_level': 0, 'length': 5, 'fan_in': 0, 'fan_out': 0, 'general_fan_out': 0}]",148,849,9,"[{'cyclomatic_complexity': 2, 'nloc': 10, 'token_count': 58, 'name': 'Test1KBInstantaneous', 'long_name': 'Test1KBInstantaneous t * testing . T', 'start_line': 31, 'end_line': 41, 'full_parameters': ['t * testing . T'], 'filename': '/home/dimi/Documents/Informatik_Studium/FSS/SoftEvo/DataCollection/FFS_SoftEvo/go-ipfs/test/integration/addcat_test.go', 'top_nesting_level': 0, 'length': 11, 'fan_in': 0, 'fan_out': 0, 'general_fan_out': 0}, {'cyclomatic_complexity': 2, 'nloc': 7, 'token_count': 50, 'name': 'TestDegenerateSlowBlockstore', 'long_name': 'TestDegenerateSlowBlockstore t * testing . T', 'start_line': 43, 'end_line': 49, 'full_parameters': ['t * testing . T'], 'filename': '/home/dimi/Documents/Informatik_Studium/FSS/SoftEvo/DataCollection/FFS_SoftEvo/go-ipfs/test/integration/addcat_test.go', 'top_nesting_level': 0, 'length': 7, 'fan_in': 0, 'fan_out': 0, 'general_fan_out': 0}, {'cyclomatic_complexity': 2, 'nloc': 7, 'token_count': 50, 'name': 'TestDegenerateSlowNetwork', 'long_name': 'TestDegenerateSlowNetwork t * testing . T', 'start_line': 51, 'end_line': 57, 'full_parameters': ['t * testing . T'], 'filename': '/home/dimi/Documents/Informatik_Studium/FSS/SoftEvo/DataCollection/FFS_SoftEvo/go-ipfs/test/integration/addcat_test.go', 'top_nesting_level': 0, 'length': 7, 'fan_in': 0, 'fan_out': 0, 'general_fan_out': 0}, {'cyclomatic_complexity': 2, 'nloc': 7, 'token_count': 50, 'name': 'TestDegenerateSlowRouting', 'long_name': 'TestDegenerateSlowRouting t * testing . T', 'start_line': 59, 'end_line': 65, 'full_parameters': ['t * testing . T'], 'filename': '/home/dimi/Documents/Informatik_Studium/FSS/SoftEvo/DataCollection/FFS_SoftEvo/go-ipfs/test/integration/addcat_test.go', 'top_nesting_level': 0, 'length': 7, 'fan_in': 0, 'fan_out': 0, 'general_fan_out': 0}, {'cyclomatic_complexity': 2, 'nloc': 7, 'token_count': 62, 'name': 'Test100MBMacbookCoastToCoast', 'long_name': 'Test100MBMacbookCoastToCoast t * testing . T', 'start_line': 67, 'end_line': 73, 'full_parameters': ['t * testing . T'], 'filename': '/home/dimi/Documents/Informatik_Studium/FSS/SoftEvo/DataCollection/FFS_SoftEvo/go-ipfs/test/integration/addcat_test.go', 'top_nesting_level': 0, 'length': 7, 'fan_in': 0, 'fan_out': 0, 'general_fan_out': 0}, {'cyclomatic_complexity': 3, 'nloc': 10, 'token_count': 67, 'name': 'AddCatPowers', 'long_name': 'AddCatPowers conf testutil . LatencyConfig , megabytesMax int64', 'start_line': 75, 'end_line': 84, 'full_parameters': ['conf testutil . LatencyConfig', ' megabytesMax int64'], 'filename': '/home/dimi/Documents/Informatik_Studium/FSS/SoftEvo/DataCollection/FFS_SoftEvo/go-ipfs/test/integration/addcat_test.go', 'top_nesting_level': 0, 'length': 10, 'fan_in': 0, 'fan_out': 0, 'general_fan_out': 0}, {'cyclomatic_complexity': 2, 'nloc': 8, 'token_count': 45, 'name': 'RandomBytes', 'long_name': 'RandomBytes n int64', 'start_line': 86, 'end_line': 93, 'full_parameters': ['n int64'], 'filename': '/home/dimi/Documents/Informatik_Studium/FSS/SoftEvo/DataCollection/FFS_SoftEvo/go-ipfs/test/integration/addcat_test.go', 'top_nesting_level': 0, 'length': 8, 'fan_in': 0, 'fan_out': 0, 'general_fan_out': 0}, {'cyclomatic_complexity': 12, 'nloc': 62, 'token_count': 395, 'name': 'DirectAddCat', 'long_name': 'DirectAddCat data [ ] byte , conf testutil . LatencyConfig', 'start_line': 95, 'end_line': 171, 'full_parameters': ['data [ ] byte', ' conf testutil . LatencyConfig'], 'filename': '/home/dimi/Documents/Informatik_Studium/FSS/SoftEvo/DataCollection/FFS_SoftEvo/go-ipfs/test/integration/addcat_test.go', 'top_nesting_level': 0, 'length': 77, 'fan_in': 0, 'fan_out': 0, 'general_fan_out': 0}, {'cyclomatic_complexity': 2, 'nloc': 5, 'token_count': 27, 'name': 'SkipUnlessEpic', 'long_name': 'SkipUnlessEpic t * testing . T', 'start_line': 173, 'end_line': 177, 'full_parameters': ['t * testing . T'], 'filename': '/home/dimi/Documents/Informatik_Studium/FSS/SoftEvo/DataCollection/FFS_SoftEvo/go-ipfs/test/integration/addcat_test.go', 'top_nesting_level': 0, 'length': 5, 'fan_in': 0, 'fan_out': 0, 'general_fan_out': 0}]",15,65,0,51,51,"[{'timestamp': 1507212616.0, 'added_lines': 1, 'deleted_lines': 1, 'nloc': 133}, {'timestamp': 1507304579.0, 'added_lines': 2, 'deleted_lines': 2, 'nloc': 133}, {'timestamp': 1508424715.0, 'added_lines': 1, 'deleted_lines': 1, 'nloc': 133}, {'timestamp': 1491058697.0, 'added_lines': 2, 'deleted_lines': 1, 'nloc': 133}, {'timestamp': 1511223906.0, 'added_lines': 2, 'deleted_lines': 2, 'nloc': 133}, {'timestamp': 1512365669.0, 'added_lines': 3, 'deleted_lines': 3, 'nloc': 133}, {'timestamp': 1516838128.0, 'added_lines': 3, 'deleted_lines': 3, 'nloc': 133}, {'timestamp': 1517105039.0, 'added_lines': 1, 'deleted_lines': 1, 'nloc': 133}, {'timestamp': 1517453697.0, 'added_lines': 4, 'deleted_lines': 4, 'nloc': 133}, {'timestamp': 1525408792.0, 'added_lines': 4, 'deleted_lines': 4, 'nloc': 133}, {'timestamp': 1528131220.0, 'added_lines': 1, 'deleted_lines': 1, 'nloc': 133}, {'timestamp': 1528268108.0, 'added_lines': 2, 'deleted_lines': 2, 'nloc': 133}, {'timestamp': 1528520460.0, 'added_lines': 4, 'deleted_lines': 4, 'nloc': 133}, {'timestamp': 1529984485.0, 'added_lines': 4, 'deleted_lines': 4, 'nloc': 133}, {'timestamp': 1532146078.0, 'added_lines': 1, 'deleted_lines': 1, 'nloc': 133}, {'timestamp': 1533779477.0, 'added_lines': 4, 'deleted_lines': 4, 'nloc': 133}, {'timestamp': 1534896611.0, 'added_lines': 3, 'deleted_lines': 3, 'nloc': 133}, {'timestamp': 1535601896.0, 'added_lines': 1, 'deleted_lines': 1, 'nloc': 133}, {'timestamp': 1536388808.0, 'added_lines': 2, 'deleted_lines': 2, 'nloc': 133}, {'timestamp': 1536357700.0, 'added_lines': 1, 'deleted_lines': 2, 'nloc': 133}, {'timestamp': 1537792589.0, 'added_lines': 4, 'deleted_lines': 4, 'nloc': 133}, {'timestamp': 1537393245.0, 'added_lines': 10, 'deleted_lines': 1, 'nloc': 140}, {'timestamp': 1538544957.0, 'added_lines': 2, 'deleted_lines': 2, 'nloc': 140}, {'timestamp': 1538695953.0, 'added_lines': 1, 'deleted_lines': 1, 'nloc': 140}, {'timestamp': 1538773916.0, 'added_lines': 2, 'deleted_lines': 2, 'nloc': 140}, {'timestamp': 1539176817.0, 'added_lines': 2, 'deleted_lines': 2, 'nloc': 140}, {'timestamp': 1539357340.0, 'added_lines': 1, 'deleted_lines': 1, 'nloc': 140}, {'timestamp': 1539104245.0, 'added_lines': 1, 'deleted_lines': 1, 'nloc': 140}, {'timestamp': 1540400358.0, 'added_lines': 3, 'deleted_lines': 3, 'nloc': 140}, {'timestamp': 1540410565.0, 'added_lines': 1, 'deleted_lines': 1, 'nloc': 140}, {'timestamp': 1540418491.0, 'added_lines': 1, 'deleted_lines': 1, 'nloc': 140}, {'timestamp': 1541204121.0, 'added_lines': 4, 'deleted_lines': 4, 'nloc': 140}, {'timestamp': 1541903826.0, 'added_lines': 2, 'deleted_lines': 2, 'nloc': 140}, {'timestamp': 1544225843.0, 'added_lines': 3, 'deleted_lines': 3, 'nloc': 140}, {'timestamp': 1542594282.0, 'added_lines': 1, 'deleted_lines': 1, 'nloc': 140}, {'timestamp': 1544131548.0, 'added_lines': 4, 'deleted_lines': 1, 'nloc': 143}, {'timestamp': 1547003974.0, 'added_lines': 3, 'deleted_lines': 3, 'nloc': 143}, {'timestamp': 1548165641.0, 'added_lines': 8, 'deleted_lines': 9, 'nloc': 142}, {'timestamp': 1548866534.0, 'added_lines': 1, 'deleted_lines': 1, 'nloc': 142}, {'timestamp': 1549588289.0, 'added_lines': 3, 'deleted_lines': 3, 'nloc': 142}, {'timestamp': 1549903582.0, 'added_lines': 1, 'deleted_lines': 1, 'nloc': 142}, {'timestamp': 1550185115.0, 'added_lines': 1, 'deleted_lines': 1, 'nloc': 142}, {'timestamp': 1550507829.0, 'added_lines': 4, 'deleted_lines': 4, 'nloc': 142}, {'timestamp': 1550610741.0, 'added_lines': 1, 'deleted_lines': 1, 'nloc': 142}, {'timestamp': 1550723346.0, 'added_lines': 1, 'deleted_lines': 1, 'nloc': 142}, {'timestamp': 1551229859.0, 'added_lines': 3, 'deleted_lines': 3, 'nloc': 142}, {'timestamp': 1551299964.0, 'added_lines': 1, 'deleted_lines': 1, 'nloc': 142}, {'timestamp': 1551551196.0, 'added_lines': 6, 'deleted_lines': 6, 'nloc': 142}, {'timestamp': 1553697989.0, 'added_lines': 11, 'deleted_lines': 6, 'nloc': 147}, {'timestamp': 1554255872.0, 'added_lines': 3, 'deleted_lines': 2, 'nloc': 148}, {'timestamp': 1559060517.0, 'added_lines': 5, 'deleted_lines': 6, 'nloc': 148}]","{'core/bootstrap_test.go': 27, 'core/commands/dht_test.go': 26, 'core/mock/mock.go': 40, 'exchange/bitswap/bitswap_test.go': 15, 'exchange/bitswap/decision/bench_test.go': 9, 'exchange/bitswap/decision/engine_test.go': 11, 'exchange/bitswap/decision/peer_request_queue_test.go': 9, 'exchange/bitswap/testnet/interface.go': 9, 'exchange/bitswap/testnet/network_test.go': 12, 'exchange/bitswap/testnet/peernet.go': 15, 'exchange/bitswap/testnet/virtual.go': 11, 'exchange/bitswap/testutils.go': 14, 'exchange/reprovide/reprovide_test.go': 32, 'fuse/ipns/ipns_test.go': 30, 'fuse/node/mount_test.go': 30, 'fuse/readonly/ipfs_test.go': 41, 'mfs/repub_test.go': 11, 'namesys/publisher_test.go': 30, 'namesys/resolve_test.go': 36, 'package.json': 42, 'routing/mock/centralized_client.go': 6, 'routing/mock/centralized_server.go': 6, 'routing/mock/centralized_test.go': 6, 'routing/mock/interface.go': 6, 'routing/offline/offline_test.go': 7, 'test/integration/bench_cat_test.go': 49, 'test/integration/bench_test.go': 21, 'test/integration/grandcentral_test.go': 1, 'test/integration/three_legged_cat_test.go': 49, 'core/bootstrap.go': 29, 'core/commands/dht.go': 41, 'core/commands/id.go': 42, 'core/commands/pubsub.go': 31, 'core/core.go': 42, 'core/corehttp/gateway.go': 40, 'core/corehttp/gateway_test.go': 42, 'core/corehttp/metrics_test.go': 38, 'exchange/bitswap/network/ipfs_impl.go': 10, 'namesys/republisher/repub_test.go': 41, 'p2p/p2p.go': 28, 'routing/none/none_client.go': 5, 'test/integration/bitswap_wo_routing_test.go': 40, 'thirdparty/ipfsaddr/ipfsaddr.go': 2, 'core/commands/swarm.go': 39, 'blocks/blockstore/caching.go': 1, 'blocks/blockstore/util/remove.go': 3, 'cmd/ipfs/daemon.go': 26, 'cmd/ipfs/init.go': 25, 'cmd/ipfs/ipfs.go': 19, 'cmd/ipfs/main.go': 29, 'cmd/ipfs/main_test.go': 3, 'cmd/ipfswatch/main.go': 22, 'cmd/seccat/seccat.go': 29, None: 42, 'commands/channelmarshaler.go': 1, 'commands/cli/cmd_suggestion.go': 1, 'commands/cli/helptext.go': 2, 'commands/cli/helptext_test.go': 2, 'commands/cli/parse.go': 2, 'commands/cli/parse_test.go': 2, 'commands/command.go': 13, 'commands/command_test.go': 6, 'commands/http/client.go': 2, 'commands/http/handler.go': 2, 'commands/http/multifilereader.go': 2, 'commands/http/multifilereader_test.go': 2, 'commands/http/parse.go': 2, 'commands/reqlog.go': 2, 'commands/request.go': 17, 'commands/response.go': 8, 'commands/response_test.go': 6, 'core/commands/active.go': 11, 'core/commands/add.go': 29, 'core/commands/bitswap.go': 37, 'core/commands/block.go': 23, 'core/commands/bootstrap.go': 21, 'core/commands/cat.go': 25, 'core/commands/commands.go': 20, 'core/commands/config.go': 23, 'core/commands/dag/dag.go': 34, 'core/commands/diag.go': 11, 'core/commands/dns.go': 16, 'core/commands/e/error.go': 1, 'core/commands/external.go': 11, 'core/commands/files/files.go': 5, 'core/commands/filestore.go': 20, 'core/commands/get.go': 36, 'core/commands/helptext_test.go': 19, 'core/commands/ipns.go': 10, 'core/commands/keystore.go': 21, 'core/commands/log.go': 17, 'core/commands/ls.go': 35, 'core/commands/mount_nofuse.go': 11, 'core/commands/mount_unix.go': 21, 'core/commands/mount_windows.go': 10, 'core/commands/name.go': 5, 'core/commands/object/diff.go': 15, 'core/commands/object/object.go': 35, 'core/commands/object/patch.go': 21, 'core/commands/p2p.go': 26, 'core/commands/pin.go': 36, 'core/commands/ping.go': 32, 'core/commands/publish.go': 10, 'core/commands/refs.go': 32, 'core/commands/repo.go': 32, 'core/commands/resolve.go': 31, 'core/commands/root.go': 19, 'core/commands/shutdown.go': 14, 'core/commands/stat.go': 25, 'core/commands/sysdiag.go': 18, 'core/commands/tar.go': 32, 'core/commands/unixfs/ls.go': 32, 'core/commands/unixfs/unixfs.go': 11, 'core/commands/version.go': 12, 'core/core_test.go': 17, 'core/corehttp/commands.go': 36, 'core/coreunix/add.go': 37, 'core/coreunix/add_test.go': 37, 'core/coreunix/metadata_test.go': 34, 'exchange/bitswap/message/message_test.go': 4, 'exchange/bitswap/message/pb/Makefile': 1, 'fuse/ipns/common.go': 29, 'importer/balanced/balanced_test.go': 6, 'importer/chunk/rabin_test.go': 3, 'importer/helpers/dagbuilder.go': 7, 'importer/importer.go': 7, 'merkledag/utils/utils_test.go': 4, 'namesys/dns.go': 26, 'namesys/interface.go': 28, 'namesys/ipns_select_test.go': 5, 'namesys/proquint.go': 26, 'repo/config/identity.go': 3, 'core/commands/get_test.go': 18, 'exchange/bitswap/message/message.go': 8, 'exchange/bitswap/network/interface.go': 8, 'p2p/registry.go': 12, 'repo/config/bootstrap_peers.go': 12, 'assets/assets.go': 29, 'blocks/blockstore/arc_cache.go': 2, 'blocks/blockstore/arc_cache_test.go': 2, 'blocks/blockstore/blockstore.go': 3, 'blocks/blockstore/blockstore_test.go': 2, 'blocks/blockstore/bloom_cache.go': 2, 'blocks/blockstore/bloom_cache_test.go': 2, 'blocks/blocksutil/block_generator.go': 2, 'blockservice/blockservice.go': 7, 'blockservice/blockservice_test.go': 6, 'blockservice/test/blocks_test.go': 6, 'core/builder.go': 36, 'core/commands/ipnsps.go': 5, 'core/coreapi/coreapi.go': 21, 'core/coreapi/interface/interface.go': 2, 'core/coreapi/unixfs.go': 31, 'core/coreapi/unixfs_test.go': 25, 'core/coredag/cbor.go': 9, 'core/coredag/dagpb.go': 27, 'core/coredag/dagtransl.go': 7, 'core/coredag/raw.go': 27, 'core/corehttp/corehttp.go': 15, 'core/corehttp/gateway_handler.go': 37, 'core/corerepo/gc.go': 34, 'core/corerepo/pinning.go': 10, 'core/coreunix/metadata.go': 29, 'core/pathresolver.go': 31, 'exchange/bitswap/bitswap.go': 7, 'exchange/bitswap/decision/engine.go': 7, 'exchange/bitswap/decision/ledger.go': 6, 'exchange/bitswap/decision/peer_request_queue.go': 6, 'exchange/bitswap/get.go': 6, 'exchange/bitswap/notifications/notifications.go': 3, 'exchange/bitswap/notifications/notifications_test.go': 3, 'exchange/bitswap/session.go': 7, 'exchange/bitswap/session_test.go': 5, 'exchange/bitswap/stat.go': 3, 'exchange/bitswap/wantlist/wantlist.go': 3, 'exchange/bitswap/wantlist/wantlist_test.go': 3, 'exchange/bitswap/wantmanager.go': 7, 'exchange/bitswap/workers.go': 6, 'exchange/interface.go': 2, 'exchange/offline/offline.go': 2, 'exchange/offline/offline_test.go': 2, 'exchange/reprovide/providers.go': 30, 'exchange/reprovide/reprovide.go': 24, 'filestore/filestore.go': 18, 'filestore/filestore_test.go': 30, 'filestore/fsrefstore.go': 17, 'filestore/util.go': 17, 'fuse/ipns/ipns_unix.go': 33, 'fuse/readonly/readonly_unix.go': 33, 'importer/balanced/builder.go': 3, 'importer/chunk/splitting_test.go': 2, 'importer/helpers/helpers.go': 3, 'importer/importer_test.go': 5, 'importer/trickle/trickle_test.go': 5, 'importer/trickle/trickledag.go': 3, 'merkledag/batch.go': 2, 'merkledag/coding.go': 3, 'merkledag/merkledag.go': 3, 'merkledag/merkledag_test.go': 6, 'merkledag/node.go': 3, 'merkledag/node_test.go': 3, 'merkledag/raw.go': 3, 'merkledag/traverse/traverse.go': 3, 'merkledag/traverse/traverse_test.go': 3, 'merkledag/utils/diff.go': 3, 'merkledag/utils/diffenum.go': 3, 'merkledag/utils/diffenum_test.go': 3, 'merkledag/utils/utils.go': 6, 'mfs/dir.go': 4, 'mfs/file.go': 6, 'mfs/mfs_test.go': 7, 'mfs/ops.go': 4, 'mfs/system.go': 7, 'namesys/namesys.go': 35, 'namesys/publisher.go': 34, 'namesys/pubsub.go': 5, 'namesys/pubsub_test.go': 5, 'namesys/republisher/repub.go': 31, 'namesys/routing.go': 36, 'path/path.go': 3, 'path/resolver.go': 3, 'path/resolver_test.go': 2, 'pin/gc/gc.go': 31, 'pin/pin.go': 30, 'pin/pin_test.go': 31, 'pin/set.go': 27, 'pin/set_test.go': 30, 'plugin/ipld.go': 7, 'plugin/loader/initializer.go': 5, 'plugin/plugins/git/git.go': 7, 'repo/config/init.go': 7, 'repo/fsrepo/fsrepo.go': 24, 'repo/fsrepo/lock/lock.go': 3, 'repo/fsrepo/serialize/serialize.go': 3, 'repo/mock.go': 17, 'repo/repo.go': 20, 'routing/offline/offline.go': 3, 'tar/format.go': 32, 'test/dependencies/ma-pipe-unidir/main.go': 11, 'thirdparty/ds-help/key.go': 2, 'thirdparty/pollEndpoint/main.go': 15, 'thirdparty/posinfo/posinfo.go': 2, 'unixfs/archive/archive.go': 3, 'unixfs/archive/tar/writer.go': 3, 'unixfs/hamt/hamt.go': 3, 'unixfs/io/dagreader.go': 3, 'unixfs/io/dirbuilder.go': 3, 'unixfs/io/resolve.go': 3, 'unixfs/mod/dagmodifier.go': 5, 'unixfs/mod/dagmodifier_test.go': 3, 'unixfs/test/utils.go': 5, 'commands/legacy/command.go': 10, 'commands/legacy/legacy.go': 10, 'commands/legacy/legacy_test.go': 10, 'commands/legacy/request.go': 10, 'commands/legacy/response.go': 10, 'core/commands/commands_test.go': 16, 'core/coreapi/dag.go': 6, 'core/coreapi/dag_test.go': 3, 'core/coreapi/interface/options/dag.go': 4, 'core/coreapi/key.go': 31, 'core/coreapi/name.go': 34, 'merkledag/test/utils.go': 5, 'namesys/namesys_test.go': 34, 'repo/fsrepo/datastores.go': 15, 'repo/fsrepo/fsrepo_test.go': 17, 'thirdparty/datastore2/datastore_closer.go': 1, 'thirdparty/datastore2/delayed.go': 1, 'thirdparty/datastore2/threadsafe.go': 1, 'unixfs/io/pbdagreader.go': 2, 'cmd/ipfs/util/ulimit.go': 9, 'cmd/seccat/util.go': 9, 'core/corehttp/logs.go': 9, 'fuse/mount/mount.go': 9, 'fuse/node/mount_unix.go': 10, 'importer/chunk/splitting.go': 1, 'namesys/ipns_validate_test.go': 5, 'plugin/loader/load.go': 7, 'blocks/blockstoreutil/remove.go': 15, 'blockservice/test/mock.go': 5, 'core/commands/files.go': 34, 'core/coreapi/pin.go': 30, 'keystore/keystore.go': 9, 'keystore/keystore_test.go': 7, 'keystore/memkeystore.go': 6, 'namesys/validator.go': 3, 'path/resolver/resolver.go': 3, 'thirdparty/verifbs/verifbs.go': 15, 'cmd/ipfs/util/ulimit_freebsd.go': 2, 'cmd/ipfs/util/ulimit_unix.go': 2, 'core/coreapi/block.go': 10, 'core/coreapi/block_test.go': 2, 'core/coreapi/interface/coreapi.go': 3, 'core/coreapi/interface/dag.go': 3, 'core/coreapi/interface/object.go': 3, 'core/coreapi/interface/options/block.go': 2, 'core/coreapi/interface/path.go': 19, 'core/coreapi/interface/unixfs.go': 7, 'core/coreapi/object.go': 27, 'fuse/ipns/link_unix.go': 2, 'fuse/mount/fuse.go': 3, 'fuse/node/mount_darwin.go': 2, 'merkledag/errservice.go': 1, 'merkledag/readonly.go': 1, 'merkledag/readonly_test.go': 1, 'merkledag/rwservice.go': 1, 'merkledag/session.go': 1, 'path/resolver/resolver_test.go': 1, 'thirdparty/verifcid/validate.go': 1, 'thirdparty/verifcid/validate_test.go': 1, 'unixfs/hamt/hamt_stress_test.go': 1, 'unixfs/hamt/hamt_test.go': 1, 'namesys/ipns_resolver_validation_test.go': 27, 'test/sharness/t0170-dht.sh': 1, 'core/corehttp/metrics.go': 2, 'core/commands/env.go': 2, 'core/commands/urlstore.go': 27, 'core/coreapi/interface/key.go': 7, 'core/coreapi/name_test.go': 16, 'core/coreapi/path.go': 26, 'core/coreunix/cat.go': 5, 'core/pathresolver_test.go': 24, 'dagutils/diff.go': 26, 'dagutils/diffenum.go': 24, 'dagutils/diffenum_test.go': 24, 'dagutils/utils.go': 25, 'dagutils/utils_test.go': 24, 'filestore/pb/dataobj.pb.go': 3, 'mfs/fd.go': 1, 'namesys/base.go': 25, 'namesys/cache.go': 24, 'pin/internal/pb/header.pb.go': 3, 'thirdparty/cidv0v1/blockstore.go': 11, 'repo/fsrepo/config_test.go': 13, 'repo/fsrepo/misc.go': 14, 'test/bench/bench_cli_ipfs_add/main.go': 16, 'test/bench/offline_add/main.go': 16, 'core/commands/cmdenv/env.go': 18, 'core/commands/name/ipns.go': 25, 'core/commands/name/publish.go': 14, 'cmd/ipfs/Rules.mk': 1, 'coverage/Rules.mk': 1, 'mk/golang.mk': 1, 'pin/internal/pb/doc.go': 1, 'test/3nodetest/Makefile': 1, 'test/bin/Rules.mk': 1, 'test/bin/verify-go-fmt.sh': 1, 'core/commands/name/ipnsps.go': 13, 'core/commands/name/name.go': 8, 'core/coreapi/dht.go': 23, 'core/coreapi/dht_test.go': 4, 'core/coreapi/interface/dht.go': 10, 'p2p/listener.go': 14, 'p2p/local.go': 14, 'p2p/remote.go': 15, 'p2p/stream.go': 15, 'core/coreapi/interface/util.go': 1, 'core/coreapi/interface/swarm.go': 9, 'core/coreapi/swarm.go': 21, 'core/coreapi/interface/options/unixfs.go': 11, 'core/coreapi/pubsub.go': 20, 'core/coreapi/unixfile.go': 11, 'cmd/ipfs/dnsresolve_test.go': 5, 'core/coreapi/interface/pubsub.go': 4, 'core/commands/cid.go': 9, 'test/dependencies/iptb/iptb.go': 11, 'plugin/plugins/badgerds/badgerds.go': 4, 'plugin/plugins/flatfs/flatfs.go': 3, 'plugin/plugins/levelds/levelds.go': 3, 'commands/context.go': 13, 'core/corehttp/proxy.go': 10, 'core/coreapi/interface/tests/name.go': 3, 'core/coreapi/interface/tests/unixfs.go': 3, 'core/coreapi/test/api_test.go': 11, 'core/commands/cmdenv/cidbase.go': 7, 'core/commands/cmdenv/file.go': 3, 'core/corehttp/ipns_hostname.go': 7, 'namesys/dns_test.go': 7, 'plugin/daemon.go': 7, 'plugin/loader/loader.go': 8, 'core/corerepo/stat.go': 2, 'core/commands/cmdenv/cidbase_test.go': 2, 'core/corehttp/proxy_test.go': 2, 'plugin/tracer.go': 1, 'thirdparty/notifier/notifier.go': 1, 'core/corehttp/mutex_profile.go': 1, 'core/corehttp/option_test.go': 1, 'provider/queue.go': 1, 'provider/queue_test.go': 1, 'core/bootstrap/bootstrap.go': 2, 'core/bootstrap/bootstrap_test.go': 2, 'core/ncore.go': 1, 'core/node/builder.go': 2, 'core/node/core.go': 2, 'core/node/discovery.go': 1, 'core/node/groups.go': 2, 'core/node/helpers.go': 1, 'core/node/identity.go': 2, 'core/node/ipns.go': 2, 'core/node/libp2p.go': 1, 'core/node/provider.go': 2, 'core/node/storage.go': 1, 'core/node/libp2p/addrs.go': 1, 'core/node/libp2p/discovery.go': 1, 'core/node/libp2p/host.go': 1, 'core/node/libp2p/hostopt.go': 1, 'core/node/libp2p/libp2p.go': 1, 'core/node/libp2p/nat.go': 1, 'core/node/libp2p/pnet.go': 1, 'core/node/libp2p/pubsub.go': 1, 'core/node/libp2p/routing.go': 1, 'core/node/libp2p/routingopt.go': 1, 'core/node/libp2p/smux.go': 1, 'core/node/libp2p/transport.go': 1, 'go.mod': 1, 'go.sum': 1, 'provider/simple/provider.go': 1, 'provider/simple/provider_test.go': 1, 'provider/simple/reprovide.go': 1, 'provider/simple/reprovide_test.go': 1}","('test/integration/bench_cat_test.go', 0.9607843137254902, 1.0)"
test/integration/bench_cat_test.go,82,504,5,"[{'cyclomatic_complexity': 1, 'nloc': 1, 'token_count': 21, 'name': 'BenchmarkCat1MB', 'long_name': 'BenchmarkCat1MB b * testing . B', 'start_line': 20, 'end_line': 20, 'full_parameters': ['b * testing . B'], 'filename': '/home/dimi/Documents/Informatik_Studium/FSS/SoftEvo/DataCollection/FFS_SoftEvo/go-ipfs/test/integration/bench_cat_test.go', 'top_nesting_level': 0, 'length': 1, 'fan_in': 0, 'fan_out': 0, 'general_fan_out': 0}, {'cyclomatic_complexity': 1, 'nloc': 1, 'token_count': 21, 'name': 'BenchmarkCat2MB', 'long_name': 'BenchmarkCat2MB b * testing . B', 'start_line': 21, 'end_line': 21, 'full_parameters': ['b * testing . B'], 'filename': '/home/dimi/Documents/Informatik_Studium/FSS/SoftEvo/DataCollection/FFS_SoftEvo/go-ipfs/test/integration/bench_cat_test.go', 'top_nesting_level': 0, 'length': 1, 'fan_in': 0, 'fan_out': 0, 'general_fan_out': 0}, {'cyclomatic_complexity': 1, 'nloc': 1, 'token_count': 21, 'name': 'BenchmarkCat4MB', 'long_name': 'BenchmarkCat4MB b * testing . B', 'start_line': 22, 'end_line': 22, 'full_parameters': ['b * testing . B'], 'filename': '/home/dimi/Documents/Informatik_Studium/FSS/SoftEvo/DataCollection/FFS_SoftEvo/go-ipfs/test/integration/bench_cat_test.go', 'top_nesting_level': 0, 'length': 1, 'fan_in': 0, 'fan_out': 0, 'general_fan_out': 0}, {'cyclomatic_complexity': 3, 'nloc': 10, 'token_count': 63, 'name': 'benchmarkVarCat', 'long_name': 'benchmarkVarCat b * testing . B , size int64', 'start_line': 24, 'end_line': 33, 'full_parameters': ['b * testing . B', ' size int64'], 'filename': '/home/dimi/Documents/Informatik_Studium/FSS/SoftEvo/DataCollection/FFS_SoftEvo/go-ipfs/test/integration/bench_cat_test.go', 'top_nesting_level': 0, 'length': 10, 'fan_in': 0, 'fan_out': 0, 'general_fan_out': 0}, {'cyclomatic_complexity': 9, 'nloc': 53, 'token_count': 354, 'name': 'benchCat', 'long_name': 'benchCat b * testing . B , data [ ] byte , conf testutil . LatencyConfig', 'start_line': 35, 'end_line': 99, 'full_parameters': ['b * testing . B', ' data [ ] byte', ' conf testutil . LatencyConfig'], 'filename': '/home/dimi/Documents/Informatik_Studium/FSS/SoftEvo/DataCollection/FFS_SoftEvo/go-ipfs/test/integration/bench_cat_test.go', 'top_nesting_level': 0, 'length': 65, 'fan_in': 0, 'fan_out': 0, 'general_fan_out': 0}]",95,562,5,"[{'cyclomatic_complexity': 1, 'nloc': 1, 'token_count': 21, 'name': 'BenchmarkCat1MB', 'long_name': 'BenchmarkCat1MB b * testing . B', 'start_line': 22, 'end_line': 22, 'full_parameters': ['b * testing . B'], 'filename': '/home/dimi/Documents/Informatik_Studium/FSS/SoftEvo/DataCollection/FFS_SoftEvo/go-ipfs/test/integration/bench_cat_test.go', 'top_nesting_level': 0, 'length': 1, 'fan_in': 0, 'fan_out': 0, 'general_fan_out': 0}, {'cyclomatic_complexity': 1, 'nloc': 1, 'token_count': 21, 'name': 'BenchmarkCat2MB', 'long_name': 'BenchmarkCat2MB b * testing . B', 'start_line': 23, 'end_line': 23, 'full_parameters': ['b * testing . B'], 'filename': '/home/dimi/Documents/Informatik_Studium/FSS/SoftEvo/DataCollection/FFS_SoftEvo/go-ipfs/test/integration/bench_cat_test.go', 'top_nesting_level': 0, 'length': 1, 'fan_in': 0, 'fan_out': 0, 'general_fan_out': 0}, {'cyclomatic_complexity': 1, 'nloc': 1, 'token_count': 21, 'name': 'BenchmarkCat4MB', 'long_name': 'BenchmarkCat4MB b * testing . B', 'start_line': 24, 'end_line': 24, 'full_parameters': ['b * testing . B'], 'filename': '/home/dimi/Documents/Informatik_Studium/FSS/SoftEvo/DataCollection/FFS_SoftEvo/go-ipfs/test/integration/bench_cat_test.go', 'top_nesting_level': 0, 'length': 1, 'fan_in': 0, 'fan_out': 0, 'general_fan_out': 0}, {'cyclomatic_complexity': 3, 'nloc': 10, 'token_count': 63, 'name': 'benchmarkVarCat', 'long_name': 'benchmarkVarCat b * testing . B , size int64', 'start_line': 26, 'end_line': 35, 'full_parameters': ['b * testing . B', ' size int64'], 'filename': '/home/dimi/Documents/Informatik_Studium/FSS/SoftEvo/DataCollection/FFS_SoftEvo/go-ipfs/test/integration/bench_cat_test.go', 'top_nesting_level': 0, 'length': 10, 'fan_in': 0, 'fan_out': 0, 'general_fan_out': 0}, {'cyclomatic_complexity': 12, 'nloc': 64, 'token_count': 411, 'name': 'benchCat', 'long_name': 'benchCat b * testing . B , data [ ] byte , conf testutil . LatencyConfig', 'start_line': 37, 'end_line': 114, 'full_parameters': ['b * testing . B', ' data [ ] byte', ' conf testutil . LatencyConfig'], 'filename': '/home/dimi/Documents/Informatik_Studium/FSS/SoftEvo/DataCollection/FFS_SoftEvo/go-ipfs/test/integration/bench_cat_test.go', 'top_nesting_level': 0, 'length': 78, 'fan_in': 0, 'fan_out': 0, 'general_fan_out': 0}]",13,58,0,49,49,"[{'timestamp': 1507212616.0, 'added_lines': 1, 'deleted_lines': 1, 'nloc': 82}, {'timestamp': 1507304579.0, 'added_lines': 2, 'deleted_lines': 2, 'nloc': 82}, {'timestamp': 1508424715.0, 'added_lines': 1, 'deleted_lines': 1, 'nloc': 82}, {'timestamp': 1491058697.0, 'added_lines': 2, 'deleted_lines': 1, 'nloc': 82}, {'timestamp': 1511223906.0, 'added_lines': 2, 'deleted_lines': 2, 'nloc': 82}, {'timestamp': 1512365669.0, 'added_lines': 3, 'deleted_lines': 3, 'nloc': 82}, {'timestamp': 1516838128.0, 'added_lines': 3, 'deleted_lines': 3, 'nloc': 82}, {'timestamp': 1517105039.0, 'added_lines': 1, 'deleted_lines': 1, 'nloc': 82}, {'timestamp': 1517453697.0, 'added_lines': 3, 'deleted_lines': 3, 'nloc': 82}, {'timestamp': 1525408792.0, 'added_lines': 3, 'deleted_lines': 3, 'nloc': 82}, {'timestamp': 1528131220.0, 'added_lines': 1, 'deleted_lines': 1, 'nloc': 82}, {'timestamp': 1528268108.0, 'added_lines': 2, 'deleted_lines': 2, 'nloc': 82}, {'timestamp': 1528520460.0, 'added_lines': 3, 'deleted_lines': 3, 'nloc': 82}, {'timestamp': 1529984485.0, 'added_lines': 3, 'deleted_lines': 3, 'nloc': 82}, {'timestamp': 1532146078.0, 'added_lines': 1, 'deleted_lines': 1, 'nloc': 82}, {'timestamp': 1533779477.0, 'added_lines': 3, 'deleted_lines': 3, 'nloc': 82}, {'timestamp': 1534896611.0, 'added_lines': 3, 'deleted_lines': 3, 'nloc': 82}, {'timestamp': 1535601896.0, 'added_lines': 1, 'deleted_lines': 1, 'nloc': 82}, {'timestamp': 1536388808.0, 'added_lines': 2, 'deleted_lines': 2, 'nloc': 82}, {'timestamp': 1537792589.0, 'added_lines': 3, 'deleted_lines': 3, 'nloc': 82}, {'timestamp': 1537393245.0, 'added_lines': 10, 'deleted_lines': 1, 'nloc': 89}, {'timestamp': 1538544957.0, 'added_lines': 2, 'deleted_lines': 2, 'nloc': 89}, {'timestamp': 1538695953.0, 'added_lines': 1, 'deleted_lines': 1, 'nloc': 89}, {'timestamp': 1538773916.0, 'added_lines': 2, 'deleted_lines': 2, 'nloc': 89}, {'timestamp': 1539176817.0, 'added_lines': 2, 'deleted_lines': 2, 'nloc': 89}, {'timestamp': 1539357340.0, 'added_lines': 1, 'deleted_lines': 1, 'nloc': 89}, {'timestamp': 1539104245.0, 'added_lines': 1, 'deleted_lines': 1, 'nloc': 89}, {'timestamp': 1540400358.0, 'added_lines': 3, 'deleted_lines': 3, 'nloc': 89}, {'timestamp': 1540410565.0, 'added_lines': 1, 'deleted_lines': 1, 'nloc': 89}, {'timestamp': 1540418491.0, 'added_lines': 1, 'deleted_lines': 1, 'nloc': 89}, {'timestamp': 1541204121.0, 'added_lines': 3, 'deleted_lines': 3, 'nloc': 89}, {'timestamp': 1541903826.0, 'added_lines': 2, 'deleted_lines': 2, 'nloc': 89}, {'timestamp': 1544225843.0, 'added_lines': 3, 'deleted_lines': 3, 'nloc': 89}, {'timestamp': 1542594282.0, 'added_lines': 1, 'deleted_lines': 1, 'nloc': 89}, {'timestamp': 1544131548.0, 'added_lines': 4, 'deleted_lines': 1, 'nloc': 92}, {'timestamp': 1547003974.0, 'added_lines': 3, 'deleted_lines': 3, 'nloc': 92}, {'timestamp': 1548165641.0, 'added_lines': 8, 'deleted_lines': 9, 'nloc': 91}, {'timestamp': 1548866534.0, 'added_lines': 1, 'deleted_lines': 1, 'nloc': 91}, {'timestamp': 1549588289.0, 'added_lines': 3, 'deleted_lines': 3, 'nloc': 91}, {'timestamp': 1549903582.0, 'added_lines': 1, 'deleted_lines': 1, 'nloc': 91}, {'timestamp': 1550185115.0, 'added_lines': 1, 'deleted_lines': 1, 'nloc': 91}, {'timestamp': 1550507829.0, 'added_lines': 3, 'deleted_lines': 3, 'nloc': 91}, {'timestamp': 1550723346.0, 'added_lines': 1, 'deleted_lines': 1, 'nloc': 91}, {'timestamp': 1551229859.0, 'added_lines': 3, 'deleted_lines': 3, 'nloc': 91}, {'timestamp': 1551299964.0, 'added_lines': 1, 'deleted_lines': 1, 'nloc': 91}, {'timestamp': 1551551196.0, 'added_lines': 4, 'deleted_lines': 4, 'nloc': 91}, {'timestamp': 1553697989.0, 'added_lines': 6, 'deleted_lines': 3, 'nloc': 94}, {'timestamp': 1554255872.0, 'added_lines': 3, 'deleted_lines': 2, 'nloc': 95}, {'timestamp': 1559060517.0, 'added_lines': 5, 'deleted_lines': 6, 'nloc': 95}]","{'core/bootstrap_test.go': 27, 'core/commands/dht_test.go': 26, 'core/mock/mock.go': 40, 'exchange/bitswap/bitswap_test.go': 15, 'exchange/bitswap/decision/bench_test.go': 9, 'exchange/bitswap/decision/engine_test.go': 11, 'exchange/bitswap/decision/peer_request_queue_test.go': 9, 'exchange/bitswap/testnet/interface.go': 9, 'exchange/bitswap/testnet/network_test.go': 12, 'exchange/bitswap/testnet/peernet.go': 15, 'exchange/bitswap/testnet/virtual.go': 11, 'exchange/bitswap/testutils.go': 14, 'exchange/reprovide/reprovide_test.go': 32, 'fuse/ipns/ipns_test.go': 30, 'fuse/node/mount_test.go': 30, 'fuse/readonly/ipfs_test.go': 41, 'mfs/repub_test.go': 11, 'namesys/publisher_test.go': 30, 'namesys/resolve_test.go': 36, 'package.json': 40, 'routing/mock/centralized_client.go': 6, 'routing/mock/centralized_server.go': 6, 'routing/mock/centralized_test.go': 6, 'routing/mock/interface.go': 6, 'routing/offline/offline_test.go': 7, 'test/integration/addcat_test.go': 49, 'test/integration/bench_test.go': 21, 'test/integration/grandcentral_test.go': 1, 'test/integration/three_legged_cat_test.go': 49, 'core/bootstrap.go': 29, 'core/commands/dht.go': 40, 'core/commands/id.go': 41, 'core/commands/pubsub.go': 30, 'core/core.go': 42, 'core/corehttp/gateway.go': 40, 'core/corehttp/gateway_test.go': 42, 'core/corehttp/metrics_test.go': 38, 'exchange/bitswap/network/ipfs_impl.go': 10, 'namesys/republisher/repub_test.go': 41, 'p2p/p2p.go': 28, 'routing/none/none_client.go': 5, 'test/integration/bitswap_wo_routing_test.go': 40, 'thirdparty/ipfsaddr/ipfsaddr.go': 2, 'core/commands/swarm.go': 38, 'blocks/blockstore/caching.go': 1, 'blocks/blockstore/util/remove.go': 3, 'cmd/ipfs/daemon.go': 25, 'cmd/ipfs/init.go': 24, 'cmd/ipfs/ipfs.go': 18, 'cmd/ipfs/main.go': 28, 'cmd/ipfs/main_test.go': 3, 'cmd/ipfswatch/main.go': 21, 'cmd/seccat/seccat.go': 29, None: 13, 'commands/channelmarshaler.go': 1, 'commands/cli/cmd_suggestion.go': 1, 'commands/cli/helptext.go': 2, 'commands/cli/helptext_test.go': 2, 'commands/cli/parse.go': 2, 'commands/cli/parse_test.go': 2, 'commands/command.go': 13, 'commands/command_test.go': 6, 'commands/http/client.go': 2, 'commands/http/handler.go': 2, 'commands/http/multifilereader.go': 2, 'commands/http/multifilereader_test.go': 2, 'commands/http/parse.go': 2, 'commands/reqlog.go': 2, 'commands/request.go': 17, 'commands/response.go': 8, 'commands/response_test.go': 6, 'core/commands/active.go': 10, 'core/commands/add.go': 28, 'core/commands/bitswap.go': 36, 'core/commands/block.go': 22, 'core/commands/bootstrap.go': 20, 'core/commands/cat.go': 24, 'core/commands/commands.go': 19, 'core/commands/config.go': 22, 'core/commands/dag/dag.go': 33, 'core/commands/diag.go': 10, 'core/commands/dns.go': 15, 'core/commands/e/error.go': 1, 'core/commands/external.go': 10, 'core/commands/files/files.go': 5, 'core/commands/filestore.go': 19, 'core/commands/get.go': 35, 'core/commands/helptext_test.go': 18, 'core/commands/ipns.go': 10, 'core/commands/keystore.go': 20, 'core/commands/log.go': 16, 'core/commands/ls.go': 34, 'core/commands/mount_nofuse.go': 10, 'core/commands/mount_unix.go': 20, 'core/commands/mount_windows.go': 9, 'core/commands/name.go': 5, 'core/commands/object/diff.go': 14, 'core/commands/object/object.go': 34, 'core/commands/object/patch.go': 20, 'core/commands/p2p.go': 25, 'core/commands/pin.go': 35, 'core/commands/ping.go': 31, 'core/commands/publish.go': 10, 'core/commands/refs.go': 31, 'core/commands/repo.go': 31, 'core/commands/resolve.go': 30, 'core/commands/root.go': 18, 'core/commands/shutdown.go': 13, 'core/commands/stat.go': 24, 'core/commands/sysdiag.go': 17, 'core/commands/tar.go': 31, 'core/commands/unixfs/ls.go': 31, 'core/commands/unixfs/unixfs.go': 10, 'core/commands/version.go': 11, 'core/core_test.go': 17, 'core/corehttp/commands.go': 35, 'core/coreunix/add.go': 37, 'core/coreunix/add_test.go': 37, 'core/coreunix/metadata_test.go': 34, 'exchange/bitswap/message/message_test.go': 4, 'exchange/bitswap/message/pb/Makefile': 1, 'fuse/ipns/common.go': 29, 'importer/balanced/balanced_test.go': 6, 'importer/chunk/rabin_test.go': 3, 'importer/helpers/dagbuilder.go': 7, 'importer/importer.go': 7, 'merkledag/utils/utils_test.go': 4, 'namesys/dns.go': 26, 'namesys/interface.go': 28, 'namesys/ipns_select_test.go': 5, 'namesys/proquint.go': 26, 'repo/config/identity.go': 3, 'core/commands/get_test.go': 17, 'exchange/bitswap/message/message.go': 8, 'exchange/bitswap/network/interface.go': 8, 'p2p/registry.go': 12, 'repo/config/bootstrap_peers.go': 12, 'assets/assets.go': 29, 'blocks/blockstore/arc_cache.go': 2, 'blocks/blockstore/arc_cache_test.go': 2, 'blocks/blockstore/blockstore.go': 3, 'blocks/blockstore/blockstore_test.go': 2, 'blocks/blockstore/bloom_cache.go': 2, 'blocks/blockstore/bloom_cache_test.go': 2, 'blocks/blocksutil/block_generator.go': 2, 'blockservice/blockservice.go': 7, 'blockservice/blockservice_test.go': 6, 'blockservice/test/blocks_test.go': 6, 'core/builder.go': 36, 'core/commands/ipnsps.go': 5, 'core/coreapi/coreapi.go': 21, 'core/coreapi/interface/interface.go': 2, 'core/coreapi/unixfs.go': 31, 'core/coreapi/unixfs_test.go': 25, 'core/coredag/cbor.go': 9, 'core/coredag/dagpb.go': 27, 'core/coredag/dagtransl.go': 7, 'core/coredag/raw.go': 27, 'core/corehttp/corehttp.go': 15, 'core/corehttp/gateway_handler.go': 36, 'core/corerepo/gc.go': 33, 'core/corerepo/pinning.go': 10, 'core/coreunix/metadata.go': 29, 'core/pathresolver.go': 31, 'exchange/bitswap/bitswap.go': 7, 'exchange/bitswap/decision/engine.go': 7, 'exchange/bitswap/decision/ledger.go': 6, 'exchange/bitswap/decision/peer_request_queue.go': 6, 'exchange/bitswap/get.go': 6, 'exchange/bitswap/notifications/notifications.go': 3, 'exchange/bitswap/notifications/notifications_test.go': 3, 'exchange/bitswap/session.go': 7, 'exchange/bitswap/session_test.go': 5, 'exchange/bitswap/stat.go': 3, 'exchange/bitswap/wantlist/wantlist.go': 3, 'exchange/bitswap/wantlist/wantlist_test.go': 3, 'exchange/bitswap/wantmanager.go': 7, 'exchange/bitswap/workers.go': 6, 'exchange/interface.go': 2, 'exchange/offline/offline.go': 2, 'exchange/offline/offline_test.go': 2, 'exchange/reprovide/providers.go': 30, 'exchange/reprovide/reprovide.go': 24, 'filestore/filestore.go': 18, 'filestore/filestore_test.go': 30, 'filestore/fsrefstore.go': 17, 'filestore/util.go': 17, 'fuse/ipns/ipns_unix.go': 33, 'fuse/readonly/readonly_unix.go': 33, 'importer/balanced/builder.go': 3, 'importer/chunk/splitting_test.go': 2, 'importer/helpers/helpers.go': 3, 'importer/importer_test.go': 5, 'importer/trickle/trickle_test.go': 5, 'importer/trickle/trickledag.go': 3, 'merkledag/batch.go': 2, 'merkledag/coding.go': 3, 'merkledag/merkledag.go': 3, 'merkledag/merkledag_test.go': 6, 'merkledag/node.go': 3, 'merkledag/node_test.go': 3, 'merkledag/raw.go': 3, 'merkledag/traverse/traverse.go': 3, 'merkledag/traverse/traverse_test.go': 3, 'merkledag/utils/diff.go': 3, 'merkledag/utils/diffenum.go': 3, 'merkledag/utils/diffenum_test.go': 3, 'merkledag/utils/utils.go': 6, 'mfs/dir.go': 4, 'mfs/file.go': 6, 'mfs/mfs_test.go': 7, 'mfs/ops.go': 4, 'mfs/system.go': 7, 'namesys/namesys.go': 35, 'namesys/publisher.go': 34, 'namesys/pubsub.go': 5, 'namesys/pubsub_test.go': 5, 'namesys/republisher/repub.go': 31, 'namesys/routing.go': 36, 'path/path.go': 3, 'path/resolver.go': 3, 'path/resolver_test.go': 2, 'pin/gc/gc.go': 31, 'pin/pin.go': 30, 'pin/pin_test.go': 31, 'pin/set.go': 27, 'pin/set_test.go': 30, 'plugin/ipld.go': 7, 'plugin/loader/initializer.go': 5, 'plugin/plugins/git/git.go': 7, 'repo/config/init.go': 7, 'repo/fsrepo/fsrepo.go': 23, 'repo/fsrepo/lock/lock.go': 3, 'repo/fsrepo/serialize/serialize.go': 3, 'repo/mock.go': 17, 'repo/repo.go': 20, 'routing/offline/offline.go': 3, 'tar/format.go': 32, 'test/dependencies/ma-pipe-unidir/main.go': 11, 'thirdparty/ds-help/key.go': 2, 'thirdparty/pollEndpoint/main.go': 15, 'thirdparty/posinfo/posinfo.go': 2, 'unixfs/archive/archive.go': 3, 'unixfs/archive/tar/writer.go': 3, 'unixfs/hamt/hamt.go': 3, 'unixfs/io/dagreader.go': 3, 'unixfs/io/dirbuilder.go': 3, 'unixfs/io/resolve.go': 3, 'unixfs/mod/dagmodifier.go': 5, 'unixfs/mod/dagmodifier_test.go': 3, 'unixfs/test/utils.go': 5, 'commands/legacy/command.go': 10, 'commands/legacy/legacy.go': 10, 'commands/legacy/legacy_test.go': 10, 'commands/legacy/request.go': 10, 'commands/legacy/response.go': 10, 'core/commands/commands_test.go': 15, 'core/coreapi/dag.go': 6, 'core/coreapi/dag_test.go': 3, 'core/coreapi/interface/options/dag.go': 4, 'core/coreapi/key.go': 31, 'core/coreapi/name.go': 34, 'merkledag/test/utils.go': 5, 'namesys/namesys_test.go': 34, 'repo/fsrepo/datastores.go': 15, 'repo/fsrepo/fsrepo_test.go': 17, 'thirdparty/datastore2/datastore_closer.go': 1, 'thirdparty/datastore2/delayed.go': 1, 'thirdparty/datastore2/threadsafe.go': 1, 'unixfs/io/pbdagreader.go': 2, 'cmd/ipfs/util/ulimit.go': 9, 'cmd/seccat/util.go': 9, 'core/corehttp/logs.go': 9, 'fuse/mount/mount.go': 9, 'fuse/node/mount_unix.go': 10, 'importer/chunk/splitting.go': 1, 'namesys/ipns_validate_test.go': 5, 'plugin/loader/load.go': 7, 'blocks/blockstoreutil/remove.go': 15, 'blockservice/test/mock.go': 5, 'core/commands/files.go': 33, 'core/coreapi/pin.go': 30, 'keystore/keystore.go': 9, 'keystore/keystore_test.go': 7, 'keystore/memkeystore.go': 6, 'namesys/validator.go': 3, 'path/resolver/resolver.go': 3, 'thirdparty/verifbs/verifbs.go': 15, 'cmd/ipfs/util/ulimit_freebsd.go': 2, 'cmd/ipfs/util/ulimit_unix.go': 2, 'core/coreapi/block.go': 10, 'core/coreapi/block_test.go': 2, 'core/coreapi/interface/coreapi.go': 3, 'core/coreapi/interface/dag.go': 3, 'core/coreapi/interface/object.go': 3, 'core/coreapi/interface/options/block.go': 2, 'core/coreapi/interface/path.go': 19, 'core/coreapi/interface/unixfs.go': 7, 'core/coreapi/object.go': 27, 'fuse/ipns/link_unix.go': 2, 'fuse/mount/fuse.go': 3, 'fuse/node/mount_darwin.go': 2, 'merkledag/errservice.go': 1, 'merkledag/readonly.go': 1, 'merkledag/readonly_test.go': 1, 'merkledag/rwservice.go': 1, 'merkledag/session.go': 1, 'path/resolver/resolver_test.go': 1, 'thirdparty/verifcid/validate.go': 1, 'thirdparty/verifcid/validate_test.go': 1, 'unixfs/hamt/hamt_stress_test.go': 1, 'unixfs/hamt/hamt_test.go': 1, 'namesys/ipns_resolver_validation_test.go': 27, 'test/sharness/t0170-dht.sh': 1, 'core/corehttp/metrics.go': 2, 'core/commands/env.go': 2, 'core/commands/urlstore.go': 26, 'core/coreapi/interface/key.go': 7, 'core/coreapi/name_test.go': 16, 'core/coreapi/path.go': 26, 'core/coreunix/cat.go': 5, 'core/pathresolver_test.go': 24, 'dagutils/diff.go': 26, 'dagutils/diffenum.go': 24, 'dagutils/diffenum_test.go': 24, 'dagutils/utils.go': 25, 'dagutils/utils_test.go': 24, 'filestore/pb/dataobj.pb.go': 3, 'mfs/fd.go': 1, 'namesys/base.go': 25, 'namesys/cache.go': 24, 'pin/internal/pb/header.pb.go': 3, 'thirdparty/cidv0v1/blockstore.go': 11, 'repo/fsrepo/config_test.go': 13, 'repo/fsrepo/misc.go': 13, 'test/bench/bench_cli_ipfs_add/main.go': 14, 'test/bench/offline_add/main.go': 14, 'core/commands/cmdenv/env.go': 17, 'core/commands/name/ipns.go': 24, 'core/commands/name/publish.go': 13, 'core/commands/name/ipnsps.go': 12, 'core/commands/name/name.go': 7, 'core/coreapi/dht.go': 23, 'core/coreapi/dht_test.go': 4, 'core/coreapi/interface/dht.go': 10, 'p2p/listener.go': 14, 'p2p/local.go': 14, 'p2p/remote.go': 15, 'p2p/stream.go': 15, 'core/coreapi/interface/util.go': 1, 'core/coreapi/interface/swarm.go': 9, 'core/coreapi/swarm.go': 21, 'core/coreapi/interface/options/unixfs.go': 11, 'core/coreapi/pubsub.go': 20, 'core/coreapi/unixfile.go': 11, 'cmd/ipfs/dnsresolve_test.go': 5, 'core/coreapi/interface/pubsub.go': 4, 'core/commands/cid.go': 8, 'test/dependencies/iptb/iptb.go': 11, 'plugin/plugins/badgerds/badgerds.go': 3, 'plugin/plugins/flatfs/flatfs.go': 3, 'plugin/plugins/levelds/levelds.go': 3, 'commands/context.go': 12, 'core/corehttp/proxy.go': 10, 'core/coreapi/interface/tests/name.go': 3, 'core/coreapi/interface/tests/unixfs.go': 3, 'core/coreapi/test/api_test.go': 11, 'core/commands/cmdenv/cidbase.go': 6, 'core/commands/cmdenv/file.go': 3, 'core/corehttp/ipns_hostname.go': 7, 'namesys/dns_test.go': 7, 'plugin/daemon.go': 7, 'plugin/loader/loader.go': 8, 'core/commands/cmdenv/cidbase_test.go': 2, 'core/corehttp/proxy_test.go': 2, 'core/corerepo/stat.go': 1, 'plugin/tracer.go': 1, 'thirdparty/notifier/notifier.go': 1, 'core/corehttp/mutex_profile.go': 1, 'core/corehttp/option_test.go': 1, 'provider/queue.go': 1, 'provider/queue_test.go': 1, 'core/bootstrap/bootstrap.go': 2, 'core/bootstrap/bootstrap_test.go': 2, 'core/ncore.go': 1, 'core/node/builder.go': 2, 'core/node/core.go': 2, 'core/node/discovery.go': 1, 'core/node/groups.go': 2, 'core/node/helpers.go': 1, 'core/node/identity.go': 2, 'core/node/ipns.go': 2, 'core/node/libp2p.go': 1, 'core/node/provider.go': 2, 'core/node/storage.go': 1, 'core/node/libp2p/addrs.go': 1, 'core/node/libp2p/discovery.go': 1, 'core/node/libp2p/host.go': 1, 'core/node/libp2p/hostopt.go': 1, 'core/node/libp2p/libp2p.go': 1, 'core/node/libp2p/nat.go': 1, 'core/node/libp2p/pnet.go': 1, 'core/node/libp2p/pubsub.go': 1, 'core/node/libp2p/routing.go': 1, 'core/node/libp2p/routingopt.go': 1, 'core/node/libp2p/smux.go': 1, 'core/node/libp2p/transport.go': 1, 'go.mod': 1, 'go.sum': 1, 'provider/simple/provider.go': 1, 'provider/simple/provider_test.go': 1, 'provider/simple/reprovide.go': 1, 'provider/simple/reprovide_test.go': 1}","('test/integration/addcat_test.go', 1.0, 0.9607843137254902)"
test/integration/bench_test.go,69,1235,48,"[{'cyclomatic_complexity': 3, 'nloc': 11, 'token_count': 77, 'name': 'benchmarkAddCat', 'long_name': 'benchmarkAddCat numBytes int64 , conf testutil . LatencyConfig , b * testing . B', 'start_line': 10, 'end_line': 22, 'full_parameters': ['numBytes int64', ' conf testutil . LatencyConfig', ' b * testing . B'], 'filename': '/home/dimi/Documents/Informatik_Studium/FSS/SoftEvo/DataCollection/FFS_SoftEvo/go-ipfs/test/integration/bench_test.go', 'top_nesting_level': 0, 'length': 13, 'fan_in': 0, 'fan_out': 0, 'general_fan_out': 0}, {'cyclomatic_complexity': 1, 'nloc': 1, 'token_count': 23, 'name': 'BenchmarkInstantaneousAddCat1KB', 'long_name': 'BenchmarkInstantaneousAddCat1KB b * testing . B', 'start_line': 26, 'end_line': 26, 'full_parameters': ['b * testing . B'], 'filename': '/home/dimi/Documents/Informatik_Studium/FSS/SoftEvo/DataCollection/FFS_SoftEvo/go-ipfs/test/integration/bench_test.go', 'top_nesting_level': 0, 'length': 1, 'fan_in': 0, 'fan_out': 0, 'general_fan_out': 0}, {'cyclomatic_complexity': 1, 'nloc': 1, 'token_count': 23, 'name': 'BenchmarkInstantaneousAddCat1MB', 'long_name': 'BenchmarkInstantaneousAddCat1MB b * testing . B', 'start_line': 27, 'end_line': 27, 'full_parameters': ['b * testing . B'], 'filename': '/home/dimi/Documents/Informatik_Studium/FSS/SoftEvo/DataCollection/FFS_SoftEvo/go-ipfs/test/integration/bench_test.go', 'top_nesting_level': 0, 'length': 1, 'fan_in': 0, 'fan_out': 0, 'general_fan_out': 0}, {'cyclomatic_complexity': 1, 'nloc': 1, 'token_count': 23, 'name': 'BenchmarkInstantaneousAddCat2MB', 'long_name': 'BenchmarkInstantaneousAddCat2MB b * testing . B', 'start_line': 28, 'end_line': 28, 'full_parameters': ['b * testing . B'], 'filename': '/home/dimi/Documents/Informatik_Studium/FSS/SoftEvo/DataCollection/FFS_SoftEvo/go-ipfs/test/integration/bench_test.go', 'top_nesting_level': 0, 'length': 1, 'fan_in': 0, 'fan_out': 0, 'general_fan_out': 0}, {'cyclomatic_complexity': 1, 'nloc': 1, 'token_count': 23, 'name': 'BenchmarkInstantaneousAddCat4MB', 'long_name': 'BenchmarkInstantaneousAddCat4MB b * testing . B', 'start_line': 29, 'end_line': 29, 'full_parameters': ['b * testing . B'], 'filename': '/home/dimi/Documents/Informatik_Studium/FSS/SoftEvo/DataCollection/FFS_SoftEvo/go-ipfs/test/integration/bench_test.go', 'top_nesting_level': 0, 'length': 1, 'fan_in': 0, 'fan_out': 0, 'general_fan_out': 0}, {'cyclomatic_complexity': 1, 'nloc': 1, 'token_count': 23, 'name': 'BenchmarkInstantaneousAddCat8MB', 'long_name': 'BenchmarkInstantaneousAddCat8MB b * testing . B', 'start_line': 30, 'end_line': 30, 'full_parameters': ['b * testing . B'], 'filename': '/home/dimi/Documents/Informatik_Studium/FSS/SoftEvo/DataCollection/FFS_SoftEvo/go-ipfs/test/integration/bench_test.go', 'top_nesting_level': 0, 'length': 1, 'fan_in': 0, 'fan_out': 0, 'general_fan_out': 0}, {'cyclomatic_complexity': 1, 'nloc': 1, 'token_count': 23, 'name': 'BenchmarkInstantaneousAddCat16MB', 'long_name': 'BenchmarkInstantaneousAddCat16MB b * testing . B', 'start_line': 31, 'end_line': 31, 'full_parameters': ['b * testing . B'], 'filename': '/home/dimi/Documents/Informatik_Studium/FSS/SoftEvo/DataCollection/FFS_SoftEvo/go-ipfs/test/integration/bench_test.go', 'top_nesting_level': 0, 'length': 1, 'fan_in': 0, 'fan_out': 0, 'general_fan_out': 0}, {'cyclomatic_complexity': 1, 'nloc': 1, 'token_count': 23, 'name': 'BenchmarkInstantaneousAddCat32MB', 'long_name': 'BenchmarkInstantaneousAddCat32MB b * testing . B', 'start_line': 32, 'end_line': 32, 'full_parameters': ['b * testing . B'], 'filename': '/home/dimi/Documents/Informatik_Studium/FSS/SoftEvo/DataCollection/FFS_SoftEvo/go-ipfs/test/integration/bench_test.go', 'top_nesting_level': 0, 'length': 1, 'fan_in': 0, 'fan_out': 0, 'general_fan_out': 0}, {'cyclomatic_complexity': 1, 'nloc': 1, 'token_count': 23, 'name': 'BenchmarkInstantaneousAddCat64MB', 'long_name': 'BenchmarkInstantaneousAddCat64MB b * testing . B', 'start_line': 33, 'end_line': 33, 'full_parameters': ['b * testing . B'], 'filename': '/home/dimi/Documents/Informatik_Studium/FSS/SoftEvo/DataCollection/FFS_SoftEvo/go-ipfs/test/integration/bench_test.go', 'top_nesting_level': 0, 'length': 1, 'fan_in': 0, 'fan_out': 0, 'general_fan_out': 0}, {'cyclomatic_complexity': 1, 'nloc': 1, 'token_count': 23, 'name': 'BenchmarkInstantaneousAddCat128MB', 'long_name': 'BenchmarkInstantaneousAddCat128MB b * testing . B', 'start_line': 34, 'end_line': 34, 'full_parameters': ['b * testing . B'], 'filename': '/home/dimi/Documents/Informatik_Studium/FSS/SoftEvo/DataCollection/FFS_SoftEvo/go-ipfs/test/integration/bench_test.go', 'top_nesting_level': 0, 'length': 1, 'fan_in': 0, 'fan_out': 0, 'general_fan_out': 0}, {'cyclomatic_complexity': 1, 'nloc': 1, 'token_count': 23, 'name': 'BenchmarkInstantaneousAddCat256MB', 'long_name': 'BenchmarkInstantaneousAddCat256MB b * testing . B', 'start_line': 35, 'end_line': 35, 'full_parameters': ['b * testing . B'], 'filename': '/home/dimi/Documents/Informatik_Studium/FSS/SoftEvo/DataCollection/FFS_SoftEvo/go-ipfs/test/integration/bench_test.go', 'top_nesting_level': 0, 'length': 1, 'fan_in': 0, 'fan_out': 0, 'general_fan_out': 0}, {'cyclomatic_complexity': 1, 'nloc': 1, 'token_count': 23, 'name': 'BenchmarkRoutingSlowAddCat1MB', 'long_name': 'BenchmarkRoutingSlowAddCat1MB b * testing . B', 'start_line': 39, 'end_line': 39, 'full_parameters': ['b * testing . B'], 'filename': '/home/dimi/Documents/Informatik_Studium/FSS/SoftEvo/DataCollection/FFS_SoftEvo/go-ipfs/test/integration/bench_test.go', 'top_nesting_level': 0, 'length': 1, 'fan_in': 0, 'fan_out': 0, 'general_fan_out': 0}, {'cyclomatic_complexity': 1, 'nloc': 1, 'token_count': 23, 'name': 'BenchmarkRoutingSlowAddCat2MB', 'long_name': 'BenchmarkRoutingSlowAddCat2MB b * testing . B', 'start_line': 40, 'end_line': 40, 'full_parameters': ['b * testing . B'], 'filename': '/home/dimi/Documents/Informatik_Studium/FSS/SoftEvo/DataCollection/FFS_SoftEvo/go-ipfs/test/integration/bench_test.go', 'top_nesting_level': 0, 'length': 1, 'fan_in': 0, 'fan_out': 0, 'general_fan_out': 0}, {'cyclomatic_complexity': 1, 'nloc': 1, 'token_count': 23, 'name': 'BenchmarkRoutingSlowAddCat4MB', 'long_name': 'BenchmarkRoutingSlowAddCat4MB b * testing . B', 'start_line': 41, 'end_line': 41, 'full_parameters': ['b * testing . B'], 'filename': '/home/dimi/Documents/Informatik_Studium/FSS/SoftEvo/DataCollection/FFS_SoftEvo/go-ipfs/test/integration/bench_test.go', 'top_nesting_level': 0, 'length': 1, 'fan_in': 0, 'fan_out': 0, 'general_fan_out': 0}, {'cyclomatic_complexity': 1, 'nloc': 1, 'token_count': 23, 'name': 'BenchmarkRoutingSlowAddCat8MB', 'long_name': 'BenchmarkRoutingSlowAddCat8MB b * testing . B', 'start_line': 42, 'end_line': 42, 'full_parameters': ['b * testing . B'], 'filename': '/home/dimi/Documents/Informatik_Studium/FSS/SoftEvo/DataCollection/FFS_SoftEvo/go-ipfs/test/integration/bench_test.go', 'top_nesting_level': 0, 'length': 1, 'fan_in': 0, 'fan_out': 0, 'general_fan_out': 0}, {'cyclomatic_complexity': 1, 'nloc': 1, 'token_count': 23, 'name': 'BenchmarkRoutingSlowAddCat16MB', 'long_name': 'BenchmarkRoutingSlowAddCat16MB b * testing . B', 'start_line': 43, 'end_line': 43, 'full_parameters': ['b * testing . B'], 'filename': '/home/dimi/Documents/Informatik_Studium/FSS/SoftEvo/DataCollection/FFS_SoftEvo/go-ipfs/test/integration/bench_test.go', 'top_nesting_level': 0, 'length': 1, 'fan_in': 0, 'fan_out': 0, 'general_fan_out': 0}, {'cyclomatic_complexity': 1, 'nloc': 1, 'token_count': 23, 'name': 'BenchmarkRoutingSlowAddCat32MB', 'long_name': 'BenchmarkRoutingSlowAddCat32MB b * testing . B', 'start_line': 44, 'end_line': 44, 'full_parameters': ['b * testing . B'], 'filename': '/home/dimi/Documents/Informatik_Studium/FSS/SoftEvo/DataCollection/FFS_SoftEvo/go-ipfs/test/integration/bench_test.go', 'top_nesting_level': 0, 'length': 1, 'fan_in': 0, 'fan_out': 0, 'general_fan_out': 0}, {'cyclomatic_complexity': 1, 'nloc': 1, 'token_count': 23, 'name': 'BenchmarkRoutingSlowAddCat64MB', 'long_name': 'BenchmarkRoutingSlowAddCat64MB b * testing . B', 'start_line': 45, 'end_line': 45, 'full_parameters': ['b * testing . B'], 'filename': '/home/dimi/Documents/Informatik_Studium/FSS/SoftEvo/DataCollection/FFS_SoftEvo/go-ipfs/test/integration/bench_test.go', 'top_nesting_level': 0, 'length': 1, 'fan_in': 0, 'fan_out': 0, 'general_fan_out': 0}, {'cyclomatic_complexity': 1, 'nloc': 1, 'token_count': 23, 'name': 'BenchmarkRoutingSlowAddCat128MB', 'long_name': 'BenchmarkRoutingSlowAddCat128MB b * testing . B', 'start_line': 46, 'end_line': 46, 'full_parameters': ['b * testing . B'], 'filename': '/home/dimi/Documents/Informatik_Studium/FSS/SoftEvo/DataCollection/FFS_SoftEvo/go-ipfs/test/integration/bench_test.go', 'top_nesting_level': 0, 'length': 1, 'fan_in': 0, 'fan_out': 0, 'general_fan_out': 0}, {'cyclomatic_complexity': 1, 'nloc': 1, 'token_count': 23, 'name': 'BenchmarkRoutingSlowAddCat256MB', 'long_name': 'BenchmarkRoutingSlowAddCat256MB b * testing . B', 'start_line': 47, 'end_line': 47, 'full_parameters': ['b * testing . B'], 'filename': '/home/dimi/Documents/Informatik_Studium/FSS/SoftEvo/DataCollection/FFS_SoftEvo/go-ipfs/test/integration/bench_test.go', 'top_nesting_level': 0, 'length': 1, 'fan_in': 0, 'fan_out': 0, 'general_fan_out': 0}, {'cyclomatic_complexity': 1, 'nloc': 1, 'token_count': 23, 'name': 'BenchmarkRoutingSlowAddCat512MB', 'long_name': 'BenchmarkRoutingSlowAddCat512MB b * testing . B', 'start_line': 48, 'end_line': 48, 'full_parameters': ['b * testing . B'], 'filename': '/home/dimi/Documents/Informatik_Studium/FSS/SoftEvo/DataCollection/FFS_SoftEvo/go-ipfs/test/integration/bench_test.go', 'top_nesting_level': 0, 'length': 1, 'fan_in': 0, 'fan_out': 0, 'general_fan_out': 0}, {'cyclomatic_complexity': 1, 'nloc': 1, 'token_count': 23, 'name': 'BenchmarkNetworkSlowAddCat1MB', 'long_name': 'BenchmarkNetworkSlowAddCat1MB b * testing . B', 'start_line': 52, 'end_line': 52, 'full_parameters': ['b * testing . B'], 'filename': '/home/dimi/Documents/Informatik_Studium/FSS/SoftEvo/DataCollection/FFS_SoftEvo/go-ipfs/test/integration/bench_test.go', 'top_nesting_level': 0, 'length': 1, 'fan_in': 0, 'fan_out': 0, 'general_fan_out': 0}, {'cyclomatic_complexity': 1, 'nloc': 1, 'token_count': 23, 'name': 'BenchmarkNetworkSlowAddCat2MB', 'long_name': 'BenchmarkNetworkSlowAddCat2MB b * testing . B', 'start_line': 53, 'end_line': 53, 'full_parameters': ['b * testing . B'], 'filename': '/home/dimi/Documents/Informatik_Studium/FSS/SoftEvo/DataCollection/FFS_SoftEvo/go-ipfs/test/integration/bench_test.go', 'top_nesting_level': 0, 'length': 1, 'fan_in': 0, 'fan_out': 0, 'general_fan_out': 0}, {'cyclomatic_complexity': 1, 'nloc': 1, 'token_count': 23, 'name': 'BenchmarkNetworkSlowAddCat4MB', 'long_name': 'BenchmarkNetworkSlowAddCat4MB b * testing . B', 'start_line': 54, 'end_line': 54, 'full_parameters': ['b * testing . B'], 'filename': '/home/dimi/Documents/Informatik_Studium/FSS/SoftEvo/DataCollection/FFS_SoftEvo/go-ipfs/test/integration/bench_test.go', 'top_nesting_level': 0, 'length': 1, 'fan_in': 0, 'fan_out': 0, 'general_fan_out': 0}, {'cyclomatic_complexity': 1, 'nloc': 1, 'token_count': 23, 'name': 'BenchmarkNetworkSlowAddCat8MB', 'long_name': 'BenchmarkNetworkSlowAddCat8MB b * testing . B', 'start_line': 55, 'end_line': 55, 'full_parameters': ['b * testing . B'], 'filename': '/home/dimi/Documents/Informatik_Studium/FSS/SoftEvo/DataCollection/FFS_SoftEvo/go-ipfs/test/integration/bench_test.go', 'top_nesting_level': 0, 'length': 1, 'fan_in': 0, 'fan_out': 0, 'general_fan_out': 0}, {'cyclomatic_complexity': 1, 'nloc': 1, 'token_count': 23, 'name': 'BenchmarkNetworkSlowAddCat16MB', 'long_name': 'BenchmarkNetworkSlowAddCat16MB b * testing . B', 'start_line': 56, 'end_line': 56, 'full_parameters': ['b * testing . B'], 'filename': '/home/dimi/Documents/Informatik_Studium/FSS/SoftEvo/DataCollection/FFS_SoftEvo/go-ipfs/test/integration/bench_test.go', 'top_nesting_level': 0, 'length': 1, 'fan_in': 0, 'fan_out': 0, 'general_fan_out': 0}, {'cyclomatic_complexity': 1, 'nloc': 1, 'token_count': 23, 'name': 'BenchmarkNetworkSlowAddCat32MB', 'long_name': 'BenchmarkNetworkSlowAddCat32MB b * testing . B', 'start_line': 57, 'end_line': 57, 'full_parameters': ['b * testing . B'], 'filename': '/home/dimi/Documents/Informatik_Studium/FSS/SoftEvo/DataCollection/FFS_SoftEvo/go-ipfs/test/integration/bench_test.go', 'top_nesting_level': 0, 'length': 1, 'fan_in': 0, 'fan_out': 0, 'general_fan_out': 0}, {'cyclomatic_complexity': 1, 'nloc': 1, 'token_count': 23, 'name': 'BenchmarkNetworkSlowAddCat64MB', 'long_name': 'BenchmarkNetworkSlowAddCat64MB b * testing . B', 'start_line': 58, 'end_line': 58, 'full_parameters': ['b * testing . B'], 'filename': '/home/dimi/Documents/Informatik_Studium/FSS/SoftEvo/DataCollection/FFS_SoftEvo/go-ipfs/test/integration/bench_test.go', 'top_nesting_level': 0, 'length': 1, 'fan_in': 0, 'fan_out': 0, 'general_fan_out': 0}, {'cyclomatic_complexity': 1, 'nloc': 1, 'token_count': 23, 'name': 'BenchmarkNetworkSlowAddCat128MB', 'long_name': 'BenchmarkNetworkSlowAddCat128MB b * testing . B', 'start_line': 59, 'end_line': 59, 'full_parameters': ['b * testing . B'], 'filename': '/home/dimi/Documents/Informatik_Studium/FSS/SoftEvo/DataCollection/FFS_SoftEvo/go-ipfs/test/integration/bench_test.go', 'top_nesting_level': 0, 'length': 1, 'fan_in': 0, 'fan_out': 0, 'general_fan_out': 0}, {'cyclomatic_complexity': 1, 'nloc': 1, 'token_count': 23, 'name': 'BenchmarkNetworkSlowAddCat256MB', 'long_name': 'BenchmarkNetworkSlowAddCat256MB b * testing . B', 'start_line': 60, 'end_line': 60, 'full_parameters': ['b * testing . B'], 'filename': '/home/dimi/Documents/Informatik_Studium/FSS/SoftEvo/DataCollection/FFS_SoftEvo/go-ipfs/test/integration/bench_test.go', 'top_nesting_level': 0, 'length': 1, 'fan_in': 0, 'fan_out': 0, 'general_fan_out': 0}, {'cyclomatic_complexity': 1, 'nloc': 1, 'token_count': 23, 'name': 'BenchmarkBlockstoreSlowAddCat1MB', 'long_name': 'BenchmarkBlockstoreSlowAddCat1MB b * testing . B', 'start_line': 64, 'end_line': 64, 'full_parameters': ['b * testing . B'], 'filename': '/home/dimi/Documents/Informatik_Studium/FSS/SoftEvo/DataCollection/FFS_SoftEvo/go-ipfs/test/integration/bench_test.go', 'top_nesting_level': 0, 'length': 1, 'fan_in': 0, 'fan_out': 0, 'general_fan_out': 0}, {'cyclomatic_complexity': 1, 'nloc': 1, 'token_count': 23, 'name': 'BenchmarkBlockstoreSlowAddCat2MB', 'long_name': 'BenchmarkBlockstoreSlowAddCat2MB b * testing . B', 'start_line': 65, 'end_line': 65, 'full_parameters': ['b * testing . B'], 'filename': '/home/dimi/Documents/Informatik_Studium/FSS/SoftEvo/DataCollection/FFS_SoftEvo/go-ipfs/test/integration/bench_test.go', 'top_nesting_level': 0, 'length': 1, 'fan_in': 0, 'fan_out': 0, 'general_fan_out': 0}, {'cyclomatic_complexity': 1, 'nloc': 1, 'token_count': 23, 'name': 'BenchmarkBlockstoreSlowAddCat4MB', 'long_name': 'BenchmarkBlockstoreSlowAddCat4MB b * testing . B', 'start_line': 66, 'end_line': 66, 'full_parameters': ['b * testing . B'], 'filename': '/home/dimi/Documents/Informatik_Studium/FSS/SoftEvo/DataCollection/FFS_SoftEvo/go-ipfs/test/integration/bench_test.go', 'top_nesting_level': 0, 'length': 1, 'fan_in': 0, 'fan_out': 0, 'general_fan_out': 0}, {'cyclomatic_complexity': 1, 'nloc': 1, 'token_count': 23, 'name': 'BenchmarkBlockstoreSlowAddCat8MB', 'long_name': 'BenchmarkBlockstoreSlowAddCat8MB b * testing . B', 'start_line': 67, 'end_line': 67, 'full_parameters': ['b * testing . B'], 'filename': '/home/dimi/Documents/Informatik_Studium/FSS/SoftEvo/DataCollection/FFS_SoftEvo/go-ipfs/test/integration/bench_test.go', 'top_nesting_level': 0, 'length': 1, 'fan_in': 0, 'fan_out': 0, 'general_fan_out': 0}, {'cyclomatic_complexity': 1, 'nloc': 1, 'token_count': 23, 'name': 'BenchmarkBlockstoreSlowAddCat16MB', 'long_name': 'BenchmarkBlockstoreSlowAddCat16MB b * testing . B', 'start_line': 68, 'end_line': 68, 'full_parameters': ['b * testing . B'], 'filename': '/home/dimi/Documents/Informatik_Studium/FSS/SoftEvo/DataCollection/FFS_SoftEvo/go-ipfs/test/integration/bench_test.go', 'top_nesting_level': 0, 'length': 1, 'fan_in': 0, 'fan_out': 0, 'general_fan_out': 0}, {'cyclomatic_complexity': 1, 'nloc': 1, 'token_count': 23, 'name': 'BenchmarkBlockstoreSlowAddCat32MB', 'long_name': 'BenchmarkBlockstoreSlowAddCat32MB b * testing . B', 'start_line': 69, 'end_line': 69, 'full_parameters': ['b * testing . B'], 'filename': '/home/dimi/Documents/Informatik_Studium/FSS/SoftEvo/DataCollection/FFS_SoftEvo/go-ipfs/test/integration/bench_test.go', 'top_nesting_level': 0, 'length': 1, 'fan_in': 0, 'fan_out': 0, 'general_fan_out': 0}, {'cyclomatic_complexity': 1, 'nloc': 1, 'token_count': 23, 'name': 'BenchmarkBlockstoreSlowAddCat64MB', 'long_name': 'BenchmarkBlockstoreSlowAddCat64MB b * testing . B', 'start_line': 70, 'end_line': 70, 'full_parameters': ['b * testing . B'], 'filename': '/home/dimi/Documents/Informatik_Studium/FSS/SoftEvo/DataCollection/FFS_SoftEvo/go-ipfs/test/integration/bench_test.go', 'top_nesting_level': 0, 'length': 1, 'fan_in': 0, 'fan_out': 0, 'general_fan_out': 0}, {'cyclomatic_complexity': 1, 'nloc': 1, 'token_count': 23, 'name': 'BenchmarkBlockstoreSlowAddCat128MB', 'long_name': 'BenchmarkBlockstoreSlowAddCat128MB b * testing . B', 'start_line': 71, 'end_line': 71, 'full_parameters': ['b * testing . B'], 'filename': '/home/dimi/Documents/Informatik_Studium/FSS/SoftEvo/DataCollection/FFS_SoftEvo/go-ipfs/test/integration/bench_test.go', 'top_nesting_level': 0, 'length': 1, 'fan_in': 0, 'fan_out': 0, 'general_fan_out': 0}, {'cyclomatic_complexity': 1, 'nloc': 1, 'token_count': 23, 'name': 'BenchmarkBlockstoreSlowAddCat256MB', 'long_name': 'BenchmarkBlockstoreSlowAddCat256MB b * testing . B', 'start_line': 72, 'end_line': 72, 'full_parameters': ['b * testing . B'], 'filename': '/home/dimi/Documents/Informatik_Studium/FSS/SoftEvo/DataCollection/FFS_SoftEvo/go-ipfs/test/integration/bench_test.go', 'top_nesting_level': 0, 'length': 1, 'fan_in': 0, 'fan_out': 0, 'general_fan_out': 0}, {'cyclomatic_complexity': 1, 'nloc': 1, 'token_count': 23, 'name': 'BenchmarkMixedAddCat1MBXX', 'long_name': 'BenchmarkMixedAddCat1MBXX b * testing . B', 'start_line': 76, 'end_line': 76, 'full_parameters': ['b * testing . B'], 'filename': '/home/dimi/Documents/Informatik_Studium/FSS/SoftEvo/DataCollection/FFS_SoftEvo/go-ipfs/test/integration/bench_test.go', 'top_nesting_level': 0, 'length': 1, 'fan_in': 0, 'fan_out': 0, 'general_fan_out': 0}, {'cyclomatic_complexity': 1, 'nloc': 1, 'token_count': 23, 'name': 'BenchmarkMixedAddCat2MBXX', 'long_name': 'BenchmarkMixedAddCat2MBXX b * testing . B', 'start_line': 77, 'end_line': 77, 'full_parameters': ['b * testing . B'], 'filename': '/home/dimi/Documents/Informatik_Studium/FSS/SoftEvo/DataCollection/FFS_SoftEvo/go-ipfs/test/integration/bench_test.go', 'top_nesting_level': 0, 'length': 1, 'fan_in': 0, 'fan_out': 0, 'general_fan_out': 0}, {'cyclomatic_complexity': 1, 'nloc': 1, 'token_count': 23, 'name': 'BenchmarkMixedAddCat4MBXX', 'long_name': 'BenchmarkMixedAddCat4MBXX b * testing . B', 'start_line': 78, 'end_line': 78, 'full_parameters': ['b * testing . B'], 'filename': '/home/dimi/Documents/Informatik_Studium/FSS/SoftEvo/DataCollection/FFS_SoftEvo/go-ipfs/test/integration/bench_test.go', 'top_nesting_level': 0, 'length': 1, 'fan_in': 0, 'fan_out': 0, 'general_fan_out': 0}, {'cyclomatic_complexity': 1, 'nloc': 1, 'token_count': 23, 'name': 'BenchmarkMixedAddCat8MBXX', 'long_name': 'BenchmarkMixedAddCat8MBXX b * testing . B', 'start_line': 79, 'end_line': 79, 'full_parameters': ['b * testing . B'], 'filename': '/home/dimi/Documents/Informatik_Studium/FSS/SoftEvo/DataCollection/FFS_SoftEvo/go-ipfs/test/integration/bench_test.go', 'top_nesting_level': 0, 'length': 1, 'fan_in': 0, 'fan_out': 0, 'general_fan_out': 0}, {'cyclomatic_complexity': 1, 'nloc': 1, 'token_count': 23, 'name': 'BenchmarkMixedAddCat16MBX', 'long_name': 'BenchmarkMixedAddCat16MBX b * testing . B', 'start_line': 80, 'end_line': 80, 'full_parameters': ['b * testing . B'], 'filename': '/home/dimi/Documents/Informatik_Studium/FSS/SoftEvo/DataCollection/FFS_SoftEvo/go-ipfs/test/integration/bench_test.go', 'top_nesting_level': 0, 'length': 1, 'fan_in': 0, 'fan_out': 0, 'general_fan_out': 0}, {'cyclomatic_complexity': 1, 'nloc': 1, 'token_count': 23, 'name': 'BenchmarkMixedAddCat32MBX', 'long_name': 'BenchmarkMixedAddCat32MBX b * testing . B', 'start_line': 81, 'end_line': 81, 'full_parameters': ['b * testing . B'], 'filename': '/home/dimi/Documents/Informatik_Studium/FSS/SoftEvo/DataCollection/FFS_SoftEvo/go-ipfs/test/integration/bench_test.go', 'top_nesting_level': 0, 'length': 1, 'fan_in': 0, 'fan_out': 0, 'general_fan_out': 0}, {'cyclomatic_complexity': 1, 'nloc': 1, 'token_count': 23, 'name': 'BenchmarkMixedAddCat64MBX', 'long_name': 'BenchmarkMixedAddCat64MBX b * testing . B', 'start_line': 82, 'end_line': 82, 'full_parameters': ['b * testing . B'], 'filename': '/home/dimi/Documents/Informatik_Studium/FSS/SoftEvo/DataCollection/FFS_SoftEvo/go-ipfs/test/integration/bench_test.go', 'top_nesting_level': 0, 'length': 1, 'fan_in': 0, 'fan_out': 0, 'general_fan_out': 0}, {'cyclomatic_complexity': 1, 'nloc': 1, 'token_count': 23, 'name': 'BenchmarkMixedAddCat128MB', 'long_name': 'BenchmarkMixedAddCat128MB b * testing . B', 'start_line': 83, 'end_line': 83, 'full_parameters': ['b * testing . B'], 'filename': '/home/dimi/Documents/Informatik_Studium/FSS/SoftEvo/DataCollection/FFS_SoftEvo/go-ipfs/test/integration/bench_test.go', 'top_nesting_level': 0, 'length': 1, 'fan_in': 0, 'fan_out': 0, 'general_fan_out': 0}, {'cyclomatic_complexity': 1, 'nloc': 1, 'token_count': 23, 'name': 'BenchmarkMixedAddCat256MB', 'long_name': 'BenchmarkMixedAddCat256MB b * testing . B', 'start_line': 84, 'end_line': 84, 'full_parameters': ['b * testing . B'], 'filename': '/home/dimi/Documents/Informatik_Studium/FSS/SoftEvo/DataCollection/FFS_SoftEvo/go-ipfs/test/integration/bench_test.go', 'top_nesting_level': 0, 'length': 1, 'fan_in': 0, 'fan_out': 0, 'general_fan_out': 0}]",69,1235,48,"[{'cyclomatic_complexity': 3, 'nloc': 11, 'token_count': 77, 'name': 'benchmarkAddCat', 'long_name': 'benchmarkAddCat numBytes int64 , conf testutil . LatencyConfig , b * testing . B', 'start_line': 10, 'end_line': 22, 'full_parameters': ['numBytes int64', ' conf testutil . LatencyConfig', ' b * testing . B'], 'filename': '/home/dimi/Documents/Informatik_Studium/FSS/SoftEvo/DataCollection/FFS_SoftEvo/go-ipfs/test/integration/bench_test.go', 'top_nesting_level': 0, 'length': 13, 'fan_in': 0, 'fan_out': 0, 'general_fan_out': 0}, {'cyclomatic_complexity': 1, 'nloc': 1, 'token_count': 23, 'name': 'BenchmarkInstantaneousAddCat1KB', 'long_name': 'BenchmarkInstantaneousAddCat1KB b * testing . B', 'start_line': 26, 'end_line': 26, 'full_parameters': ['b * testing . B'], 'filename': '/home/dimi/Documents/Informatik_Studium/FSS/SoftEvo/DataCollection/FFS_SoftEvo/go-ipfs/test/integration/bench_test.go', 'top_nesting_level': 0, 'length': 1, 'fan_in': 0, 'fan_out': 0, 'general_fan_out': 0}, {'cyclomatic_complexity': 1, 'nloc': 1, 'token_count': 23, 'name': 'BenchmarkInstantaneousAddCat1MB', 'long_name': 'BenchmarkInstantaneousAddCat1MB b * testing . B', 'start_line': 27, 'end_line': 27, 'full_parameters': ['b * testing . B'], 'filename': '/home/dimi/Documents/Informatik_Studium/FSS/SoftEvo/DataCollection/FFS_SoftEvo/go-ipfs/test/integration/bench_test.go', 'top_nesting_level': 0, 'length': 1, 'fan_in': 0, 'fan_out': 0, 'general_fan_out': 0}, {'cyclomatic_complexity': 1, 'nloc': 1, 'token_count': 23, 'name': 'BenchmarkInstantaneousAddCat2MB', 'long_name': 'BenchmarkInstantaneousAddCat2MB b * testing . B', 'start_line': 28, 'end_line': 28, 'full_parameters': ['b * testing . B'], 'filename': '/home/dimi/Documents/Informatik_Studium/FSS/SoftEvo/DataCollection/FFS_SoftEvo/go-ipfs/test/integration/bench_test.go', 'top_nesting_level': 0, 'length': 1, 'fan_in': 0, 'fan_out': 0, 'general_fan_out': 0}, {'cyclomatic_complexity': 1, 'nloc': 1, 'token_count': 23, 'name': 'BenchmarkInstantaneousAddCat4MB', 'long_name': 'BenchmarkInstantaneousAddCat4MB b * testing . B', 'start_line': 29, 'end_line': 29, 'full_parameters': ['b * testing . B'], 'filename': '/home/dimi/Documents/Informatik_Studium/FSS/SoftEvo/DataCollection/FFS_SoftEvo/go-ipfs/test/integration/bench_test.go', 'top_nesting_level': 0, 'length': 1, 'fan_in': 0, 'fan_out': 0, 'general_fan_out': 0}, {'cyclomatic_complexity': 1, 'nloc': 1, 'token_count': 23, 'name': 'BenchmarkInstantaneousAddCat8MB', 'long_name': 'BenchmarkInstantaneousAddCat8MB b * testing . B', 'start_line': 30, 'end_line': 30, 'full_parameters': ['b * testing . B'], 'filename': '/home/dimi/Documents/Informatik_Studium/FSS/SoftEvo/DataCollection/FFS_SoftEvo/go-ipfs/test/integration/bench_test.go', 'top_nesting_level': 0, 'length': 1, 'fan_in': 0, 'fan_out': 0, 'general_fan_out': 0}, {'cyclomatic_complexity': 1, 'nloc': 1, 'token_count': 23, 'name': 'BenchmarkInstantaneousAddCat16MB', 'long_name': 'BenchmarkInstantaneousAddCat16MB b * testing . B', 'start_line': 31, 'end_line': 31, 'full_parameters': ['b * testing . B'], 'filename': '/home/dimi/Documents/Informatik_Studium/FSS/SoftEvo/DataCollection/FFS_SoftEvo/go-ipfs/test/integration/bench_test.go', 'top_nesting_level': 0, 'length': 1, 'fan_in': 0, 'fan_out': 0, 'general_fan_out': 0}, {'cyclomatic_complexity': 1, 'nloc': 1, 'token_count': 23, 'name': 'BenchmarkInstantaneousAddCat32MB', 'long_name': 'BenchmarkInstantaneousAddCat32MB b * testing . B', 'start_line': 32, 'end_line': 32, 'full_parameters': ['b * testing . B'], 'filename': '/home/dimi/Documents/Informatik_Studium/FSS/SoftEvo/DataCollection/FFS_SoftEvo/go-ipfs/test/integration/bench_test.go', 'top_nesting_level': 0, 'length': 1, 'fan_in': 0, 'fan_out': 0, 'general_fan_out': 0}, {'cyclomatic_complexity': 1, 'nloc': 1, 'token_count': 23, 'name': 'BenchmarkInstantaneousAddCat64MB', 'long_name': 'BenchmarkInstantaneousAddCat64MB b * testing . B', 'start_line': 33, 'end_line': 33, 'full_parameters': ['b * testing . B'], 'filename': '/home/dimi/Documents/Informatik_Studium/FSS/SoftEvo/DataCollection/FFS_SoftEvo/go-ipfs/test/integration/bench_test.go', 'top_nesting_level': 0, 'length': 1, 'fan_in': 0, 'fan_out': 0, 'general_fan_out': 0}, {'cyclomatic_complexity': 1, 'nloc': 1, 'token_count': 23, 'name': 'BenchmarkInstantaneousAddCat128MB', 'long_name': 'BenchmarkInstantaneousAddCat128MB b * testing . B', 'start_line': 34, 'end_line': 34, 'full_parameters': ['b * testing . B'], 'filename': '/home/dimi/Documents/Informatik_Studium/FSS/SoftEvo/DataCollection/FFS_SoftEvo/go-ipfs/test/integration/bench_test.go', 'top_nesting_level': 0, 'length': 1, 'fan_in': 0, 'fan_out': 0, 'general_fan_out': 0}, {'cyclomatic_complexity': 1, 'nloc': 1, 'token_count': 23, 'name': 'BenchmarkInstantaneousAddCat256MB', 'long_name': 'BenchmarkInstantaneousAddCat256MB b * testing . B', 'start_line': 35, 'end_line': 35, 'full_parameters': ['b * testing . B'], 'filename': '/home/dimi/Documents/Informatik_Studium/FSS/SoftEvo/DataCollection/FFS_SoftEvo/go-ipfs/test/integration/bench_test.go', 'top_nesting_level': 0, 'length': 1, 'fan_in': 0, 'fan_out': 0, 'general_fan_out': 0}, {'cyclomatic_complexity': 1, 'nloc': 1, 'token_count': 23, 'name': 'BenchmarkRoutingSlowAddCat1MB', 'long_name': 'BenchmarkRoutingSlowAddCat1MB b * testing . B', 'start_line': 39, 'end_line': 39, 'full_parameters': ['b * testing . B'], 'filename': '/home/dimi/Documents/Informatik_Studium/FSS/SoftEvo/DataCollection/FFS_SoftEvo/go-ipfs/test/integration/bench_test.go', 'top_nesting_level': 0, 'length': 1, 'fan_in': 0, 'fan_out': 0, 'general_fan_out': 0}, {'cyclomatic_complexity': 1, 'nloc': 1, 'token_count': 23, 'name': 'BenchmarkRoutingSlowAddCat2MB', 'long_name': 'BenchmarkRoutingSlowAddCat2MB b * testing . B', 'start_line': 40, 'end_line': 40, 'full_parameters': ['b * testing . B'], 'filename': '/home/dimi/Documents/Informatik_Studium/FSS/SoftEvo/DataCollection/FFS_SoftEvo/go-ipfs/test/integration/bench_test.go', 'top_nesting_level': 0, 'length': 1, 'fan_in': 0, 'fan_out': 0, 'general_fan_out': 0}, {'cyclomatic_complexity': 1, 'nloc': 1, 'token_count': 23, 'name': 'BenchmarkRoutingSlowAddCat4MB', 'long_name': 'BenchmarkRoutingSlowAddCat4MB b * testing . B', 'start_line': 41, 'end_line': 41, 'full_parameters': ['b * testing . B'], 'filename': '/home/dimi/Documents/Informatik_Studium/FSS/SoftEvo/DataCollection/FFS_SoftEvo/go-ipfs/test/integration/bench_test.go', 'top_nesting_level': 0, 'length': 1, 'fan_in': 0, 'fan_out': 0, 'general_fan_out': 0}, {'cyclomatic_complexity': 1, 'nloc': 1, 'token_count': 23, 'name': 'BenchmarkRoutingSlowAddCat8MB', 'long_name': 'BenchmarkRoutingSlowAddCat8MB b * testing . B', 'start_line': 42, 'end_line': 42, 'full_parameters': ['b * testing . B'], 'filename': '/home/dimi/Documents/Informatik_Studium/FSS/SoftEvo/DataCollection/FFS_SoftEvo/go-ipfs/test/integration/bench_test.go', 'top_nesting_level': 0, 'length': 1, 'fan_in': 0, 'fan_out': 0, 'general_fan_out': 0}, {'cyclomatic_complexity': 1, 'nloc': 1, 'token_count': 23, 'name': 'BenchmarkRoutingSlowAddCat16MB', 'long_name': 'BenchmarkRoutingSlowAddCat16MB b * testing . B', 'start_line': 43, 'end_line': 43, 'full_parameters': ['b * testing . B'], 'filename': '/home/dimi/Documents/Informatik_Studium/FSS/SoftEvo/DataCollection/FFS_SoftEvo/go-ipfs/test/integration/bench_test.go', 'top_nesting_level': 0, 'length': 1, 'fan_in': 0, 'fan_out': 0, 'general_fan_out': 0}, {'cyclomatic_complexity': 1, 'nloc': 1, 'token_count': 23, 'name': 'BenchmarkRoutingSlowAddCat32MB', 'long_name': 'BenchmarkRoutingSlowAddCat32MB b * testing . B', 'start_line': 44, 'end_line': 44, 'full_parameters': ['b * testing . B'], 'filename': '/home/dimi/Documents/Informatik_Studium/FSS/SoftEvo/DataCollection/FFS_SoftEvo/go-ipfs/test/integration/bench_test.go', 'top_nesting_level': 0, 'length': 1, 'fan_in': 0, 'fan_out': 0, 'general_fan_out': 0}, {'cyclomatic_complexity': 1, 'nloc': 1, 'token_count': 23, 'name': 'BenchmarkRoutingSlowAddCat64MB', 'long_name': 'BenchmarkRoutingSlowAddCat64MB b * testing . B', 'start_line': 45, 'end_line': 45, 'full_parameters': ['b * testing . B'], 'filename': '/home/dimi/Documents/Informatik_Studium/FSS/SoftEvo/DataCollection/FFS_SoftEvo/go-ipfs/test/integration/bench_test.go', 'top_nesting_level': 0, 'length': 1, 'fan_in': 0, 'fan_out': 0, 'general_fan_out': 0}, {'cyclomatic_complexity': 1, 'nloc': 1, 'token_count': 23, 'name': 'BenchmarkRoutingSlowAddCat128MB', 'long_name': 'BenchmarkRoutingSlowAddCat128MB b * testing . B', 'start_line': 46, 'end_line': 46, 'full_parameters': ['b * testing . B'], 'filename': '/home/dimi/Documents/Informatik_Studium/FSS/SoftEvo/DataCollection/FFS_SoftEvo/go-ipfs/test/integration/bench_test.go', 'top_nesting_level': 0, 'length': 1, 'fan_in': 0, 'fan_out': 0, 'general_fan_out': 0}, {'cyclomatic_complexity': 1, 'nloc': 1, 'token_count': 23, 'name': 'BenchmarkRoutingSlowAddCat256MB', 'long_name': 'BenchmarkRoutingSlowAddCat256MB b * testing . B', 'start_line': 47, 'end_line': 47, 'full_parameters': ['b * testing . B'], 'filename': '/home/dimi/Documents/Informatik_Studium/FSS/SoftEvo/DataCollection/FFS_SoftEvo/go-ipfs/test/integration/bench_test.go', 'top_nesting_level': 0, 'length': 1, 'fan_in': 0, 'fan_out': 0, 'general_fan_out': 0}, {'cyclomatic_complexity': 1, 'nloc': 1, 'token_count': 23, 'name': 'BenchmarkRoutingSlowAddCat512MB', 'long_name': 'BenchmarkRoutingSlowAddCat512MB b * testing . B', 'start_line': 48, 'end_line': 48, 'full_parameters': ['b * testing . B'], 'filename': '/home/dimi/Documents/Informatik_Studium/FSS/SoftEvo/DataCollection/FFS_SoftEvo/go-ipfs/test/integration/bench_test.go', 'top_nesting_level': 0, 'length': 1, 'fan_in': 0, 'fan_out': 0, 'general_fan_out': 0}, {'cyclomatic_complexity': 1, 'nloc': 1, 'token_count': 23, 'name': 'BenchmarkNetworkSlowAddCat1MB', 'long_name': 'BenchmarkNetworkSlowAddCat1MB b * testing . B', 'start_line': 52, 'end_line': 52, 'full_parameters': ['b * testing . B'], 'filename': '/home/dimi/Documents/Informatik_Studium/FSS/SoftEvo/DataCollection/FFS_SoftEvo/go-ipfs/test/integration/bench_test.go', 'top_nesting_level': 0, 'length': 1, 'fan_in': 0, 'fan_out': 0, 'general_fan_out': 0}, {'cyclomatic_complexity': 1, 'nloc': 1, 'token_count': 23, 'name': 'BenchmarkNetworkSlowAddCat2MB', 'long_name': 'BenchmarkNetworkSlowAddCat2MB b * testing . B', 'start_line': 53, 'end_line': 53, 'full_parameters': ['b * testing . B'], 'filename': '/home/dimi/Documents/Informatik_Studium/FSS/SoftEvo/DataCollection/FFS_SoftEvo/go-ipfs/test/integration/bench_test.go', 'top_nesting_level': 0, 'length': 1, 'fan_in': 0, 'fan_out': 0, 'general_fan_out': 0}, {'cyclomatic_complexity': 1, 'nloc': 1, 'token_count': 23, 'name': 'BenchmarkNetworkSlowAddCat4MB', 'long_name': 'BenchmarkNetworkSlowAddCat4MB b * testing . B', 'start_line': 54, 'end_line': 54, 'full_parameters': ['b * testing . B'], 'filename': '/home/dimi/Documents/Informatik_Studium/FSS/SoftEvo/DataCollection/FFS_SoftEvo/go-ipfs/test/integration/bench_test.go', 'top_nesting_level': 0, 'length': 1, 'fan_in': 0, 'fan_out': 0, 'general_fan_out': 0}, {'cyclomatic_complexity': 1, 'nloc': 1, 'token_count': 23, 'name': 'BenchmarkNetworkSlowAddCat8MB', 'long_name': 'BenchmarkNetworkSlowAddCat8MB b * testing . B', 'start_line': 55, 'end_line': 55, 'full_parameters': ['b * testing . B'], 'filename': '/home/dimi/Documents/Informatik_Studium/FSS/SoftEvo/DataCollection/FFS_SoftEvo/go-ipfs/test/integration/bench_test.go', 'top_nesting_level': 0, 'length': 1, 'fan_in': 0, 'fan_out': 0, 'general_fan_out': 0}, {'cyclomatic_complexity': 1, 'nloc': 1, 'token_count': 23, 'name': 'BenchmarkNetworkSlowAddCat16MB', 'long_name': 'BenchmarkNetworkSlowAddCat16MB b * testing . B', 'start_line': 56, 'end_line': 56, 'full_parameters': ['b * testing . B'], 'filename': '/home/dimi/Documents/Informatik_Studium/FSS/SoftEvo/DataCollection/FFS_SoftEvo/go-ipfs/test/integration/bench_test.go', 'top_nesting_level': 0, 'length': 1, 'fan_in': 0, 'fan_out': 0, 'general_fan_out': 0}, {'cyclomatic_complexity': 1, 'nloc': 1, 'token_count': 23, 'name': 'BenchmarkNetworkSlowAddCat32MB', 'long_name': 'BenchmarkNetworkSlowAddCat32MB b * testing . B', 'start_line': 57, 'end_line': 57, 'full_parameters': ['b * testing . B'], 'filename': '/home/dimi/Documents/Informatik_Studium/FSS/SoftEvo/DataCollection/FFS_SoftEvo/go-ipfs/test/integration/bench_test.go', 'top_nesting_level': 0, 'length': 1, 'fan_in': 0, 'fan_out': 0, 'general_fan_out': 0}, {'cyclomatic_complexity': 1, 'nloc': 1, 'token_count': 23, 'name': 'BenchmarkNetworkSlowAddCat64MB', 'long_name': 'BenchmarkNetworkSlowAddCat64MB b * testing . B', 'start_line': 58, 'end_line': 58, 'full_parameters': ['b * testing . B'], 'filename': '/home/dimi/Documents/Informatik_Studium/FSS/SoftEvo/DataCollection/FFS_SoftEvo/go-ipfs/test/integration/bench_test.go', 'top_nesting_level': 0, 'length': 1, 'fan_in': 0, 'fan_out': 0, 'general_fan_out': 0}, {'cyclomatic_complexity': 1, 'nloc': 1, 'token_count': 23, 'name': 'BenchmarkNetworkSlowAddCat128MB', 'long_name': 'BenchmarkNetworkSlowAddCat128MB b * testing . B', 'start_line': 59, 'end_line': 59, 'full_parameters': ['b * testing . B'], 'filename': '/home/dimi/Documents/Informatik_Studium/FSS/SoftEvo/DataCollection/FFS_SoftEvo/go-ipfs/test/integration/bench_test.go', 'top_nesting_level': 0, 'length': 1, 'fan_in': 0, 'fan_out': 0, 'general_fan_out': 0}, {'cyclomatic_complexity': 1, 'nloc': 1, 'token_count': 23, 'name': 'BenchmarkNetworkSlowAddCat256MB', 'long_name': 'BenchmarkNetworkSlowAddCat256MB b * testing . B', 'start_line': 60, 'end_line': 60, 'full_parameters': ['b * testing . B'], 'filename': '/home/dimi/Documents/Informatik_Studium/FSS/SoftEvo/DataCollection/FFS_SoftEvo/go-ipfs/test/integration/bench_test.go', 'top_nesting_level': 0, 'length': 1, 'fan_in': 0, 'fan_out': 0, 'general_fan_out': 0}, {'cyclomatic_complexity': 1, 'nloc': 1, 'token_count': 23, 'name': 'BenchmarkBlockstoreSlowAddCat1MB', 'long_name': 'BenchmarkBlockstoreSlowAddCat1MB b * testing . B', 'start_line': 64, 'end_line': 64, 'full_parameters': ['b * testing . B'], 'filename': '/home/dimi/Documents/Informatik_Studium/FSS/SoftEvo/DataCollection/FFS_SoftEvo/go-ipfs/test/integration/bench_test.go', 'top_nesting_level': 0, 'length': 1, 'fan_in': 0, 'fan_out': 0, 'general_fan_out': 0}, {'cyclomatic_complexity': 1, 'nloc': 1, 'token_count': 23, 'name': 'BenchmarkBlockstoreSlowAddCat2MB', 'long_name': 'BenchmarkBlockstoreSlowAddCat2MB b * testing . B', 'start_line': 65, 'end_line': 65, 'full_parameters': ['b * testing . B'], 'filename': '/home/dimi/Documents/Informatik_Studium/FSS/SoftEvo/DataCollection/FFS_SoftEvo/go-ipfs/test/integration/bench_test.go', 'top_nesting_level': 0, 'length': 1, 'fan_in': 0, 'fan_out': 0, 'general_fan_out': 0}, {'cyclomatic_complexity': 1, 'nloc': 1, 'token_count': 23, 'name': 'BenchmarkBlockstoreSlowAddCat4MB', 'long_name': 'BenchmarkBlockstoreSlowAddCat4MB b * testing . B', 'start_line': 66, 'end_line': 66, 'full_parameters': ['b * testing . B'], 'filename': '/home/dimi/Documents/Informatik_Studium/FSS/SoftEvo/DataCollection/FFS_SoftEvo/go-ipfs/test/integration/bench_test.go', 'top_nesting_level': 0, 'length': 1, 'fan_in': 0, 'fan_out': 0, 'general_fan_out': 0}, {'cyclomatic_complexity': 1, 'nloc': 1, 'token_count': 23, 'name': 'BenchmarkBlockstoreSlowAddCat8MB', 'long_name': 'BenchmarkBlockstoreSlowAddCat8MB b * testing . B', 'start_line': 67, 'end_line': 67, 'full_parameters': ['b * testing . B'], 'filename': '/home/dimi/Documents/Informatik_Studium/FSS/SoftEvo/DataCollection/FFS_SoftEvo/go-ipfs/test/integration/bench_test.go', 'top_nesting_level': 0, 'length': 1, 'fan_in': 0, 'fan_out': 0, 'general_fan_out': 0}, {'cyclomatic_complexity': 1, 'nloc': 1, 'token_count': 23, 'name': 'BenchmarkBlockstoreSlowAddCat16MB', 'long_name': 'BenchmarkBlockstoreSlowAddCat16MB b * testing . B', 'start_line': 68, 'end_line': 68, 'full_parameters': ['b * testing . B'], 'filename': '/home/dimi/Documents/Informatik_Studium/FSS/SoftEvo/DataCollection/FFS_SoftEvo/go-ipfs/test/integration/bench_test.go', 'top_nesting_level': 0, 'length': 1, 'fan_in': 0, 'fan_out': 0, 'general_fan_out': 0}, {'cyclomatic_complexity': 1, 'nloc': 1, 'token_count': 23, 'name': 'BenchmarkBlockstoreSlowAddCat32MB', 'long_name': 'BenchmarkBlockstoreSlowAddCat32MB b * testing . B', 'start_line': 69, 'end_line': 69, 'full_parameters': ['b * testing . B'], 'filename': '/home/dimi/Documents/Informatik_Studium/FSS/SoftEvo/DataCollection/FFS_SoftEvo/go-ipfs/test/integration/bench_test.go', 'top_nesting_level': 0, 'length': 1, 'fan_in': 0, 'fan_out': 0, 'general_fan_out': 0}, {'cyclomatic_complexity': 1, 'nloc': 1, 'token_count': 23, 'name': 'BenchmarkBlockstoreSlowAddCat64MB', 'long_name': 'BenchmarkBlockstoreSlowAddCat64MB b * testing . B', 'start_line': 70, 'end_line': 70, 'full_parameters': ['b * testing . B'], 'filename': '/home/dimi/Documents/Informatik_Studium/FSS/SoftEvo/DataCollection/FFS_SoftEvo/go-ipfs/test/integration/bench_test.go', 'top_nesting_level': 0, 'length': 1, 'fan_in': 0, 'fan_out': 0, 'general_fan_out': 0}, {'cyclomatic_complexity': 1, 'nloc': 1, 'token_count': 23, 'name': 'BenchmarkBlockstoreSlowAddCat128MB', 'long_name': 'BenchmarkBlockstoreSlowAddCat128MB b * testing . B', 'start_line': 71, 'end_line': 71, 'full_parameters': ['b * testing . B'], 'filename': '/home/dimi/Documents/Informatik_Studium/FSS/SoftEvo/DataCollection/FFS_SoftEvo/go-ipfs/test/integration/bench_test.go', 'top_nesting_level': 0, 'length': 1, 'fan_in': 0, 'fan_out': 0, 'general_fan_out': 0}, {'cyclomatic_complexity': 1, 'nloc': 1, 'token_count': 23, 'name': 'BenchmarkBlockstoreSlowAddCat256MB', 'long_name': 'BenchmarkBlockstoreSlowAddCat256MB b * testing . B', 'start_line': 72, 'end_line': 72, 'full_parameters': ['b * testing . B'], 'filename': '/home/dimi/Documents/Informatik_Studium/FSS/SoftEvo/DataCollection/FFS_SoftEvo/go-ipfs/test/integration/bench_test.go', 'top_nesting_level': 0, 'length': 1, 'fan_in': 0, 'fan_out': 0, 'general_fan_out': 0}, {'cyclomatic_complexity': 1, 'nloc': 1, 'token_count': 23, 'name': 'BenchmarkMixedAddCat1MBXX', 'long_name': 'BenchmarkMixedAddCat1MBXX b * testing . B', 'start_line': 76, 'end_line': 76, 'full_parameters': ['b * testing . B'], 'filename': '/home/dimi/Documents/Informatik_Studium/FSS/SoftEvo/DataCollection/FFS_SoftEvo/go-ipfs/test/integration/bench_test.go', 'top_nesting_level': 0, 'length': 1, 'fan_in': 0, 'fan_out': 0, 'general_fan_out': 0}, {'cyclomatic_complexity': 1, 'nloc': 1, 'token_count': 23, 'name': 'BenchmarkMixedAddCat2MBXX', 'long_name': 'BenchmarkMixedAddCat2MBXX b * testing . B', 'start_line': 77, 'end_line': 77, 'full_parameters': ['b * testing . B'], 'filename': '/home/dimi/Documents/Informatik_Studium/FSS/SoftEvo/DataCollection/FFS_SoftEvo/go-ipfs/test/integration/bench_test.go', 'top_nesting_level': 0, 'length': 1, 'fan_in': 0, 'fan_out': 0, 'general_fan_out': 0}, {'cyclomatic_complexity': 1, 'nloc': 1, 'token_count': 23, 'name': 'BenchmarkMixedAddCat4MBXX', 'long_name': 'BenchmarkMixedAddCat4MBXX b * testing . B', 'start_line': 78, 'end_line': 78, 'full_parameters': ['b * testing . B'], 'filename': '/home/dimi/Documents/Informatik_Studium/FSS/SoftEvo/DataCollection/FFS_SoftEvo/go-ipfs/test/integration/bench_test.go', 'top_nesting_level': 0, 'length': 1, 'fan_in': 0, 'fan_out': 0, 'general_fan_out': 0}, {'cyclomatic_complexity': 1, 'nloc': 1, 'token_count': 23, 'name': 'BenchmarkMixedAddCat8MBXX', 'long_name': 'BenchmarkMixedAddCat8MBXX b * testing . B', 'start_line': 79, 'end_line': 79, 'full_parameters': ['b * testing . B'], 'filename': '/home/dimi/Documents/Informatik_Studium/FSS/SoftEvo/DataCollection/FFS_SoftEvo/go-ipfs/test/integration/bench_test.go', 'top_nesting_level': 0, 'length': 1, 'fan_in': 0, 'fan_out': 0, 'general_fan_out': 0}, {'cyclomatic_complexity': 1, 'nloc': 1, 'token_count': 23, 'name': 'BenchmarkMixedAddCat16MBX', 'long_name': 'BenchmarkMixedAddCat16MBX b * testing . B', 'start_line': 80, 'end_line': 80, 'full_parameters': ['b * testing . B'], 'filename': '/home/dimi/Documents/Informatik_Studium/FSS/SoftEvo/DataCollection/FFS_SoftEvo/go-ipfs/test/integration/bench_test.go', 'top_nesting_level': 0, 'length': 1, 'fan_in': 0, 'fan_out': 0, 'general_fan_out': 0}, {'cyclomatic_complexity': 1, 'nloc': 1, 'token_count': 23, 'name': 'BenchmarkMixedAddCat32MBX', 'long_name': 'BenchmarkMixedAddCat32MBX b * testing . B', 'start_line': 81, 'end_line': 81, 'full_parameters': ['b * testing . B'], 'filename': '/home/dimi/Documents/Informatik_Studium/FSS/SoftEvo/DataCollection/FFS_SoftEvo/go-ipfs/test/integration/bench_test.go', 'top_nesting_level': 0, 'length': 1, 'fan_in': 0, 'fan_out': 0, 'general_fan_out': 0}, {'cyclomatic_complexity': 1, 'nloc': 1, 'token_count': 23, 'name': 'BenchmarkMixedAddCat64MBX', 'long_name': 'BenchmarkMixedAddCat64MBX b * testing . B', 'start_line': 82, 'end_line': 82, 'full_parameters': ['b * testing . B'], 'filename': '/home/dimi/Documents/Informatik_Studium/FSS/SoftEvo/DataCollection/FFS_SoftEvo/go-ipfs/test/integration/bench_test.go', 'top_nesting_level': 0, 'length': 1, 'fan_in': 0, 'fan_out': 0, 'general_fan_out': 0}, {'cyclomatic_complexity': 1, 'nloc': 1, 'token_count': 23, 'name': 'BenchmarkMixedAddCat128MB', 'long_name': 'BenchmarkMixedAddCat128MB b * testing . B', 'start_line': 83, 'end_line': 83, 'full_parameters': ['b * testing . B'], 'filename': '/home/dimi/Documents/Informatik_Studium/FSS/SoftEvo/DataCollection/FFS_SoftEvo/go-ipfs/test/integration/bench_test.go', 'top_nesting_level': 0, 'length': 1, 'fan_in': 0, 'fan_out': 0, 'general_fan_out': 0}, {'cyclomatic_complexity': 1, 'nloc': 1, 'token_count': 23, 'name': 'BenchmarkMixedAddCat256MB', 'long_name': 'BenchmarkMixedAddCat256MB b * testing . B', 'start_line': 84, 'end_line': 84, 'full_parameters': ['b * testing . B'], 'filename': '/home/dimi/Documents/Informatik_Studium/FSS/SoftEvo/DataCollection/FFS_SoftEvo/go-ipfs/test/integration/bench_test.go', 'top_nesting_level': 0, 'length': 1, 'fan_in': 0, 'fan_out': 0, 'general_fan_out': 0}]",0,0,0,21,21,"[{'timestamp': 1507212616.0, 'added_lines': 1, 'deleted_lines': 1, 'nloc': 69}, {'timestamp': 1507304579.0, 'added_lines': 1, 'deleted_lines': 1, 'nloc': 69}, {'timestamp': 1511223906.0, 'added_lines': 1, 'deleted_lines': 1, 'nloc': 69}, {'timestamp': 1512365669.0, 'added_lines': 1, 'deleted_lines': 1, 'nloc': 69}, {'timestamp': 1516838128.0, 'added_lines': 1, 'deleted_lines': 1, 'nloc': 69}, {'timestamp': 1517453697.0, 'added_lines': 1, 'deleted_lines': 1, 'nloc': 69}, {'timestamp': 1525408792.0, 'added_lines': 1, 'deleted_lines': 1, 'nloc': 69}, {'timestamp': 1528520460.0, 'added_lines': 1, 'deleted_lines': 1, 'nloc': 69}, {'timestamp': 1529984485.0, 'added_lines': 1, 'deleted_lines': 1, 'nloc': 69}, {'timestamp': 1533779477.0, 'added_lines': 1, 'deleted_lines': 1, 'nloc': 69}, {'timestamp': 1534896611.0, 'added_lines': 1, 'deleted_lines': 1, 'nloc': 69}, {'timestamp': 1537792589.0, 'added_lines': 1, 'deleted_lines': 1, 'nloc': 69}, {'timestamp': 1540400358.0, 'added_lines': 1, 'deleted_lines': 1, 'nloc': 69}, {'timestamp': 1541204121.0, 'added_lines': 1, 'deleted_lines': 1, 'nloc': 69}, {'timestamp': 1544225843.0, 'added_lines': 1, 'deleted_lines': 1, 'nloc': 69}, {'timestamp': 1547003974.0, 'added_lines': 1, 'deleted_lines': 1, 'nloc': 69}, {'timestamp': 1549588289.0, 'added_lines': 1, 'deleted_lines': 1, 'nloc': 69}, {'timestamp': 1550507829.0, 'added_lines': 1, 'deleted_lines': 1, 'nloc': 69}, {'timestamp': 1551229859.0, 'added_lines': 1, 'deleted_lines': 1, 'nloc': 69}, {'timestamp': 1551551196.0, 'added_lines': 1, 'deleted_lines': 1, 'nloc': 69}, {'timestamp': 1559060517.0, 'added_lines': 1, 'deleted_lines': 1, 'nloc': 69}]","{'core/bootstrap_test.go': 20, 'core/commands/dht_test.go': 21, 'core/mock/mock.go': 21, 'exchange/bitswap/bitswap_test.go': 9, 'exchange/bitswap/decision/bench_test.go': 9, 'exchange/bitswap/decision/engine_test.go': 9, 'exchange/bitswap/decision/peer_request_queue_test.go': 9, 'exchange/bitswap/testnet/interface.go': 9, 'exchange/bitswap/testnet/network_test.go': 9, 'exchange/bitswap/testnet/peernet.go': 9, 'exchange/bitswap/testnet/virtual.go': 9, 'exchange/bitswap/testutils.go': 9, 'exchange/reprovide/reprovide_test.go': 20, 'fuse/ipns/ipns_test.go': 21, 'fuse/node/mount_test.go': 21, 'fuse/readonly/ipfs_test.go': 21, 'mfs/repub_test.go': 10, 'namesys/publisher_test.go': 21, 'namesys/resolve_test.go': 21, 'package.json': 19, 'routing/mock/centralized_client.go': 6, 'routing/mock/centralized_server.go': 6, 'routing/mock/centralized_test.go': 6, 'routing/mock/interface.go': 6, 'routing/offline/offline_test.go': 6, 'test/integration/addcat_test.go': 21, 'test/integration/bench_cat_test.go': 21, 'test/integration/grandcentral_test.go': 1, 'test/integration/three_legged_cat_test.go': 21, 'core/bootstrap.go': 19, 'core/commands/dht.go': 20, 'core/commands/id.go': 20, 'core/commands/pubsub.go': 15, 'core/core.go': 20, 'core/corehttp/gateway.go': 19, 'core/corehttp/gateway_test.go': 20, 'core/corehttp/metrics_test.go': 20, 'exchange/bitswap/network/ipfs_impl.go': 8, 'namesys/republisher/repub_test.go': 20, 'p2p/p2p.go': 20, 'routing/none/none_client.go': 5, 'test/integration/bitswap_wo_routing_test.go': 19, 'thirdparty/ipfsaddr/ipfsaddr.go': 1, 'cmd/ipfs/daemon.go': 16, 'cmd/ipfs/init.go': 16, 'cmd/ipfs/ipfs.go': 13, 'cmd/ipfs/main.go': 18, 'cmd/ipfs/main_test.go': 2, 'cmd/ipfswatch/main.go': 13, 'cmd/seccat/seccat.go': 19, 'commands/cli/helptext.go': 1, 'commands/cli/helptext_test.go': 1, 'commands/cli/parse.go': 1, 'commands/cli/parse_test.go': 1, 'commands/command.go': 11, 'commands/command_test.go': 4, 'commands/http/client.go': 1, 'commands/http/handler.go': 1, 'commands/http/multifilereader.go': 1, 'commands/http/multifilereader_test.go': 1, 'commands/http/parse.go': 1, 'commands/request.go': 12, 'commands/response.go': 6, 'commands/response_test.go': 4, 'core/commands/active.go': 6, 'core/commands/add.go': 14, 'core/commands/bitswap.go': 19, 'core/commands/block.go': 14, 'core/commands/bootstrap.go': 13, 'core/commands/cat.go': 14, 'core/commands/commands.go': 13, 'core/commands/config.go': 13, 'core/commands/dag/dag.go': 16, 'core/commands/diag.go': 6, 'core/commands/dns.go': 9, 'core/commands/external.go': 6, 'core/commands/files/files.go': 4, 'core/commands/filestore.go': 13, 'core/commands/get.go': 17, 'core/commands/get_test.go': 13, 'core/commands/helptext_test.go': 13, 'core/commands/ipns.go': 7, 'core/commands/keystore.go': 14, 'core/commands/log.go': 12, 'core/commands/ls.go': 16, 'core/commands/mount_nofuse.go': 6, 'core/commands/mount_unix.go': 13, 'core/commands/name.go': 4, 'core/commands/object/diff.go': 8, 'core/commands/object/object.go': 17, 'core/commands/object/patch.go': 13, 'core/commands/p2p.go': 16, 'core/commands/pin.go': 17, 'core/commands/ping.go': 19, 'core/commands/publish.go': 9, 'core/commands/refs.go': 15, 'core/commands/repo.go': 18, 'core/commands/resolve.go': 14, 'core/commands/root.go': 13, 'core/commands/shutdown.go': 9, 'core/commands/stat.go': 18, 'core/commands/swarm.go': 19, 'core/commands/sysdiag.go': 12, 'core/commands/tar.go': 14, 'core/commands/unixfs/ls.go': 14, 'core/commands/unixfs/unixfs.go': 6, 'core/commands/version.go': 7, 'core/corehttp/commands.go': 18, 'core/coreunix/add.go': 18, 'core/coreunix/add_test.go': 17, 'exchange/bitswap/message/message.go': 7, 'exchange/bitswap/network/interface.go': 7, 'importer/helpers/dagbuilder.go': 6, 'importer/importer.go': 6, 'p2p/registry.go': 9, 'repo/config/bootstrap_peers.go': 8, 'assets/assets.go': 13, 'blocks/blockstore/arc_cache.go': 2, 'blocks/blockstore/arc_cache_test.go': 2, 'blocks/blockstore/blockstore.go': 3, 'blocks/blockstore/blockstore_test.go': 2, 'blocks/blockstore/bloom_cache.go': 2, 'blocks/blockstore/bloom_cache_test.go': 2, 'blocks/blockstore/util/remove.go': 2, 'blocks/blocksutil/block_generator.go': 2, 'blockservice/blockservice.go': 6, 'blockservice/blockservice_test.go': 5, 'blockservice/test/blocks_test.go': 5, 'core/builder.go': 17, 'core/commands/ipnsps.go': 5, 'core/commands/mount_windows.go': 5, 'core/coreapi/coreapi.go': 12, 'core/coreapi/interface/interface.go': 2, 'core/coreapi/unixfs.go': 14, 'core/coreapi/unixfs_test.go': 12, 'core/coredag/cbor.go': 7, 'core/coredag/dagpb.go': 14, 'core/coredag/dagtransl.go': 6, 'core/coredag/raw.go': 14, 'core/corehttp/corehttp.go': 14, 'core/corehttp/gateway_handler.go': 18, 'core/corerepo/gc.go': 17, 'core/corerepo/pinning.go': 7, 'core/coreunix/metadata.go': 14, 'core/coreunix/metadata_test.go': 16, 'core/pathresolver.go': 17, 'exchange/bitswap/bitswap.go': 6, 'exchange/bitswap/decision/engine.go': 6, 'exchange/bitswap/decision/ledger.go': 6, 'exchange/bitswap/decision/peer_request_queue.go': 6, 'exchange/bitswap/get.go': 5, 'exchange/bitswap/message/message_test.go': 3, 'exchange/bitswap/notifications/notifications.go': 3, 'exchange/bitswap/notifications/notifications_test.go': 3, 'exchange/bitswap/session.go': 6, 'exchange/bitswap/session_test.go': 5, 'exchange/bitswap/stat.go': 3, 'exchange/bitswap/wantlist/wantlist.go': 3, 'exchange/bitswap/wantlist/wantlist_test.go': 3, 'exchange/bitswap/wantmanager.go': 6, 'exchange/bitswap/workers.go': 6, 'exchange/interface.go': 2, 'exchange/offline/offline.go': 2, 'exchange/offline/offline_test.go': 2, 'exchange/reprovide/providers.go': 16, 'exchange/reprovide/reprovide.go': 17, 'filestore/filestore.go': 12, 'filestore/filestore_test.go': 16, 'filestore/fsrefstore.go': 11, 'filestore/util.go': 11, 'fuse/ipns/ipns_unix.go': 18, 'fuse/readonly/readonly_unix.go': 17, 'importer/balanced/balanced_test.go': 5, 'importer/balanced/builder.go': 3, 'importer/chunk/rabin_test.go': 2, 'importer/chunk/splitting_test.go': 2, 'importer/helpers/helpers.go': 3, 'importer/importer_test.go': 5, 'importer/trickle/trickle_test.go': 5, 'importer/trickle/trickledag.go': 3, 'merkledag/batch.go': 2, 'merkledag/coding.go': 3, 'merkledag/merkledag.go': 3, 'merkledag/merkledag_test.go': 5, 'merkledag/node.go': 3, 'merkledag/node_test.go': 3, 'merkledag/raw.go': 3, 'merkledag/traverse/traverse.go': 3, 'merkledag/traverse/traverse_test.go': 3, 'merkledag/utils/diff.go': 3, 'merkledag/utils/diffenum.go': 3, 'merkledag/utils/diffenum_test.go': 3, 'merkledag/utils/utils.go': 5, 'merkledag/utils/utils_test.go': 3, 'mfs/dir.go': 4, 'mfs/file.go': 6, 'mfs/mfs_test.go': 6, 'mfs/ops.go': 4, 'mfs/system.go': 7, 'namesys/ipns_select_test.go': 4, 'namesys/namesys.go': 18, 'namesys/publisher.go': 18, 'namesys/pubsub.go': 4, 'namesys/pubsub_test.go': 4, 'namesys/republisher/repub.go': 18, 'namesys/routing.go': 18, 'path/path.go': 3, 'path/resolver.go': 3, 'path/resolver_test.go': 2, 'pin/gc/gc.go': 17, 'pin/pin.go': 17, 'pin/pin_test.go': 16, 'pin/set.go': 14, 'pin/set_test.go': 16, 'plugin/ipld.go': 6, 'plugin/loader/initializer.go': 5, 'plugin/plugins/git/git.go': 6, 'repo/config/init.go': 7, 'repo/fsrepo/fsrepo.go': 17, 'repo/fsrepo/lock/lock.go': 3, 'repo/fsrepo/serialize/serialize.go': 3, 'repo/mock.go': 14, 'repo/repo.go': 15, 'routing/offline/offline.go': 3, 'tar/format.go': 17, 'test/dependencies/ma-pipe-unidir/main.go': 9, 'thirdparty/ds-help/key.go': 2, 'thirdparty/pollEndpoint/main.go': 14, 'thirdparty/posinfo/posinfo.go': 2, 'unixfs/archive/archive.go': 3, 'unixfs/archive/tar/writer.go': 3, 'unixfs/hamt/hamt.go': 3, 'unixfs/io/dagreader.go': 3, 'unixfs/io/dirbuilder.go': 3, 'unixfs/io/resolve.go': 3, 'unixfs/mod/dagmodifier.go': 5, 'unixfs/mod/dagmodifier_test.go': 3, 'unixfs/test/utils.go': 5, 'commands/legacy/command.go': 9, 'commands/legacy/legacy.go': 9, 'commands/legacy/legacy_test.go': 9, 'commands/legacy/request.go': 9, 'commands/legacy/response.go': 9, 'core/commands/commands_test.go': 11, 'core/coreapi/dag.go': 5, 'core/coreapi/dag_test.go': 3, 'core/coreapi/interface/options/dag.go': 4, 'core/coreapi/key.go': 17, 'core/coreapi/name.go': 17, 'merkledag/test/utils.go': 4, 'namesys/namesys_test.go': 16, 'repo/fsrepo/datastores.go': 10, 'repo/fsrepo/fsrepo_test.go': 12, 'thirdparty/datastore2/datastore_closer.go': 1, 'thirdparty/datastore2/delayed.go': 1, 'thirdparty/datastore2/threadsafe.go': 1, 'unixfs/io/pbdagreader.go': 2, 'cmd/ipfs/util/ulimit.go': 9, 'cmd/seccat/util.go': 9, 'core/corehttp/logs.go': 9, 'fuse/mount/mount.go': 9, 'fuse/node/mount_unix.go': 9, 'importer/chunk/splitting.go': 1, 'namesys/ipns_validate_test.go': 3, 'plugin/loader/load.go': 7, 'blocks/blockstoreutil/remove.go': 9, 'blockservice/test/mock.go': 3, 'core/commands/files.go': 14, 'core/core_test.go': 11, 'core/coreapi/pin.go': 14, 'fuse/ipns/common.go': 13, 'keystore/keystore.go': 9, 'keystore/keystore_test.go': 6, 'keystore/memkeystore.go': 6, 'namesys/interface.go': 13, 'namesys/validator.go': 2, 'path/resolver/resolver.go': 3, 'repo/config/identity.go': 2, 'thirdparty/verifbs/verifbs.go': 9, 'cmd/ipfs/util/ulimit_freebsd.go': 2, 'cmd/ipfs/util/ulimit_unix.go': 2, 'core/coreapi/block.go': 6, 'core/coreapi/block_test.go': 2, 'core/coreapi/interface/coreapi.go': 3, 'core/coreapi/interface/dag.go': 3, 'core/coreapi/interface/object.go': 3, 'core/coreapi/interface/options/block.go': 2, 'core/coreapi/interface/path.go': 9, 'core/coreapi/interface/unixfs.go': 4, 'core/coreapi/object.go': 12, 'fuse/ipns/link_unix.go': 2, 'fuse/mount/fuse.go': 2, 'fuse/node/mount_darwin.go': 2, 'merkledag/errservice.go': 1, 'merkledag/readonly.go': 1, 'merkledag/readonly_test.go': 1, 'merkledag/rwservice.go': 1, 'merkledag/session.go': 1, 'path/resolver/resolver_test.go': 1, 'thirdparty/verifcid/validate.go': 1, 'thirdparty/verifcid/validate_test.go': 1, 'unixfs/hamt/hamt_stress_test.go': 1, 'unixfs/hamt/hamt_test.go': 1, 'namesys/ipns_resolver_validation_test.go': 13, 'test/sharness/t0170-dht.sh': 1, 'core/commands/env.go': 2, 'core/commands/urlstore.go': 11, 'core/coreapi/interface/key.go': 7, 'core/coreapi/name_test.go': 6, 'core/coreapi/path.go': 11, 'core/coreunix/cat.go': 3, 'core/pathresolver_test.go': 11, 'dagutils/diff.go': 11, 'dagutils/diffenum.go': 11, 'dagutils/diffenum_test.go': 11, 'dagutils/utils.go': 11, 'dagutils/utils_test.go': 11, 'filestore/pb/dataobj.pb.go': 3, 'mfs/fd.go': 1, 'namesys/base.go': 11, 'namesys/cache.go': 11, 'namesys/dns.go': 11, 'namesys/proquint.go': 11, 'pin/internal/pb/header.pb.go': 3, 'thirdparty/cidv0v1/blockstore.go': 6, 'repo/fsrepo/config_test.go': 10, 'repo/fsrepo/misc.go': 10, 'test/bench/bench_cli_ipfs_add/main.go': 10, 'test/bench/offline_add/main.go': 10, 'core/commands/cmdenv/env.go': 9, 'core/commands/name/ipns.go': 9, 'core/commands/name/ipnsps.go': 9, 'core/commands/name/name.go': 4, 'core/commands/name/publish.go': 5, 'core/coreapi/dht.go': 10, 'core/coreapi/dht_test.go': 4, 'core/coreapi/interface/dht.go': 6, 'p2p/listener.go': 10, 'p2p/local.go': 10, 'p2p/remote.go': 10, 'p2p/stream.go': 10, 'cmd/ipfs/dnsresolve_test.go': 5, 'core/coreapi/interface/options/unixfs.go': 5, 'core/coreapi/interface/pubsub.go': 4, 'core/coreapi/interface/swarm.go': 5, 'core/coreapi/pubsub.go': 9, 'core/coreapi/swarm.go': 9, 'core/coreapi/unixfile.go': 4, 'core/commands/cid.go': 3, 'test/dependencies/iptb/iptb.go': 7, 'commands/context.go': 6, 'core/corehttp/proxy.go': 7, 'core/coreapi/interface/tests/name.go': 2, 'core/coreapi/interface/tests/unixfs.go': 2, 'core/coreapi/test/api_test.go': 6, 'core/commands/cmdenv/cidbase.go': 2, 'core/corehttp/ipns_hostname.go': 3, 'namesys/dns_test.go': 3, 'plugin/daemon.go': 3, 'plugin/loader/loader.go': 3, 'plugin/plugins/badgerds/badgerds.go': 2, 'plugin/plugins/flatfs/flatfs.go': 2, 'plugin/plugins/levelds/levelds.go': 2, 'core/commands/cmdenv/cidbase_test.go': 1, 'core/commands/cmdenv/file.go': 1, 'core/corehttp/metrics.go': 1, 'core/corehttp/proxy_test.go': 2, 'core/corerepo/stat.go': 1, 'plugin/tracer.go': 1, 'thirdparty/notifier/notifier.go': 1, 'core/bootstrap/bootstrap.go': 1, 'core/bootstrap/bootstrap_test.go': 1, 'core/node/builder.go': 1, 'core/node/core.go': 1, 'core/node/groups.go': 1, 'core/node/identity.go': 1, 'core/node/ipns.go': 1, 'core/node/libp2p/addrs.go': 1, 'core/node/libp2p/discovery.go': 1, 'core/node/libp2p/host.go': 1, 'core/node/libp2p/hostopt.go': 1, 'core/node/libp2p/libp2p.go': 1, 'core/node/libp2p/nat.go': 1, 'core/node/libp2p/pnet.go': 1, 'core/node/libp2p/pubsub.go': 1, 'core/node/libp2p/routing.go': 1, 'core/node/libp2p/routingopt.go': 1, 'core/node/libp2p/smux.go': 1, 'core/node/libp2p/transport.go': 1, 'core/node/provider.go': 1, 'go.mod': 1, 'go.sum': 1, 'provider/simple/provider.go': 1, 'provider/simple/provider_test.go': 1, 'provider/simple/reprovide.go': 1, 'provider/simple/reprovide_test.go': 1}","('core/commands/dht_test.go', 1.0, 0.7241379310344828)"
test/integration/bitswap_wo_routing_test.go,76,496,1,"[{'cyclomatic_complexity': 16, 'nloc': 65, 'token_count': 480, 'name': 'TestBitswapWithoutRouting', 'long_name': 'TestBitswapWithoutRouting t * testing . T', 'start_line': 16, 'end_line': 99, 'full_parameters': ['t * testing . T'], 'filename': '/home/dimi/Documents/Informatik_Studium/FSS/SoftEvo/DataCollection/FFS_SoftEvo/go-ipfs/test/integration/bitswap_wo_routing_test.go', 'top_nesting_level': 0, 'length': 84, 'fan_in': 0, 'fan_out': 0, 'general_fan_out': 0}]",80,509,1,"[{'cyclomatic_complexity': 17, 'nloc': 68, 'token_count': 494, 'name': 'TestBitswapWithoutRouting', 'long_name': 'TestBitswapWithoutRouting t * testing . T', 'start_line': 16, 'end_line': 102, 'full_parameters': ['t * testing . T'], 'filename': '/home/dimi/Documents/Informatik_Studium/FSS/SoftEvo/DataCollection/FFS_SoftEvo/go-ipfs/test/integration/bitswap_wo_routing_test.go', 'top_nesting_level': 0, 'length': 87, 'fan_in': 0, 'fan_out': 0, 'general_fan_out': 0}]",4,13,0,45,45,"[{'timestamp': 1507304579.0, 'added_lines': 1, 'deleted_lines': 1, 'nloc': 76}, {'timestamp': 1508424715.0, 'added_lines': 1, 'deleted_lines': 1, 'nloc': 76}, {'timestamp': 1491058697.0, 'added_lines': 1, 'deleted_lines': 1, 'nloc': 76}, {'timestamp': 1511223906.0, 'added_lines': 1, 'deleted_lines': 1, 'nloc': 76}, {'timestamp': 1512365669.0, 'added_lines': 3, 'deleted_lines': 3, 'nloc': 76}, {'timestamp': 1516838128.0, 'added_lines': 3, 'deleted_lines': 3, 'nloc': 76}, {'timestamp': 1517105039.0, 'added_lines': 1, 'deleted_lines': 1, 'nloc': 76}, {'timestamp': 1517453697.0, 'added_lines': 1, 'deleted_lines': 1, 'nloc': 76}, {'timestamp': 1525408792.0, 'added_lines': 1, 'deleted_lines': 1, 'nloc': 76}, {'timestamp': 1528131220.0, 'added_lines': 1, 'deleted_lines': 1, 'nloc': 76}, {'timestamp': 1528268108.0, 'added_lines': 1, 'deleted_lines': 1, 'nloc': 76}, {'timestamp': 1528520460.0, 'added_lines': 3, 'deleted_lines': 3, 'nloc': 76}, {'timestamp': 1529984485.0, 'added_lines': 1, 'deleted_lines': 1, 'nloc': 76}, {'timestamp': 1531779409.0, 'added_lines': 2, 'deleted_lines': 2, 'nloc': 76}, {'timestamp': 1532146078.0, 'added_lines': 1, 'deleted_lines': 1, 'nloc': 76}, {'timestamp': 1533779477.0, 'added_lines': 1, 'deleted_lines': 1, 'nloc': 76}, {'timestamp': 1534115707.0, 'added_lines': 2, 'deleted_lines': 2, 'nloc': 76}, {'timestamp': 1534347022.0, 'added_lines': 2, 'deleted_lines': 2, 'nloc': 76}, {'timestamp': 1534896611.0, 'added_lines': 3, 'deleted_lines': 3, 'nloc': 76}, {'timestamp': 1535601896.0, 'added_lines': 1, 'deleted_lines': 1, 'nloc': 76}, {'timestamp': 1536388808.0, 'added_lines': 1, 'deleted_lines': 1, 'nloc': 76}, {'timestamp': 1536718784.0, 'added_lines': 2, 'deleted_lines': 2, 'nloc': 76}, {'timestamp': 1537792589.0, 'added_lines': 1, 'deleted_lines': 1, 'nloc': 76}, {'timestamp': 1538544957.0, 'added_lines': 1, 'deleted_lines': 1, 'nloc': 76}, {'timestamp': 1538695953.0, 'added_lines': 1, 'deleted_lines': 1, 'nloc': 76}, {'timestamp': 1538773916.0, 'added_lines': 1, 'deleted_lines': 1, 'nloc': 76}, {'timestamp': 1539176817.0, 'added_lines': 1, 'deleted_lines': 1, 'nloc': 76}, {'timestamp': 1539357340.0, 'added_lines': 1, 'deleted_lines': 1, 'nloc': 76}, {'timestamp': 1540400358.0, 'added_lines': 1, 'deleted_lines': 1, 'nloc': 76}, {'timestamp': 1540410565.0, 'added_lines': 1, 'deleted_lines': 1, 'nloc': 76}, {'timestamp': 1540418491.0, 'added_lines': 1, 'deleted_lines': 1, 'nloc': 76}, {'timestamp': 1541204121.0, 'added_lines': 3, 'deleted_lines': 3, 'nloc': 76}, {'timestamp': 1541903826.0, 'added_lines': 1, 'deleted_lines': 1, 'nloc': 76}, {'timestamp': 1544225843.0, 'added_lines': 1, 'deleted_lines': 1, 'nloc': 76}, {'timestamp': 1547003974.0, 'added_lines': 1, 'deleted_lines': 1, 'nloc': 76}, {'timestamp': 1549588289.0, 'added_lines': 1, 'deleted_lines': 1, 'nloc': 76}, {'timestamp': 1550185115.0, 'added_lines': 1, 'deleted_lines': 1, 'nloc': 76}, {'timestamp': 1550507829.0, 'added_lines': 1, 'deleted_lines': 1, 'nloc': 76}, {'timestamp': 1550723346.0, 'added_lines': 3, 'deleted_lines': 3, 'nloc': 76}, {'timestamp': 1551229859.0, 'added_lines': 1, 'deleted_lines': 1, 'nloc': 76}, {'timestamp': 1551299964.0, 'added_lines': 1, 'deleted_lines': 1, 'nloc': 76}, {'timestamp': 1551551196.0, 'added_lines': 3, 'deleted_lines': 3, 'nloc': 76}, {'timestamp': 1553697989.0, 'added_lines': 4, 'deleted_lines': 1, 'nloc': 79}, {'timestamp': 1554255872.0, 'added_lines': 2, 'deleted_lines': 1, 'nloc': 80}, {'timestamp': 1556015751.0, 'added_lines': 3, 'deleted_lines': 4, 'nloc': 80}]","{'core/bootstrap.go': 29, 'core/bootstrap_test.go': 26, 'core/commands/dht.go': 41, 'core/commands/dht_test.go': 24, 'core/commands/id.go': 38, 'core/commands/pubsub.go': 32, 'core/core.go': 44, 'core/corehttp/gateway.go': 38, 'core/corehttp/gateway_test.go': 41, 'core/corehttp/metrics_test.go': 37, 'core/mock/mock.go': 39, 'exchange/bitswap/bitswap_test.go': 15, 'exchange/bitswap/decision/bench_test.go': 9, 'exchange/bitswap/decision/engine_test.go': 11, 'exchange/bitswap/decision/peer_request_queue_test.go': 9, 'exchange/bitswap/network/ipfs_impl.go': 11, 'exchange/bitswap/testnet/interface.go': 8, 'exchange/bitswap/testnet/network_test.go': 12, 'exchange/bitswap/testnet/peernet.go': 15, 'exchange/bitswap/testnet/virtual.go': 11, 'exchange/bitswap/testutils.go': 14, 'exchange/reprovide/reprovide_test.go': 35, 'fuse/ipns/ipns_test.go': 32, 'fuse/node/mount_test.go': 32, 'fuse/readonly/ipfs_test.go': 37, 'mfs/repub_test.go': 13, 'namesys/publisher_test.go': 32, 'namesys/republisher/repub_test.go': 43, 'namesys/resolve_test.go': 38, 'p2p/p2p.go': 27, 'package.json': 41, 'routing/mock/centralized_client.go': 5, 'routing/mock/centralized_server.go': 5, 'routing/mock/centralized_test.go': 5, 'routing/mock/interface.go': 5, 'routing/none/none_client.go': 5, 'routing/offline/offline_test.go': 6, 'test/integration/addcat_test.go': 40, 'test/integration/bench_cat_test.go': 40, 'test/integration/bench_test.go': 19, 'test/integration/three_legged_cat_test.go': 40, 'thirdparty/ipfsaddr/ipfsaddr.go': 2, 'core/commands/swarm.go': 35, 'blocks/blockstore/caching.go': 1, 'blocks/blockstore/util/remove.go': 3, 'cmd/ipfs/daemon.go': 24, 'cmd/ipfs/init.go': 21, 'cmd/ipfs/ipfs.go': 16, 'cmd/ipfs/main.go': 26, 'cmd/ipfs/main_test.go': 3, 'cmd/ipfswatch/main.go': 18, 'cmd/seccat/seccat.go': 28, None: 12, 'commands/channelmarshaler.go': 1, 'commands/cli/cmd_suggestion.go': 1, 'commands/cli/helptext.go': 2, 'commands/cli/helptext_test.go': 2, 'commands/cli/parse.go': 2, 'commands/cli/parse_test.go': 2, 'commands/command.go': 13, 'commands/command_test.go': 6, 'commands/http/client.go': 2, 'commands/http/handler.go': 2, 'commands/http/multifilereader.go': 2, 'commands/http/multifilereader_test.go': 2, 'commands/http/parse.go': 2, 'commands/reqlog.go': 2, 'commands/request.go': 17, 'commands/response.go': 8, 'commands/response_test.go': 6, 'core/commands/active.go': 8, 'core/commands/add.go': 29, 'core/commands/bitswap.go': 37, 'core/commands/block.go': 22, 'core/commands/bootstrap.go': 18, 'core/commands/cat.go': 19, 'core/commands/commands.go': 17, 'core/commands/config.go': 19, 'core/commands/dag/dag.go': 34, 'core/commands/diag.go': 8, 'core/commands/dns.go': 12, 'core/commands/e/error.go': 1, 'core/commands/external.go': 8, 'core/commands/files/files.go': 5, 'core/commands/filestore.go': 21, 'core/commands/get.go': 36, 'core/commands/helptext_test.go': 16, 'core/commands/ipns.go': 13, 'core/commands/keystore.go': 18, 'core/commands/log.go': 14, 'core/commands/ls.go': 35, 'core/commands/mount_nofuse.go': 8, 'core/commands/mount_unix.go': 18, 'core/commands/mount_windows.go': 7, 'core/commands/name.go': 5, 'core/commands/object/diff.go': 12, 'core/commands/object/object.go': 35, 'core/commands/object/patch.go': 17, 'core/commands/p2p.go': 22, 'core/commands/pin.go': 36, 'core/commands/ping.go': 28, 'core/commands/publish.go': 12, 'core/commands/refs.go': 33, 'core/commands/repo.go': 33, 'core/commands/resolve.go': 31, 'core/commands/root.go': 16, 'core/commands/shutdown.go': 11, 'core/commands/stat.go': 21, 'core/commands/sysdiag.go': 15, 'core/commands/tar.go': 31, 'core/commands/unixfs/ls.go': 31, 'core/commands/unixfs/unixfs.go': 8, 'core/commands/version.go': 9, 'core/core_test.go': 17, 'core/corehttp/commands.go': 36, 'core/coreunix/add.go': 37, 'core/coreunix/add_test.go': 37, 'core/coreunix/metadata_test.go': 36, 'exchange/bitswap/message/message_test.go': 5, 'exchange/bitswap/message/pb/Makefile': 1, 'fuse/ipns/common.go': 29, 'importer/balanced/balanced_test.go': 7, 'importer/chunk/rabin_test.go': 3, 'importer/helpers/dagbuilder.go': 8, 'importer/importer.go': 8, 'merkledag/utils/utils_test.go': 5, 'namesys/dns.go': 28, 'namesys/interface.go': 29, 'namesys/ipns_select_test.go': 5, 'namesys/proquint.go': 28, 'repo/config/identity.go': 3, 'core/commands/get_test.go': 15, 'exchange/bitswap/message/message.go': 9, 'exchange/bitswap/network/interface.go': 9, 'p2p/registry.go': 12, 'repo/config/bootstrap_peers.go': 12, 'assets/assets.go': 30, 'blocks/blockstore/arc_cache.go': 2, 'blocks/blockstore/arc_cache_test.go': 2, 'blocks/blockstore/blockstore.go': 3, 'blocks/blockstore/blockstore_test.go': 2, 'blocks/blockstore/bloom_cache.go': 2, 'blocks/blockstore/bloom_cache_test.go': 2, 'blocks/blocksutil/block_generator.go': 2, 'blockservice/blockservice.go': 8, 'blockservice/blockservice_test.go': 7, 'blockservice/test/blocks_test.go': 7, 'core/builder.go': 38, 'core/commands/ipnsps.go': 5, 'core/coreapi/coreapi.go': 19, 'core/coreapi/interface/interface.go': 2, 'core/coreapi/unixfs.go': 31, 'core/coreapi/unixfs_test.go': 26, 'core/coredag/cbor.go': 13, 'core/coredag/dagpb.go': 31, 'core/coredag/dagtransl.go': 11, 'core/coredag/raw.go': 31, 'core/corehttp/corehttp.go': 15, 'core/corehttp/gateway_handler.go': 35, 'core/corerepo/gc.go': 35, 'core/corerepo/pinning.go': 13, 'core/coreunix/metadata.go': 31, 'core/pathresolver.go': 34, 'exchange/bitswap/bitswap.go': 8, 'exchange/bitswap/decision/engine.go': 8, 'exchange/bitswap/decision/ledger.go': 7, 'exchange/bitswap/decision/peer_request_queue.go': 7, 'exchange/bitswap/get.go': 7, 'exchange/bitswap/notifications/notifications.go': 4, 'exchange/bitswap/notifications/notifications_test.go': 4, 'exchange/bitswap/session.go': 8, 'exchange/bitswap/session_test.go': 6, 'exchange/bitswap/stat.go': 4, 'exchange/bitswap/wantlist/wantlist.go': 4, 'exchange/bitswap/wantlist/wantlist_test.go': 4, 'exchange/bitswap/wantmanager.go': 8, 'exchange/bitswap/workers.go': 7, 'exchange/interface.go': 2, 'exchange/offline/offline.go': 2, 'exchange/offline/offline_test.go': 2, 'exchange/reprovide/providers.go': 34, 'exchange/reprovide/reprovide.go': 28, 'filestore/filestore.go': 22, 'filestore/filestore_test.go': 34, 'filestore/fsrefstore.go': 21, 'filestore/util.go': 21, 'fuse/ipns/ipns_unix.go': 34, 'fuse/readonly/readonly_unix.go': 35, 'importer/balanced/builder.go': 4, 'importer/chunk/splitting_test.go': 2, 'importer/helpers/helpers.go': 4, 'importer/importer_test.go': 6, 'importer/trickle/trickle_test.go': 6, 'importer/trickle/trickledag.go': 4, 'merkledag/batch.go': 2, 'merkledag/coding.go': 4, 'merkledag/merkledag.go': 4, 'merkledag/merkledag_test.go': 7, 'merkledag/node.go': 4, 'merkledag/node_test.go': 4, 'merkledag/raw.go': 4, 'merkledag/traverse/traverse.go': 4, 'merkledag/traverse/traverse_test.go': 4, 'merkledag/utils/diff.go': 4, 'merkledag/utils/diffenum.go': 4, 'merkledag/utils/diffenum_test.go': 4, 'merkledag/utils/utils.go': 7, 'mfs/dir.go': 7, 'mfs/file.go': 9, 'mfs/mfs_test.go': 10, 'mfs/ops.go': 7, 'mfs/system.go': 10, 'namesys/namesys.go': 37, 'namesys/publisher.go': 35, 'namesys/pubsub.go': 5, 'namesys/pubsub_test.go': 5, 'namesys/republisher/repub.go': 33, 'namesys/routing.go': 38, 'path/path.go': 4, 'path/resolver.go': 3, 'path/resolver_test.go': 2, 'pin/gc/gc.go': 35, 'pin/pin.go': 34, 'pin/pin_test.go': 35, 'pin/set.go': 31, 'pin/set_test.go': 34, 'plugin/ipld.go': 11, 'plugin/loader/initializer.go': 9, 'plugin/plugins/git/git.go': 11, 'repo/config/init.go': 7, 'repo/fsrepo/fsrepo.go': 23, 'repo/fsrepo/lock/lock.go': 3, 'repo/fsrepo/serialize/serialize.go': 3, 'repo/mock.go': 17, 'repo/repo.go': 20, 'routing/offline/offline.go': 3, 'tar/format.go': 34, 'test/dependencies/ma-pipe-unidir/main.go': 11, 'thirdparty/ds-help/key.go': 2, 'thirdparty/pollEndpoint/main.go': 15, 'thirdparty/posinfo/posinfo.go': 2, 'unixfs/archive/archive.go': 4, 'unixfs/archive/tar/writer.go': 4, 'unixfs/hamt/hamt.go': 4, 'unixfs/io/dagreader.go': 4, 'unixfs/io/dirbuilder.go': 3, 'unixfs/io/resolve.go': 4, 'unixfs/mod/dagmodifier.go': 6, 'unixfs/mod/dagmodifier_test.go': 3, 'unixfs/test/utils.go': 6, 'commands/legacy/command.go': 10, 'commands/legacy/legacy.go': 10, 'commands/legacy/legacy_test.go': 10, 'commands/legacy/request.go': 10, 'commands/legacy/response.go': 10, 'core/commands/commands_test.go': 13, 'core/coreapi/dag.go': 10, 'core/coreapi/dag_test.go': 3, 'core/coreapi/interface/options/dag.go': 8, 'core/coreapi/key.go': 32, 'core/coreapi/name.go': 35, 'merkledag/test/utils.go': 6, 'namesys/namesys_test.go': 35, 'repo/fsrepo/datastores.go': 15, 'repo/fsrepo/fsrepo_test.go': 17, 'thirdparty/datastore2/datastore_closer.go': 1, 'thirdparty/datastore2/delayed.go': 1, 'thirdparty/datastore2/threadsafe.go': 1, 'unixfs/io/pbdagreader.go': 3, 'cmd/ipfs/util/ulimit.go': 9, 'cmd/seccat/util.go': 9, 'core/corehttp/logs.go': 9, 'fuse/mount/mount.go': 9, 'fuse/node/mount_unix.go': 10, 'importer/chunk/splitting.go': 1, 'namesys/ipns_validate_test.go': 5, 'plugin/loader/load.go': 7, 'blocks/blockstoreutil/remove.go': 19, 'blockservice/test/mock.go': 6, 'core/commands/files.go': 33, 'core/coreapi/pin.go': 32, 'keystore/keystore.go': 8, 'keystore/keystore_test.go': 6, 'keystore/memkeystore.go': 5, 'namesys/validator.go': 3, 'path/resolver/resolver.go': 4, 'thirdparty/verifbs/verifbs.go': 19, 'cmd/ipfs/util/ulimit_freebsd.go': 2, 'cmd/ipfs/util/ulimit_unix.go': 2, 'core/coreapi/block.go': 13, 'core/coreapi/block_test.go': 2, 'core/coreapi/interface/coreapi.go': 7, 'core/coreapi/interface/dag.go': 7, 'core/coreapi/interface/object.go': 7, 'core/coreapi/interface/options/block.go': 3, 'core/coreapi/interface/path.go': 23, 'core/coreapi/interface/unixfs.go': 8, 'core/coreapi/object.go': 29, 'fuse/ipns/link_unix.go': 2, 'fuse/mount/fuse.go': 3, 'fuse/node/mount_darwin.go': 2, 'merkledag/errservice.go': 2, 'merkledag/readonly.go': 2, 'merkledag/readonly_test.go': 2, 'merkledag/rwservice.go': 2, 'merkledag/session.go': 2, 'path/resolver/resolver_test.go': 2, 'thirdparty/verifcid/validate.go': 2, 'thirdparty/verifcid/validate_test.go': 2, 'unixfs/hamt/hamt_stress_test.go': 2, 'unixfs/hamt/hamt_test.go': 2, 'namesys/ipns_resolver_validation_test.go': 29, 'test/sharness/t0170-dht.sh': 1, 'core/commands/urlstore.go': 28, 'unixfs/io/directory.go': 1, 'core/corehttp/metrics.go': 2, 'core/commands/env.go': 2, 'core/coreapi/interface/key.go': 7, 'core/coreapi/name_test.go': 19, 'core/coreapi/path.go': 27, 'core/coreunix/cat.go': 8, 'core/pathresolver_test.go': 27, 'dagutils/diff.go': 28, 'dagutils/diffenum.go': 27, 'dagutils/diffenum_test.go': 27, 'dagutils/utils.go': 28, 'dagutils/utils_test.go': 27, 'filestore/pb/dataobj.pb.go': 3, 'mfs/fd.go': 3, 'namesys/base.go': 27, 'namesys/cache.go': 27, 'pin/internal/pb/header.pb.go': 3, 'thirdparty/cidv0v1/blockstore.go': 14, 'repo/fsrepo/config_test.go': 13, 'repo/fsrepo/misc.go': 13, 'test/bench/bench_cli_ipfs_add/main.go': 14, 'test/bench/offline_add/main.go': 14, 'core/commands/cmdenv/env.go': 15, 'core/commands/name/ipns.go': 23, 'core/commands/name/publish.go': 12, 'core/coreapi/dht.go': 21, 'core/coreapi/dht_test.go': 5, 'test/sharness/t0275-cid-security.sh': 1, 'core/commands/name/ipnsps.go': 9, 'core/commands/name/name.go': 5, 'core/coreapi/interface/dht.go': 10, 'p2p/listener.go': 13, 'p2p/local.go': 13, 'p2p/remote.go': 14, 'p2p/stream.go': 14, 'core/coreapi/interface/swarm.go': 9, 'core/coreapi/swarm.go': 19, 'core/coreapi/interface/options/unixfs.go': 11, 'core/coreapi/pubsub.go': 17, 'core/coreapi/unixfile.go': 10, 'cmd/ipfs/dnsresolve_test.go': 5, 'core/coreapi/interface/pubsub.go': 4, 'core/commands/cid.go': 6, 'test/dependencies/iptb/iptb.go': 11, 'plugin/plugins/badgerds/badgerds.go': 3, 'plugin/plugins/flatfs/flatfs.go': 3, 'plugin/plugins/levelds/levelds.go': 3, 'commands/context.go': 9, 'core/corehttp/proxy.go': 9, 'core/coreapi/interface/tests/name.go': 2, 'core/coreapi/interface/tests/unixfs.go': 2, 'core/coreapi/test/api_test.go': 9, 'core/corehttp/ipns_hostname.go': 6, 'namesys/dns_test.go': 6, 'plugin/daemon.go': 6, 'plugin/loader/loader.go': 7, 'core/commands/cmdenv/cidbase.go': 4, 'core/commands/cmdenv/cidbase_test.go': 2, 'core/commands/cmdenv/file.go': 1, 'core/corehttp/proxy_test.go': 1, 'core/corerepo/stat.go': 1, 'plugin/tracer.go': 1, 'thirdparty/notifier/notifier.go': 1, 'core/corehttp/mutex_profile.go': 1, 'core/corehttp/option_test.go': 1, 'provider/queue.go': 1, 'provider/queue_test.go': 1, 'core/bootstrap/bootstrap.go': 1, 'core/bootstrap/bootstrap_test.go': 1, 'core/ncore.go': 1, 'core/node/builder.go': 2, 'core/node/core.go': 2, 'core/node/discovery.go': 1, 'core/node/groups.go': 2, 'core/node/helpers.go': 2, 'core/node/identity.go': 1, 'core/node/ipns.go': 1, 'core/node/libp2p.go': 1, 'core/node/provider.go': 2, 'core/node/storage.go': 2, 'core/node/helpers/helpers.go': 1, 'core/node/libp2p/discovery.go': 1, 'core/node/libp2p/libp2p.go': 1}","('core/core.go', 0.9777777777777777, 0.24581005586592178)"
test/integration/three_legged_cat_test.go,112,675,6,"[{'cyclomatic_complexity': 2, 'nloc': 10, 'token_count': 58, 'name': 'TestThreeLeggedCatTransfer', 'long_name': 'TestThreeLeggedCatTransfer t * testing . T', 'start_line': 22, 'end_line': 31, 'full_parameters': ['t * testing . T'], 'filename': '/home/dimi/Documents/Informatik_Studium/FSS/SoftEvo/DataCollection/FFS_SoftEvo/go-ipfs/test/integration/three_legged_cat_test.go', 'top_nesting_level': 0, 'length': 10, 'fan_in': 0, 'fan_out': 0, 'general_fan_out': 0}, {'cyclomatic_complexity': 2, 'nloc': 7, 'token_count': 57, 'name': 'TestThreeLeggedCatDegenerateSlowBlockstore', 'long_name': 'TestThreeLeggedCatDegenerateSlowBlockstore t * testing . T', 'start_line': 33, 'end_line': 39, 'full_parameters': ['t * testing . T'], 'filename': '/home/dimi/Documents/Informatik_Studium/FSS/SoftEvo/DataCollection/FFS_SoftEvo/go-ipfs/test/integration/three_legged_cat_test.go', 'top_nesting_level': 0, 'length': 7, 'fan_in': 0, 'fan_out': 0, 'general_fan_out': 0}, {'cyclomatic_complexity': 2, 'nloc': 7, 'token_count': 57, 'name': 'TestThreeLeggedCatDegenerateSlowNetwork', 'long_name': 'TestThreeLeggedCatDegenerateSlowNetwork t * testing . T', 'start_line': 41, 'end_line': 47, 'full_parameters': ['t * testing . T'], 'filename': '/home/dimi/Documents/Informatik_Studium/FSS/SoftEvo/DataCollection/FFS_SoftEvo/go-ipfs/test/integration/three_legged_cat_test.go', 'top_nesting_level': 0, 'length': 7, 'fan_in': 0, 'fan_out': 0, 'general_fan_out': 0}, {'cyclomatic_complexity': 2, 'nloc': 7, 'token_count': 57, 'name': 'TestThreeLeggedCatDegenerateSlowRouting', 'long_name': 'TestThreeLeggedCatDegenerateSlowRouting t * testing . T', 'start_line': 49, 'end_line': 55, 'full_parameters': ['t * testing . T'], 'filename': '/home/dimi/Documents/Informatik_Studium/FSS/SoftEvo/DataCollection/FFS_SoftEvo/go-ipfs/test/integration/three_legged_cat_test.go', 'top_nesting_level': 0, 'length': 7, 'fan_in': 0, 'fan_out': 0, 'general_fan_out': 0}, {'cyclomatic_complexity': 2, 'nloc': 7, 'token_count': 62, 'name': 'TestThreeLeggedCat100MBMacbookCoastToCoast', 'long_name': 'TestThreeLeggedCat100MBMacbookCoastToCoast t * testing . T', 'start_line': 57, 'end_line': 63, 'full_parameters': ['t * testing . T'], 'filename': '/home/dimi/Documents/Informatik_Studium/FSS/SoftEvo/DataCollection/FFS_SoftEvo/go-ipfs/test/integration/three_legged_cat_test.go', 'top_nesting_level': 0, 'length': 7, 'fan_in': 0, 'fan_out': 0, 'general_fan_out': 0}, {'cyclomatic_complexity': 9, 'nloc': 57, 'token_count': 358, 'name': 'RunThreeLeggedCat', 'long_name': 'RunThreeLeggedCat data [ ] byte , conf testutil . LatencyConfig', 'start_line': 65, 'end_line': 132, 'full_parameters': ['data [ ] byte', ' conf testutil . LatencyConfig'], 'filename': '/home/dimi/Documents/Informatik_Studium/FSS/SoftEvo/DataCollection/FFS_SoftEvo/go-ipfs/test/integration/three_legged_cat_test.go', 'top_nesting_level': 0, 'length': 68, 'fan_in': 0, 'fan_out': 0, 'general_fan_out': 0}]",117,685,6,"[{'cyclomatic_complexity': 2, 'nloc': 10, 'token_count': 58, 'name': 'TestThreeLeggedCatTransfer', 'long_name': 'TestThreeLeggedCatTransfer t * testing . T', 'start_line': 23, 'end_line': 32, 'full_parameters': ['t * testing . T'], 'filename': '/home/dimi/Documents/Informatik_Studium/FSS/SoftEvo/DataCollection/FFS_SoftEvo/go-ipfs/test/integration/three_legged_cat_test.go', 'top_nesting_level': 0, 'length': 10, 'fan_in': 0, 'fan_out': 0, 'general_fan_out': 0}, {'cyclomatic_complexity': 2, 'nloc': 7, 'token_count': 57, 'name': 'TestThreeLeggedCatDegenerateSlowBlockstore', 'long_name': 'TestThreeLeggedCatDegenerateSlowBlockstore t * testing . T', 'start_line': 34, 'end_line': 40, 'full_parameters': ['t * testing . T'], 'filename': '/home/dimi/Documents/Informatik_Studium/FSS/SoftEvo/DataCollection/FFS_SoftEvo/go-ipfs/test/integration/three_legged_cat_test.go', 'top_nesting_level': 0, 'length': 7, 'fan_in': 0, 'fan_out': 0, 'general_fan_out': 0}, {'cyclomatic_complexity': 2, 'nloc': 7, 'token_count': 57, 'name': 'TestThreeLeggedCatDegenerateSlowNetwork', 'long_name': 'TestThreeLeggedCatDegenerateSlowNetwork t * testing . T', 'start_line': 42, 'end_line': 48, 'full_parameters': ['t * testing . T'], 'filename': '/home/dimi/Documents/Informatik_Studium/FSS/SoftEvo/DataCollection/FFS_SoftEvo/go-ipfs/test/integration/three_legged_cat_test.go', 'top_nesting_level': 0, 'length': 7, 'fan_in': 0, 'fan_out': 0, 'general_fan_out': 0}, {'cyclomatic_complexity': 2, 'nloc': 7, 'token_count': 57, 'name': 'TestThreeLeggedCatDegenerateSlowRouting', 'long_name': 'TestThreeLeggedCatDegenerateSlowRouting t * testing . T', 'start_line': 50, 'end_line': 56, 'full_parameters': ['t * testing . T'], 'filename': '/home/dimi/Documents/Informatik_Studium/FSS/SoftEvo/DataCollection/FFS_SoftEvo/go-ipfs/test/integration/three_legged_cat_test.go', 'top_nesting_level': 0, 'length': 7, 'fan_in': 0, 'fan_out': 0, 'general_fan_out': 0}, {'cyclomatic_complexity': 2, 'nloc': 7, 'token_count': 62, 'name': 'TestThreeLeggedCat100MBMacbookCoastToCoast', 'long_name': 'TestThreeLeggedCat100MBMacbookCoastToCoast t * testing . T', 'start_line': 58, 'end_line': 64, 'full_parameters': ['t * testing . T'], 'filename': '/home/dimi/Documents/Informatik_Studium/FSS/SoftEvo/DataCollection/FFS_SoftEvo/go-ipfs/test/integration/three_legged_cat_test.go', 'top_nesting_level': 0, 'length': 7, 'fan_in': 0, 'fan_out': 0, 'general_fan_out': 0}, {'cyclomatic_complexity': 13, 'nloc': 61, 'token_count': 368, 'name': 'RunThreeLeggedCat', 'long_name': 'RunThreeLeggedCat data [ ] byte , conf testutil . LatencyConfig', 'start_line': 66, 'end_line': 140, 'full_parameters': ['data [ ] byte', ' conf testutil . LatencyConfig'], 'filename': '/home/dimi/Documents/Informatik_Studium/FSS/SoftEvo/DataCollection/FFS_SoftEvo/go-ipfs/test/integration/three_legged_cat_test.go', 'top_nesting_level': 0, 'length': 75, 'fan_in': 0, 'fan_out': 0, 'general_fan_out': 0}]",5,10,0,50,50,"[{'timestamp': 1507212616.0, 'added_lines': 1, 'deleted_lines': 1, 'nloc': 112}, {'timestamp': 1507304579.0, 'added_lines': 2, 'deleted_lines': 2, 'nloc': 112}, {'timestamp': 1508424715.0, 'added_lines': 1, 'deleted_lines': 1, 'nloc': 112}, {'timestamp': 1491058697.0, 'added_lines': 2, 'deleted_lines': 2, 'nloc': 112}, {'timestamp': 1511223906.0, 'added_lines': 2, 'deleted_lines': 2, 'nloc': 112}, {'timestamp': 1512365669.0, 'added_lines': 3, 'deleted_lines': 3, 'nloc': 112}, {'timestamp': 1516838128.0, 'added_lines': 3, 'deleted_lines': 3, 'nloc': 112}, {'timestamp': 1517105039.0, 'added_lines': 1, 'deleted_lines': 1, 'nloc': 112}, {'timestamp': 1517453697.0, 'added_lines': 3, 'deleted_lines': 3, 'nloc': 112}, {'timestamp': 1525408792.0, 'added_lines': 3, 'deleted_lines': 3, 'nloc': 112}, {'timestamp': 1528131220.0, 'added_lines': 1, 'deleted_lines': 1, 'nloc': 112}, {'timestamp': 1528268108.0, 'added_lines': 2, 'deleted_lines': 2, 'nloc': 112}, {'timestamp': 1528520460.0, 'added_lines': 3, 'deleted_lines': 3, 'nloc': 112}, {'timestamp': 1529984485.0, 'added_lines': 3, 'deleted_lines': 3, 'nloc': 112}, {'timestamp': 1532146078.0, 'added_lines': 1, 'deleted_lines': 1, 'nloc': 112}, {'timestamp': 1533779477.0, 'added_lines': 3, 'deleted_lines': 3, 'nloc': 112}, {'timestamp': 1534896611.0, 'added_lines': 3, 'deleted_lines': 3, 'nloc': 112}, {'timestamp': 1535601896.0, 'added_lines': 1, 'deleted_lines': 1, 'nloc': 112}, {'timestamp': 1536388808.0, 'added_lines': 2, 'deleted_lines': 2, 'nloc': 112}, {'timestamp': 1537792589.0, 'added_lines': 3, 'deleted_lines': 3, 'nloc': 112}, {'timestamp': 1537393245.0, 'added_lines': 11, 'deleted_lines': 1, 'nloc': 119}, {'timestamp': 1538544957.0, 'added_lines': 2, 'deleted_lines': 2, 'nloc': 119}, {'timestamp': 1538695953.0, 'added_lines': 1, 'deleted_lines': 1, 'nloc': 119}, {'timestamp': 1538773916.0, 'added_lines': 2, 'deleted_lines': 2, 'nloc': 119}, {'timestamp': 1539176817.0, 'added_lines': 2, 'deleted_lines': 2, 'nloc': 119}, {'timestamp': 1539357340.0, 'added_lines': 1, 'deleted_lines': 1, 'nloc': 119}, {'timestamp': 1539104245.0, 'added_lines': 1, 'deleted_lines': 1, 'nloc': 119}, {'timestamp': 1540400358.0, 'added_lines': 3, 'deleted_lines': 3, 'nloc': 119}, {'timestamp': 1540410565.0, 'added_lines': 1, 'deleted_lines': 1, 'nloc': 119}, {'timestamp': 1540418491.0, 'added_lines': 1, 'deleted_lines': 1, 'nloc': 119}, {'timestamp': 1541204121.0, 'added_lines': 3, 'deleted_lines': 3, 'nloc': 119}, {'timestamp': 1541903826.0, 'added_lines': 2, 'deleted_lines': 2, 'nloc': 119}, {'timestamp': 1544225843.0, 'added_lines': 3, 'deleted_lines': 3, 'nloc': 119}, {'timestamp': 1542594282.0, 'added_lines': 1, 'deleted_lines': 1, 'nloc': 119}, {'timestamp': 1544131548.0, 'added_lines': 4, 'deleted_lines': 1, 'nloc': 122}, {'timestamp': 1547003974.0, 'added_lines': 3, 'deleted_lines': 3, 'nloc': 122}, {'timestamp': 1548165641.0, 'added_lines': 8, 'deleted_lines': 9, 'nloc': 121}, {'timestamp': 1548866534.0, 'added_lines': 1, 'deleted_lines': 1, 'nloc': 121}, {'timestamp': 1549588289.0, 'added_lines': 3, 'deleted_lines': 3, 'nloc': 121}, {'timestamp': 1549903582.0, 'added_lines': 1, 'deleted_lines': 1, 'nloc': 121}, {'timestamp': 1550185115.0, 'added_lines': 1, 'deleted_lines': 1, 'nloc': 121}, {'timestamp': 1550507829.0, 'added_lines': 3, 'deleted_lines': 3, 'nloc': 121}, {'timestamp': 1550723346.0, 'added_lines': 1, 'deleted_lines': 1, 'nloc': 121}, {'timestamp': 1551229859.0, 'added_lines': 3, 'deleted_lines': 3, 'nloc': 121}, {'timestamp': 1551299964.0, 'added_lines': 1, 'deleted_lines': 1, 'nloc': 121}, {'timestamp': 1551551196.0, 'added_lines': 4, 'deleted_lines': 4, 'nloc': 121}, {'timestamp': 1553697989.0, 'added_lines': 10, 'deleted_lines': 5, 'nloc': 126}, {'timestamp': 1554255872.0, 'added_lines': 2, 'deleted_lines': 1, 'nloc': 127}, {'timestamp': 1559060517.0, 'added_lines': 3, 'deleted_lines': 3, 'nloc': 127}, {'timestamp': 1584668316.0, 'added_lines': 3, 'deleted_lines': 13, 'nloc': 117}]","{'core/bootstrap_test.go': 27, 'core/commands/dht_test.go': 26, 'core/mock/mock.go': 41, 'exchange/bitswap/bitswap_test.go': 15, 'exchange/bitswap/decision/bench_test.go': 9, 'exchange/bitswap/decision/engine_test.go': 11, 'exchange/bitswap/decision/peer_request_queue_test.go': 9, 'exchange/bitswap/testnet/interface.go': 9, 'exchange/bitswap/testnet/network_test.go': 12, 'exchange/bitswap/testnet/peernet.go': 15, 'exchange/bitswap/testnet/virtual.go': 11, 'exchange/bitswap/testutils.go': 14, 'exchange/reprovide/reprovide_test.go': 32, 'fuse/ipns/ipns_test.go': 30, 'fuse/node/mount_test.go': 30, 'fuse/readonly/ipfs_test.go': 41, 'mfs/repub_test.go': 11, 'namesys/publisher_test.go': 30, 'namesys/resolve_test.go': 36, 'package.json': 40, 'routing/mock/centralized_client.go': 6, 'routing/mock/centralized_server.go': 6, 'routing/mock/centralized_test.go': 6, 'routing/mock/interface.go': 6, 'routing/offline/offline_test.go': 7, 'test/integration/addcat_test.go': 49, 'test/integration/bench_cat_test.go': 49, 'test/integration/bench_test.go': 21, 'test/integration/grandcentral_test.go': 1, 'core/bootstrap.go': 29, 'core/commands/dht.go': 40, 'core/commands/id.go': 41, 'core/commands/pubsub.go': 30, 'core/core.go': 42, 'core/corehttp/gateway.go': 40, 'core/corehttp/gateway_test.go': 42, 'core/corehttp/metrics_test.go': 38, 'exchange/bitswap/network/ipfs_impl.go': 10, 'namesys/republisher/repub_test.go': 42, 'p2p/p2p.go': 28, 'routing/none/none_client.go': 5, 'test/integration/bitswap_wo_routing_test.go': 40, 'thirdparty/ipfsaddr/ipfsaddr.go': 2, 'core/commands/swarm.go': 38, 'blocks/blockstore/caching.go': 1, 'blocks/blockstore/util/remove.go': 3, 'cmd/ipfs/daemon.go': 25, 'cmd/ipfs/init.go': 24, 'cmd/ipfs/ipfs.go': 18, 'cmd/ipfs/main.go': 28, 'cmd/ipfs/main_test.go': 3, 'cmd/ipfswatch/main.go': 21, 'cmd/seccat/seccat.go': 29, None: 13, 'commands/channelmarshaler.go': 1, 'commands/cli/cmd_suggestion.go': 1, 'commands/cli/helptext.go': 2, 'commands/cli/helptext_test.go': 2, 'commands/cli/parse.go': 2, 'commands/cli/parse_test.go': 2, 'commands/command.go': 13, 'commands/command_test.go': 6, 'commands/http/client.go': 2, 'commands/http/handler.go': 2, 'commands/http/multifilereader.go': 2, 'commands/http/multifilereader_test.go': 2, 'commands/http/parse.go': 2, 'commands/reqlog.go': 2, 'commands/request.go': 17, 'commands/response.go': 8, 'commands/response_test.go': 6, 'core/commands/active.go': 10, 'core/commands/add.go': 28, 'core/commands/bitswap.go': 36, 'core/commands/block.go': 22, 'core/commands/bootstrap.go': 20, 'core/commands/cat.go': 24, 'core/commands/commands.go': 19, 'core/commands/config.go': 22, 'core/commands/dag/dag.go': 33, 'core/commands/diag.go': 10, 'core/commands/dns.go': 15, 'core/commands/e/error.go': 1, 'core/commands/external.go': 10, 'core/commands/files/files.go': 5, 'core/commands/filestore.go': 19, 'core/commands/get.go': 35, 'core/commands/helptext_test.go': 18, 'core/commands/ipns.go': 10, 'core/commands/keystore.go': 20, 'core/commands/log.go': 16, 'core/commands/ls.go': 34, 'core/commands/mount_nofuse.go': 10, 'core/commands/mount_unix.go': 20, 'core/commands/mount_windows.go': 9, 'core/commands/name.go': 5, 'core/commands/object/diff.go': 14, 'core/commands/object/object.go': 34, 'core/commands/object/patch.go': 20, 'core/commands/p2p.go': 25, 'core/commands/pin.go': 35, 'core/commands/ping.go': 31, 'core/commands/publish.go': 10, 'core/commands/refs.go': 31, 'core/commands/repo.go': 31, 'core/commands/resolve.go': 30, 'core/commands/root.go': 18, 'core/commands/shutdown.go': 13, 'core/commands/stat.go': 24, 'core/commands/sysdiag.go': 17, 'core/commands/tar.go': 31, 'core/commands/unixfs/ls.go': 31, 'core/commands/unixfs/unixfs.go': 10, 'core/commands/version.go': 11, 'core/core_test.go': 17, 'core/corehttp/commands.go': 35, 'core/coreunix/add.go': 37, 'core/coreunix/add_test.go': 37, 'core/coreunix/metadata_test.go': 34, 'exchange/bitswap/message/message_test.go': 4, 'exchange/bitswap/message/pb/Makefile': 1, 'fuse/ipns/common.go': 29, 'importer/balanced/balanced_test.go': 6, 'importer/chunk/rabin_test.go': 3, 'importer/helpers/dagbuilder.go': 7, 'importer/importer.go': 7, 'merkledag/utils/utils_test.go': 4, 'namesys/dns.go': 26, 'namesys/interface.go': 28, 'namesys/ipns_select_test.go': 5, 'namesys/proquint.go': 26, 'repo/config/identity.go': 3, 'core/commands/get_test.go': 17, 'exchange/bitswap/message/message.go': 8, 'exchange/bitswap/network/interface.go': 8, 'p2p/registry.go': 12, 'repo/config/bootstrap_peers.go': 12, 'assets/assets.go': 29, 'blocks/blockstore/arc_cache.go': 2, 'blocks/blockstore/arc_cache_test.go': 2, 'blocks/blockstore/blockstore.go': 3, 'blocks/blockstore/blockstore_test.go': 2, 'blocks/blockstore/bloom_cache.go': 2, 'blocks/blockstore/bloom_cache_test.go': 2, 'blocks/blocksutil/block_generator.go': 2, 'blockservice/blockservice.go': 7, 'blockservice/blockservice_test.go': 6, 'blockservice/test/blocks_test.go': 6, 'core/builder.go': 36, 'core/commands/ipnsps.go': 5, 'core/coreapi/coreapi.go': 21, 'core/coreapi/interface/interface.go': 2, 'core/coreapi/unixfs.go': 31, 'core/coreapi/unixfs_test.go': 25, 'core/coredag/cbor.go': 9, 'core/coredag/dagpb.go': 27, 'core/coredag/dagtransl.go': 7, 'core/coredag/raw.go': 27, 'core/corehttp/corehttp.go': 15, 'core/corehttp/gateway_handler.go': 36, 'core/corerepo/gc.go': 33, 'core/corerepo/pinning.go': 10, 'core/coreunix/metadata.go': 29, 'core/pathresolver.go': 31, 'exchange/bitswap/bitswap.go': 7, 'exchange/bitswap/decision/engine.go': 7, 'exchange/bitswap/decision/ledger.go': 6, 'exchange/bitswap/decision/peer_request_queue.go': 6, 'exchange/bitswap/get.go': 6, 'exchange/bitswap/notifications/notifications.go': 3, 'exchange/bitswap/notifications/notifications_test.go': 3, 'exchange/bitswap/session.go': 7, 'exchange/bitswap/session_test.go': 5, 'exchange/bitswap/stat.go': 3, 'exchange/bitswap/wantlist/wantlist.go': 3, 'exchange/bitswap/wantlist/wantlist_test.go': 3, 'exchange/bitswap/wantmanager.go': 7, 'exchange/bitswap/workers.go': 6, 'exchange/interface.go': 2, 'exchange/offline/offline.go': 2, 'exchange/offline/offline_test.go': 2, 'exchange/reprovide/providers.go': 30, 'exchange/reprovide/reprovide.go': 24, 'filestore/filestore.go': 18, 'filestore/filestore_test.go': 30, 'filestore/fsrefstore.go': 17, 'filestore/util.go': 17, 'fuse/ipns/ipns_unix.go': 33, 'fuse/readonly/readonly_unix.go': 33, 'importer/balanced/builder.go': 3, 'importer/chunk/splitting_test.go': 2, 'importer/helpers/helpers.go': 3, 'importer/importer_test.go': 5, 'importer/trickle/trickle_test.go': 5, 'importer/trickle/trickledag.go': 3, 'merkledag/batch.go': 2, 'merkledag/coding.go': 3, 'merkledag/merkledag.go': 3, 'merkledag/merkledag_test.go': 6, 'merkledag/node.go': 3, 'merkledag/node_test.go': 3, 'merkledag/raw.go': 3, 'merkledag/traverse/traverse.go': 3, 'merkledag/traverse/traverse_test.go': 3, 'merkledag/utils/diff.go': 3, 'merkledag/utils/diffenum.go': 3, 'merkledag/utils/diffenum_test.go': 3, 'merkledag/utils/utils.go': 6, 'mfs/dir.go': 4, 'mfs/file.go': 6, 'mfs/mfs_test.go': 7, 'mfs/ops.go': 4, 'mfs/system.go': 7, 'namesys/namesys.go': 35, 'namesys/publisher.go': 34, 'namesys/pubsub.go': 5, 'namesys/pubsub_test.go': 5, 'namesys/republisher/repub.go': 31, 'namesys/routing.go': 36, 'path/path.go': 3, 'path/resolver.go': 3, 'path/resolver_test.go': 2, 'pin/gc/gc.go': 31, 'pin/pin.go': 30, 'pin/pin_test.go': 31, 'pin/set.go': 27, 'pin/set_test.go': 30, 'plugin/ipld.go': 7, 'plugin/loader/initializer.go': 5, 'plugin/plugins/git/git.go': 7, 'repo/config/init.go': 7, 'repo/fsrepo/fsrepo.go': 23, 'repo/fsrepo/lock/lock.go': 3, 'repo/fsrepo/serialize/serialize.go': 3, 'repo/mock.go': 17, 'repo/repo.go': 20, 'routing/offline/offline.go': 3, 'tar/format.go': 32, 'test/dependencies/ma-pipe-unidir/main.go': 11, 'thirdparty/ds-help/key.go': 2, 'thirdparty/pollEndpoint/main.go': 15, 'thirdparty/posinfo/posinfo.go': 2, 'unixfs/archive/archive.go': 3, 'unixfs/archive/tar/writer.go': 3, 'unixfs/hamt/hamt.go': 3, 'unixfs/io/dagreader.go': 3, 'unixfs/io/dirbuilder.go': 3, 'unixfs/io/resolve.go': 3, 'unixfs/mod/dagmodifier.go': 5, 'unixfs/mod/dagmodifier_test.go': 3, 'unixfs/test/utils.go': 5, 'commands/legacy/command.go': 10, 'commands/legacy/legacy.go': 10, 'commands/legacy/legacy_test.go': 10, 'commands/legacy/request.go': 10, 'commands/legacy/response.go': 10, 'core/commands/commands_test.go': 15, 'core/coreapi/dag.go': 6, 'core/coreapi/dag_test.go': 3, 'core/coreapi/interface/options/dag.go': 4, 'core/coreapi/key.go': 31, 'core/coreapi/name.go': 34, 'merkledag/test/utils.go': 5, 'namesys/namesys_test.go': 34, 'repo/fsrepo/datastores.go': 15, 'repo/fsrepo/fsrepo_test.go': 17, 'thirdparty/datastore2/datastore_closer.go': 1, 'thirdparty/datastore2/delayed.go': 1, 'thirdparty/datastore2/threadsafe.go': 1, 'unixfs/io/pbdagreader.go': 2, 'cmd/ipfs/util/ulimit.go': 9, 'cmd/seccat/util.go': 9, 'core/corehttp/logs.go': 9, 'fuse/mount/mount.go': 9, 'fuse/node/mount_unix.go': 10, 'importer/chunk/splitting.go': 1, 'namesys/ipns_validate_test.go': 5, 'plugin/loader/load.go': 7, 'blocks/blockstoreutil/remove.go': 15, 'blockservice/test/mock.go': 5, 'core/commands/files.go': 33, 'core/coreapi/pin.go': 30, 'keystore/keystore.go': 9, 'keystore/keystore_test.go': 7, 'keystore/memkeystore.go': 6, 'namesys/validator.go': 3, 'path/resolver/resolver.go': 3, 'thirdparty/verifbs/verifbs.go': 15, 'cmd/ipfs/util/ulimit_freebsd.go': 2, 'cmd/ipfs/util/ulimit_unix.go': 2, 'core/coreapi/block.go': 10, 'core/coreapi/block_test.go': 2, 'core/coreapi/interface/coreapi.go': 3, 'core/coreapi/interface/dag.go': 3, 'core/coreapi/interface/object.go': 3, 'core/coreapi/interface/options/block.go': 2, 'core/coreapi/interface/path.go': 19, 'core/coreapi/interface/unixfs.go': 7, 'core/coreapi/object.go': 27, 'fuse/ipns/link_unix.go': 2, 'fuse/mount/fuse.go': 3, 'fuse/node/mount_darwin.go': 2, 'merkledag/errservice.go': 1, 'merkledag/readonly.go': 1, 'merkledag/readonly_test.go': 1, 'merkledag/rwservice.go': 1, 'merkledag/session.go': 1, 'path/resolver/resolver_test.go': 1, 'thirdparty/verifcid/validate.go': 1, 'thirdparty/verifcid/validate_test.go': 1, 'unixfs/hamt/hamt_stress_test.go': 1, 'unixfs/hamt/hamt_test.go': 1, 'namesys/ipns_resolver_validation_test.go': 27, 'test/sharness/t0170-dht.sh': 1, 'core/corehttp/metrics.go': 2, 'core/commands/env.go': 2, 'core/commands/urlstore.go': 26, 'core/coreapi/interface/key.go': 7, 'core/coreapi/name_test.go': 16, 'core/coreapi/path.go': 26, 'core/coreunix/cat.go': 5, 'core/pathresolver_test.go': 24, 'dagutils/diff.go': 26, 'dagutils/diffenum.go': 24, 'dagutils/diffenum_test.go': 24, 'dagutils/utils.go': 25, 'dagutils/utils_test.go': 24, 'filestore/pb/dataobj.pb.go': 3, 'mfs/fd.go': 1, 'namesys/base.go': 25, 'namesys/cache.go': 24, 'pin/internal/pb/header.pb.go': 3, 'thirdparty/cidv0v1/blockstore.go': 11, 'repo/fsrepo/config_test.go': 13, 'repo/fsrepo/misc.go': 13, 'test/bench/bench_cli_ipfs_add/main.go': 14, 'test/bench/offline_add/main.go': 14, 'core/commands/cmdenv/env.go': 17, 'core/commands/name/ipns.go': 24, 'core/commands/name/publish.go': 13, 'core/commands/name/ipnsps.go': 12, 'core/commands/name/name.go': 7, 'core/coreapi/dht.go': 23, 'core/coreapi/dht_test.go': 4, 'core/coreapi/interface/dht.go': 10, 'p2p/listener.go': 14, 'p2p/local.go': 14, 'p2p/remote.go': 15, 'p2p/stream.go': 15, 'core/coreapi/interface/util.go': 1, 'core/coreapi/interface/swarm.go': 9, 'core/coreapi/swarm.go': 21, 'core/coreapi/interface/options/unixfs.go': 11, 'core/coreapi/pubsub.go': 20, 'core/coreapi/unixfile.go': 11, 'cmd/ipfs/dnsresolve_test.go': 5, 'core/coreapi/interface/pubsub.go': 4, 'core/commands/cid.go': 8, 'test/dependencies/iptb/iptb.go': 11, 'plugin/plugins/badgerds/badgerds.go': 3, 'plugin/plugins/flatfs/flatfs.go': 3, 'plugin/plugins/levelds/levelds.go': 3, 'commands/context.go': 12, 'core/corehttp/proxy.go': 10, 'core/coreapi/interface/tests/name.go': 3, 'core/coreapi/interface/tests/unixfs.go': 3, 'core/coreapi/test/api_test.go': 12, 'core/commands/cmdenv/cidbase.go': 6, 'core/commands/cmdenv/file.go': 3, 'core/corehttp/ipns_hostname.go': 7, 'namesys/dns_test.go': 7, 'plugin/daemon.go': 7, 'plugin/loader/loader.go': 8, 'core/commands/cmdenv/cidbase_test.go': 2, 'core/corehttp/proxy_test.go': 2, 'core/corerepo/stat.go': 1, 'plugin/tracer.go': 1, 'thirdparty/notifier/notifier.go': 1, 'core/corehttp/mutex_profile.go': 1, 'core/corehttp/option_test.go': 1, 'provider/queue.go': 1, 'provider/queue_test.go': 1, 'core/bootstrap/bootstrap.go': 2, 'core/bootstrap/bootstrap_test.go': 2, 'core/ncore.go': 1, 'core/node/builder.go': 2, 'core/node/core.go': 2, 'core/node/discovery.go': 1, 'core/node/groups.go': 2, 'core/node/helpers.go': 1, 'core/node/identity.go': 2, 'core/node/ipns.go': 2, 'core/node/libp2p.go': 1, 'core/node/provider.go': 2, 'core/node/storage.go': 1, 'core/node/libp2p/addrs.go': 1, 'core/node/libp2p/discovery.go': 1, 'core/node/libp2p/host.go': 1, 'core/node/libp2p/hostopt.go': 1, 'core/node/libp2p/libp2p.go': 1, 'core/node/libp2p/nat.go': 1, 'core/node/libp2p/pnet.go': 1, 'core/node/libp2p/pubsub.go': 1, 'core/node/libp2p/routing.go': 1, 'core/node/libp2p/routingopt.go': 1, 'core/node/libp2p/smux.go': 1, 'core/node/libp2p/transport.go': 1, 'go.mod': 1, 'go.sum': 1, 'provider/simple/provider.go': 1, 'provider/simple/provider_test.go': 1, 'provider/simple/reprovide.go': 1, 'provider/simple/reprovide_test.go': 1}","('test/integration/addcat_test.go', 0.98, 0.9607843137254902)"
thirdparty/assert/assert.go,20,129,4,"[{'cyclomatic_complexity': 2, 'nloc': 5, 'token_count': 34, 'name': 'Nil', 'long_name': 'Nil err error , t * testing . T , msgs ... string', 'start_line': 5, 'end_line': 9, 'full_parameters': ['err error', ' t * testing . T', ' msgs ... string'], 'filename': '/home/dimi/Documents/Informatik_Studium/FSS/SoftEvo/DataCollection/FFS_SoftEvo/go-ipfs/thirdparty/assert/assert.go', 'top_nesting_level': 0, 'length': 5, 'fan_in': 0, 'fan_out': 0, 'general_fan_out': 0}, {'cyclomatic_complexity': 2, 'nloc': 5, 'token_count': 29, 'name': 'True', 'long_name': 'True v bool , t * testing . T , msgs ... string', 'start_line': 11, 'end_line': 15, 'full_parameters': ['v bool', ' t * testing . T', ' msgs ... string'], 'filename': '/home/dimi/Documents/Informatik_Studium/FSS/SoftEvo/DataCollection/FFS_SoftEvo/go-ipfs/thirdparty/assert/assert.go', 'top_nesting_level': 0, 'length': 5, 'fan_in': 0, 'fan_out': 0, 'general_fan_out': 0}, {'cyclomatic_complexity': 1, 'nloc': 3, 'token_count': 28, 'name': 'False', 'long_name': 'False v bool , t * testing . T , msgs ... string', 'start_line': 17, 'end_line': 19, 'full_parameters': ['v bool', ' t * testing . T', ' msgs ... string'], 'filename': '/home/dimi/Documents/Informatik_Studium/FSS/SoftEvo/DataCollection/FFS_SoftEvo/go-ipfs/thirdparty/assert/assert.go', 'top_nesting_level': 0, 'length': 3, 'fan_in': 0, 'fan_out': 0, 'general_fan_out': 0}, {'cyclomatic_complexity': 2, 'nloc': 5, 'token_count': 34, 'name': 'Err', 'long_name': 'Err err error , t * testing . T , msgs ... string', 'start_line': 21, 'end_line': 25, 'full_parameters': ['err error', ' t * testing . T', ' msgs ... string'], 'filename': '/home/dimi/Documents/Informatik_Studium/FSS/SoftEvo/DataCollection/FFS_SoftEvo/go-ipfs/thirdparty/assert/assert.go', 'top_nesting_level': 0, 'length': 5, 'fan_in': 0, 'fan_out': 0, 'general_fan_out': 0}]",20,129,4,"[{'cyclomatic_complexity': 2, 'nloc': 5, 'token_count': 34, 'name': 'Nil', 'long_name': 'Nil err error , t * testing . T , msgs ... string', 'start_line': 5, 'end_line': 9, 'full_parameters': ['err error', ' t * testing . T', ' msgs ... string'], 'filename': '/home/dimi/Documents/Informatik_Studium/FSS/SoftEvo/DataCollection/FFS_SoftEvo/go-ipfs/thirdparty/assert/assert.go', 'top_nesting_level': 0, 'length': 5, 'fan_in': 0, 'fan_out': 0, 'general_fan_out': 0}, {'cyclomatic_complexity': 2, 'nloc': 5, 'token_count': 29, 'name': 'True', 'long_name': 'True v bool , t * testing . T , msgs ... string', 'start_line': 11, 'end_line': 15, 'full_parameters': ['v bool', ' t * testing . T', ' msgs ... string'], 'filename': '/home/dimi/Documents/Informatik_Studium/FSS/SoftEvo/DataCollection/FFS_SoftEvo/go-ipfs/thirdparty/assert/assert.go', 'top_nesting_level': 0, 'length': 5, 'fan_in': 0, 'fan_out': 0, 'general_fan_out': 0}, {'cyclomatic_complexity': 1, 'nloc': 3, 'token_count': 28, 'name': 'False', 'long_name': 'False v bool , t * testing . T , msgs ... string', 'start_line': 17, 'end_line': 19, 'full_parameters': ['v bool', ' t * testing . T', ' msgs ... string'], 'filename': '/home/dimi/Documents/Informatik_Studium/FSS/SoftEvo/DataCollection/FFS_SoftEvo/go-ipfs/thirdparty/assert/assert.go', 'top_nesting_level': 0, 'length': 3, 'fan_in': 0, 'fan_out': 0, 'general_fan_out': 0}, {'cyclomatic_complexity': 2, 'nloc': 5, 'token_count': 34, 'name': 'Err', 'long_name': 'Err err error , t * testing . T , msgs ... string', 'start_line': 21, 'end_line': 25, 'full_parameters': ['err error', ' t * testing . T', ' msgs ... string'], 'filename': '/home/dimi/Documents/Informatik_Studium/FSS/SoftEvo/DataCollection/FFS_SoftEvo/go-ipfs/thirdparty/assert/assert.go', 'top_nesting_level': 0, 'length': 5, 'fan_in': 0, 'fan_out': 0, 'general_fan_out': 0}]",0,0,0,0,0,[],{},()
thirdparty/dir/dir.go,18,93,1,"[{'cyclomatic_complexity': 3, 'nloc': 12, 'token_count': 85, 'name': 'Writable', 'long_name': 'Writable path string', 'start_line': 12, 'end_line': 25, 'full_parameters': ['path string'], 'filename': '/home/dimi/Documents/Informatik_Studium/FSS/SoftEvo/DataCollection/FFS_SoftEvo/go-ipfs/thirdparty/dir/dir.go', 'top_nesting_level': 0, 'length': 14, 'fan_in': 0, 'fan_out': 0, 'general_fan_out': 0}]",18,93,1,"[{'cyclomatic_complexity': 3, 'nloc': 12, 'token_count': 85, 'name': 'Writable', 'long_name': 'Writable path string', 'start_line': 12, 'end_line': 25, 'full_parameters': ['path string'], 'filename': '/home/dimi/Documents/Informatik_Studium/FSS/SoftEvo/DataCollection/FFS_SoftEvo/go-ipfs/thirdparty/dir/dir.go', 'top_nesting_level': 0, 'length': 14, 'fan_in': 0, 'fan_out': 0, 'general_fan_out': 0}]",0,0,0,1,1,"[{'timestamp': 1521427288.0, 'added_lines': 3, 'deleted_lines': 3, 'nloc': 18}]","{'CHANGELOG.md': 1, 'README.md': 1, 'bin/dist_get': 1, 'cmd/ipfs/init.go': 1, 'cmd/ipfs/main.go': 1, 'cmd/ipfs/util/ulimit_freebsd.go': 1, 'cmd/seccat/seccat.go': 1, 'commands/request.go': 1, 'contribute.md': 1, 'core/builder.go': 1, 'core/commands/add.go': 1, 'core/commands/block.go': 1, 'core/commands/dag/dag.go': 1, 'core/commands/mount_unix.go': 1, 'core/commands/refs.go': 1, 'core/coreapi/coreapi.go': 1, 'core/coreapi/interface/options/pin.go': 1, 'core/coredag/dagtransl.go': 1, 'core/corerepo/pinning.go': 1, 'core/pathresolver.go': 1, 'docs/experimental-features.md': 1, 'docs/file-transfer.md': 1, 'docs/releases.md': 1, 'exchange/bitswap/README.md': 1, 'exchange/bitswap/bitswap.go': 1, 'exchange/bitswap/decision/ledger.go': 1, 'importer/helpers/dagbuilder.go': 1, 'importer/trickle/trickledag.go': 1, 'merkledag/raw.go': 1, 'namesys/pubsub.go': 1, 'pin/pin.go': 1, 'pin/set.go': 1, 'plugin/plugin.go': 1, 'repo/fsrepo/fsrepo.go': 1, 'repo/fsrepo/migrations/mfsr_test.go': 1, 'repo/fsrepo/migrations/migrations.go': 1, 'test/sharness/README.md': 1, 'unixfs/mod/dagmodifier.go': 1}","('core/coredag/dagtransl.go', 1.0, 0.058823529411764705)"
thirdparty/notifier/notifier_test.go,240,1454,23,"[{'cyclomatic_complexity': 1, 'nloc': 3, 'token_count': 21, 'name': 'Notify', 'long_name': '(r*Router)Notify n RouterNotifiee', 'start_line': 24, 'end_line': 26, 'full_parameters': ['n RouterNotifiee'], 'filename': '/home/dimi/Documents/Informatik_Studium/FSS/SoftEvo/DataCollection/FFS_SoftEvo/go-ipfs/thirdparty/notifier/notifier_test.go', 'top_nesting_level': 0, 'length': 3, 'fan_in': 0, 'fan_out': 0, 'general_fan_out': 0}, {'cyclomatic_complexity': 1, 'nloc': 3, 'token_count': 21, 'name': 'StopNotify', 'long_name': '(r*Router)StopNotify n RouterNotifiee', 'start_line': 28, 'end_line': 30, 'full_parameters': ['n RouterNotifiee'], 'filename': '/home/dimi/Documents/Informatik_Studium/FSS/SoftEvo/DataCollection/FFS_SoftEvo/go-ipfs/thirdparty/notifier/notifier_test.go', 'top_nesting_level': 0, 'length': 3, 'fan_in': 0, 'fan_out': 0, 'general_fan_out': 0}, {'cyclomatic_complexity': 1, 'nloc': 3, 'token_count': 15, 'name': '', 'long_name': '(n Notifiee)', 'start_line': 33, 'end_line': 35, 'full_parameters': [], 'filename': '/home/dimi/Documents/Informatik_Studium/FSS/SoftEvo/DataCollection/FFS_SoftEvo/go-ipfs/thirdparty/notifier/notifier_test.go', 'top_nesting_level': 0, 'length': 3, 'fan_in': 0, 'fan_out': 0, 'general_fan_out': 0}, {'cyclomatic_complexity': 1, 'nloc': 3, 'token_count': 25, 'name': 'notifyAll', 'long_name': '(r*Router)notifyAll notify func n RouterNotifiee', 'start_line': 32, 'end_line': 36, 'full_parameters': ['notify func n RouterNotifiee'], 'filename': '/home/dimi/Documents/Informatik_Studium/FSS/SoftEvo/DataCollection/FFS_SoftEvo/go-ipfs/thirdparty/notifier/notifier_test.go', 'top_nesting_level': 0, 'length': 5, 'fan_in': 0, 'fan_out': 0, 'general_fan_out': 0}, {'cyclomatic_complexity': 1, 'nloc': 3, 'token_count': 15, 'name': '', 'long_name': '(n RouterNotifiee)', 'start_line': 42, 'end_line': 44, 'full_parameters': [], 'filename': '/home/dimi/Documents/Informatik_Studium/FSS/SoftEvo/DataCollection/FFS_SoftEvo/go-ipfs/thirdparty/notifier/notifier_test.go', 'top_nesting_level': 0, 'length': 3, 'fan_in': 0, 'fan_out': 0, 'general_fan_out': 0}, {'cyclomatic_complexity': 1, 'nloc': 3, 'token_count': 15, 'name': '', 'long_name': '(n RouterNotifiee)', 'start_line': 47, 'end_line': 49, 'full_parameters': [], 'filename': '/home/dimi/Documents/Informatik_Studium/FSS/SoftEvo/DataCollection/FFS_SoftEvo/go-ipfs/thirdparty/notifier/notifier_test.go', 'top_nesting_level': 0, 'length': 3, 'fan_in': 0, 'fan_out': 0, 'general_fan_out': 0}, {'cyclomatic_complexity': 2, 'nloc': 8, 'token_count': 38, 'name': 'Receive', 'long_name': '(r*Router)Receive p Packet', 'start_line': 38, 'end_line': 51, 'full_parameters': ['p Packet'], 'filename': '/home/dimi/Documents/Informatik_Studium/FSS/SoftEvo/DataCollection/FFS_SoftEvo/go-ipfs/thirdparty/notifier/notifier_test.go', 'top_nesting_level': 0, 'length': 14, 'fan_in': 0, 'fan_out': 0, 'general_fan_out': 0}, {'cyclomatic_complexity': 1, 'nloc': 3, 'token_count': 15, 'name': '', 'long_name': '(n RouterNotifiee)', 'start_line': 55, 'end_line': 57, 'full_parameters': [], 'filename': '/home/dimi/Documents/Informatik_Studium/FSS/SoftEvo/DataCollection/FFS_SoftEvo/go-ipfs/thirdparty/notifier/notifier_test.go', 'top_nesting_level': 0, 'length': 3, 'fan_in': 0, 'fan_out': 0, 'general_fan_out': 0}, {'cyclomatic_complexity': 1, 'nloc': 4, 'token_count': 24, 'name': 'Forward', 'long_name': '(r*Router)Forward', 'start_line': 53, 'end_line': 58, 'full_parameters': [], 'filename': '/home/dimi/Documents/Informatik_Studium/FSS/SoftEvo/DataCollection/FFS_SoftEvo/go-ipfs/thirdparty/notifier/notifier_test.go', 'top_nesting_level': 0, 'length': 6, 'fan_in': 0, 'fan_out': 0, 'general_fan_out': 0}, {'cyclomatic_complexity': 2, 'nloc': 8, 'token_count': 47, 'name': 'Enqueued', 'long_name': '(m*Metrics)Enqueued * Router , Packet', 'start_line': 68, 'end_line': 75, 'full_parameters': ['* Router', ' Packet'], 'filename': '/home/dimi/Documents/Informatik_Studium/FSS/SoftEvo/DataCollection/FFS_SoftEvo/go-ipfs/thirdparty/notifier/notifier_test.go', 'top_nesting_level': 0, 'length': 8, 'fan_in': 0, 'fan_out': 0, 'general_fan_out': 0}, {'cyclomatic_complexity': 2, 'nloc': 8, 'token_count': 47, 'name': 'Forwarded', 'long_name': '(m*Metrics)Forwarded * Router , Packet', 'start_line': 77, 'end_line': 84, 'full_parameters': ['* Router', ' Packet'], 'filename': '/home/dimi/Documents/Informatik_Studium/FSS/SoftEvo/DataCollection/FFS_SoftEvo/go-ipfs/thirdparty/notifier/notifier_test.go', 'top_nesting_level': 0, 'length': 8, 'fan_in': 0, 'fan_out': 0, 'general_fan_out': 0}, {'cyclomatic_complexity': 2, 'nloc': 8, 'token_count': 47, 'name': 'Dropped', 'long_name': '(m*Metrics)Dropped * Router , Packet', 'start_line': 86, 'end_line': 93, 'full_parameters': ['* Router', ' Packet'], 'filename': '/home/dimi/Documents/Informatik_Studium/FSS/SoftEvo/DataCollection/FFS_SoftEvo/go-ipfs/thirdparty/notifier/notifier_test.go', 'top_nesting_level': 0, 'length': 8, 'fan_in': 0, 'fan_out': 0, 'general_fan_out': 0}, {'cyclomatic_complexity': 1, 'nloc': 6, 'token_count': 50, 'name': 'String', 'long_name': '(m*Metrics)String', 'start_line': 95, 'end_line': 100, 'full_parameters': [], 'filename': '/home/dimi/Documents/Informatik_Studium/FSS/SoftEvo/DataCollection/FFS_SoftEvo/go-ipfs/thirdparty/notifier/notifier_test.go', 'top_nesting_level': 0, 'length': 6, 'fan_in': 0, 'fan_out': 0, 'general_fan_out': 0}, {'cyclomatic_complexity': 6, 'nloc': 22, 'token_count': 170, 'name': 'TestNotifies', 'long_name': 'TestNotifies t * testing . T', 'start_line': 102, 'end_line': 127, 'full_parameters': ['t * testing . T'], 'filename': '/home/dimi/Documents/Informatik_Studium/FSS/SoftEvo/DataCollection/FFS_SoftEvo/go-ipfs/thirdparty/notifier/notifier_test.go', 'top_nesting_level': 0, 'length': 26, 'fan_in': 0, 'fan_out': 0, 'general_fan_out': 0}, {'cyclomatic_complexity': 6, 'nloc': 24, 'token_count': 150, 'name': 'TestStopsNotifying', 'long_name': 'TestStopsNotifying t * testing . T', 'start_line': 129, 'end_line': 155, 'full_parameters': ['t * testing . T'], 'filename': '/home/dimi/Documents/Informatik_Studium/FSS/SoftEvo/DataCollection/FFS_SoftEvo/go-ipfs/thirdparty/notifier/notifier_test.go', 'top_nesting_level': 0, 'length': 27, 'fan_in': 0, 'fan_out': 0, 'general_fan_out': 0}, {'cyclomatic_complexity': 1, 'nloc': 4, 'token_count': 19, 'name': '', 'long_name': '()', 'start_line': 172, 'end_line': 175, 'full_parameters': [], 'filename': '/home/dimi/Documents/Informatik_Studium/FSS/SoftEvo/DataCollection/FFS_SoftEvo/go-ipfs/thirdparty/notifier/notifier_test.go', 'top_nesting_level': 0, 'length': 4, 'fan_in': 0, 'fan_out': 0, 'general_fan_out': 0}, {'cyclomatic_complexity': 1, 'nloc': 4, 'token_count': 16, 'name': '', 'long_name': '()', 'start_line': 180, 'end_line': 183, 'full_parameters': [], 'filename': '/home/dimi/Documents/Informatik_Studium/FSS/SoftEvo/DataCollection/FFS_SoftEvo/go-ipfs/thirdparty/notifier/notifier_test.go', 'top_nesting_level': 0, 'length': 4, 'fan_in': 0, 'fan_out': 0, 'general_fan_out': 0}, {'cyclomatic_complexity': 9, 'nloc': 36, 'token_count': 258, 'name': 'TestThreadsafe', 'long_name': 'TestThreadsafe t * testing . T', 'start_line': 157, 'end_line': 208, 'full_parameters': ['t * testing . T'], 'filename': '/home/dimi/Documents/Informatik_Studium/FSS/SoftEvo/DataCollection/FFS_SoftEvo/go-ipfs/thirdparty/notifier/notifier_test.go', 'top_nesting_level': 0, 'length': 52, 'fan_in': 0, 'fan_out': 0, 'general_fan_out': 0}, {'cyclomatic_complexity': 2, 'nloc': 8, 'token_count': 58, 'name': 'incr', 'long_name': '(m*highwatermark)incr', 'start_line': 217, 'end_line': 225, 'full_parameters': [], 'filename': '/home/dimi/Documents/Informatik_Studium/FSS/SoftEvo/DataCollection/FFS_SoftEvo/go-ipfs/thirdparty/notifier/notifier_test.go', 'top_nesting_level': 0, 'length': 9, 'fan_in': 0, 'fan_out': 0, 'general_fan_out': 0}, {'cyclomatic_complexity': 2, 'nloc': 8, 'token_count': 56, 'name': 'decr', 'long_name': '(m*highwatermark)decr', 'start_line': 227, 'end_line': 235, 'full_parameters': [], 'filename': '/home/dimi/Documents/Informatik_Studium/FSS/SoftEvo/DataCollection/FFS_SoftEvo/go-ipfs/thirdparty/notifier/notifier_test.go', 'top_nesting_level': 0, 'length': 9, 'fan_in': 0, 'fan_out': 0, 'general_fan_out': 0}, {'cyclomatic_complexity': 1, 'nloc': 6, 'token_count': 28, 'name': '', 'long_name': '(e Notifiee)', 'start_line': 253, 'end_line': 258, 'full_parameters': [], 'filename': '/home/dimi/Documents/Informatik_Studium/FSS/SoftEvo/DataCollection/FFS_SoftEvo/go-ipfs/thirdparty/notifier/notifier_test.go', 'top_nesting_level': 0, 'length': 6, 'fan_in': 0, 'fan_out': 0, 'general_fan_out': 0}, {'cyclomatic_complexity': 2, 'nloc': 6, 'token_count': 32, 'name': '', 'long_name': '()', 'start_line': 250, 'end_line': 261, 'full_parameters': [], 'filename': '/home/dimi/Documents/Informatik_Studium/FSS/SoftEvo/DataCollection/FFS_SoftEvo/go-ipfs/thirdparty/notifier/notifier_test.go', 'top_nesting_level': 0, 'length': 12, 'fan_in': 0, 'fan_out': 0, 'general_fan_out': 0}, {'cyclomatic_complexity': 10, 'nloc': 37, 'token_count': 210, 'name': 'TestLimited', 'long_name': 'TestLimited t * testing . T', 'start_line': 237, 'end_line': 291, 'full_parameters': ['t * testing . T'], 'filename': '/home/dimi/Documents/Informatik_Studium/FSS/SoftEvo/DataCollection/FFS_SoftEvo/go-ipfs/thirdparty/notifier/notifier_test.go', 'top_nesting_level': 0, 'length': 55, 'fan_in': 0, 'fan_out': 0, 'general_fan_out': 0}]",240,1454,23,"[{'cyclomatic_complexity': 1, 'nloc': 3, 'token_count': 21, 'name': 'Notify', 'long_name': '(r*Router)Notify n RouterNotifiee', 'start_line': 24, 'end_line': 26, 'full_parameters': ['n RouterNotifiee'], 'filename': '/home/dimi/Documents/Informatik_Studium/FSS/SoftEvo/DataCollection/FFS_SoftEvo/go-ipfs/thirdparty/notifier/notifier_test.go', 'top_nesting_level': 0, 'length': 3, 'fan_in': 0, 'fan_out': 0, 'general_fan_out': 0}, {'cyclomatic_complexity': 1, 'nloc': 3, 'token_count': 21, 'name': 'StopNotify', 'long_name': '(r*Router)StopNotify n RouterNotifiee', 'start_line': 28, 'end_line': 30, 'full_parameters': ['n RouterNotifiee'], 'filename': '/home/dimi/Documents/Informatik_Studium/FSS/SoftEvo/DataCollection/FFS_SoftEvo/go-ipfs/thirdparty/notifier/notifier_test.go', 'top_nesting_level': 0, 'length': 3, 'fan_in': 0, 'fan_out': 0, 'general_fan_out': 0}, {'cyclomatic_complexity': 1, 'nloc': 3, 'token_count': 15, 'name': '', 'long_name': '(n Notifiee)', 'start_line': 33, 'end_line': 35, 'full_parameters': [], 'filename': '/home/dimi/Documents/Informatik_Studium/FSS/SoftEvo/DataCollection/FFS_SoftEvo/go-ipfs/thirdparty/notifier/notifier_test.go', 'top_nesting_level': 0, 'length': 3, 'fan_in': 0, 'fan_out': 0, 'general_fan_out': 0}, {'cyclomatic_complexity': 1, 'nloc': 3, 'token_count': 25, 'name': 'notifyAll', 'long_name': '(r*Router)notifyAll notify func n RouterNotifiee', 'start_line': 32, 'end_line': 36, 'full_parameters': ['notify func n RouterNotifiee'], 'filename': '/home/dimi/Documents/Informatik_Studium/FSS/SoftEvo/DataCollection/FFS_SoftEvo/go-ipfs/thirdparty/notifier/notifier_test.go', 'top_nesting_level': 0, 'length': 5, 'fan_in': 0, 'fan_out': 0, 'general_fan_out': 0}, {'cyclomatic_complexity': 1, 'nloc': 3, 'token_count': 15, 'name': '', 'long_name': '(n RouterNotifiee)', 'start_line': 42, 'end_line': 44, 'full_parameters': [], 'filename': '/home/dimi/Documents/Informatik_Studium/FSS/SoftEvo/DataCollection/FFS_SoftEvo/go-ipfs/thirdparty/notifier/notifier_test.go', 'top_nesting_level': 0, 'length': 3, 'fan_in': 0, 'fan_out': 0, 'general_fan_out': 0}, {'cyclomatic_complexity': 1, 'nloc': 3, 'token_count': 15, 'name': '', 'long_name': '(n RouterNotifiee)', 'start_line': 47, 'end_line': 49, 'full_parameters': [], 'filename': '/home/dimi/Documents/Informatik_Studium/FSS/SoftEvo/DataCollection/FFS_SoftEvo/go-ipfs/thirdparty/notifier/notifier_test.go', 'top_nesting_level': 0, 'length': 3, 'fan_in': 0, 'fan_out': 0, 'general_fan_out': 0}, {'cyclomatic_complexity': 2, 'nloc': 8, 'token_count': 38, 'name': 'Receive', 'long_name': '(r*Router)Receive p Packet', 'start_line': 38, 'end_line': 51, 'full_parameters': ['p Packet'], 'filename': '/home/dimi/Documents/Informatik_Studium/FSS/SoftEvo/DataCollection/FFS_SoftEvo/go-ipfs/thirdparty/notifier/notifier_test.go', 'top_nesting_level': 0, 'length': 14, 'fan_in': 0, 'fan_out': 0, 'general_fan_out': 0}, {'cyclomatic_complexity': 1, 'nloc': 3, 'token_count': 15, 'name': '', 'long_name': '(n RouterNotifiee)', 'start_line': 55, 'end_line': 57, 'full_parameters': [], 'filename': '/home/dimi/Documents/Informatik_Studium/FSS/SoftEvo/DataCollection/FFS_SoftEvo/go-ipfs/thirdparty/notifier/notifier_test.go', 'top_nesting_level': 0, 'length': 3, 'fan_in': 0, 'fan_out': 0, 'general_fan_out': 0}, {'cyclomatic_complexity': 1, 'nloc': 4, 'token_count': 24, 'name': 'Forward', 'long_name': '(r*Router)Forward', 'start_line': 53, 'end_line': 58, 'full_parameters': [], 'filename': '/home/dimi/Documents/Informatik_Studium/FSS/SoftEvo/DataCollection/FFS_SoftEvo/go-ipfs/thirdparty/notifier/notifier_test.go', 'top_nesting_level': 0, 'length': 6, 'fan_in': 0, 'fan_out': 0, 'general_fan_out': 0}, {'cyclomatic_complexity': 2, 'nloc': 8, 'token_count': 47, 'name': 'Enqueued', 'long_name': '(m*Metrics)Enqueued * Router , Packet', 'start_line': 68, 'end_line': 75, 'full_parameters': ['* Router', ' Packet'], 'filename': '/home/dimi/Documents/Informatik_Studium/FSS/SoftEvo/DataCollection/FFS_SoftEvo/go-ipfs/thirdparty/notifier/notifier_test.go', 'top_nesting_level': 0, 'length': 8, 'fan_in': 0, 'fan_out': 0, 'general_fan_out': 0}, {'cyclomatic_complexity': 2, 'nloc': 8, 'token_count': 47, 'name': 'Forwarded', 'long_name': '(m*Metrics)Forwarded * Router , Packet', 'start_line': 77, 'end_line': 84, 'full_parameters': ['* Router', ' Packet'], 'filename': '/home/dimi/Documents/Informatik_Studium/FSS/SoftEvo/DataCollection/FFS_SoftEvo/go-ipfs/thirdparty/notifier/notifier_test.go', 'top_nesting_level': 0, 'length': 8, 'fan_in': 0, 'fan_out': 0, 'general_fan_out': 0}, {'cyclomatic_complexity': 2, 'nloc': 8, 'token_count': 47, 'name': 'Dropped', 'long_name': '(m*Metrics)Dropped * Router , Packet', 'start_line': 86, 'end_line': 93, 'full_parameters': ['* Router', ' Packet'], 'filename': '/home/dimi/Documents/Informatik_Studium/FSS/SoftEvo/DataCollection/FFS_SoftEvo/go-ipfs/thirdparty/notifier/notifier_test.go', 'top_nesting_level': 0, 'length': 8, 'fan_in': 0, 'fan_out': 0, 'general_fan_out': 0}, {'cyclomatic_complexity': 1, 'nloc': 6, 'token_count': 50, 'name': 'String', 'long_name': '(m*Metrics)String', 'start_line': 95, 'end_line': 100, 'full_parameters': [], 'filename': '/home/dimi/Documents/Informatik_Studium/FSS/SoftEvo/DataCollection/FFS_SoftEvo/go-ipfs/thirdparty/notifier/notifier_test.go', 'top_nesting_level': 0, 'length': 6, 'fan_in': 0, 'fan_out': 0, 'general_fan_out': 0}, {'cyclomatic_complexity': 6, 'nloc': 22, 'token_count': 170, 'name': 'TestNotifies', 'long_name': 'TestNotifies t * testing . T', 'start_line': 102, 'end_line': 127, 'full_parameters': ['t * testing . T'], 'filename': '/home/dimi/Documents/Informatik_Studium/FSS/SoftEvo/DataCollection/FFS_SoftEvo/go-ipfs/thirdparty/notifier/notifier_test.go', 'top_nesting_level': 0, 'length': 26, 'fan_in': 0, 'fan_out': 0, 'general_fan_out': 0}, {'cyclomatic_complexity': 6, 'nloc': 24, 'token_count': 150, 'name': 'TestStopsNotifying', 'long_name': 'TestStopsNotifying t * testing . T', 'start_line': 129, 'end_line': 155, 'full_parameters': ['t * testing . T'], 'filename': '/home/dimi/Documents/Informatik_Studium/FSS/SoftEvo/DataCollection/FFS_SoftEvo/go-ipfs/thirdparty/notifier/notifier_test.go', 'top_nesting_level': 0, 'length': 27, 'fan_in': 0, 'fan_out': 0, 'general_fan_out': 0}, {'cyclomatic_complexity': 1, 'nloc': 4, 'token_count': 19, 'name': '', 'long_name': '()', 'start_line': 172, 'end_line': 175, 'full_parameters': [], 'filename': '/home/dimi/Documents/Informatik_Studium/FSS/SoftEvo/DataCollection/FFS_SoftEvo/go-ipfs/thirdparty/notifier/notifier_test.go', 'top_nesting_level': 0, 'length': 4, 'fan_in': 0, 'fan_out': 0, 'general_fan_out': 0}, {'cyclomatic_complexity': 1, 'nloc': 4, 'token_count': 16, 'name': '', 'long_name': '()', 'start_line': 180, 'end_line': 183, 'full_parameters': [], 'filename': '/home/dimi/Documents/Informatik_Studium/FSS/SoftEvo/DataCollection/FFS_SoftEvo/go-ipfs/thirdparty/notifier/notifier_test.go', 'top_nesting_level': 0, 'length': 4, 'fan_in': 0, 'fan_out': 0, 'general_fan_out': 0}, {'cyclomatic_complexity': 9, 'nloc': 36, 'token_count': 258, 'name': 'TestThreadsafe', 'long_name': 'TestThreadsafe t * testing . T', 'start_line': 157, 'end_line': 208, 'full_parameters': ['t * testing . T'], 'filename': '/home/dimi/Documents/Informatik_Studium/FSS/SoftEvo/DataCollection/FFS_SoftEvo/go-ipfs/thirdparty/notifier/notifier_test.go', 'top_nesting_level': 0, 'length': 52, 'fan_in': 0, 'fan_out': 0, 'general_fan_out': 0}, {'cyclomatic_complexity': 2, 'nloc': 8, 'token_count': 58, 'name': 'incr', 'long_name': '(m*highwatermark)incr', 'start_line': 217, 'end_line': 225, 'full_parameters': [], 'filename': '/home/dimi/Documents/Informatik_Studium/FSS/SoftEvo/DataCollection/FFS_SoftEvo/go-ipfs/thirdparty/notifier/notifier_test.go', 'top_nesting_level': 0, 'length': 9, 'fan_in': 0, 'fan_out': 0, 'general_fan_out': 0}, {'cyclomatic_complexity': 2, 'nloc': 8, 'token_count': 56, 'name': 'decr', 'long_name': '(m*highwatermark)decr', 'start_line': 227, 'end_line': 235, 'full_parameters': [], 'filename': '/home/dimi/Documents/Informatik_Studium/FSS/SoftEvo/DataCollection/FFS_SoftEvo/go-ipfs/thirdparty/notifier/notifier_test.go', 'top_nesting_level': 0, 'length': 9, 'fan_in': 0, 'fan_out': 0, 'general_fan_out': 0}, {'cyclomatic_complexity': 1, 'nloc': 6, 'token_count': 28, 'name': '', 'long_name': '(e Notifiee)', 'start_line': 253, 'end_line': 258, 'full_parameters': [], 'filename': '/home/dimi/Documents/Informatik_Studium/FSS/SoftEvo/DataCollection/FFS_SoftEvo/go-ipfs/thirdparty/notifier/notifier_test.go', 'top_nesting_level': 0, 'length': 6, 'fan_in': 0, 'fan_out': 0, 'general_fan_out': 0}, {'cyclomatic_complexity': 2, 'nloc': 6, 'token_count': 32, 'name': '', 'long_name': '()', 'start_line': 250, 'end_line': 261, 'full_parameters': [], 'filename': '/home/dimi/Documents/Informatik_Studium/FSS/SoftEvo/DataCollection/FFS_SoftEvo/go-ipfs/thirdparty/notifier/notifier_test.go', 'top_nesting_level': 0, 'length': 12, 'fan_in': 0, 'fan_out': 0, 'general_fan_out': 0}, {'cyclomatic_complexity': 10, 'nloc': 37, 'token_count': 210, 'name': 'TestLimited', 'long_name': 'TestLimited t * testing . T', 'start_line': 237, 'end_line': 291, 'full_parameters': ['t * testing . T'], 'filename': '/home/dimi/Documents/Informatik_Studium/FSS/SoftEvo/DataCollection/FFS_SoftEvo/go-ipfs/thirdparty/notifier/notifier_test.go', 'top_nesting_level': 0, 'length': 55, 'fan_in': 0, 'fan_out': 0, 'general_fan_out': 0}]",0,0,0,0,0,[],{},()
thirdparty/notifier/notifier.go,55,290,6,"[{'cyclomatic_complexity': 2, 'nloc': 7, 'token_count': 38, 'name': 'RateLimited', 'long_name': 'RateLimited limit int', 'start_line': 43, 'end_line': 49, 'full_parameters': ['limit int'], 'filename': '/home/dimi/Documents/Informatik_Studium/FSS/SoftEvo/DataCollection/FFS_SoftEvo/go-ipfs/thirdparty/notifier/notifier.go', 'top_nesting_level': 0, 'length': 7, 'fan_in': 0, 'fan_out': 0, 'general_fan_out': 0}, {'cyclomatic_complexity': 2, 'nloc': 8, 'token_count': 61, 'name': 'Notify', 'long_name': '(n*Notifier)Notify e Notifiee', 'start_line': 65, 'end_line': 72, 'full_parameters': ['e Notifiee'], 'filename': '/home/dimi/Documents/Informatik_Studium/FSS/SoftEvo/DataCollection/FFS_SoftEvo/go-ipfs/thirdparty/notifier/notifier.go', 'top_nesting_level': 0, 'length': 8, 'fan_in': 0, 'fan_out': 0, 'general_fan_out': 0}, {'cyclomatic_complexity': 2, 'nloc': 7, 'token_count': 43, 'name': 'StopNotify', 'long_name': '(n*Notifier)StopNotify e Notifiee', 'start_line': 88, 'end_line': 94, 'full_parameters': ['e Notifiee'], 'filename': '/home/dimi/Documents/Informatik_Studium/FSS/SoftEvo/DataCollection/FFS_SoftEvo/go-ipfs/thirdparty/notifier/notifier.go', 'top_nesting_level': 0, 'length': 7, 'fan_in': 0, 'fan_out': 0, 'general_fan_out': 0}, {'cyclomatic_complexity': 1, 'nloc': 3, 'token_count': 13, 'name': '', 'long_name': '(worker process.Process)', 'start_line': 141, 'end_line': 143, 'full_parameters': [], 'filename': '/home/dimi/Documents/Informatik_Studium/FSS/SoftEvo/DataCollection/FFS_SoftEvo/go-ipfs/thirdparty/notifier/notifier.go', 'top_nesting_level': 0, 'length': 3, 'fan_in': 0, 'fan_out': 0, 'general_fan_out': 0}, {'cyclomatic_complexity': 2, 'nloc': 6, 'token_count': 29, 'name': '', 'long_name': '(worker process.Process)', 'start_line': 138, 'end_line': 145, 'full_parameters': [], 'filename': '/home/dimi/Documents/Informatik_Studium/FSS/SoftEvo/DataCollection/FFS_SoftEvo/go-ipfs/thirdparty/notifier/notifier.go', 'top_nesting_level': 0, 'length': 8, 'fan_in': 0, 'fan_out': 0, 'general_fan_out': 0}, {'cyclomatic_complexity': 4, 'nloc': 14, 'token_count': 71, 'name': 'NotifyAll', 'long_name': '(n*Notifier)NotifyAll notify func Notifiee', 'start_line': 121, 'end_line': 146, 'full_parameters': ['notify func Notifiee'], 'filename': '/home/dimi/Documents/Informatik_Studium/FSS/SoftEvo/DataCollection/FFS_SoftEvo/go-ipfs/thirdparty/notifier/notifier.go', 'top_nesting_level': 0, 'length': 26, 'fan_in': 0, 'fan_out': 0, 'general_fan_out': 0}]",55,292,6,"[{'cyclomatic_complexity': 2, 'nloc': 7, 'token_count': 40, 'name': 'RateLimited', 'long_name': 'RateLimited limit int', 'start_line': 43, 'end_line': 49, 'full_parameters': ['limit int'], 'filename': '/home/dimi/Documents/Informatik_Studium/FSS/SoftEvo/DataCollection/FFS_SoftEvo/go-ipfs/thirdparty/notifier/notifier.go', 'top_nesting_level': 0, 'length': 7, 'fan_in': 0, 'fan_out': 0, 'general_fan_out': 0}, {'cyclomatic_complexity': 2, 'nloc': 8, 'token_count': 61, 'name': 'Notify', 'long_name': '(n*Notifier)Notify e Notifiee', 'start_line': 65, 'end_line': 72, 'full_parameters': ['e Notifiee'], 'filename': '/home/dimi/Documents/Informatik_Studium/FSS/SoftEvo/DataCollection/FFS_SoftEvo/go-ipfs/thirdparty/notifier/notifier.go', 'top_nesting_level': 0, 'length': 8, 'fan_in': 0, 'fan_out': 0, 'general_fan_out': 0}, {'cyclomatic_complexity': 2, 'nloc': 7, 'token_count': 43, 'name': 'StopNotify', 'long_name': '(n*Notifier)StopNotify e Notifiee', 'start_line': 88, 'end_line': 94, 'full_parameters': ['e Notifiee'], 'filename': '/home/dimi/Documents/Informatik_Studium/FSS/SoftEvo/DataCollection/FFS_SoftEvo/go-ipfs/thirdparty/notifier/notifier.go', 'top_nesting_level': 0, 'length': 7, 'fan_in': 0, 'fan_out': 0, 'general_fan_out': 0}, {'cyclomatic_complexity': 1, 'nloc': 3, 'token_count': 13, 'name': '', 'long_name': '(worker process.Process)', 'start_line': 141, 'end_line': 143, 'full_parameters': [], 'filename': '/home/dimi/Documents/Informatik_Studium/FSS/SoftEvo/DataCollection/FFS_SoftEvo/go-ipfs/thirdparty/notifier/notifier.go', 'top_nesting_level': 0, 'length': 3, 'fan_in': 0, 'fan_out': 0, 'general_fan_out': 0}, {'cyclomatic_complexity': 2, 'nloc': 6, 'token_count': 29, 'name': '', 'long_name': '(worker process.Process)', 'start_line': 138, 'end_line': 145, 'full_parameters': [], 'filename': '/home/dimi/Documents/Informatik_Studium/FSS/SoftEvo/DataCollection/FFS_SoftEvo/go-ipfs/thirdparty/notifier/notifier.go', 'top_nesting_level': 0, 'length': 8, 'fan_in': 0, 'fan_out': 0, 'general_fan_out': 0}, {'cyclomatic_complexity': 4, 'nloc': 14, 'token_count': 71, 'name': 'NotifyAll', 'long_name': '(n*Notifier)NotifyAll notify func Notifiee', 'start_line': 121, 'end_line': 146, 'full_parameters': ['notify func Notifiee'], 'filename': '/home/dimi/Documents/Informatik_Studium/FSS/SoftEvo/DataCollection/FFS_SoftEvo/go-ipfs/thirdparty/notifier/notifier.go', 'top_nesting_level': 0, 'length': 26, 'fan_in': 0, 'fan_out': 0, 'general_fan_out': 0}]",0,2,0,3,3,"[{'timestamp': 1521687673.0, 'added_lines': 2, 'deleted_lines': 2, 'nloc': 55}, {'timestamp': 1551551196.0, 'added_lines': 2, 'deleted_lines': 2, 'nloc': 55}, {'timestamp': 1587221101.0, 'added_lines': 1, 'deleted_lines': 1, 'nloc': 55}]","{'core/builder.go': 2, 'filestore/fsrefstore.go': 2, 'repo/fsrepo/fsrepo.go': 2, 'test/dependencies/go-timeout/main.go': 1, 'assets/assets.go': 1, 'blocks/blockstoreutil/remove.go': 2, 'cmd/ipfs/daemon.go': 2, 'cmd/ipfs/dnsresolve_test.go': 1, 'cmd/ipfs/init.go': 1, 'cmd/ipfs/ipfs.go': 1, 'cmd/ipfs/main.go': 1, 'cmd/ipfs/util/ulimit.go': 2, 'cmd/ipfs/util/ulimit_freebsd.go': 1, 'cmd/ipfs/util/ulimit_unix.go': 1, 'cmd/ipfswatch/main.go': 1, 'cmd/seccat/seccat.go': 1, 'cmd/seccat/util.go': 1, 'commands/context.go': 1, 'core/bootstrap.go': 1, 'core/bootstrap_test.go': 1, 'core/commands/active.go': 1, 'core/commands/add.go': 1, 'core/commands/bitswap.go': 1, 'core/commands/block.go': 1, 'core/commands/bootstrap.go': 1, 'core/commands/cat.go': 1, 'core/commands/cid.go': 2, 'core/commands/cmdenv/cidbase.go': 1, 'core/commands/cmdenv/cidbase_test.go': 1, 'core/commands/cmdenv/env.go': 1, 'core/commands/cmdenv/file.go': 1, 'core/commands/commands.go': 2, 'core/commands/commands_test.go': 1, 'core/commands/config.go': 1, 'core/commands/dag/dag.go': 2, 'core/commands/dht.go': 1, 'core/commands/dht_test.go': 1, 'core/commands/diag.go': 1, 'core/commands/dns.go': 1, 'core/commands/external.go': 1, 'core/commands/files.go': 2, 'core/commands/filestore.go': 1, 'core/commands/get.go': 2, 'core/commands/get_test.go': 1, 'core/commands/helptext_test.go': 1, 'core/commands/id.go': 1, 'core/commands/keystore.go': 1, 'core/commands/log.go': 1, 'core/commands/ls.go': 1, 'core/commands/mount_nofuse.go': 1, 'core/commands/mount_unix.go': 1, 'core/commands/mount_windows.go': 1, 'core/commands/name/ipns.go': 1, 'core/commands/name/ipnsps.go': 1, 'core/commands/name/name.go': 1, 'core/commands/name/publish.go': 1, 'core/commands/object/diff.go': 1, 'core/commands/object/object.go': 1, 'core/commands/object/patch.go': 1, 'core/commands/p2p.go': 1, 'core/commands/pin.go': 2, 'core/commands/ping.go': 1, 'core/commands/pubsub.go': 1, 'core/commands/refs.go': 1, 'core/commands/repo.go': 1, 'core/commands/resolve.go': 1, 'core/commands/root.go': 1, 'core/commands/shutdown.go': 1, 'core/commands/stat.go': 1, 'core/commands/swarm.go': 1, 'core/commands/sysdiag.go': 1, 'core/commands/tar.go': 1, 'core/commands/unixfs/ls.go': 1, 'core/commands/unixfs/unixfs.go': 1, 'core/commands/urlstore.go': 1, 'core/commands/version.go': 1, 'core/core.go': 1, 'core/core_test.go': 1, 'core/coreapi/block.go': 1, 'core/coreapi/coreapi.go': 1, 'core/coreapi/dag.go': 1, 'core/coreapi/dht.go': 1, 'core/coreapi/key.go': 1, 'core/coreapi/name.go': 1, 'core/coreapi/object.go': 1, 'core/coreapi/path.go': 1, 'core/coreapi/pin.go': 1, 'core/coreapi/pubsub.go': 1, 'core/coreapi/swarm.go': 1, 'core/coreapi/test/api_test.go': 1, 'core/coreapi/unixfs.go': 1, 'core/coredag/cbor.go': 1, 'core/coredag/dagpb.go': 1, 'core/coredag/dagtransl.go': 1, 'core/coredag/raw.go': 1, 'core/corehttp/commands.go': 1, 'core/corehttp/corehttp.go': 2, 'core/corehttp/gateway.go': 1, 'core/corehttp/gateway_handler.go': 2, 'core/corehttp/gateway_test.go': 1, 'core/corehttp/ipns_hostname.go': 1, 'core/corehttp/logs.go': 1, 'core/corehttp/metrics.go': 1, 'core/corehttp/metrics_test.go': 1, 'core/corehttp/proxy.go': 1, 'core/corehttp/proxy_test.go': 1, 'core/corerepo/gc.go': 1, 'core/corerepo/stat.go': 1, 'core/coreunix/add.go': 1, 'core/coreunix/add_test.go': 2, 'core/coreunix/metadata.go': 1, 'core/coreunix/metadata_test.go': 1, 'core/mock/mock.go': 1, 'core/pathresolver.go': 1, 'core/pathresolver_test.go': 1, 'dagutils/diff.go': 1, 'dagutils/diffenum.go': 1, 'dagutils/diffenum_test.go': 1, 'dagutils/utils.go': 1, 'dagutils/utils_test.go': 1, 'exchange/reprovide/providers.go': 1, 'exchange/reprovide/reprovide.go': 1, 'exchange/reprovide/reprovide_test.go': 1, 'filestore/filestore.go': 1, 'filestore/filestore_test.go': 1, 'filestore/pb/dataobj.pb.go': 1, 'filestore/util.go': 1, 'fuse/ipns/common.go': 1, 'fuse/ipns/ipns_test.go': 2, 'fuse/ipns/ipns_unix.go': 1, 'fuse/ipns/link_unix.go': 1, 'fuse/mount/fuse.go': 1, 'fuse/mount/mount.go': 1, 'fuse/node/mount_darwin.go': 2, 'fuse/node/mount_test.go': 1, 'fuse/node/mount_unix.go': 1, 'fuse/readonly/ipfs_test.go': 1, 'fuse/readonly/readonly_unix.go': 2, 'keystore/keystore.go': 2, 'keystore/keystore_test.go': 2, 'keystore/memkeystore.go': 2, 'namesys/base.go': 1, 'namesys/cache.go': 1, 'namesys/dns.go': 1, 'namesys/dns_test.go': 1, 'namesys/interface.go': 1, 'namesys/ipns_resolver_validation_test.go': 1, 'namesys/namesys.go': 2, 'namesys/namesys_test.go': 1, 'namesys/proquint.go': 1, 'namesys/publisher.go': 1, 'namesys/publisher_test.go': 1, 'namesys/republisher/repub.go': 1, 'namesys/republisher/repub_test.go': 2, 'namesys/resolve_test.go': 1, 'namesys/routing.go': 1, 'p2p/listener.go': 1, 'p2p/local.go': 1, 'p2p/p2p.go': 1, 'p2p/remote.go': 1, 'p2p/stream.go': 1, 'pin/gc/gc.go': 1, 'pin/internal/pb/header.pb.go': 1, 'pin/pin.go': 1, 'pin/pin_test.go': 1, 'pin/set.go': 1, 'pin/set_test.go': 1, 'plugin/daemon.go': 1, 'plugin/ipld.go': 1, 'plugin/loader/loader.go': 1, 'plugin/plugins/badgerds/badgerds.go': 1, 'plugin/plugins/flatfs/flatfs.go': 1, 'plugin/plugins/git/git.go': 1, 'plugin/plugins/levelds/levelds.go': 1, 'plugin/tracer.go': 1, 'repo/fsrepo/config_test.go': 1, 'repo/fsrepo/datastores.go': 1, 'repo/fsrepo/fsrepo_test.go': 1, 'repo/fsrepo/misc.go': 1, 'repo/mock.go': 1, 'repo/repo.go': 1, 'tar/format.go': 1, 'test/bench/bench_cli_ipfs_add/main.go': 1, 'test/bench/offline_add/main.go': 1, 'test/dependencies/iptb/iptb.go': 1, 'test/dependencies/ma-pipe-unidir/main.go': 1, 'test/integration/addcat_test.go': 1, 'test/integration/bench_cat_test.go': 1, 'test/integration/bench_test.go': 1, 'test/integration/bitswap_wo_routing_test.go': 1, 'test/integration/three_legged_cat_test.go': 1, 'thirdparty/cidv0v1/blockstore.go': 1, 'thirdparty/pollEndpoint/main.go': 1, 'thirdparty/verifbs/verifbs.go': 1, 'CHANGELOG.md': 1, 'Dockerfile': 1, 'README.md': 1, 'bin/check_go_version': 1, 'coverage/Rules.mk': 1, 'docs/config.md': 1, 'docs/debug-guide.md': 1, 'docs/environment-variables.md': 1, 'gc/gc.go': 1, 'keystore/memkeystore_test.go': 1, 'misc/completion/ipfs-completion.bash': 1, 'plugin/plugins/gen_main.sh': 1, 'repo/fsrepo/migrations/migrations.go': 1, 'repo/onlyone.go': 1, 'test/3nodetest/run-test-on-img.sh': 1, 'test/ipfs-test-lib.sh': 1, 'test/sharness/README.md': 1, 'test/sharness/lib/iptb-lib.sh': 1, 'test/sharness/t0010-basic-commands.sh': 1, 'test/sharness/t0020-init.sh': 1, 'test/sharness/t0030-mount.sh': 1, 'test/sharness/t0031-mount-publish.sh': 1, 'test/sharness/t0040-add-and-cat.sh': 1, 'test/sharness/t0050-block.sh': 1, 'test/sharness/t0051-object.sh': 1, 'test/sharness/t0053-dag.sh': 1, 'test/sharness/t0060-daemon.sh': 1, 'test/sharness/t0062-daemon-api.sh': 1, 'test/sharness/t0080-repo.sh': 1, 'test/sharness/t0087-repo-robust-gc.sh': 1, 'test/sharness/t0090-get.sh': 1, 'test/sharness/t0110-gateway.sh': 1, 'test/sharness/t0114-gateway-subdomains.sh': 1, 'test/sharness/t0131-multinode-client-routing.sh': 1, 'test/sharness/t0140-swarm.sh': 1, 'test/sharness/t0183-namesys-pubsub.sh': 1, 'test/sharness/t0250-files-api.sh': 1, 'test/sharness/t0270-filestore.sh': 1, 'test/sharness/t0272-urlstore.sh': 1, 'test/sharness/t0410-api-add.sh': 1, 'test/sharness/t0600-issues-and-regressions-online.sh': 1, 'test/sharness_test_coverage_helper.sh': 1, 'thirdparty/README.md': 1}","('fuse/ipns/ipns_test.go', 0.6666666666666666, 0.038461538461538464)"
thirdparty/unit/unit.go,38,145,1,"[{'cyclomatic_complexity': 7, 'nloc': 26, 'token_count': 116, 'name': 'String', 'long_name': '(i Information)String', 'start_line': 17, 'end_line': 46, 'full_parameters': [], 'filename': '/home/dimi/Documents/Informatik_Studium/FSS/SoftEvo/DataCollection/FFS_SoftEvo/go-ipfs/thirdparty/unit/unit.go', 'top_nesting_level': 0, 'length': 30, 'fan_in': 0, 'fan_out': 0, 'general_fan_out': 0}]",38,145,1,"[{'cyclomatic_complexity': 7, 'nloc': 26, 'token_count': 116, 'name': 'String', 'long_name': '(i Information)String', 'start_line': 17, 'end_line': 46, 'full_parameters': [], 'filename': '/home/dimi/Documents/Informatik_Studium/FSS/SoftEvo/DataCollection/FFS_SoftEvo/go-ipfs/thirdparty/unit/unit.go', 'top_nesting_level': 0, 'length': 30, 'fan_in': 0, 'fan_out': 0, 'general_fan_out': 0}]",0,0,0,0,0,[],{},()
thirdparty/unit/unit_test.go,22,138,1,"[{'cyclomatic_complexity': 7, 'nloc': 20, 'token_count': 134, 'name': 'TestByteSizeUnit', 'long_name': 'TestByteSizeUnit t * testing . T', 'start_line': 7, 'end_line': 26, 'full_parameters': ['t * testing . T'], 'filename': '/home/dimi/Documents/Informatik_Studium/FSS/SoftEvo/DataCollection/FFS_SoftEvo/go-ipfs/thirdparty/unit/unit_test.go', 'top_nesting_level': 0, 'length': 20, 'fan_in': 0, 'fan_out': 0, 'general_fan_out': 0}]",22,138,1,"[{'cyclomatic_complexity': 7, 'nloc': 20, 'token_count': 134, 'name': 'TestByteSizeUnit', 'long_name': 'TestByteSizeUnit t * testing . T', 'start_line': 7, 'end_line': 26, 'full_parameters': ['t * testing . T'], 'filename': '/home/dimi/Documents/Informatik_Studium/FSS/SoftEvo/DataCollection/FFS_SoftEvo/go-ipfs/thirdparty/unit/unit_test.go', 'top_nesting_level': 0, 'length': 20, 'fan_in': 0, 'fan_out': 0, 'general_fan_out': 0}]",0,0,0,0,0,[],{},()
